author_id,norigins,nretweets,nquotes,nreplies,ntotal
1464109950305771520,32,575,0,7,614
2241016927,386,2,107,48,543
1389852494931525632,2,416,0,3,421
213410859,5,0,2,374,381
1303269337315205120,1,346,1,0,348
1261953016141316096,3,303,0,0,306
252640345,175,85,8,7,275
232726199,221,0,1,34,256
2998154515,20,0,0,230,250
1347290999173697536,1,236,0,0,237
2303377808,215,7,2,0,224
359273665,0,199,0,0,199
1155887881115668480,1,179,0,2,182
851867050461061120,98,6,69,5,178
1301328728769740800,7,135,0,31,173
1498924788034969600,1,151,4,3,159
459549176,0,153,0,0,153
1460038886,0,145,0,5,150
1265977284374102016,2,145,0,0,147
1499435966641352704,1,134,0,0,135
1012874467,0,120,0,2,122
1499807075265875968,0,0,1,118,119
1287075548905316352,3,109,2,3,117
953315170561835008,0,116,0,0,116
817142082666106880,3,0,0,105,108
259975018,5,87,2,6,100
1263316367119441920,2,97,0,0,99
1164624374286159872,0,98,0,0,98
1454733411780861952,0,95,0,0,95
154253449,0,92,0,0,92
1488819687408369664,0,89,0,0,89
1746969764,0,88,0,0,88
874976538218901504,0,85,0,0,85
1352801561466920960,81,0,3,0,84
1411547607940276224,0,83,0,0,83
1021830850357473280,0,79,0,0,79
1277940103566913536,1,78,0,0,79
3263253388,2,69,1,6,78
1306424103549759488,2,73,1,0,76
4662549279,0,72,0,2,74
1548657728746569728,71,0,0,0,71
1061676898638454784,0,71,0,0,71
1317491549635190784,18,1,50,1,70
1497069953362821120,1,67,0,2,70
828440635917160448,1,63,3,3,70
1491449827950882816,3,66,0,0,69
1225227547014615040,15,53,0,0,68
1359425297175564288,0,67,0,0,67
723971829459750912,1,63,0,0,64
1499238291916296192,0,62,0,0,62
3251622968,0,60,0,0,60
1283280987795775488,0,60,0,0,60
2629732851,3,29,5,22,59
824532111386415104,0,58,0,0,58
1361782179387244544,2,54,0,0,56
1942991023,0,56,0,0,56
1118218455805652992,0,56,0,0,56
1152341808426340352,0,54,0,0,54
1322520349683011584,0,52,0,0,52
1498934561249828864,42,2,0,6,50
19341031,0,50,0,0,50
3149547500,0,49,0,0,49
2188862107,0,47,0,0,47
1017377261769625600,0,0,1,46,47
1009259102,0,47,0,0,47
1661793438,0,46,0,0,46
3003544912,1,43,1,0,45
140707607,0,44,0,0,44
1303590288024166400,0,44,0,0,44
387215979,0,43,0,0,43
101386226,16,13,1,13,43
2916094244,0,43,0,0,43
368970616,0,43,0,0,43
313192451,42,0,0,0,42
1491067250715283456,3,39,0,0,42
2695586680,0,42,0,0,42
1455417563073024000,0,42,0,0,42
725902218382069760,1,40,0,0,41
1276871952049885184,0,41,0,0,41
728258539974742016,0,41,0,0,41
1158596220333391872,0,41,0,0,41
1372884056808038400,0,40,0,0,40
923610641033699328,0,40,0,0,40
1385876684994396160,0,40,0,0,40
1244346317276467200,18,16,1,5,40
1476618277338365952,1,0,0,39,40
1266748588375207936,1,39,0,0,40
1489875180822298624,0,40,0,0,40
2217982250,0,40,0,0,40
777154919405002752,0,39,0,0,39
2772643687,0,39,0,0,39
914154426859950080,39,0,0,0,39
1520897450,0,39,0,0,39
4135351574,0,38,0,0,38
409134639,0,38,0,0,38
1487999355626070016,0,37,0,0,37
1536030259,0,37,0,0,37
1073014598171672576,1,35,0,0,36
1394092727948615680,0,0,0,36,36
1446882985916121088,0,36,0,0,36
304914420,0,36,0,0,36
1343791091032629248,2,0,0,34,36
2211840224,0,36,0,0,36
1012234518,0,36,0,0,36
758212869666312192,0,36,0,0,36
1353691169092341760,0,36,0,0,36
1085152847199494144,2,34,0,0,36
1363482556834881536,0,35,0,0,35
1277715645430468608,0,35,0,0,35
1300121269891788800,0,35,0,0,35
1497946112204107776,0,34,1,0,35
944091245273432064,35,0,0,0,35
2346330083,2,32,0,0,34
449587818,0,34,0,0,34
168717964,0,34,0,0,34
1340948993958932480,2,31,0,1,34
157222024,0,34,0,0,34
807184908795813888,0,0,0,34,34
1410242191801397248,0,34,0,0,34
174561640,7,26,0,0,33
1032197793790578688,5,28,0,0,33
1405090486361083904,3,30,0,0,33
157290262,32,1,0,0,33
1487154274899742720,0,33,0,0,33
1120071023829901312,1,32,0,0,33
194583788,0,32,0,0,32
4285104556,2,30,0,0,32
1251771284905754624,0,32,0,0,32
1304531318919716864,0,32,0,0,32
63420095,3,26,3,0,32
826477732523548672,0,32,0,0,32
573581777,0,31,0,0,31
2435380381,31,0,0,0,31
1064353632965939200,1,30,0,0,31
1288743463639494656,0,31,0,0,31
2959982664,0,31,0,0,31
2210529512,0,31,0,0,31
1035264056012169216,0,30,0,0,30
1233379401271738368,0,30,0,0,30
1518179414,1,25,2,2,30
1442078484747079680,0,29,0,0,29
1239719445548974080,2,27,0,0,29
1345104343649943552,1,26,1,1,29
4902835513,0,29,0,0,29
887953992,0,29,0,0,29
1307933329556205568,0,8,0,21,29
125809675,0,29,0,0,29
1466909764311527424,1,0,1,27,29
4309574834,29,0,0,0,29
1254384560617304064,4,19,6,0,29
1020464462673989632,0,28,0,0,28
2613726861,0,28,0,0,28
4092799607,0,28,0,0,28
2493875932,0,26,2,0,28
1198842699304128512,11,17,0,0,28
2226670256,1,27,0,0,28
754621440599687168,0,22,0,6,28
384144428,0,28,0,0,28
1198251901604769792,0,28,0,0,28
4848598031,0,28,0,0,28
798442484,1,26,0,0,27
3006912188,3,22,2,0,27
1009438682514903040,0,27,0,0,27
2907924362,0,27,0,0,27
1318386685470625792,0,27,0,0,27
625758496,0,27,0,0,27
1492430206941814784,0,27,0,0,27
1468582653415010304,1,26,0,0,27
1180580024308703232,0,27,0,0,27
1291629276521881600,0,27,0,0,27
1331657129271422976,0,22,0,4,26
1264954219410358272,0,26,0,0,26
1390532889767399424,0,26,0,0,26
1405062809029804032,0,26,0,0,26
2233329334,0,26,0,0,26
2718787601,0,26,0,0,26
1433375716465418240,0,26,0,0,26
1498066073509588992,0,26,0,0,26
1241775773301653504,0,26,0,0,26
716956588314083328,0,26,0,0,26
826656174615437312,3,21,0,2,26
1424609744,1,4,20,0,25
282985695,0,25,0,0,25
4536997332,0,25,0,0,25
124091966,24,1,0,0,25
3168427454,1,22,0,2,25
1344572635317817344,0,25,0,0,25
1485962686815141888,6,19,0,0,25
429070770,19,0,0,6,25
1258652029389623296,0,24,0,0,24
184440272,0,24,0,0,24
247756527,0,24,0,0,24
1485314174670761984,2,22,0,0,24
1222944019275231232,0,24,0,0,24
1357529126215712768,0,24,0,0,24
391184274,0,24,0,0,24
956825497089998848,0,24,0,0,24
2453069245,0,23,0,0,23
1462848594,0,23,0,0,23
1312355264595554304,0,23,0,0,23
91535323,0,23,0,0,23
1313440740500893696,2,21,0,0,23
1479046036186222592,0,23,0,0,23
1459511881673154560,20,2,1,0,23
1428979851910909952,23,0,0,0,23
1447426514035752960,0,23,0,0,23
1311469512408014848,0,23,0,0,23
3193532793,0,22,0,1,23
1262196439,0,23,0,0,23
825370935205191680,0,23,0,0,23
1356492054419755008,0,23,0,0,23
1213346529622151168,0,23,0,0,23
819934967937560576,0,23,0,0,23
1312269143303880704,0,22,1,0,23
455506488,0,22,0,1,23
1287704194825089024,0,23,0,0,23
729774030950158336,0,23,0,0,23
859773869300862976,0,23,0,0,23
77412644,0,22,0,0,22
1186667134107209728,0,22,0,0,22
1248292698286481408,0,22,0,0,22
1499023793314230272,0,22,0,0,22
2401571502,4,10,0,8,22
2591119002,0,22,0,0,22
1265544027937669120,0,22,0,0,22
482124731,0,22,0,0,22
988376114178547712,0,22,0,0,22
1490758371137536000,0,19,0,3,22
1497377519372468224,2,0,20,0,22
1539150654991646720,1,5,0,16,22
1279507422390910976,0,22,0,0,22
3326930005,0,21,0,0,21
318143888,3,16,2,0,21
1192885841447788544,0,21,0,0,21
823227497118650368,1,20,0,0,21
983281466493820928,0,21,0,0,21
1150633538158510080,0,21,0,0,21
1434567658515673088,0,21,0,0,21
1300518499404582912,0,21,0,0,21
1317037539807514624,0,21,0,0,21
1397804855138295808,0,21,0,0,21
1269194069042966528,15,5,0,1,21
1392549806044684288,0,21,0,0,21
864817195234115584,0,21,0,0,21
1296888938934571008,0,20,0,0,20
948378847455539200,8,12,0,0,20
269758317,8,8,0,4,20
1253188497487192064,0,20,0,0,20
4404957501,5,9,6,0,20
741677155214561280,0,20,0,0,20
1362230919550091264,2,9,1,8,20
1183153675,0,20,0,0,20
1032876796587466752,0,20,0,0,20
1418737554745036800,0,20,0,0,20
1246301905023729664,0,20,0,0,20
978890932761358336,0,20,0,0,20
767108071,1,17,2,0,20
1177965670614609920,0,20,0,0,20
1363917754756182016,4,16,0,0,20
149256036,0,20,0,0,20
3342564448,0,20,0,0,20
1387403197640286208,0,20,0,0,20
726764100118704128,0,20,0,0,20
1341662221009444864,0,20,0,0,20
2323357013,1,19,0,0,20
1275082861993840640,0,20,0,0,20
1485797142321008640,0,0,0,20,20
45513780,6,1,0,13,20
97863560,20,0,0,0,20
3881142327,0,19,0,0,19
1499405452546744320,8,6,5,0,19
1125111055326121984,0,19,0,0,19
1179253358218997760,0,1,18,0,19
1861069266,0,19,0,0,19
1183105193988280320,0,18,1,0,19
2878137990,0,19,0,0,19
2903689263,0,19,0,0,19
1273992009666031616,0,19,0,0,19
1266554533070553088,3,15,1,0,19
2263001041,0,0,0,19,19
354467621,0,19,0,0,19
730012054376075264,19,0,0,0,19
1287039217416065024,0,19,0,0,19
1350745127359156224,0,19,0,0,19
1184895609435635712,0,18,0,0,18
472635887,0,18,0,0,18
3770817040,0,18,0,0,18
1392538034998939648,0,18,0,0,18
1302427846552555520,0,18,0,0,18
3757612212,0,18,0,0,18
2868731347,0,18,0,0,18
1012036551415599104,0,18,0,0,18
582243157,0,18,0,0,18
488187893,0,18,0,0,18
1173660019025276928,5,13,0,0,18
4353714016,0,18,0,0,18
819019776844513280,8,10,0,0,18
1446859443669401600,0,18,0,0,18
381008411,0,15,3,0,18
1147040963833077760,12,0,0,6,18
1497576261874753536,0,18,0,0,18
1444184144808841216,0,18,0,0,18
177296591,0,18,0,0,18
354718815,0,18,0,0,18
1215522177702748160,0,18,0,0,18
1440485862,0,18,0,0,18
1330584463919616000,0,18,0,0,18
43516735,2,16,0,0,18
723614058,0,18,0,0,18
1347764257056673792,0,18,0,0,18
719347830196801536,0,17,0,0,17
761625260944977920,0,17,0,0,17
3816205632,17,0,0,0,17
711834548468715520,0,17,0,0,17
1148473208309350400,1,16,0,0,17
1096123907554316288,0,17,0,0,17
1498584461323030528,0,17,0,0,17
1358245615642181632,0,14,0,3,17
1046760567690711040,0,17,0,0,17
1491602545,0,17,0,0,17
1482683128317550592,0,17,0,0,17
1252099726570217472,0,17,0,0,17
563731594,0,17,0,0,17
1358322425495244800,4,1,2,10,17
1473757606032265216,0,17,0,0,17
1473856175368458240,1,16,0,0,17
1444026508637392896,0,17,0,0,17
1891551493,0,17,0,0,17
18863947,0,17,0,0,17
1319166125150621696,0,17,0,0,17
1308601244282507264,0,17,0,0,17
398383251,0,17,0,0,17
785449001352966144,0,16,0,0,16
1270978218120622080,0,16,0,0,16
2834794321,0,16,0,0,16
941684925052235776,0,16,0,0,16
787300672957878272,0,16,0,0,16
918922001443639296,0,16,0,0,16
878147313260257280,10,6,0,0,16
1280039919570817024,0,16,0,0,16
821586566078459904,0,16,0,0,16
1437286048271380480,16,0,0,0,16
1476101191582900224,0,16,0,0,16
1020586917002391552,0,16,0,0,16
1201783950626177024,1,7,0,8,16
971620109197312000,0,16,0,0,16
2886243601,0,16,0,0,16
1199058601089929216,0,16,0,0,16
927393238540894208,0,16,0,0,16
1253616720666910720,0,16,0,0,16
1031838976607367168,0,16,0,0,16
1359404116489891840,0,0,4,12,16
1349319674929045504,16,0,0,0,16
1217268154516361216,12,1,3,0,16
3259075933,0,16,0,0,16
3240089363,1,15,0,0,16
1247181715661115392,0,16,0,0,16
1492708787140005888,3,10,1,2,16
1249701538672578560,0,0,16,0,16
1309548468172550144,0,16,0,0,16
163162895,0,16,0,0,16
100290058,0,16,0,0,16
1491843286503661568,0,16,0,0,16
1156564868922658816,0,16,0,0,16
1483401003785650176,0,16,0,0,16
1336671768887447552,0,16,0,0,16
795947224446418944,1,13,1,1,16
798099204203839488,0,16,0,0,16
1513027404,0,15,0,0,15
1032806955356545024,0,15,0,0,15
990191941139681280,0,15,0,0,15
1169030688240283648,15,0,0,0,15
1516186346,0,15,0,0,15
1348656464668160000,0,15,0,0,15
1136555258589646848,0,15,0,0,15
971791513867956224,0,15,0,0,15
1164070869913784320,0,15,0,0,15
976351521549021184,0,15,0,0,15
1311890359727710208,0,15,0,0,15
1415776379124305920,0,15,0,0,15
906379123798433792,0,15,0,0,15
1078306880840257536,0,15,0,0,15
3041929291,0,15,0,0,15
185944693,0,15,0,0,15
189418978,0,15,0,0,15
1204128767251230720,0,15,0,0,15
1480824162390142976,0,15,0,0,15
1396796898078388224,0,15,0,0,15
881396172,0,15,0,0,15
482190562,0,15,0,0,15
226324210,2,0,0,13,15
116755366,0,15,0,0,15
725910660157067264,0,15,0,0,15
427324563,0,15,0,0,15
836592921587642368,0,15,0,0,15
1298452564950650880,10,5,0,0,15
1024263721806225408,0,15,0,0,15
1366986802150531072,2,1,7,5,15
1300790941695893504,1,14,0,0,15
1238827349103251456,0,15,0,0,15
733851507695718400,0,15,0,0,15
111680876,0,15,0,0,15
1419344062763606016,0,14,0,0,14
1436034508780761088,0,14,0,0,14
561358190,0,14,0,0,14
1427310851145433088,0,14,0,0,14
845628347325595648,0,13,0,1,14
705110876,0,14,0,0,14
1362397551559852032,0,14,0,0,14
1385195194644148224,1,13,0,0,14
1225515875106684928,0,0,0,14,14
373338620,0,14,0,0,14
1285673281,0,14,0,0,14
3260643408,0,14,0,0,14
3254178188,0,14,0,0,14
3195538819,0,14,0,0,14
154658462,0,14,0,0,14
1480153933389565952,14,0,0,0,14
709269749876654080,0,14,0,0,14
1191722887721431040,0,14,0,0,14
1283114597298429952,0,14,0,0,14
2638759226,2,12,0,0,14
83138732,0,14,0,0,14
82757763,0,12,2,0,14
1472653778528751616,0,14,0,0,14
1298557056815779840,1,8,0,5,14
260802409,0,14,0,0,14
2306915652,0,14,0,0,14
1180776073698652160,13,0,0,1,14
1178749130639675392,0,14,0,0,14
1675006460,0,14,0,0,14
1168254731355115520,0,13,0,1,14
1452230701374451712,4,10,0,0,14
1496786397457432576,14,0,0,0,14
1306413359852449792,1,13,0,0,14
3019397966,0,10,0,4,14
906165406926233600,0,13,1,0,14
906067690154024960,2,12,0,0,14
884749614397751296,0,14,0,0,14
950242659486044160,0,14,0,0,14
1065315362709766144,0,14,0,0,14
1278191177003495424,0,13,0,0,13
1570648068,1,11,1,0,13
1022049842019950592,0,13,0,0,13
431402255,0,13,0,0,13
1382593343574659072,0,13,0,0,13
1276214131058565120,0,13,0,0,13
1328418924979884032,2,7,2,2,13
1311723896526180352,0,13,0,0,13
1024797881293828096,0,13,0,0,13
108265218,5,8,0,0,13
912928123326312448,4,9,0,0,13
280765875,0,13,0,0,13
1013422579665625088,0,13,0,0,13
1243907845705224192,0,13,0,0,13
1327970860351725568,0,13,0,0,13
1143566054448406528,0,13,0,0,13
1491871628619182080,0,13,0,0,13
2670531416,0,8,0,5,13
3124509220,0,13,0,0,13
1953647418,1,12,0,0,13
4849721413,0,13,0,0,13
1393185127497338880,0,13,0,0,13
1728224730,0,13,0,0,13
180395181,0,13,0,0,13
1322153326155198464,0,13,0,0,13
1476606768658534400,0,13,0,0,13
1300685776850767872,0,13,0,0,13
1914136687,0,13,0,0,13
2967448373,1,11,1,0,13
922551450911330304,0,13,0,0,13
1491303318484054016,0,13,0,0,13
955370903537250304,0,13,0,0,13
758319705849524224,13,0,0,0,13
883171838406397952,0,13,0,0,13
1159473255918514176,0,13,0,0,13
781141985151291392,0,13,0,0,13
988322207075045376,0,13,0,0,13
1270273328306098176,0,13,0,0,13
200688599,0,13,0,0,13
1483018398082772992,0,13,0,0,13
917618012,0,13,0,0,13
586914923,0,13,0,0,13
2500233264,0,13,0,0,13
962036089409032192,0,13,0,0,13
1013473632578748416,1,0,0,12,13
1498945622267023360,0,13,0,0,13
63579029,0,12,0,0,12
978713581,0,12,0,0,12
1455380046198329344,2,3,7,0,12
1299826075095236608,0,12,0,0,12
609834284,0,12,0,0,12
2890863350,10,0,1,1,12
988914240483360768,0,12,0,0,12
1291041983960502272,0,12,0,0,12
1324284936,0,12,0,0,12
1447321916314988544,0,12,0,0,12
236417498,0,12,0,0,12
1390240458123579392,0,12,0,0,12
1112169600,0,12,0,0,12
1354106845338730496,0,12,0,0,12
1299997893575749632,0,12,0,0,12
1030796175178432512,0,12,0,0,12
371705126,0,12,0,0,12
1205451580318896128,12,0,0,0,12
196943356,0,12,0,0,12
896308421032648704,0,12,0,0,12
1352842768603697152,0,12,0,0,12
160566531,0,12,0,0,12
1198256276653916160,0,12,0,0,12
65943167,0,12,0,0,12
771820890,0,12,0,0,12
903170373226659840,0,12,0,0,12
82061902,12,0,0,0,12
1334873626642767872,0,12,0,0,12
1185542849414225920,0,12,0,0,12
1472336425,0,12,0,0,12
1274667725193912320,0,12,0,0,12
1165813867747762176,0,12,0,0,12
2897969805,0,12,0,0,12
1221756991,0,12,0,0,12
586413467,0,12,0,0,12
1234163475703746560,1,11,0,0,12
365910585,0,12,0,0,12
1493556982799757312,3,8,0,1,12
954158240,0,12,0,0,12
1261310726,11,0,0,1,12
920335243055214592,0,12,0,0,12
3075233047,1,11,0,0,12
1285134346626760704,0,12,0,0,12
1127162646183272448,0,12,0,0,12
1051649960,0,12,0,0,12
92530794,0,12,0,0,12
1101579491384664064,0,12,0,0,12
875315086759428096,1,11,0,0,12
1410535126526615552,0,12,0,0,12
511821384,3,9,0,0,12
1466963427897733120,0,12,0,0,12
2792610063,0,12,0,0,12
909799895912943616,0,12,0,0,12
860063969603719168,0,12,0,0,12
1490874738805149696,0,12,0,0,12
572341460,0,12,0,0,12
4310695453,1,11,0,0,12
3004679768,9,3,0,0,12
488570848,0,12,0,0,12
1491675241466122240,0,12,0,0,12
2264130177,4,4,4,0,12
1307966731147714560,0,12,0,0,12
3114693488,0,11,0,0,11
927224808,2,9,0,0,11
710221315,0,11,0,0,11
1336012139278913536,0,11,0,0,11
1436297215371145216,0,11,0,0,11
1389093227798712320,2,7,2,0,11
2785332022,0,11,0,0,11
1627810940,0,11,0,0,11
1237616817570537472,0,11,0,0,11
918813768418775040,1,10,0,0,11
1285156706415149056,0,11,0,0,11
235926498,0,11,0,0,11
158213538,0,11,0,0,11
3393130394,0,11,0,0,11
1249995549652082688,0,11,0,0,11
1344330130131353600,0,11,0,0,11
1227273954655522816,0,11,0,0,11
2246488225,0,11,0,0,11
1066520393287168000,0,11,0,0,11
1459587695005495296,1,10,0,0,11
326724298,0,11,0,0,11
1496043125739261952,0,11,0,0,11
1346328559128756224,0,11,0,0,11
291577292,0,11,0,0,11
1061310119886110720,0,11,0,0,11
289242650,0,11,0,0,11
1131834896115126272,0,11,0,0,11
1253157012,2,9,0,0,11
1248759402,0,0,6,5,11
239304636,4,0,4,3,11
289221148,0,11,0,0,11
3238095595,0,11,0,0,11
53752278,0,11,0,0,11
2870827412,2,8,1,0,11
1159864875927187456,0,11,0,0,11
831758977,0,11,0,0,11
146908825,0,11,0,0,11
1076897248758222848,0,11,0,0,11
1469626217141653504,0,11,0,0,11
1268480863496556544,0,11,0,0,11
1944484520,0,11,0,0,11
458468113,3,4,4,0,11
1296130483495907328,6,5,0,0,11
1324202905419702272,0,11,0,0,11
1395064048690028544,0,11,0,0,11
847275061337669632,0,11,0,0,11
844119324789035008,0,11,0,0,11
100486104,0,11,0,0,11
1320819648930193408,4,0,6,1,11
1288221158223962112,0,11,0,0,11
788051161362423808,0,11,0,0,11
192517432,2,8,0,1,11
1282702180693221376,11,0,0,0,11
795678827305279488,0,10,1,0,11
973935135916740608,0,11,0,0,11
339682523,0,11,0,0,11
121237555,0,11,0,0,11
1497873200255959040,0,11,0,0,11
1477777971436003328,0,11,0,0,11
386111756,0,11,0,0,11
1094579073517580288,11,0,0,0,11
780380422278619136,0,11,0,0,11
38630618,11,0,0,0,11
1341327785575522304,0,11,0,0,11
1058773558719991808,1,10,0,0,11
1499301686732476416,0,11,0,0,11
1496908632759234560,8,1,1,1,11
1483799559490846720,11,0,0,0,11
1374429465237852160,10,0,0,0,10
1341686180,0,10,0,0,10
1371080189950713856,0,10,0,0,10
414221776,0,10,0,0,10
1066860162152050688,0,10,0,0,10
755208011031810048,0,0,10,0,10
4718962452,0,10,0,0,10
1498465106153279488,0,10,0,0,10
51014850,0,10,0,0,10
221928782,0,10,0,0,10
895924695400198144,0,10,0,0,10
785197196127924224,1,9,0,0,10
371626659,0,10,0,0,10
241879012,0,10,0,0,10
1101133441435754496,0,0,0,10,10
1514099517754417152,10,0,0,0,10
55472950,0,10,0,0,10
979850508,0,10,0,0,10
1121989218,0,10,0,0,10
1352498679765114880,0,10,0,0,10
1079226419408982016,0,10,0,0,10
2993900105,0,10,0,0,10
817884018,2,5,0,3,10
1260195764946587648,0,10,0,0,10
772338686746689536,0,10,0,0,10
768798676491853824,1,9,0,0,10
3398865573,0,10,0,0,10
2255339388,0,10,0,0,10
2592660002,0,10,0,0,10
1434092692666044416,0,10,0,0,10
1218744945583906816,0,9,0,1,10
1379123293232328704,9,0,0,1,10
1275155331849629696,0,10,0,0,10
1498202239218982912,1,2,6,1,10
2699984065,0,10,0,0,10
1133275772934938624,0,10,0,0,10
924968395216441344,0,10,0,0,10
1696446428,0,10,0,0,10
4492362135,0,10,0,0,10
1951019052,0,10,0,0,10
1400774739497394176,0,10,0,0,10
1468518444794400768,0,10,0,0,10
3840887835,0,10,0,0,10
830619040963899392,0,10,0,0,10
966620922630299648,1,9,0,0,10
120701342,0,10,0,0,10
1211616052339036160,0,10,0,0,10
969340007738724352,0,10,0,0,10
837260004809900032,0,10,0,0,10
1499112898144370688,10,0,0,0,10
140314060,0,10,0,0,10
1483234885179432960,0,10,0,0,10
4920420859,3,7,0,0,10
836074834467545088,0,5,5,0,10
629933900,0,10,0,0,10
853572644465201152,0,10,0,0,10
1492554015363964928,0,10,0,0,10
1086623732918046720,0,10,0,0,10
2433481014,0,10,0,0,10
39531926,0,10,0,0,10
864445608559468544,3,7,0,0,10
1300769978883256320,0,10,0,0,10
1135146597367537664,0,10,0,0,10
1457583758324887552,0,10,0,0,10
1498342080787193856,0,10,0,0,10
1244877144964169728,0,10,0,0,10
478504580,0,10,0,0,10
2210379942,0,10,0,0,10
1499232727631294464,2,8,0,0,10
1121426228513320960,0,10,0,0,10
1427857326,0,10,0,0,10
8526952,0,10,0,0,10
1336857549908262912,0,10,0,0,10
1449910156637216768,0,10,0,0,10
904047154997719040,10,0,0,0,10
2147850506,0,7,1,1,9
1299563345201082368,0,9,0,0,9
1356631030166249472,8,0,0,1,9
375437357,0,9,0,0,9
4881765863,0,9,0,0,9
1490628179719254016,0,9,0,0,9
1272232182044430336,0,9,0,0,9
1209934709993558016,0,9,0,0,9
1465739751479078912,0,9,0,0,9
1479718556992303104,6,2,0,1,9
1325135754369110016,0,9,0,0,9
1161907035484622848,0,9,0,0,9
1441789211451949056,0,9,0,0,9
1515661769607372800,9,0,0,0,9
926553976312684544,0,9,0,0,9
1069844060104478720,0,9,0,0,9
1685640846,0,9,0,0,9
1267779989648420864,6,3,0,0,9
18735955,0,9,0,0,9
3722301080,0,9,0,0,9
346694590,0,9,0,0,9
16263066,1,7,1,0,9
311338364,0,9,0,0,9
2166040802,9,0,0,0,9
1470762079145521152,0,9,0,0,9
1333270891573067776,0,9,0,0,9
2479740884,0,9,0,0,9
1313406417089556480,0,9,0,0,9
2475858078,0,9,0,0,9
1342925471290372096,0,9,0,0,9
1372789634,0,9,0,0,9
75233270,0,9,0,0,9
1379464873,0,9,0,0,9
1495236778428559360,0,1,5,3,9
1251742033670107136,0,9,0,0,9
119464565,0,9,0,0,9
939694624020598784,0,9,0,0,9
1180168114069295104,2,7,0,0,9
1080146564667068416,5,4,0,0,9
1331969851410231296,0,9,0,0,9
1319679199,0,9,0,0,9
938930514274258944,0,9,0,0,9
1211913726908985344,0,9,0,0,9
1309028643759443968,0,9,0,0,9
1300841239881760768,0,9,0,0,9
1252384533409927168,0,9,0,0,9
1269275550020927488,3,4,2,0,9
1447503320097165312,0,9,0,0,9
1327238704461561856,0,9,0,0,9
1328266128133537792,8,0,0,1,9
4256376808,0,9,0,0,9
2999478886,0,9,0,0,9
707910187248525312,0,9,0,0,9
1267647740642643968,0,9,0,0,9
1253276042,0,9,0,0,9
1191633531459342336,0,9,0,0,9
2835780014,4,5,0,0,9
1158399252575354880,0,9,0,0,9
1490771051512762368,7,1,1,0,9
224200861,3,2,0,4,9
452327968,0,9,0,0,9
1263161014201114624,0,9,0,0,9
2796521062,0,9,0,0,9
1364075237961211904,0,9,0,0,9
1147752489493491712,0,9,0,0,9
1417850839910162432,0,9,0,0,9
1062772479209304064,0,9,0,0,9
1149741418996330496,0,9,0,0,9
1280019052455268352,0,9,0,0,9
452461529,0,9,0,0,9
1097822775853477888,0,9,0,0,9
880615525444853760,0,9,0,0,9
1064125399247011840,0,9,0,0,9
2765853637,9,0,0,0,9
1029113423714377728,0,9,0,0,9
831190424320622592,0,9,0,0,9
1065145301550288896,0,9,0,0,9
1387555327046979584,0,9,0,0,9
712949643,0,9,0,0,9
874505142,0,9,0,0,9
2996457280,0,9,0,0,9
1435088516610936832,0,0,0,9,9
724519225,0,9,0,0,9
3032515753,0,4,5,0,9
1097137252944224256,0,9,0,0,9
1385014878503645184,0,9,0,0,9
1431093200161280000,0,9,0,0,9
822666445184176128,0,9,0,0,9
1381306459187785728,0,9,0,0,9
406943930,0,9,0,0,9
1497441279176851456,0,9,0,0,9
1096159671671549952,0,9,0,0,9
1360787422334844928,0,9,0,0,9
521658594,0,9,0,0,9
1279555966988513280,0,9,0,0,9
379082219,0,8,1,0,9
482920851,0,9,0,0,9
1117152110330765312,1,6,0,2,9
1527802640637100032,1,0,1,7,9
1439809986306056192,1,8,0,0,9
187113999,0,9,0,0,9
3010827654,0,9,0,0,9
480660323,0,9,0,0,9
947687439597891584,0,0,0,8,8
1480627477,0,8,0,0,8
2224187462,8,0,0,0,8
427257284,0,8,0,0,8
14741039,0,8,0,0,8
276483767,8,0,0,0,8
719374388,0,8,0,0,8
1186907791497277440,0,8,0,0,8
1273102180711571456,0,7,1,0,8
1563186870,0,8,0,0,8
1078662855870693376,0,8,0,0,8
328074637,0,8,0,0,8
1134668128489656320,0,8,0,0,8
1499284680943669248,0,5,0,3,8
1568743130,0,8,0,0,8
3011941428,0,8,0,0,8
106697439,0,8,0,0,8
1490318161551704064,2,6,0,0,8
1189038295214243840,0,8,0,0,8
1478207496628039680,2,1,0,5,8
1497505040285720576,8,0,0,0,8
1183442914896015360,6,2,0,0,8
1392603206,0,8,0,0,8
1088895672286363648,4,4,0,0,8
1337209535006527488,3,4,1,0,8
1296150766663671808,0,8,0,0,8
947689621776945152,0,8,0,0,8
79469151,0,8,0,0,8
341469464,2,6,0,0,8
1263923764384817152,1,7,0,0,8
2782385865,0,8,0,0,8
1266724225445920768,0,8,0,0,8
1402298409168551936,8,0,0,0,8
776426744,0,8,0,0,8
1405054701435904000,0,8,0,0,8
1251221853127028736,0,8,0,0,8
888727100093591552,0,8,0,0,8
903275353874939904,0,8,0,0,8
1453270633,0,8,0,0,8
963090290528563200,0,8,0,0,8
2435967874,3,0,0,5,8
1263868941744496640,0,8,0,0,8
1191985681943293952,0,8,0,0,8
1272448775462637568,0,8,0,0,8
848814775538769920,0,8,0,0,8
1491238729088106496,1,7,0,0,8
837707214349549568,8,0,0,0,8
43127687,0,8,0,0,8
2161269692,0,8,0,0,8
3699599177,0,8,0,0,8
178628673,0,8,0,0,8
1257722892793417728,0,8,0,0,8
1005529664008306688,0,8,0,0,8
568857221,0,8,0,0,8
1422542239826432000,1,7,0,0,8
4803638526,2,0,0,6,8
1492005475616845824,0,8,0,0,8
843144506144907264,0,8,0,0,8
966645057787801600,0,8,0,0,8
930827090966011904,0,8,0,0,8
850342645062930432,4,4,0,0,8
279868489,0,8,0,0,8
1262193302830411776,0,8,0,0,8
1122060907553742848,4,4,0,0,8
100937348,0,8,0,0,8
1017191141760876544,0,8,0,0,8
915946533673099264,0,8,0,0,8
1004981806985367552,0,8,0,0,8
1458952606135562240,0,8,0,0,8
1386718613155893248,7,1,0,0,8
622886215,0,6,0,2,8
1311317379419439104,0,8,0,0,8
1480193755336429568,0,8,0,0,8
1489821004880695296,2,6,0,0,8
27013240,0,0,0,8,8
1302284557249470464,1,7,0,0,8
138839349,0,8,0,0,8
1493295960822530048,8,0,0,0,8
1493286034670747648,0,8,0,0,8
1328288561406373888,0,8,0,0,8
1021141971535122432,0,8,0,0,8
1467078995737026560,0,8,0,0,8
1248132407498125312,4,4,0,0,8
1220254064262303744,0,8,0,0,8
140111029,2,4,1,1,8
2953633502,0,8,0,0,8
4508344428,1,6,1,0,8
2175337530,0,0,0,8,8
1103363068132655104,0,8,0,0,8
1019637275620233216,0,7,0,1,8
1111867154754949120,0,8,0,0,8
1009862954223718400,0,8,0,0,8
1385709282,0,8,0,0,8
1450813308576014336,0,8,0,0,8
759998681860845568,0,8,0,0,8
1026876828139413504,1,7,0,0,8
1343966620549406720,0,8,0,0,8
1198203523,0,8,0,0,8
4113518177,0,8,0,0,8
1168575116772429824,0,8,0,0,8
753057467496558592,0,8,0,0,8
1499881559809478656,8,0,0,0,8
1368680105665519616,0,8,0,0,8
1480971430439313408,0,8,0,0,8
1086545700,1,7,0,0,8
1521804074693402624,8,0,0,0,8
1445835856942485504,1,6,0,1,8
1161671424794222592,0,8,0,0,8
929983970523017216,0,8,0,0,8
1264377841279475712,0,4,0,4,8
3046006507,0,8,0,0,8
795626222562775040,0,8,0,0,8
1254137127476101120,0,8,0,0,8
370060892,0,8,0,0,8
1477574960109342720,8,0,0,0,8
1445269736686698496,0,8,0,0,8
992631124127043584,7,0,0,1,8
501397421,0,8,0,0,8
1068113213819158528,0,8,0,0,8
1299021534,0,8,0,0,8
114184679,8,0,0,0,8
1152583689659809792,0,8,0,0,8
1303938558999187456,0,8,0,0,8
2946638923,0,8,0,0,8
985595625503907840,0,8,0,0,8
1463602990791622656,0,0,0,8,8
748564326794006528,0,8,0,0,8
1264855668466438144,0,8,0,0,8
815053423930245120,1,7,0,0,8
929584380304961536,0,8,0,0,8
1443885804879704064,1,7,0,0,8
919915692375330816,0,8,0,0,8
1147868343443042304,0,8,0,0,8
791914265078665216,4,3,1,0,8
1031845399,0,0,0,8,8
1227868981,1,0,0,7,8
3355671952,0,8,0,0,8
1072468186019364864,0,8,0,0,8
1218511241926397952,0,8,0,0,8
1255315345,8,0,0,0,8
1304695088660971520,0,8,0,0,8
920587616,1,0,0,7,8
1260015280048222208,0,8,0,0,8
1457204915533533184,0,7,0,0,7
116572628,0,7,0,0,7
1869889452,0,7,0,0,7
206001327,2,5,0,0,7
1673529085,0,7,0,0,7
1321701505527803904,0,7,0,0,7
1105550193263546368,0,7,0,0,7
2942068323,0,7,0,0,7
1670249780,0,7,0,0,7
17686959,0,7,0,0,7
3221566268,1,5,1,0,7
1165220587666460672,5,2,0,0,7
1492363714586361856,0,7,0,0,7
943148599591833600,1,5,0,1,7
1699198255,0,7,0,0,7
967955693180473344,0,7,0,0,7
1477909909006012416,0,7,0,0,7
229436006,0,7,0,0,7
1292095370655301632,2,5,0,0,7
840009957726662656,0,7,0,0,7
1032613201949540352,0,7,0,0,7
1101660648977575936,0,7,0,0,7
774979118685446144,0,7,0,0,7
1287260824428371968,0,7,0,0,7
1740733466,0,7,0,0,7
2722645802,0,7,0,0,7
527150544,0,7,0,0,7
843528505417777152,0,7,0,0,7
1694414149,2,0,0,5,7
1322114553694412800,0,7,0,0,7
2585692510,0,3,4,0,7
1202153545786544128,0,7,0,0,7
392076897,0,7,0,0,7
2925267913,0,7,0,0,7
1349708108914950144,5,2,0,0,7
494756647,0,7,0,0,7
1310928050087960576,0,7,0,0,7
923439691667353600,0,7,0,0,7
1314867574291787776,0,6,1,0,7
1488300575016030208,3,4,0,0,7
1421129881505583104,7,0,0,0,7
785523420414947328,0,7,0,0,7
290483042,0,7,0,0,7
1401413449616289792,0,7,0,0,7
1261186473186996224,2,5,0,0,7
197573623,0,7,0,0,7
1083550278031269888,3,2,1,1,7
1242006848242429952,0,7,0,0,7
1460069261745995776,0,7,0,0,7
1278047278104809472,0,7,0,0,7
1031279588381548544,0,7,0,0,7
3889532472,0,7,0,0,7
1542240495845478400,0,4,1,2,7
2566646988,0,7,0,0,7
1039122331,7,0,0,0,7
2228315983,7,0,0,0,7
1247369235031973888,0,7,0,0,7
281387770,0,7,0,0,7
57375140,0,0,0,7,7
104508438,0,7,0,0,7
793473129112674304,0,7,0,0,7
4709525004,0,7,0,0,7
1246359066290479104,0,7,0,0,7
574598423,0,7,0,0,7
1319903481486950400,0,7,0,0,7
1287363539288518656,0,7,0,0,7
957792169107976192,0,7,0,0,7
1207896237560582144,0,7,0,0,7
1311098876498259968,0,7,0,0,7
382539589,0,7,0,0,7
1422623322572050432,0,7,0,0,7
1117912317637718016,0,7,0,0,7
987180025484136448,0,7,0,0,7
1481503882224476160,0,7,0,0,7
4594396524,2,5,0,0,7
853803156098207744,0,7,0,0,7
2158338572,0,7,0,0,7
1221436171001057280,0,7,0,0,7
855006163322245120,0,7,0,0,7
37951988,0,7,0,0,7
1355222390414794752,0,7,0,0,7
1421617781691363328,0,7,0,0,7
1496778245580406784,0,7,0,0,7
3165150723,0,7,0,0,7
4860818217,0,7,0,0,7
311436824,0,7,0,0,7
1125752275928883200,0,7,0,0,7
1385458645199163392,7,0,0,0,7
1495581178333523968,0,7,0,0,7
1480794166854447104,0,1,0,6,7
48372776,0,7,0,0,7
811653822128996352,7,0,0,0,7
951757302754717696,0,7,0,0,7
729218838160654336,5,2,0,0,7
1381126059840602112,0,7,0,0,7
50938081,4,0,0,3,7
405363489,1,5,1,0,7
2485308468,0,7,0,0,7
1479711061,0,7,0,0,7
1043822244189765632,0,7,0,0,7
2430771937,2,4,0,1,7
1266323313049186304,0,7,0,0,7
1497204877717811200,0,7,0,0,7
996985852365504512,0,1,1,5,7
402187717,0,7,0,0,7
1332024399835389952,7,0,0,0,7
1318393015,0,7,0,0,7
1297471936172195840,3,0,4,0,7
876723647230091264,0,7,0,0,7
1314361747,0,1,6,0,7
259802562,0,7,0,0,7
1380165075269525504,0,7,0,0,7
1176824656843534336,0,7,0,0,7
1237397462333009920,0,7,0,0,7
1238264690880503808,0,7,0,0,7
348579429,0,7,0,0,7
1307391684909690880,0,7,0,0,7
1413889154157629440,0,7,0,0,7
747726756803641344,0,7,0,0,7
826971452,0,7,0,0,7
816802917093167104,0,4,1,2,7
1273125293822181376,0,7,0,0,7
1043039509682835456,0,7,0,0,7
806845656,0,7,0,0,7
1377965149,1,4,0,2,7
2341350087,0,7,0,0,7
2469561373,1,6,0,0,7
1424741372,0,7,0,0,7
1258823700700266496,1,5,0,1,7
1256078998519476224,0,7,0,0,7
1448009188404338688,0,7,0,0,7
3926156714,0,7,0,0,7
2456633918,1,6,0,0,7
1481830108113809408,0,7,0,0,7
1183054440447795200,0,7,0,0,7
1435272576,5,2,0,0,7
851226151,1,6,0,0,7
2279875495,3,0,0,4,7
758709829066252288,0,7,0,0,7
1497602067397021696,0,7,0,0,7
1388013496344924160,0,7,0,0,7
1468190090862088192,0,6,0,1,7
1487940731000209408,0,7,0,0,7
1593605090,0,7,0,0,7
1596162080,0,7,0,0,7
317223956,0,7,0,0,7
1298870368325664768,0,7,0,0,7
275473645,0,7,0,0,7
1609894374,0,7,0,0,7
1487691460510384128,0,7,0,0,7
898859759947833344,0,6,0,1,7
1263436276071571456,0,7,0,0,7
2588792030,0,7,0,0,7
1003215786427772928,0,7,0,0,7
1027021238047137792,0,7,0,0,7
1644798937,0,7,0,0,7
815729427493613568,0,7,0,0,7
2500055300,0,7,0,0,7
246820262,0,7,0,0,7
1349204915516796928,0,7,0,0,7
1126585182100774912,1,6,0,0,7
1650299124,0,7,0,0,7
94981004,1,6,0,0,7
2493214662,0,7,0,0,7
1239257943985569792,0,7,0,0,7
1330027824120414208,0,7,0,0,7
713086926207787008,0,7,0,0,7
716922000304840704,0,7,0,0,7
1298889751,4,3,0,0,7
1330869580131086336,0,7,0,0,7
401295614,0,3,4,0,7
716104938,0,4,3,0,7
1132068723664097280,0,1,1,5,7
1267540478,0,7,0,0,7
1366798738698731520,0,7,0,0,7
1252321484388745216,1,2,4,0,7
1330161924265439232,0,7,0,0,7
1573759129,0,7,0,0,7
2405441950,0,7,0,0,7
1170414881956225024,0,7,0,0,7
1575096062,0,7,0,0,7
194913333,0,7,0,0,7
69558002,0,7,0,0,7
993258423939665920,0,7,0,0,7
709678650304634880,0,7,0,0,7
2931865536,0,7,0,0,7
1486589983175544832,0,5,1,0,6
2348851509,0,6,0,0,6
269737794,1,5,0,0,6
1302471540408111104,0,6,0,0,6
1055758398233415680,0,6,0,0,6
3915424275,0,6,0,0,6
1465880604642263040,0,6,0,0,6
223610043,0,6,0,0,6
1223557637595418624,5,0,0,1,6
3891851195,0,6,0,0,6
3224904662,0,6,0,0,6
1489191140335124480,0,6,0,0,6
2459963732,0,6,0,0,6
1470168873278205952,0,6,0,0,6
3420643156,3,1,2,0,6
1227888711309774848,1,5,0,0,6
1227930199951462400,0,6,0,0,6
950370560730714112,0,6,0,0,6
2813097318,0,6,0,0,6
2496708457,0,6,0,0,6
924959083224059904,0,6,0,0,6
949328078580469760,0,6,0,0,6
3192397735,0,6,0,0,6
3196432411,0,6,0,0,6
2512897836,0,6,0,0,6
239914045,0,6,0,0,6
2513498819,0,6,0,0,6
1287347720693243904,0,6,0,0,6
1236214237799878656,0,5,0,1,6
2576960380,0,6,0,0,6
2526367077,0,6,0,0,6
2807799074,0,6,0,0,6
1289542546000154624,0,6,0,0,6
1060071098211954688,0,6,0,0,6
214903184,0,6,0,0,6
3300122833,0,6,0,0,6
251318959,0,6,0,0,6
1299275479510253568,1,5,0,0,6
1278334848294244352,0,6,0,0,6
954997485310689280,0,6,0,0,6
1487163576603365376,0,6,0,0,6
2380134303,1,0,0,5,6
1487286456871575552,0,6,0,0,6
2724785876,0,6,0,0,6
3736933170,0,6,0,0,6
2387298926,0,6,0,0,6
229852129,0,6,0,0,6
946596573739335680,0,6,0,0,6
140463914,0,4,0,2,6
136836015,0,6,0,0,6
1062190145103949824,1,5,0,0,6
952506322854924288,2,4,0,0,6
1239209539821547520,0,6,0,0,6
949692936614285312,1,3,2,0,6
3619139954,0,6,0,0,6
1297554276286423040,0,6,0,0,6
1297487389477175296,0,6,0,0,6
1489478521747644416,0,6,0,0,6
1061681464348164096,0,6,0,0,6
1238376629992329216,0,6,0,0,6
1233087503692943360,0,6,0,0,6
2654,0,6,0,0,6
1303626399199031296,0,6,0,0,6
1433327066917715968,1,5,0,0,6
1148789555224408064,0,6,0,0,6
3049002434,0,6,0,0,6
1498850454423228416,6,0,0,0,6
1365531977097437184,0,1,0,5,6
1095692147787993088,0,6,0,0,6
400528800,0,6,0,0,6
1142317979129933824,1,5,0,0,6
407096546,0,6,0,0,6
840951744,0,6,0,0,6
1255721368655560704,0,6,0,0,6
1373237155565203456,4,0,0,2,6
771405105321025536,0,6,0,0,6
1374035683719843840,0,6,0,0,6
1374289180705107968,0,6,0,0,6
813735050,0,6,0,0,6
1481875161574182912,0,6,0,0,6
1137569301869793280,0,6,0,0,6
1497392734117986304,0,5,1,0,6
778633622,0,6,0,0,6
1381641098179846144,0,6,0,0,6
756652620,0,6,0,0,6
1096863151629320192,5,0,1,0,6
1436279882741338112,0,6,0,0,6
1027727549550526464,0,6,0,0,6
1361777486502256640,1,5,0,0,6
800751764408397824,0,6,0,0,6
1443861761854218240,1,0,0,5,6
1054979864556695552,0,6,0,0,6
775773546559725568,0,6,0,0,6
775902971632771072,0,6,0,0,6
981830681612378112,0,6,0,0,6
364862323,1,5,0,0,6
1158104882,0,6,0,0,6
1496733531698970624,0,6,0,0,6
1092456012697620480,1,5,0,0,6
1252987529869099008,0,6,0,0,6
1356420453317885952,0,6,0,0,6
1159877876704899072,0,6,0,0,6
1253009837249576960,1,5,0,0,6
1159073813046452224,0,6,0,0,6
1356888997335818240,0,6,0,0,6
794881706973163520,0,6,0,0,6
1004023152,0,5,0,1,6
989004355,1,0,0,5,6
1153666548139208704,0,6,0,0,6
1254172413119606784,3,2,0,1,6
2940998967,1,5,0,0,6
716048570,0,6,0,0,6
828168851045044224,2,0,0,4,6
1386925588812812288,0,6,0,0,6
885003445765378048,0,6,0,0,6
467425990,0,6,0,0,6
884799874172043264,2,4,0,0,6
3019240220,0,6,0,0,6
884692804139601920,0,6,0,0,6
861051552819281920,1,5,0,0,6
1109910306040528896,0,6,0,0,6
1109470155992690688,0,6,0,0,6
2982265688,0,6,0,0,6
933942256511238144,4,0,2,0,6
552686000,0,6,0,0,6
869209208037584896,6,0,0,0,6
1418335753625538560,0,6,0,0,6
1260374309454983168,0,6,0,0,6
2988100237,0,6,0,0,6
1417891261415976960,0,6,0,0,6
876429323804315648,1,5,0,0,6
520085140,0,6,0,0,6
1100585930799366144,0,6,0,0,6
1498596538502856704,0,6,0,0,6
1415575966965932032,0,6,0,0,6
1101022981608869888,0,5,0,1,6
3019754096,1,5,0,0,6
1396143051991519232,0,6,0,0,6
1429476781833084928,1,5,0,0,6
1424572154784321536,0,6,0,0,6
708731558,0,6,0,0,6
1387682981951594496,0,6,0,0,6
1483377650446266368,3,3,0,0,6
2955514424,0,6,0,0,6
1127828716019752960,2,3,0,1,6
181457332,0,6,0,0,6
1427482797636083712,0,6,0,0,6
1004853192688132096,0,6,0,0,6
450602670,0,6,0,0,6
1125686983269818368,4,2,0,0,6
1124879907933306880,6,0,0,0,6
42247052,0,6,0,0,6
1497952556529631232,0,6,0,0,6
168496628,1,5,0,0,6
1497983477072814080,0,6,0,0,6
1425485486169104384,0,6,0,0,6
842235402530508800,0,6,0,0,6
1007342417828343808,0,6,0,0,6
1483327359306846208,0,6,0,0,6
11076222,0,6,0,0,6
844022138688299008,0,6,0,0,6
1220038958,0,6,0,0,6
1349377050319101952,0,5,1,0,6
16362364,0,6,0,0,6
297348953,6,0,0,0,6
1319458817185247232,0,6,0,0,6
4695725899,0,6,0,0,6
4715574015,0,6,0,0,6
4733583798,1,0,0,5,6
1914081854,1,0,0,5,6
1456595171336855552,0,6,0,0,6
908294240039452672,0,6,0,0,6
4775000292,0,6,0,0,6
1857092954,0,6,0,0,6
1322706074596634624,0,6,0,0,6
1480158311718653952,6,0,0,0,6
1455031729782153216,0,6,0,0,6
4879752875,0,6,0,0,6
1454980493859069952,0,6,0,0,6
1646145848,0,6,0,0,6
906345676744871936,0,6,0,0,6
321810099,0,6,0,0,6
156552819,0,6,0,0,6
1574805500,6,0,0,0,6
1493551468703784960,0,6,0,0,6
770501436861886464,1,5,0,0,6
966769248491143168,6,0,0,0,6
2158511320,0,6,0,0,6
715705694683598848,0,6,0,0,6
1499255398435414016,3,2,0,1,6
1303914508746813440,0,6,0,0,6
4047630333,6,0,0,0,6
3163163533,6,0,0,0,6
1217380344581607424,0,6,0,0,6
1306892598594932736,0,6,0,0,6
4145806462,6,0,0,0,6
4148123788,0,6,0,0,6
276337225,0,6,0,0,6
111970180,0,6,0,0,6
277202090,0,6,0,0,6
4186843694,0,6,0,0,6
1310119891278745600,1,5,0,0,6
1082978387285721088,0,6,0,0,6
2222331694,0,6,0,0,6
283711318,0,6,0,0,6
2882303019,0,6,0,0,6
927821885139800064,0,6,0,0,6
2198992002,0,6,0,0,6
965826890589261824,0,6,0,0,6
2883218436,0,6,0,0,6
910303613712568320,0,6,0,0,6
713248506451009536,0,6,0,0,6
1182911657569378304,0,6,0,0,6
928469344715022336,0,6,0,0,6
768569699466616832,0,6,0,0,6
1388379944,0,6,0,0,6
748114524448907264,6,0,0,0,6
1178258033689931776,6,0,0,0,6
748940448044027904,0,6,0,0,6
716093536567820288,0,6,0,0,6
1447021099468738560,0,6,0,0,6
976074469587476480,1,5,0,0,6
977041047233720320,0,6,0,0,6
1343908646971867136,0,6,0,0,6
78366219,0,6,0,0,6
1246611493,0,6,0,0,6
1176465186607239168,0,6,0,0,6
1446166886601793536,0,6,0,0,6
353845281,0,6,0,0,6
72684950,0,6,0,0,6
1034676374328492032,0,6,0,0,6
1311136712,0,6,0,0,6
1171975180144349184,0,6,0,0,6
348056117,0,6,0,0,6
741025512236146688,6,0,0,0,6
1044800931022290944,0,6,0,0,6
1501557173826256896,6,0,0,0,6
1560837110,0,6,0,0,6
1560390764,0,6,0,0,6
1239649664,0,6,0,0,6
1553022080,6,0,0,0,6
1267496205199654912,1,1,3,1,6
68325989,0,6,0,0,6
1528640719,0,6,0,0,6
740891047811796992,0,6,0,0,6
1306879213,6,0,0,0,6
904671781243543552,0,6,0,0,6
3100116710,0,6,0,0,6
1348295527339757568,0,6,0,0,6
769065990823022592,0,0,0,6,6
1067698179104137216,3,3,0,0,6
340128155,0,6,0,0,6
736676996227334144,0,6,0,0,6
1270844193028501504,5,0,0,0,5
2925414141,0,5,0,0,5
1259853638937333760,0,5,0,0,5
188238112,0,5,0,0,5
1273710209387487232,0,5,0,0,5
941714418391535616,0,5,0,0,5
1266630609092268032,0,5,0,0,5
1274175577402929152,0,5,0,0,5
2854467582,5,0,0,0,5
2889521155,0,5,0,0,5
1480115522507132928,0,5,0,0,5
2800466323,0,5,0,0,5
2896967070,0,5,0,0,5
1267521801325813760,0,5,0,0,5
2840247948,1,4,0,0,5
1481995272662450176,2,3,0,0,5
1593224094,0,5,0,0,5
221403183,0,5,0,0,5
962654210,0,5,0,0,5
1044102055,0,5,0,0,5
1357466606541152256,2,3,0,0,5
1357650567938605056,0,5,0,0,5
1358020672702713856,0,5,0,0,5
987592927680622592,0,5,0,0,5
1438359286925586432,0,5,0,0,5
1359410298780717056,0,5,0,0,5
1029281928615284736,0,5,0,0,5
1448964062524497920,0,4,0,1,5
907376150,3,2,0,0,5
887148163,0,5,0,0,5
1435479912312307712,0,5,0,0,5
865126033,0,4,1,0,5
843131348,5,0,0,0,5
840316327,1,2,0,2,5
1377555655507185664,0,5,0,0,5
1356664355614556160,0,5,0,0,5
1356647682920636416,0,5,0,0,5
1066367234,0,5,0,0,5
1356138049973878784,0,5,0,0,5
1336242663515856896,0,5,0,0,5
1448152268746805248,2,1,2,0,5
352848671,0,3,1,1,5
1344009514987651072,0,5,0,0,5
353239455,0,5,0,0,5
978959644352794624,0,5,0,0,5
1307209206,0,5,0,0,5
1444678737899843584,0,5,0,0,5
1199052942,0,5,0,0,5
1351556474451886080,0,5,0,0,5
1148408072,0,5,0,0,5
1142621900,0,5,0,0,5
16125790,1,4,0,0,5
1114685454,5,0,0,0,5
1355699700653907968,0,5,0,0,5
1432432607640231936,1,4,0,0,5
420286391,0,5,0,0,5
424084271,0,5,0,0,5
560715688,0,5,0,0,5
1402607609442492416,0,5,0,0,5
478394410,0,5,0,0,5
1010926987009974272,0,5,0,0,5
1418489468198154240,3,2,0,0,5
488101851,1,4,0,0,5
488334214,0,5,0,0,5
526566088,0,5,0,0,5
520258577,0,5,0,0,5
520212741,0,0,0,5,5
1417182335393574912,2,3,0,0,5
1014256150781538304,0,5,0,0,5
1413426215558557696,0,5,0,0,5
1414894131357257728,0,5,0,0,5
497038471,0,5,0,0,5
1415768254962937856,0,5,0,0,5
1402108523572518912,0,5,0,0,5
1017007232028958720,0,4,1,0,5
732724506,0,5,0,0,5
1400119036436942848,0,5,0,0,5
1430108937983078400,0,5,0,0,5
1388033589795692544,1,4,0,0,5
1388063908095610880,0,5,0,0,5
1428338230043156480,0,5,0,0,5
700630993,0,5,0,0,5
630209517,0,5,0,0,5
1389484356209561600,0,5,0,0,5
1536331953632423936,0,5,0,0,5
1393477709603381248,0,5,0,0,5
1425086905016885248,0,5,0,0,5
458710171,0,5,0,0,5
594432586,0,5,0,0,5
578632613,0,5,0,0,5
1009457624767594496,0,5,0,0,5
570713191,0,5,0,0,5
1440195060,5,0,0,0,5
1520020598562430976,0,5,0,0,5
943026594645528576,0,5,0,0,5
2412981564,0,5,0,0,5
2494407660,0,5,0,0,5
2459130996,0,5,0,0,5
2454854688,1,4,0,0,5
2441787228,0,5,0,0,5
1297450676629323776,0,5,0,0,5
2416199047,0,5,0,0,5
2415434251,0,5,0,0,5
1058636605433491456,0,5,0,0,5
1335101197573783552,0,5,0,0,5
1298503674822406144,0,5,0,0,5
1467828159273971712,0,5,0,0,5
2359328575,2,3,0,0,5
2353030240,0,0,0,5,5
2333529211,0,5,0,0,5
2331349128,0,5,0,0,5
2325809274,0,4,0,1,5
1292506490889072640,0,5,0,0,5
246689688,0,5,0,0,5
1289619211774357504,5,0,0,0,5
2545958460,0,5,0,0,5
2756184244,0,5,0,0,5
226090605,0,5,0,0,5
1064910614793981952,0,5,0,0,5
1477147960186060800,0,5,0,0,5
1280402501590585344,2,3,0,0,5
2719190529,0,5,0,0,5
1281177406234075136,0,5,0,0,5
1285158475434057728,0,5,0,0,5
2621188862,0,5,0,0,5
948251432842645504,0,5,0,0,5
1285521928988631040,0,5,0,0,5
1473603506837671936,3,2,0,0,5
2611733894,5,0,0,0,5
2586308855,0,5,0,0,5
241581504,2,1,1,1,5
1304076129490186240,0,5,0,0,5
1304644557808832512,3,2,0,0,5
2277802730,0,5,0,0,5
1325757171003486208,5,0,0,0,5
312514346,0,5,0,0,5
321765973,0,5,0,0,5
1582156128,1,4,0,0,5
1578752616,0,5,0,0,5
969716695903494144,0,5,0,0,5
1330866491063877632,0,5,0,0,5
970031700846764032,4,1,0,0,5
1452162130971668480,0,5,0,0,5
327588158,0,5,0,0,5
328028758,0,5,0,0,5
1331603175099432960,0,5,0,0,5
972358258219368448,0,5,0,0,5
1513155571,0,5,0,0,5
1477930118,0,5,0,0,5
1469580494,5,0,0,0,5
1326384945728802816,0,5,0,0,5
1455454838477582336,0,5,0,0,5
1306956876072927232,0,5,0,0,5
1455500364623454208,0,5,0,0,5
1515678740482859008,5,0,0,0,5
2261631554,0,5,0,0,5
1310663742355505152,0,5,0,0,5
1461691260226314240,0,5,0,0,5
1311552230932148224,0,5,0,0,5
2223798115,1,4,0,0,5
1312328991009894400,0,5,0,0,5
1460654615913848832,4,1,0,0,5
289271595,1,4,0,0,5
2192758383,0,5,0,0,5
293694712,0,5,0,0,5
1321313595628507136,5,0,0,0,5
1322588672861024256,0,5,0,0,5
1323911730548760576,5,0,0,0,5
307946158,0,5,0,0,5
932568388152496128,5,0,0,0,5
1100595899389087744,0,4,0,1,5
1478347154381066240,0,5,0,0,5
1488003335974055936,0,5,0,0,5
4602505502,0,5,0,0,5
3958100296,0,5,0,0,5
4597143554,0,5,0,0,5
36270166,0,5,0,0,5
1236192474869071872,0,5,0,0,5
3160023307,0,5,0,0,5
3309618769,0,5,0,0,5
1165997336125796352,0,5,0,0,5
3973008195,0,5,0,0,5
1237183878155997184,0,5,0,0,5
3937263083,0,5,0,0,5
1490757233482813440,0,4,1,0,5
1211051520222908416,0,5,0,0,5
4519249453,1,4,0,0,5
1211958545240870912,0,5,0,0,5
1499295169870319616,3,2,0,0,5
743671634452615168,0,5,0,0,5
4039343903,0,5,0,0,5
1212017550508191744,2,1,2,0,5
1188718277909831680,1,4,0,0,5
3145942196,0,5,0,0,5
1493776905555755008,0,5,0,0,5
1179281254925000704,0,5,0,0,5
1206866465942638592,0,5,0,0,5
4752411973,0,5,0,0,5
729697978949111808,0,5,0,0,5
1172080901121073152,0,5,0,0,5
132273006,5,0,0,0,5
3849008953,0,5,0,0,5
1129272366704549888,0,5,0,0,5
1497814813430452224,0,5,0,0,5
803173490132189184,5,0,0,0,5
3107954317,0,5,0,0,5
3116863184,4,1,0,0,5
790117430567636992,0,5,0,0,5
119017495,0,5,0,0,5
1091958381831688192,0,5,0,0,5
118742718,1,0,0,4,5
3120768663,0,5,0,0,5
1074959823890984960,0,5,0,0,5
72540838,0,5,0,0,5
778265404477149184,0,5,0,0,5
1219859103440261120,0,5,0,0,5
4175161093,0,4,0,1,5
744976623963873280,0,5,0,0,5
105462428,0,5,0,0,5
740912617980452864,0,5,0,0,5
1082271616338411520,0,5,0,0,5
840466104195604480,0,4,0,1,5
1213698716839763968,0,5,0,0,5
817122983038820352,0,5,0,0,5
884997646020206592,1,1,3,0,5
49893483,0,5,0,0,5
1142436716172718080,5,0,0,0,5
4311444133,0,5,0,0,5
841933938499166208,0,5,0,0,5
83838740,0,5,0,0,5
1486421539608498176,1,0,2,2,5
1119320129811177472,0,5,0,0,5
842410622314659840,0,5,0,0,5
1215683424364531712,0,5,0,0,5
40395356,0,5,0,0,5
1178370048915918848,0,5,0,0,5
3271109508,0,5,0,0,5
111927263,0,5,0,0,5
1097873015407292416,0,5,0,0,5
1214956879547224064,0,5,0,0,5
815708250217840640,0,5,0,0,5
1242778753001861120,1,4,0,0,5
3222584008,0,5,0,0,5
1110955384276246528,0,5,0,0,5
148029805,0,5,0,0,5
910497197170466816,5,0,0,0,5
1496731385092091904,0,5,0,0,5
136059181,0,5,0,0,5
1218250255356944384,0,5,0,0,5
809646511583858688,0,5,0,0,5
780513666177392640,0,5,0,0,5
924575083884109824,0,5,0,0,5
1177110337708933120,0,5,0,0,5
106457836,0,5,0,0,5
3197770658,0,5,0,0,5
1498167138913484800,0,0,0,5,5
113721008,0,0,2,3,5
1125716619794116608,1,4,0,0,5
3198440707,3,0,0,2,5
1499561177310851072,5,0,0,0,5
4066590881,0,3,2,0,5
849449631763353600,0,5,0,0,5
1125483150472146944,0,5,0,0,5
723433622724694016,0,5,0,0,5
890612404282945536,0,5,0,0,5
4754490641,0,5,0,0,5
1128236096746397696,0,5,0,0,5
761080243729764352,4,0,1,0,5
1194641037316313088,5,0,0,0,5
702433901394993152,0,5,0,0,5
29560265,0,5,0,0,5
1087819574265987072,0,5,0,0,5
1152260333739892736,0,5,0,0,5
775272511869165568,0,5,0,0,5
875713307969077248,1,3,1,0,5
1197959934618591232,0,5,0,0,5
1226483416733929472,0,5,0,0,5
1199715685129056256,0,5,0,0,5
827823232153636864,0,5,0,0,5
3098968836,1,4,0,0,5
797374674594361344,0,4,0,1,5
1090825797001244672,1,4,0,0,5
1074352724588851200,0,5,0,0,5
1489914044572368896,0,5,0,0,5
1227779197126369280,0,5,0,0,5
1499190860906639360,5,0,0,0,5
3406474541,0,5,0,0,5
1079276177473265664,5,0,0,0,5
798953701972938752,1,4,0,0,5
1160139274504802304,0,5,0,0,5
1223835786698731520,1,3,1,0,5
3559843038,0,5,0,0,5
1498641787719663616,0,5,0,0,5
1258960043518488576,0,5,0,0,5
930931544692350976,0,5,0,0,5
731411828593414144,0,5,0,0,5
823568986277314560,0,5,0,0,5
3494381656,5,0,0,0,5
3008783191,0,5,0,0,5
170889623,1,1,0,3,5
1194892129467650048,0,5,0,0,5
786530710936956928,0,5,0,0,5
1153591858578239488,0,5,0,0,5
1165305199176630272,0,5,0,0,5
170578820,0,5,0,0,5
3588118455,0,5,0,0,5
1195524566237319168,4,0,0,1,5
169917444,0,5,0,0,5
1228568017929482240,0,5,0,0,5
1498072873742716928,0,5,0,0,5
1499087174285021184,0,5,0,0,5
1150319686543978496,0,5,0,0,5
1203984479318089728,5,0,0,0,5
88506330,1,0,0,4,5
3344975540,0,5,0,0,5
1494445702499352576,0,5,0,0,5
3086742537,0,5,0,0,5
1105798456524705792,0,5,0,0,5
1488610337880514560,0,5,0,0,5
159985620,0,5,0,0,5
48393077,0,5,0,0,5
1496044485402574848,0,5,0,0,5
4777749734,0,5,0,0,5
1231980646408556544,0,5,0,0,5
1074416792376918016,0,5,0,0,5
802777171290968064,0,5,0,0,5
1252632561618223104,0,5,0,0,5
896264443796926464,0,5,0,0,5
119798926,0,5,0,0,5
335576999,0,4,0,0,4
816518564953858048,3,1,0,0,4
889811129438023680,0,4,0,0,4
1087605990294515712,0,4,0,0,4
839489407,0,4,0,0,4
1000401919679041536,0,4,0,0,4
840285728,0,4,0,0,4
1374781497450897408,0,4,0,0,4
1305090500915949568,0,4,0,0,4
739143408,0,4,0,0,4
1463193155675705344,0,4,0,0,4
914737584064073728,0,4,0,0,4
1379322758203469824,2,2,0,0,4
1468636489475321856,0,4,0,0,4
422612609,0,4,0,0,4
3607558393,0,4,0,0,4
972760963379269632,0,0,1,3,4
823386650864533504,0,4,0,0,4
1507572672313675776,4,0,0,0,4
1304754940556976128,0,4,0,0,4
816459680163753984,0,4,0,0,4
838299828,4,0,0,0,4
2365716968,0,4,0,0,4
914526704818720768,0,4,0,0,4
3837323005,0,4,0,0,4
14828950,1,3,0,0,4
1053938157966766080,0,4,0,0,4
821415278017855488,0,4,0,0,4
1483314709,0,4,0,0,4
4135773976,0,4,0,0,4
1082630851614134272,0,4,0,0,4
2421908784,0,4,0,0,4
816316630003159040,0,4,0,0,4
1334051844176297984,1,3,0,0,4
1373366725580886016,0,3,0,1,4
904598933581832192,0,4,0,0,4
818584896,0,4,0,0,4
1053987620722638848,0,4,0,0,4
261632652,0,4,0,0,4
838832516,0,4,0,0,4
1300418403325358080,0,4,0,0,4
830999894,2,2,0,0,4
1431852289212354560,0,3,1,0,4
1138324624322715648,0,4,0,0,4
1382942148090327040,0,4,0,0,4
424280719,0,4,0,0,4
1465581964350484480,0,4,0,0,4
114705809,0,4,0,0,4
1334444411397300224,0,4,0,0,4
1357051682627063808,0,4,0,0,4
1468132930358706176,0,0,0,4,4
1223206215615905792,4,0,0,0,4
1497492819736289280,0,4,0,0,4
1186409558194962432,0,4,0,0,4
2389206156,2,2,0,0,4
763893912,0,4,0,0,4
1490726552845230080,2,2,0,0,4
1334851600943222784,0,4,0,0,4
1218080948409044992,0,4,0,0,4
1512167479690534912,0,0,0,4,4
1303047525381758976,0,4,0,0,4
1096274942419644416,4,0,0,0,4
819714557849571328,0,4,0,0,4
1378444979551363072,0,4,0,0,4
2337446900,0,4,0,0,4
2337615452,0,4,0,0,4
1222940188424359936,0,4,0,0,4
260452732,0,4,0,0,4
1081811173715120128,0,4,0,0,4
790228581607698432,2,2,0,0,4
956149381459165184,2,2,0,0,4
916513916070400000,0,4,0,0,4
271075882,1,3,0,0,4
3667108055,0,4,0,0,4
263743430,0,4,0,0,4
81979135,0,4,0,0,4
3652267035,0,4,0,0,4
31087834,0,3,0,1,4
780544476,0,4,0,0,4
1223529287984111616,0,4,0,0,4
1186297401054597120,0,4,0,0,4
419351826,0,4,0,0,4
49124116,0,4,0,0,4
1379056711734988800,0,4,0,0,4
822650044323074048,0,4,0,0,4
808993914,2,0,0,2,4
1490912364912390144,0,4,0,0,4
272403643,0,4,0,0,4
1304040036820594688,0,4,0,0,4
49076901,3,1,0,0,4
121696677,0,4,0,0,4
1377302048929153024,0,4,0,0,4
2350408909,4,0,0,0,4
2347456877,0,4,0,0,4
1490830219204341760,1,3,0,0,4
1303659791202443264,0,0,0,4,4
760508191,4,0,0,0,4
1298634053780770816,1,3,0,0,4
4358244316,0,4,0,0,4
1462681227316678656,1,3,0,0,4
1362103305715900416,1,3,0,0,4
937516584,0,4,0,0,4
1330675760726728704,4,0,0,0,4
1873171572,0,4,0,0,4
1321824536325693440,4,0,0,0,4
1518246863949946880,4,0,0,0,4
1456535481517289472,0,4,0,0,4
1028216692869136384,0,4,0,0,4
711935761260679168,0,4,0,0,4
950434154,0,4,0,0,4
27189424,0,4,0,0,4
4798409352,0,4,0,0,4
1717246483,0,4,0,0,4
1047373679988957184,1,0,0,3,4
388708143,0,4,0,0,4
4821867215,0,4,0,0,4
998480196,0,4,0,0,4
951030757,0,4,0,0,4
1202501992087556096,1,3,0,0,4
1048682333010890752,0,4,0,0,4
1085020685930381312,0,4,0,0,4
1205648788305530880,0,0,0,4,4
1155395966335213568,0,4,0,0,4
1318747019805077504,2,0,0,2,4
987533332551356416,0,4,0,0,4
894182479216746496,0,4,0,0,4
1318958426744082432,0,4,0,0,4
4642019172,0,4,0,0,4
4643279080,0,4,0,0,4
1568266970,0,4,0,0,4
909591043334578176,0,4,0,0,4
1497088535194710016,0,4,0,0,4
1940837774,0,4,0,0,4
1492159984742055936,1,2,1,0,4
925389973,0,4,0,0,4
1930208167,0,4,0,0,4
86892597,0,4,0,0,4
933788114,1,3,0,0,4
1320755792291655680,0,4,0,0,4
1205937076153094144,0,4,0,0,4
1330518111137751040,0,4,0,0,4
306631066,0,4,0,0,4
1515683524514361344,4,0,0,0,4
1617733147,0,4,0,0,4
1637824015,0,4,0,0,4
1633833824,0,4,0,0,4
1529102088592306176,4,0,0,0,4
799373285721047040,4,0,0,0,4
979105476,0,4,0,0,4
1454145071985532928,0,4,0,0,4
1196346672617361408,0,4,0,0,4
316506714,0,4,0,0,4
1153352316746997760,0,4,0,0,4
1670634036,0,4,0,0,4
1328425245821308928,0,4,0,0,4
91553266,4,0,0,0,4
1195205728467701760,0,4,0,0,4
1607347789,0,4,0,0,4
1329150394417647616,4,0,0,0,4
1596759822,0,4,0,0,4
1359107709136740352,0,4,0,0,4
1195008213336219648,1,3,0,0,4
1359534879906562048,0,4,0,0,4
312831075,0,4,0,0,4
385717299,0,4,0,0,4
1518816017966931968,1,0,0,3,4
1452951006501748736,0,4,0,0,4
1330381635397840896,1,3,0,0,4
4858526120,0,4,0,0,4
1325386984068534272,0,4,0,0,4
1659701120,0,4,0,0,4
1581821323,0,4,0,0,4
1325656409288048640,0,4,0,0,4
968471076551344128,0,4,0,0,4
1151940006887321600,0,4,0,0,4
988927442071863296,0,3,1,0,4
1259456458393034752,4,0,0,0,4
711266828534882304,0,4,0,0,4
1325984799266201600,0,4,0,0,4
1359818066192924672,0,4,0,0,4
1085683407844265984,0,4,0,0,4
972849379,0,4,0,0,4
1492973528647614464,0,4,0,0,4
1958497130,0,4,0,0,4
1318177125959172096,1,0,0,3,4
85872758,0,4,0,0,4
4342369593,1,3,0,0,4
108251673,0,4,0,0,4
1520669684,0,1,0,3,4
1213782318201991168,4,0,0,0,4
1491498023943548928,0,4,0,0,4
1051477082532851712,1,3,0,0,4
1368272752709427200,0,3,0,1,4
1312128228153196544,0,4,0,0,4
964001870011252736,0,4,0,0,4
1083023320340094976,0,4,0,0,4
1458175046753476608,3,0,0,1,4
863491279,2,2,0,0,4
2428479710,0,4,0,0,4
18220818,0,4,0,0,4
1439200659304288256,0,4,0,0,4
1312313381060186112,0,4,0,0,4
2216451449,0,4,0,0,4
4362647958,0,4,0,0,4
1460851189185060864,0,4,0,0,4
1213970447139663872,0,4,0,0,4
1032615842,0,4,0,0,4
905035324614639616,0,4,0,0,4
1310973079779250176,0,4,0,0,4
409951976,2,0,0,2,4
4229377092,0,4,0,0,4
2251875729,1,0,3,0,4
840776838,1,3,0,0,4
1309866764910510080,0,4,0,0,4
1450529340219817984,0,4,0,0,4
1462340579430486016,0,4,0,0,4
1462240755246903296,0,4,0,0,4
1489873236,0,4,0,0,4
2247269856,0,4,0,0,4
1214686810229620736,0,4,0,0,4
1141033081458921472,1,2,1,0,4
725564973217398784,0,4,0,0,4
1461821683430350848,0,4,0,0,4
962683607625056256,0,4,0,0,4
4264297743,0,4,0,0,4
1491364634955288576,0,4,0,0,4
51051938,0,4,0,0,4
1451247334268948480,2,0,0,2,4
1312392837682536448,0,4,0,0,4
794249210547859456,0,4,0,0,4
399251929,0,4,0,0,4
1497127030902734848,0,4,0,0,4
1316051932314652672,0,4,0,0,4
1435545805922910208,0,4,0,0,4
102922188,0,4,0,0,4
381496785,0,4,0,0,4
327326028,0,4,0,0,4
805756433782472704,0,4,0,0,4
894731263,1,0,1,2,4
1458668753030422528,0,4,0,0,4
102733049,0,4,0,0,4
718075629485174784,0,4,0,0,4
1364433156305117184,0,4,0,0,4
1317475456145190912,0,4,0,0,4
1147197271320223744,0,4,0,0,4
1518190178975817728,4,0,0,0,4
1148452628449255424,0,4,0,0,4
895648205534351360,0,4,0,0,4
2183713753,4,0,0,0,4
1332700056533647360,1,3,0,0,4
4479752313,0,4,0,0,4
1517860228972298240,4,0,0,0,4
4363270696,0,4,0,0,4
1213691995274612736,0,4,0,0,4
809336490656309248,1,3,0,0,4
1434910937878867968,0,4,0,0,4
289186412,2,0,1,1,4
4373488965,0,4,0,0,4
722837832071385088,0,4,0,0,4
328976852,0,4,0,0,4
1313344166479360000,1,3,0,0,4
4407079633,0,4,0,0,4
1045155322195628032,1,3,0,0,4
1491719297881706496,4,0,0,0,4
56601816,0,4,0,0,4
2198499445,0,4,0,0,4
905423455474110464,0,4,0,0,4
85299946,0,4,0,0,4
2428387686,0,4,0,0,4
721237069,0,4,0,0,4
1336194338221674496,0,4,0,0,4
2868654654,0,4,0,0,4
1270585096832274432,0,4,0,0,4
2863551224,1,3,0,0,4
151308012,0,4,0,0,4
2862600325,4,0,0,0,4
353969673,1,3,0,0,4
940244454371291136,3,1,0,0,4
477218487,0,4,0,0,4
862321907080626176,0,4,0,0,4
2851597957,0,4,0,0,4
861881129946812416,0,4,0,0,4
3167508269,1,3,0,0,4
1479394718307930112,1,0,0,3,4
2842487198,0,4,0,0,4
925114806251802624,0,4,0,0,4
2838807506,0,4,0,0,4
860658811933270016,0,4,0,0,4
558462286,0,4,0,0,4
2865488295,0,4,0,0,4
864403016316665856,0,4,0,0,4
1272467378295779328,0,4,0,0,4
1036933804022091776,1,3,0,0,4
3131731311,0,4,0,0,4
3132123721,0,4,0,0,4
1248160471930339328,0,4,0,0,4
2885593463,0,4,0,0,4
1419689298060840960,0,4,0,0,4
2882738454,0,4,0,0,4
479829789,0,4,0,0,4
927508032304615424,0,4,0,0,4
1268717764329406464,0,4,0,0,4
1402693387711660032,0,4,0,0,4
2878352642,0,4,0,0,4
3143351989,0,0,4,0,4
2875398405,0,4,0,0,4
1090200680432787456,0,4,0,0,4
152581066,0,4,0,0,4
1479778302692835328,0,4,0,0,4
1075431527733911552,0,4,0,0,4
473311561,0,4,0,0,4
1010177450058317824,0,4,0,0,4
72496760,0,4,0,0,4
571774622,0,4,0,0,4
1243146860497440768,0,4,0,0,4
64294182,0,4,0,0,4
1364093748,0,4,0,0,4
1364770308,1,3,0,0,4
1397856249232855040,0,4,0,0,4
145951368,0,4,0,0,4
787613665554030592,0,4,0,0,4
1275730000373780480,4,0,0,0,4
1017058809489920000,0,4,0,0,4
1242523043701780480,1,3,0,0,4
221707836,0,4,0,0,4
221865870,0,4,0,0,4
3230283779,0,4,0,0,4
3233220823,0,4,0,0,4
580509549,0,4,0,0,4
145209686,0,4,0,0,4
750469490408878080,0,4,0,0,4
1132397256,0,4,0,0,4
23258486,0,4,0,0,4
2831937691,0,4,0,0,4
849920358387924992,0,4,0,0,4
1446064679860662272,0,4,0,0,4
211100378,0,4,0,0,4
753984590365077504,4,0,0,0,4
1273257464767471616,0,4,0,0,4
752579531270225920,0,4,0,0,4
562882804,4,0,0,0,4
2820146632,0,4,0,0,4
1343916687326851072,0,4,0,0,4
1498202795219947520,2,2,0,0,4
751359910571569152,0,4,0,0,4
565797499,0,4,0,0,4
1346513234,0,4,0,0,4
1478495206022340608,0,4,0,0,4
38751027,1,0,0,3,4
569811318,1,2,1,0,4
880993626045599744,1,1,0,2,4
216449581,0,4,0,0,4
1268167690671120384,0,4,0,0,4
550166598,0,4,0,0,4
350977914,0,4,0,0,4
1169644664519106560,0,4,0,0,4
1263061824276135936,0,4,0,0,4
2957911101,0,4,0,0,4
775106718279823360,0,4,0,0,4
16408207,0,4,0,0,4
182430438,0,4,0,0,4
764875137661407232,0,4,0,0,4
934895178179072000,0,4,0,0,4
1256867308770910208,0,4,0,0,4
1197594115,0,4,0,0,4
3029581888,0,4,0,0,4
184400629,0,4,0,0,4
1170679925503909888,0,4,0,0,4
65581806,0,4,0,0,4
1498528857476845568,2,2,0,0,4
1255847600865058816,0,4,0,0,4
34284291,0,4,0,0,4
2946109404,0,4,0,0,4
1263055217861500928,0,4,0,0,4
1208496498,0,4,0,0,4
2941026176,0,3,0,1,4
1263044322179473408,0,4,0,0,4
16342971,0,4,0,0,4
173138505,0,4,0,0,4
1166816343301283840,0,4,0,0,4
32513311,0,4,0,0,4
3007950048,0,4,0,0,4
1482596476908105728,2,2,0,0,4
1167375852247478272,0,4,0,0,4
176383591,0,4,0,0,4
1498594372484579328,4,0,0,0,4
774881535816261632,0,4,0,0,4
934437149637832704,3,0,0,1,4
1261993223741935616,0,4,0,0,4
1482395711438155776,0,4,0,0,4
179899972,0,4,0,0,4
876761174578155520,0,4,0,0,4
168918666,0,4,0,0,4
1090247893758300160,0,4,0,0,4
490384585,0,4,0,0,4
3050100300,0,4,0,0,4
1173341508348473344,0,3,1,0,4
539833914,0,4,0,0,4
69874367,0,4,0,0,4
1067953978883874816,0,0,0,4,4
1251519927409799168,0,1,3,0,4
191532894,0,4,0,0,4
364246876,0,4,0,0,4
1484419073467625472,2,0,0,2,4
1164411580076847104,0,4,0,0,4
1266990808915296256,0,0,0,4,4
2908855027,0,4,0,0,4
938777524879765504,0,4,0,0,4
2903995864,1,3,0,0,4
1250701462251995136,0,0,0,4,4
1249867778120495104,0,4,0,0,4
1484768526137274368,0,4,0,0,4
758898687573536768,0,4,0,0,4
355599971,1,3,0,0,4
1523012780802068480,0,2,0,2,4
1034678228718243840,2,2,0,0,4
1180059428,0,4,0,0,4
358254954,3,0,0,1,4
1265625367743590400,0,4,0,0,4
1104501553233358848,0,4,0,0,4
929944672860082176,0,4,0,0,4
2937884424,0,4,0,0,4
870877024260419584,0,4,0,0,4
2937345013,0,4,0,0,4
1410122507214999552,0,0,0,4,4
2936190084,3,0,1,0,4
3052406629,1,3,0,0,4
2935905237,0,4,0,0,4
979719432149716992,0,4,0,0,4
1266634908,0,4,0,0,4
761259480164274176,1,1,2,0,4
1171680145310199808,2,2,0,0,4
1265016691370659840,0,4,0,0,4
869835002225328128,1,3,0,0,4
3068575104,0,4,0,0,4
1346125555637264384,0,4,0,0,4
1121019151294840832,0,4,0,0,4
1423244985680334848,0,4,0,0,4
1121175901822226432,0,4,0,0,4
3320942952,0,4,0,0,4
134053073,0,4,0,0,4
44902187,4,0,0,0,4
241434309,0,4,0,0,4
3313111166,0,4,0,0,4
1127401288692461568,0,4,0,0,4
62338337,1,3,0,0,4
1388767655587287040,0,4,0,0,4
1400601025,0,4,0,0,4
371089748,0,4,0,0,4
14372597,0,0,4,0,4
701600452,0,4,0,0,4
2555286540,0,4,0,0,4
901398640199057408,0,4,0,0,4
344687656,0,4,0,0,4
2542939418,0,4,0,0,4
886707742802673664,0,4,0,0,4
1098354504,0,4,0,0,4
1471725472673263616,0,4,0,0,4
1472599586413838336,0,4,0,0,4
1108118953,0,4,0,0,4
949592215659139072,0,4,0,0,4
2583183156,0,4,0,0,4
886633647620722688,0,4,0,0,4
1237739419471249408,0,4,0,0,4
1426928603120422912,0,4,0,0,4
1498715245400903680,2,2,0,0,4
1390010023,1,3,0,0,4
1497856488345419776,0,4,0,0,4
948311910180622336,0,4,0,0,4
1473350378301366272,2,2,0,0,4
623732328,0,4,0,0,4
1441771869955248128,4,0,0,0,4
3303976559,2,2,0,0,4
1389661744608387072,2,2,0,0,4
1487903344010346496,0,4,0,0,4
1126612760060669952,0,4,0,0,4
14218790,0,4,0,0,4
1088683264955637760,0,4,0,0,4
1427472448446992384,0,4,0,0,4
1043481663395622912,0,4,0,0,4
1290172004067311616,4,0,0,0,4
3298352271,4,0,0,0,4
1499003895791636480,0,0,0,4,4
1295695355527303168,0,4,0,0,4
3431206312,0,4,0,0,4
2459727702,0,4,0,0,4
3434412531,0,4,0,0,4
1161158636556771328,0,4,0,0,4
1385983794684047360,0,4,0,0,4
1132313204758126592,4,0,0,0,4
1469587381342900224,0,4,0,0,4
1225438905547124736,0,4,0,0,4
3329021633,0,4,0,0,4
1435908667,0,4,0,0,4
1494612489723596800,0,4,0,0,4
1489301212713598976,0,4,0,0,4
1296503487828647936,0,0,0,4,4
1507017619320188928,4,0,0,0,4
1297000544058236928,0,4,0,0,4
2433895133,0,4,0,0,4
1097396668368973824,0,4,0,0,4
1085757608,0,4,0,0,4
1489079193149505536,2,2,0,0,4
249780392,0,4,0,0,4
785163451475767296,0,4,0,0,4
739073154505711616,4,0,0,0,4
1448003263878635520,4,0,0,0,4
2512677344,0,4,0,0,4
1130352594574987264,0,1,0,3,4
246631721,0,4,0,0,4
918845443437682688,3,1,0,0,4
1440984077402783744,0,4,0,0,4
1131133726249799680,0,4,0,0,4
1354321857806295040,4,0,0,0,4
1181705717868302336,0,4,0,0,4
1386700286488715264,0,4,0,0,4
2492877258,0,4,0,0,4
1227665802029039616,0,4,0,0,4
1294245213091725312,0,4,0,0,4
1386572958735421440,0,4,0,0,4
1227273258644406272,0,4,0,0,4
2474924390,4,0,0,0,4
1285510753026482176,0,4,0,0,4
1359198111504162816,0,4,0,0,4
3296160681,0,4,0,0,4
143885982,0,4,0,0,4
2613491089,0,4,0,0,4
2718378998,0,4,0,0,4
1476281960259481600,0,4,0,0,4
2745255862,0,4,0,0,4
598435692,0,4,0,0,4
457465935,0,4,0,0,4
2716853496,0,4,0,0,4
1281183511903272960,0,4,0,0,4
1005989602316910592,0,4,0,0,4
923472752287219712,0,4,0,0,4
1281883652880773120,1,0,0,3,4
2755041936,0,4,0,0,4
2755986906,0,4,0,0,4
3280330428,0,4,0,0,4
1063378721208291328,0,4,0,0,4
3269340421,1,0,3,0,4
1495268259846893568,0,0,0,4,4
3269200129,0,4,0,0,4
591179346,0,4,0,0,4
1064829497458024448,0,4,0,0,4
2729224551,0,4,0,0,4
1394842119722831872,2,2,0,0,4
1241410428111974400,0,4,0,0,4
40632095,0,4,0,0,4
2728764630,0,4,0,0,4
20497920,0,4,0,0,4
596070107,0,4,0,0,4
1078136629263396864,0,4,0,0,4
1341427786976772096,0,4,0,0,4
843556423548067840,0,4,0,0,4
1123512299250122752,0,4,0,0,4
1394204349656551424,1,0,0,3,4
229160327,0,4,0,0,4
3280569967,0,4,0,0,4
922594227288096768,0,4,0,0,4
598951241,1,3,0,0,4
750278466805850112,0,4,0,0,4
615632302,0,4,0,0,4
611003560,0,4,0,0,4
3291385466,0,4,0,0,4
234600261,0,4,0,0,4
2631954141,0,4,0,0,4
1487478512462225408,3,1,0,0,4
1284862055703621632,0,4,0,0,4
886577493511163904,0,4,0,0,4
607314528,0,4,0,0,4
840455595178188800,1,3,0,0,4
2651648999,0,4,0,0,4
603575158,0,4,0,0,4
454526260,0,4,0,0,4
2762574804,2,2,0,0,4
590166638,0,4,0,0,4
747207321776848896,0,4,0,0,4
2670763158,0,4,0,0,4
1447027444448378880,0,4,0,0,4
1393121265544740864,0,4,0,0,4
1062718583946469376,0,4,0,0,4
1158758131448590336,0,3,0,0,3
1165172497370632192,0,2,0,1,3
791697542379474944,0,3,0,0,3
797231000044630016,0,3,0,0,3
1030373299,0,3,0,0,3
787193353473519616,3,0,0,0,3
986433600450052096,0,3,0,0,3
1158618386433269760,0,3,0,0,3
793129061245739008,3,0,0,0,3
793064098250518528,0,3,0,0,3
790875590668804096,1,2,0,0,3
1032083858508763136,1,2,0,0,3
1355490738818088960,0,3,0,0,3
1032884212452343808,0,3,0,0,3
780101106479292416,0,3,0,0,3
1163371339799027712,0,3,0,0,3
774429033534595072,0,3,0,0,3
1357378134300049408,0,3,0,0,3
789405715341291520,0,3,0,0,3
1349541399906029568,0,3,0,0,3
1143293335,0,3,0,0,3
1162935614481715200,0,0,0,3,3
1153671937,3,0,0,0,3
896835445123895296,0,3,0,0,3
1351859570977730560,0,3,0,0,3
1164988836,0,3,0,0,3
987613148948697088,0,3,0,0,3
778267042956795904,0,3,0,0,3
1164248090796126208,0,3,0,0,3
1145856668,0,3,0,0,3
779175673264902144,0,3,0,0,3
1353704007412326400,0,3,0,0,3
1358122401628778496,0,3,0,0,3
1091204000530128896,1,0,0,2,3
984409609866829824,0,3,0,0,3
779823431772545024,0,3,0,0,3
996701778,0,3,0,0,3
797179922087297024,0,3,0,0,3
1162779138740015104,0,3,0,0,3
983698842276237312,0,3,0,0,3
793969782362095616,0,3,0,0,3
1162010699846967296,1,2,0,0,3
1045412502,0,3,0,0,3
1097931343,0,3,0,0,3
1357720436025544704,0,3,0,0,3
1357658615868448768,3,0,0,0,3
793841833981849600,1,2,0,0,3
1133362236,0,3,0,0,3
788901979292590080,3,0,0,0,3
1161576978635460608,0,3,0,0,3
784605452290158592,0,3,0,0,3
1008554720,3,0,0,0,3
791180372,1,2,0,0,3
893705456090206208,1,1,0,1,3
555803534,0,3,0,0,3
1395379908323385344,0,3,0,0,3
1121425371763761152,0,3,0,0,3
1121305600359407616,0,3,0,0,3
585066427,3,0,0,0,3
846177313716875264,0,3,0,0,3
578257014,0,2,0,1,3
848162778376491008,0,3,0,0,3
1398197790166159360,0,3,0,0,3
1398303324340953088,0,3,0,0,3
572853284,0,3,0,0,3
1398929214825545728,0,0,1,2,3
1118563347249737728,0,3,0,0,3
851765873509634048,0,3,0,0,3
1399436511448387584,0,3,0,0,3
1399947097869369344,0,3,0,0,3
853532049856135168,2,0,0,1,3
1113450409056645120,0,3,0,0,3
1112726440318038016,0,3,0,0,3
560269519,0,3,0,0,3
1400770229907636224,0,3,0,0,3
859217248975638528,0,3,0,0,3
558046999,0,3,0,0,3
557820763,0,3,0,0,3
1394759853562900480,0,3,0,0,3
843433646962999296,0,2,0,1,3
1393855659947433984,0,3,0,0,3
833732050284867584,0,3,0,0,3
704789264,0,3,0,0,3
1129299120462548992,0,3,0,0,3
702886223,0,3,0,0,3
702695142,0,3,0,0,3
831593383709782016,0,3,0,0,3
701881546,0,3,0,0,3
701207138,0,3,0,0,3
831721454211330048,0,3,0,0,3
1388361090460000256,0,3,0,0,3
833198199632515072,0,3,0,0,3
1126913247439798272,0,3,0,0,3
1393623957748674560,0,3,0,0,3
626726653,0,3,0,0,3
1004821348730929152,0,3,0,0,3
1126558327394197504,3,0,0,0,3
836454688832782336,0,3,0,0,3
1390673290612469760,1,1,1,0,3
615660889,0,3,0,0,3
613479938,0,3,0,0,3
607927651,0,3,0,0,3
840936675333271552,0,3,0,0,3
1124276461039304704,1,2,0,0,3
556736793,0,3,0,0,3
862045674640166912,2,1,0,0,3
988735644,0,3,0,0,3
554543566,0,3,0,0,3
533211999,0,3,0,0,3
532108196,0,3,0,0,3
1104050228221612032,0,3,0,0,3
872964081019478016,0,3,0,0,3
524570396,0,3,0,0,3
522191442,0,3,0,0,3
875388783193141248,0,3,0,0,3
520326284,0,3,0,0,3
1103362455365795840,0,3,0,0,3
875782513335169024,0,3,0,0,3
520198302,0,3,0,0,3
876454866360651776,0,3,0,0,3
1411296078645710848,0,3,0,0,3
1103265602829873152,0,3,0,0,3
1411934276103204864,0,3,0,0,3
877733754709716992,2,1,0,0,3
877788301075337216,0,3,0,0,3
506374785,0,3,0,0,3
1101712235456577536,1,2,0,0,3
504885483,0,3,0,0,3
501834864,1,2,0,0,3
1101489043148140544,3,0,0,0,3
1100839058849157120,0,3,0,0,3
534720794,0,3,0,0,3
870284660797984768,0,3,0,0,3
1105889401018580992,0,3,0,0,3
1404040780860297216,0,3,0,0,3
862957859314827264,1,2,0,0,3
1402611354943492096,0,3,0,0,3
553474217,0,3,0,0,3
1108409631334793216,0,3,0,0,3
884460925327032320,0,3,0,0,3
1016903933506121728,1,2,0,0,3
1403514048088612864,0,0,0,3,3
1403766390402715648,0,3,0,0,3
865451974405177344,0,3,0,0,3
865523718646226944,3,0,0,0,3
1107593036136108032,1,0,0,2,3
1106062430277373952,0,3,0,0,3
545305049,0,3,0,0,3
866141807838679040,0,3,0,0,3
1015665452444536832,3,0,0,0,3
1015521176087453696,0,3,0,0,3
1014285533026160640,0,2,1,0,3
1405391732326375424,2,0,0,1,3
541570582,3,0,0,0,3
1405600417447284736,0,3,0,0,3
1405747321564909568,0,3,0,0,3
867671776934985728,0,3,0,0,3
830850546227621888,0,3,0,0,3
707188068,0,3,0,0,3
1129690646795694080,0,3,0,0,3
829054953440366592,0,3,0,0,3
893331068,0,3,0,0,3
1147150375876562944,0,3,0,0,3
806222129649721344,0,3,0,0,3
806525660843937792,0,3,0,0,3
884660570,1,2,0,0,3
1365952092159037440,3,0,0,0,3
1145932644640669696,0,3,0,0,3
1145729186687942656,0,3,0,0,3
1145634213233942528,0,3,0,0,3
1145548138079555584,0,3,0,0,3
808369805094858752,0,3,0,0,3
871168723,0,3,0,0,3
870544742,0,3,0,0,3
1145123841204768768,0,3,0,0,3
995497288138182656,0,3,0,0,3
1367103800016736256,2,1,0,0,3
1367304103190233088,0,3,0,0,3
865206702,0,3,0,0,3
1143606146852409344,0,3,0,0,3
1368044042110590976,0,3,0,0,3
1368515488825937920,0,3,0,0,3
810876354640183296,0,3,0,0,3
1368978950572023808,0,3,0,0,3
1364900842407563264,2,1,0,0,3
1364000493027131392,0,3,0,0,3
909102140,1,2,0,0,3
1361722477924081664,2,1,0,0,3
982078231,0,0,0,3,3
972909709,0,3,0,0,3
968675821,0,3,0,0,3
799994953137057792,0,3,0,0,3
962168826,0,3,0,0,3
1151926938623041536,0,3,0,0,3
960792289,0,3,0,0,3
959694074,2,0,0,1,3
958325040,3,0,0,0,3
800936021609226240,2,0,0,1,3
1151415466675462144,0,3,0,0,3
1095298154633805824,0,3,0,0,3
892835225084055552,1,2,0,0,3
1028758494680252416,0,3,0,0,3
1362809638475886592,0,3,0,0,3
1362816820122505216,0,3,0,0,3
891848888629383168,0,3,0,0,3
936538855,0,3,0,0,3
1150093387459989504,2,0,1,0,3
992093305101062144,0,3,0,0,3
1149638211930472448,0,3,0,0,3
992527817274408960,0,3,0,0,3
1369548909484277760,0,3,0,0,3
811804202913542144,0,3,0,0,3
859535707,2,1,0,0,3
1385329682887839744,1,2,0,0,3
822555163051393024,0,3,0,0,3
1382406581933858816,0,3,0,0,3
822854988493885440,0,3,0,0,3
1383128071524421632,0,3,0,0,3
747442399,3,0,0,0,3
734840978,0,3,0,0,3
1133643972184690688,0,3,0,0,3
1000516889976569856,1,2,0,0,3
825488184683294720,0,3,0,0,3
730112022,0,0,0,3,3
825488341197942784,0,3,0,0,3
766052262,0,3,0,0,3
826226272418283520,0,3,0,0,3
1002700900018851840,0,3,0,0,3
1097447185430519808,0,3,0,0,3
1386228184413204480,0,3,0,0,3
1386356945955610624,0,3,0,0,3
826582750958231552,0,3,0,0,3
887562915452264448,1,2,0,0,3
1131526616117587968,0,3,0,0,3
827896787155329024,0,3,0,0,3
887355087651209216,0,3,0,0,3
822517586067746816,3,0,0,0,3
1022835441144229888,0,3,0,0,3
852065904,0,1,2,0,3
816594850527277056,0,3,0,0,3
813067270410772480,0,3,0,0,3
813350853310414848,0,3,0,0,3
850633633,0,3,0,0,3
814222411042357248,0,3,0,0,3
1371758470102388736,0,2,1,0,3
1140575482854948864,0,3,0,0,3
1025276631672397824,0,3,0,0,3
815943852737470464,0,3,0,0,3
816235638441857024,0,3,0,0,3
832264788,0,3,0,0,3
1377306060537520128,0,3,0,0,3
822076177426706432,0,3,0,0,3
999199747742220288,3,0,0,0,3
1377416459194757120,0,3,0,0,3
786234571,1,0,0,2,3
784261346,0,3,0,0,3
889880178079539200,0,3,0,0,3
1135909465356505088,0,3,0,0,3
773877294,0,3,0,0,3
772856072,0,3,0,0,3
821437874742693888,0,3,0,0,3
769206559,0,3,0,0,3
1214720684,0,3,0,0,3
1259780915733004288,2,0,0,1,3
773493875839238144,0,3,0,0,3
3306523989,0,3,0,0,3
1238460654383771648,0,3,0,0,3
1238023985922621440,0,3,0,0,3
3299147397,0,3,0,0,3
3301319478,0,3,0,0,3
2605675838,0,3,0,0,3
1286306508465041408,3,0,0,0,3
2598015009,0,3,0,0,3
1286493601061535744,1,2,0,0,3
3303370282,0,3,0,0,3
2590145787,0,3,0,0,3
2589275959,0,3,0,0,3
2589089012,0,3,0,0,3
3306005987,0,3,0,0,3
2584651114,0,3,0,0,3
1078996291147902976,0,3,0,0,3
2583744355,3,0,0,0,3
3306739100,0,3,0,0,3
2582490751,2,1,0,0,3
3309750788,0,3,0,0,3
3316242587,0,3,0,0,3
2574947264,0,3,0,0,3
2574904722,0,3,0,0,3
1235613624384794624,0,3,0,0,3
1235486222815911936,0,3,0,0,3
1288542426034995200,0,3,0,0,3
2556727508,0,3,0,0,3
2556117265,1,2,0,0,3
1234811496271613952,0,3,0,0,3
1285204868307709952,0,3,0,0,3
1238709740777037824,0,3,0,0,3
1239098771205541888,3,0,0,0,3
1239618640842035200,0,3,0,0,3
2734248652,0,2,0,1,3
3256462675,0,3,0,0,3
2726025501,0,3,0,0,3
1064267064431570944,0,3,0,0,3
3260993533,3,0,0,0,3
1280778114113495040,0,3,0,0,3
1078191748881567744,0,3,0,0,3
1241053713084616704,0,3,0,0,3
2722041042,0,3,0,0,3
1063846747355648000,0,3,0,0,3
3272409102,0,3,0,0,3
1280848281279426560,0,3,0,0,3
3279552517,0,3,0,0,3
1281867530605232128,2,1,0,0,3
2677701991,0,3,0,0,3
3284309772,0,3,0,0,3
1283216955449597952,0,3,0,0,3
2670696570,0,3,0,0,3
920634364291039232,3,0,0,0,3
1239724449080860672,0,3,0,0,3
1283597293304729600,0,3,0,0,3
1283646597776027648,0,3,0,0,3
1283726414596829184,1,2,0,0,3
2651110377,0,3,0,0,3
2645904638,0,3,0,0,3
1284726528413020160,3,0,0,0,3
3284800512,0,3,0,0,3
2548427874,0,3,0,0,3
2538053700,0,3,0,0,3
771977579662233600,0,3,0,0,3
2404792921,0,3,0,0,3
1297112970741403648,0,3,0,0,3
3543884052,1,2,0,0,3
3546878417,0,3,0,0,3
1297255652767784960,0,3,0,0,3
2423008116,0,3,0,0,3
3566648835,0,3,0,0,3
2420645726,0,3,0,0,3
2419417476,0,3,0,0,3
1080837926987202560,0,3,0,0,3
1223760746162655232,0,3,0,0,3
1223536522755837952,0,3,0,0,3
3656694322,0,3,0,0,3
1058515079757488128,0,3,0,0,3
2404249158,0,3,0,0,3
2535941033,0,3,0,0,3
1298672185641295872,0,3,0,0,3
2391728237,0,3,0,0,3
916352034906923008,0,3,0,0,3
952942814999949312,0,3,0,0,3
2387750485,0,3,0,0,3
3725333233,0,3,0,0,3
953503755210670080,0,3,0,0,3
3740388976,0,3,0,0,3
953874531395006464,0,3,0,0,3
1222230296159903744,0,2,0,1,3
1057919879393800192,0,3,0,0,3
915653306646659072,0,3,0,0,3
2362771794,0,3,0,0,3
917641257580625920,0,3,0,0,3
3480739156,0,3,0,0,3
2442573267,0,3,0,0,3
1296354525503057920,0,3,0,0,3
3327554951,0,3,0,0,3
2534074718,0,3,0,0,3
2533992935,0,3,0,0,3
2532492307,0,3,0,0,3
2530554962,0,3,0,0,3
1234450722781044736,0,3,0,0,3
1234444253616623616,0,3,0,0,3
1234356238592421888,0,3,0,0,3
3341452720,0,3,0,0,3
3352361115,0,3,0,0,3
1232163611776294912,3,0,0,0,3
3365340622,2,1,0,0,3
1292767721445306368,0,3,0,0,3
1231908830885208064,0,3,0,0,3
950413862951530496,0,3,0,0,3
2486317314,0,3,0,0,3
1293826012933849088,3,0,0,0,3
1227394555126919168,0,3,0,0,3
1294967938978471936,0,3,0,0,3
1295064923685310464,0,3,0,0,3
2467553617,3,0,0,0,3
1226441982488301568,1,2,0,0,3
3437980775,0,3,0,0,3
3439033821,0,3,0,0,3
3462419953,0,3,0,0,3
1296054426256510976,0,3,0,0,3
950747432278679552,0,3,0,0,3
3250344326,0,3,0,0,3
1279349571903279104,0,3,0,0,3
3244134373,0,3,0,0,3
938440215483445248,0,3,0,0,3
2936203375,0,3,0,0,3
2935600716,0,3,0,0,3
1253892943544381440,0,3,0,0,3
935630333239754752,0,3,0,0,3
1252885330807513088,0,1,2,0,3
2927598307,0,3,0,0,3
936764913648840704,0,3,0,0,3
3075503365,0,3,0,0,3
937592771497431040,0,3,0,0,3
2915145717,0,3,0,0,3
929055703112781824,3,0,0,0,3
1266353740921147392,0,3,0,0,3
3087891900,0,0,3,0,3
1266975307510059008,0,3,0,0,3
1242074069907968000,3,0,0,0,3
1250726331085729792,0,3,0,0,3
1267217694845276160,0,3,0,0,3
1267346439203676160,0,3,0,0,3
1074690007741464576,1,1,0,1,3
3105496324,3,0,0,0,3
3106807527,0,3,0,0,3
928457924866867200,0,3,0,0,3
3112987527,3,0,0,0,3
3120079803,0,3,0,0,3
2895881257,0,3,0,0,3
1268061883287785472,0,2,0,1,3
1067353671216889856,0,3,0,0,3
2890517164,0,3,0,0,3
1254119592730988544,0,3,0,0,3
2939522719,0,3,0,0,3
935529931689168896,3,0,0,0,3
3049561140,3,0,0,0,3
1259445167653707776,0,3,0,0,3
1072963364425490432,0,3,0,0,3
1073866391823024128,0,3,0,0,3
2990520802,0,3,0,0,3
1072467918108090368,0,2,0,1,3
1260476012049174528,3,0,0,0,3
2985132422,1,2,0,0,3
3012648637,0,3,0,0,3
3017439571,0,3,0,0,3
1261208195860586496,0,3,0,0,3
1261252238846177280,0,1,2,0,3
497955452,0,3,0,0,3
934844985836367872,0,1,0,2,3
1263048785661485056,0,3,0,0,3
3019837309,0,3,0,0,3
3021405476,1,2,0,0,3
3023113715,0,3,0,0,3
1263171985753833472,2,1,0,0,3
3024466667,0,3,0,0,3
2954454747,0,3,0,0,3
2953540478,0,2,0,1,3
1256825030748655616,0,3,0,0,3
1070710084441784320,0,3,0,0,3
930632639874088960,2,0,1,0,3
2950771612,0,3,0,0,3
3034399311,0,3,0,0,3
3048892632,0,3,0,0,3
1067308004754771968,0,3,0,0,3
2885721966,3,0,0,0,3
3136985053,0,3,0,0,3
941488283405631488,0,3,0,0,3
2810138524,0,3,0,0,3
923611753216466944,0,3,0,0,3
2805007468,0,3,0,0,3
1274298292067643392,0,3,0,0,3
2799934021,0,3,0,0,3
1274403900523716608,0,3,0,0,3
2795753324,0,3,0,0,3
2794203621,0,3,0,0,3
1274632086435934208,0,3,0,0,3
1274931928223776768,0,3,0,0,3
1242839622893416448,0,3,0,0,3
941948261660704768,0,3,0,0,3
2787123007,0,2,0,1,3
2785687478,0,3,0,0,3
3225032269,0,3,0,0,3
1242719889565065216,2,1,0,0,3
1275519088811323392,0,3,0,0,3
1242693039732264960,0,3,0,0,3
2780279137,3,0,0,0,3
2773484085,0,3,0,0,3
3233423773,0,3,0,0,3
1277160025694384128,0,3,0,0,3
3236045400,0,3,0,0,3
3238615491,0,3,0,0,3
1242119102505930752,3,0,0,0,3
3239056333,0,3,0,0,3
1076750754449219584,0,3,0,0,3
1273865777733500928,0,3,0,0,3
3188503561,2,1,0,0,3
1247884397954531328,0,3,0,0,3
3188352661,0,3,0,0,3
2880780160,0,3,0,0,3
3148124366,0,3,0,0,3
1075348240495562752,0,3,0,0,3
2869006244,1,2,0,0,3
1066648678440398848,0,3,0,0,3
2868289951,0,3,0,0,3
3164611855,2,0,1,0,3
1271182097563205632,3,0,0,0,3
1271223433553207296,0,3,0,0,3
3166099586,0,3,0,0,3
2853534284,0,3,0,0,3
2853010239,0,3,0,0,3
2849717358,1,1,0,1,3
924987509787983872,0,3,0,0,3
2835870705,0,3,0,0,3
1245722572215529472,0,3,0,0,3
2834841117,0,3,0,0,3
3177653881,2,0,0,1,3
1066060907501875200,0,3,0,0,3
1272537245522653184,0,3,0,0,3
2830215925,0,3,0,0,3
1272706401220132864,0,3,0,0,3
3183745506,0,3,0,0,3
1244347913209176064,0,3,0,0,3
2821163219,0,3,0,0,3
1273498365624369152,0,3,0,0,3
1273562908220207104,0,3,0,0,3
1300720673191469056,0,3,0,0,3
3778112308,3,0,0,0,3
1221765665763184640,0,3,0,0,3
1523891821,0,3,0,0,3
1566404184,0,3,0,0,3
715886373815750656,0,3,0,0,3
718112250263777280,0,3,0,0,3
1189647560731959296,0,3,0,0,3
1556105180,2,1,0,0,3
718535135604424704,0,0,2,1,3
1331431839823581184,1,2,0,0,3
1188422677586948096,0,3,0,0,3
722411531791691776,0,3,0,0,3
970765882417754112,0,3,0,0,3
1332529613289897984,0,3,0,0,3
1524522007,0,3,0,0,3
1333086544043847680,0,3,0,0,3
723809925860872192,2,0,0,1,3
4853093049,0,3,0,0,3
1044516917728485376,0,3,0,0,3
724139267023351808,0,3,0,0,3
1087132547304378368,0,3,0,0,3
1498036753,3,0,0,0,3
972721078081433600,0,3,0,0,3
904031735494483968,0,3,0,0,3
1472616901,0,3,0,0,3
727840825661661184,0,3,0,0,3
1087638781295882240,0,1,1,1,3
1456551607,0,3,0,0,3
1335419320554426368,3,0,0,0,3
1451496727,0,3,0,0,3
1451209832,0,3,0,0,3
715759889453342720,1,2,0,0,3
1191489138538819584,0,3,0,0,3
713915736767524864,0,3,0,0,3
1192718264331382784,0,3,0,0,3
1085447858969501696,0,3,0,0,3
1201692564732006400,0,3,0,0,3
1200936284962926592,1,0,1,1,3
1652406170,0,3,0,0,3
4873810438,1,1,1,0,3
4884196393,0,3,0,0,3
907548032153133056,0,3,0,0,3
4903421877,3,0,0,0,3
1326580621691514880,0,1,2,0,3
4927949116,0,3,0,0,3
1326884407148388352,0,3,0,0,3
1197001458555772928,0,3,0,0,3
1633740872,0,3,0,0,3
702892218789568512,0,3,0,0,3
1196809135800475648,0,3,0,0,3
1328247535694090240,0,3,0,0,3
1196110695277817856,0,3,0,0,3
1611519468,0,3,0,0,3
1608591282,1,2,0,0,3
1045733896103579648,0,3,0,0,3
1594953008,0,1,2,0,3
706829685188067328,0,3,0,0,3
706861432336330752,0,3,0,0,3
1589563087,0,3,0,0,3
708208019876618240,0,3,0,0,3
708716276458323968,0,3,0,0,3
1330662970125295616,0,3,0,0,3
1443052526,0,3,0,0,3
972763368145784832,0,3,0,0,3
1184526866264158208,0,3,0,0,3
1176101700115017728,0,3,0,0,3
1090058107156393984,0,3,0,0,3
1333832185,0,3,0,0,3
1175285571671023616,0,3,0,0,3
1174669026234109952,0,3,0,0,3
756744601961050112,0,3,0,0,3
757471555425333248,0,3,0,0,3
1090234141923250176,1,0,1,1,3
1325843028,0,3,0,0,3
758540550169440256,1,2,0,0,3
1315921093,0,3,0,0,3
1312170816,0,3,0,0,3
1345269939536424960,0,3,0,0,3
1171728537444708352,0,3,0,0,3
1303460118,0,3,0,0,3
1346039517480935424,0,3,0,0,3
980042575410233344,0,3,0,0,3
761968955774869504,0,3,0,0,3
763404112050294784,0,2,0,1,3
1170131335043674112,3,0,0,0,3
1252585244,0,3,0,0,3
765051715833913344,3,0,0,0,3
1347805901105713152,0,3,0,0,3
1168158454185385984,0,3,0,0,3
1348450388324835328,0,3,0,0,3
1167983588060672000,0,3,0,0,3
1230327601,0,3,0,0,3
1348716497791635456,0,3,0,0,3
754108250761682944,0,3,0,0,3
1356641280,0,3,0,0,3
1184393109284614144,0,3,0,0,3
1362144619,0,3,0,0,3
1088063181484785664,0,3,0,0,3
1433941970,0,3,0,0,3
1432450958,0,3,0,0,3
973016581780353024,1,2,0,0,3
1428245454,0,3,0,0,3
736967318417248256,0,3,0,0,3
1182304086911262720,0,3,0,0,3
738201799157387264,0,3,0,0,3
1427749310,0,3,0,0,3
1336856553392123904,0,3,0,0,3
1088089991769518080,0,3,0,0,3
1417986104,0,3,0,0,3
1413943699,0,3,0,0,3
1338080489115176960,0,3,0,0,3
1338933573517275136,0,3,0,0,3
1339138346040385536,0,3,0,0,3
742042309542481920,0,3,0,0,3
742110251458170880,0,3,0,0,3
900750549116608512,0,0,0,3,3
746371177174679552,1,2,0,0,3
1089406241607012352,0,3,0,0,3
1380678722,0,2,1,0,3
1089811634636374016,0,3,0,0,3
1341684477865701376,0,3,0,0,3
976099785383075840,0,3,0,0,3
1177288625408446464,0,3,0,0,3
977037542091468800,3,0,0,0,3
1202041471773241344,2,0,1,0,3
4851881517,0,0,0,3,3
2359337692,0,3,0,0,3
2247750388,0,3,0,0,3
4098879861,0,3,0,0,3
2284616220,0,3,0,0,3
1306917404274900992,0,0,0,3,3
1216031904891318272,0,3,0,0,3
4160782817,0,3,0,0,3
4171454293,0,3,0,0,3
2267723737,0,3,0,0,3
1308693358576099328,0,3,0,0,3
1082714921736028160,0,3,0,0,3
1215506328820412416,0,3,0,0,3
4226286028,0,3,0,0,3
2251330809,0,3,0,0,3
2250090924,0,3,0,0,3
1214618241902891008,0,3,0,0,3
1085417543718895616,0,3,0,0,3
1310570591817273344,1,2,0,0,3
2241717492,0,3,0,0,3
4257671182,0,2,0,1,3
4273515736,0,3,0,0,3
2233708580,0,3,0,0,3
1311283606862602240,0,3,0,0,3
913059399949623296,1,0,0,2,3
4306593974,0,3,0,0,3
1311342442310823936,0,3,0,0,3
1311373742115893248,0,3,0,0,3
1051958726691880960,0,3,0,0,3
4333200796,0,3,0,0,3
963960493621829632,3,0,0,0,3
4098307185,0,3,0,0,3
2289991208,0,3,0,0,3
2297511300,0,3,0,0,3
2300205420,0,3,0,0,3
1301041964276621312,0,3,0,0,3
2356553301,0,3,0,0,3
915442356739964928,0,3,0,0,3
3889932861,0,3,0,0,3
1056897021251067904,0,3,0,0,3
2350895629,0,3,0,0,3
2350648896,0,3,0,0,3
3910263134,0,3,0,0,3
2339670506,0,3,0,0,3
1302642769421238272,0,3,0,0,3
2335484528,0,3,0,0,3
3967668794,0,2,1,0,3
2330551663,0,3,0,0,3
1303298287953481728,3,0,0,0,3
1219215573864910848,3,0,0,0,3
958201714015985664,0,3,0,0,3
2321864502,1,1,1,0,3
4046482453,3,0,0,0,3
1304493096646963200,0,3,0,0,3
4051955412,0,3,0,0,3
1304591883633668096,0,3,0,0,3
1304742381783220224,0,3,0,0,3
1054603443380330496,0,3,0,0,3
960928634809790464,0,3,0,0,3
1305378012339335168,0,3,0,0,3
1305405873951367168,0,3,0,0,3
2300898038,0,3,0,0,3
1311922496917000192,0,3,0,0,3
1312242118186811392,0,3,0,0,3
1312300806201323520,0,0,3,0,3
2154098573,0,2,0,1,3
1318171127714258944,0,3,0,0,3
1318590020404477952,0,3,0,0,3
1209522309758963712,2,1,0,0,3
4612370792,0,3,0,0,3
4666160113,0,2,0,1,3
1319356431942860800,0,3,0,0,3
1207694761450074112,0,2,1,0,3
4690407709,0,3,0,0,3
1320089067376103424,1,2,0,0,3
1922754062,0,3,0,0,3
1320680913437687808,0,3,0,0,3
4735647376,0,3,0,0,3
1321011640834224128,0,3,0,0,3
1881402330,0,3,0,0,3
4746252372,0,3,0,0,3
4765780780,0,3,0,0,3
4778840010,3,0,0,0,3
1047692651732955136,3,0,0,0,3
1204135081650065408,0,3,0,0,3
967415430410330112,0,3,0,0,3
4794057499,0,3,0,0,3
1204118085248139264,0,3,0,0,3
1707937406,0,3,0,0,3
908233293082054656,0,3,0,0,3
4824377416,0,3,0,0,3
1203641397703659520,0,3,0,0,3
1202994423577088000,0,3,0,0,3
2150931211,0,3,0,0,3
2156641712,0,2,0,1,3
1050901128358039552,0,3,0,0,3
1048903891268657152,0,3,0,0,3
2214978016,0,3,0,0,3
1050047164733382656,0,1,1,1,3
2213084613,0,3,0,0,3
1049516982217801728,0,3,0,0,3
2210333873,0,3,0,0,3
1312486710295568384,0,3,0,0,3
2207851705,0,3,0,0,3
1313238857249443840,1,2,0,0,3
4379866632,0,3,0,0,3
4397878160,0,3,0,0,3
2201496456,1,2,0,0,3
965656364004642816,0,3,0,0,3
965709651038752768,0,3,0,0,3
1213039593408229376,0,3,0,0,3
1314181532773347328,3,0,0,0,3
4416623241,3,0,0,0,3
2192362425,0,3,0,0,3
2183279885,0,3,0,0,3
2182217858,0,3,0,0,3
2176167800,3,0,0,0,3
2173988810,3,0,0,0,3
1315970255705997312,0,3,0,0,3
2166899187,0,3,0,0,3
2163849279,0,3,0,0,3
4585229115,0,3,0,0,3
2160903529,0,3,0,0,3
4585802533,0,3,0,0,3
1652843064,1,2,0,0,3
1013623905955741696,0,3,0,0,3
275665331,0,3,0,0,3
244651067,0,3,0,0,3
221246201,0,3,0,0,3
1499012870780108800,3,0,0,0,3
1499042377851609088,0,3,0,0,3
27699547,0,2,1,0,3
1477614053908439040,0,3,0,0,3
343056051,0,3,0,0,3
1437435834249011200,1,2,0,0,3
1477521778712854528,0,0,0,3,3
1447547981385715712,0,3,0,0,3
223539522,0,3,0,0,3
25682196,0,3,0,0,3
1496592176712720384,1,2,0,0,3
136935589,3,0,0,0,3
1487815617424261120,0,3,0,0,3
1499259890052866048,3,0,0,0,3
1499274623216762880,2,1,0,0,3
226103241,0,3,0,0,3
24568370,0,3,0,0,3
134038948,0,3,0,0,3
1499320152206508032,0,3,0,0,3
133839347,0,3,0,0,3
133704132,1,0,0,2,3
1499325275040935936,2,1,0,0,3
1427145408036343808,0,3,0,0,3
342371117,0,3,0,0,3
1448080029469003776,0,3,0,0,3
30163326,0,3,0,0,3
338484459,1,2,0,0,3
303756562,0,3,0,0,3
1496766472751775744,2,1,0,0,3
30758217,0,3,0,0,3
303650363,0,3,0,0,3
1478994699046187008,0,3,0,0,3
1428029360582184960,0,3,0,0,3
1487141647691694080,2,1,0,0,3
1498904967725596672,0,2,1,0,3
1498914674749759488,2,1,0,0,3
1436868759118127104,2,0,0,1,3
28528503,1,2,0,0,3
1427985464351469568,0,3,0,0,3
1437001620538155008,0,3,0,0,3
29973034,0,3,0,0,3
340818984,0,3,0,0,3
1487383187810660352,0,3,0,0,3
1427525569982263296,0,3,0,0,3
1478203007523168256,0,3,0,0,3
64618819,0,3,0,0,3
220347418,0,3,0,0,3
220382699,0,3,0,0,3
69659194,0,3,0,0,3
299718891,0,3,0,0,3
227280479,0,3,0,0,3
376336190,0,3,0,0,3
237565600,0,3,0,0,3
462906157,0,3,0,0,3
239018273,3,0,0,0,3
239060144,0,3,0,0,3
20917723,0,3,0,0,3
239114850,0,3,0,0,3
74933567,0,3,0,0,3
1472564030137008128,0,3,0,0,3
1489256416380846080,0,3,0,0,3
242028411,0,3,0,0,3
1439982302877167616,0,3,0,0,3
1501570615534313472,0,2,0,1,3
466765222,0,3,0,0,3
243247301,0,3,0,0,3
294249887,0,3,0,0,3
351676267,0,3,0,0,3
1489508757772005376,0,3,0,0,3
20203344,1,2,0,0,3
1471955834196623360,0,3,0,0,3
1505503747597901824,2,1,0,0,3
1489804796597276672,0,3,0,0,3
122108914,0,3,0,0,3
237363082,0,3,0,0,3
1501397854337716224,1,1,1,0,3
131744337,0,3,0,0,3
232106713,0,3,0,0,3
228718364,0,3,0,0,3
229909981,0,3,0,0,3
1499609108135088128,0,3,0,0,3
130838153,0,3,0,0,3
1425055645045231616,1,0,1,1,3
1475790235376263168,0,3,0,0,3
458295003,0,3,0,0,3
1458107075083440128,0,3,0,0,3
72953001,0,3,0,0,3
1500037581823643648,3,0,0,0,3
22307579,0,3,0,0,3
1495318898916343808,0,3,0,0,3
1438789740916973568,0,3,0,0,3
73081987,0,3,0,0,3
1474964265459093504,0,3,0,0,3
233887674,1,2,0,0,3
1500319855941414912,3,0,0,0,3
234731277,0,3,0,0,3
349869299,1,2,0,0,3
1495608480580964352,0,3,0,0,3
1424015944410664960,3,0,0,0,3
1458347814749048832,0,3,0,0,3
31200476,0,3,0,0,3
1428873300961230848,2,0,1,0,3
31240732,0,3,0,0,3
1431966740125204480,0,3,0,0,3
179020765,0,3,0,0,3
39724652,0,3,0,0,3
416877358,0,3,0,0,3
329688737,0,3,0,0,3
1432213954416320512,0,1,0,2,3
182663887,0,3,0,0,3
1497201209245323264,0,2,0,1,3
1481959466136387584,0,0,0,3,3
419238022,0,3,0,0,3
419525468,0,3,0,0,3
156306739,0,3,0,0,3
159774896,0,3,0,0,3
1484957604766191616,0,3,0,0,3
155902879,0,3,0,0,3
1484973789259919360,3,0,0,0,3
1450877869903675392,0,3,0,0,3
1485053450635419648,1,2,0,0,3
1481519247876673536,0,3,0,0,3
421334372,0,3,0,0,3
1497099704747773952,0,3,0,0,3
1498238473114775552,0,3,0,0,3
187417570,1,1,0,1,3
316097281,1,2,0,0,3
40388829,0,2,1,0,3
53339615,0,3,0,0,3
325054109,0,3,0,0,3
1483329108960751616,3,0,0,0,3
408414275,0,3,0,0,3
408425049,3,0,0,0,3
323608735,0,3,0,0,3
1497731047781326848,0,3,0,0,3
1497582295418654720,0,3,0,0,3
166955719,0,3,0,0,3
1483126755498299392,0,2,1,0,3
45879114,0,3,0,0,3
322559453,0,3,0,0,3
1433745874006405120,2,1,0,0,3
415858118,0,3,0,0,3
45177874,0,3,0,0,3
165067888,0,3,0,0,3
1452226549667741696,0,3,0,0,3
172712432,0,3,0,0,3
1484011763368886272,0,3,0,0,3
1484080686575362048,2,0,0,1,3
406977214,3,0,0,0,3
1482615557698785280,0,3,0,0,3
49726503,0,3,0,0,3
1484200951691243520,0,3,0,0,3
422527331,0,3,0,0,3
153132108,0,3,0,0,3
1448808143320932352,0,3,0,0,3
32877315,1,2,0,0,3
56405179,1,2,0,0,3
200080261,0,3,0,0,3
305756922,0,3,0,0,3
1436182066295541760,0,3,0,0,3
147890240,0,3,0,0,3
57145493,3,0,0,0,3
146644080,0,3,0,0,3
33272572,1,2,0,0,3
1498595378677301248,0,3,0,0,3
1479689622091223040,2,0,0,1,3
1455960212918063104,0,3,0,0,3
1496878653967581184,0,3,0,0,3
1498663974770180096,3,0,0,0,3
206529413,0,3,0,0,3
207435031,0,3,0,0,3
207824434,0,3,0,0,3
391886614,0,3,0,0,3
439456191,0,3,0,0,3
1486987026624921600,0,3,0,0,3
1429183703327068160,3,0,0,0,3
1478998783782391808,0,3,0,0,3
443428247,0,3,0,0,3
1498527122930896896,0,3,0,0,3
56035608,1,2,0,0,3
423388695,1,2,0,0,3
428870364,3,0,0,0,3
425174455,0,3,0,0,3
1480906149062918144,3,0,0,0,3
1455401497995321344,3,0,0,0,3
1435916144792068096,0,3,0,0,3
192099347,0,3,0,0,3
332412846,0,0,0,3,3
1496929425233186816,3,0,0,0,3
36378141,0,3,0,0,3
1498339034635984896,0,3,0,0,3
193999569,0,3,0,0,3
429650066,0,3,0,0,3
1498513471180132352,1,2,0,0,3
1498354089532350464,1,2,0,0,3
1455761324118401024,0,3,0,0,3
1430993069713805312,0,3,0,0,3
396770218,0,3,0,0,3
196066540,0,3,0,0,3
1480081046515249152,0,3,0,0,3
396044297,0,3,0,0,3
34705390,0,3,0,0,3
148683957,0,3,0,0,3
198193231,0,3,0,0,3
1505690696883314688,3,0,0,0,3
131796042,1,2,0,0,3
1483364602197180416,0,3,0,0,3
1417732356924866560,0,3,0,0,3
1494073915458695168,0,3,0,0,3
355525785,0,3,0,0,3
115606955,0,3,0,0,3
359428041,0,3,0,0,3
1469632044863045632,0,3,0,0,3
1417032652175994880,0,3,0,0,3
17217096,3,0,0,0,3
1419149535406804992,3,0,0,0,3
1491526791416381440,0,3,0,0,3
1491520629258227712,0,3,0,0,3
252248385,0,3,0,0,3
1445158597877448704,0,3,0,0,3
114380575,0,3,0,0,3
286641602,0,3,0,0,3
1462422883771170816,1,2,0,0,3
105882236,0,3,0,0,3
359547642,0,3,0,0,3
1470045536535257088,0,3,0,0,3
14395137,0,3,0,0,3
1464419684011364352,0,3,0,0,3
1420782855299375104,0,3,0,0,3
83375062,0,3,0,0,3
271819690,0,3,0,0,3
1470446198976749568,0,3,0,0,3
291240985,0,3,0,0,3
18199486,0,3,0,0,3
1491711853571227648,3,0,0,0,3
1470428643142811648,2,1,0,0,3
17918275,0,3,0,0,3
1470215742406594560,0,0,0,3,3
276943235,0,3,0,0,3
1532228417407557632,3,0,0,0,3
98939225,1,0,2,0,3
1490901639519039488,0,3,0,0,3
252997533,0,3,0,0,3
118268606,1,2,0,0,3
1490931267835424768,0,3,0,0,3
1461336663741718528,0,3,0,0,3
111589281,0,3,0,0,3
1523733343220633600,1,0,0,2,3
1493514512125014016,3,0,0,0,3
282543452,0,3,0,0,3
256324889,0,3,0,0,3
1417961798028992512,0,3,0,0,3
282224034,0,3,0,0,3
1493504812247547904,2,0,0,1,3
259801074,0,3,0,0,3
1493464878107230208,0,3,0,0,3
257619002,0,3,0,0,3
280641074,0,3,0,0,3
111133911,0,3,0,0,3
1468204594928914432,0,3,0,0,3
1493077041314680832,0,3,0,0,3
16448463,0,3,0,0,3
1418390864972238848,0,3,0,0,3
16819937,0,3,0,0,3
1468945962731282432,0,2,0,1,3
483878393,0,3,0,0,3
113343900,0,3,0,0,3
285741477,0,3,0,0,3
112736248,0,3,0,0,3
1493569294680141824,0,3,0,0,3
278976940,0,3,0,0,3
109849557,0,3,0,0,3
1467701649699323904,2,1,0,0,3
87983041,0,3,0,0,3
94474455,0,3,0,0,3
1461925024399605760,0,3,0,0,3
88625649,3,0,0,0,3
261035289,0,3,0,0,3
14206115,0,3,0,0,3
267336791,0,3,0,0,3
1463418642436034560,0,3,0,0,3
82498087,0,3,0,0,3
276091660,0,3,0,0,3
101415307,0,3,0,0,3
10362072,0,3,0,0,3
244963942,0,3,0,0,3
1511081980581990400,3,0,0,0,3
1492116362415996928,0,3,0,0,3
1489956313203617792,0,0,3,0,3
120054760,0,3,0,0,3
1511329869069701120,3,0,0,0,3
19258803,0,3,0,0,3
1494642549163712512,0,3,0,0,3
1446171708474503168,0,3,0,0,3
273107148,1,2,0,0,3
497234852,1,1,0,1,3
1446243893562036224,0,3,0,0,3
1490016143645425664,2,1,0,0,3
1444521593162530816,2,0,0,1,3
1462874410952499200,3,0,0,0,3
362841138,1,1,1,0,3
13525132,0,3,0,0,3
1489937817887457280,0,3,0,0,3
119397837,0,3,0,0,3
4290718220,2,0,0,0,2
4277822669,0,2,0,0,2
1244839478755086336,0,2,0,0,2
3185925794,0,2,0,0,2
108958758,0,2,0,0,2
1255040071167815680,0,2,0,0,2
148979178,0,2,0,0,2
1485340156152651776,0,2,0,0,2
1491794188396302336,0,2,0,0,2
149532170,0,2,0,0,2
3185717265,1,1,0,0,2
3165221834,0,2,0,0,2
108519351,0,2,0,0,2
1485224157159821312,0,2,0,0,2
4305883163,0,2,0,0,2
162977775,0,2,0,0,2
163684370,0,2,0,0,2
1246153290976571392,0,0,0,2,2
1483760621028274176,0,2,0,0,2
1210926500704243712,0,2,0,0,2
1485314824775278592,0,2,0,0,2
149565870,0,2,0,0,2
1245840644008009728,2,0,0,0,2
1245825781844127744,0,2,0,0,2
4298435661,0,2,0,0,2
165073959,0,2,0,0,2
1483748959973953536,0,2,0,0,2
4582618826,0,2,0,0,2
4273041988,0,2,0,0,2
1214614072760655872,0,2,0,0,2
1485409081791811584,0,2,0,0,2
110822441,0,2,0,0,2
4243248854,0,2,0,0,2
1214892248975855616,1,1,0,0,2
146377771,0,2,0,0,2
101810576,0,2,0,0,2
4233363254,2,0,0,0,2
1486147166276145152,0,2,0,0,2
4230938057,0,2,0,0,2
101745251,0,2,0,0,2
3220055287,0,2,0,0,2
4228131592,0,2,0,0,2
3226453204,0,2,0,0,2
1486194782145695744,0,2,0,0,2
3228142123,0,2,0,0,2
3228382778,0,2,0,0,2
3228553432,0,2,0,0,2
4610672903,0,2,0,0,2
3221117109,0,2,0,0,2
3204832423,1,1,0,0,2
1483656510995836928,2,0,0,0,2
4257467626,0,2,0,0,2
1244285054391484416,0,2,0,0,2
1214438838367449088,2,0,0,0,2
1255740879777611776,0,2,0,0,2
1483887330964512768,2,0,0,0,2
1491855217671151616,0,0,0,2,2
1491270534268866560,0,2,0,0,2
3193596694,0,2,0,0,2
102757229,1,1,0,0,2
1485772760706347008,1,0,0,1,2
3195136410,0,2,0,0,2
3033318092,0,2,0,0,2
1491242122674323456,2,0,0,0,2
3029899181,0,2,0,0,2
1483396868675895296,0,2,0,0,2
102619476,0,2,0,0,2
3026032228,0,2,0,0,2
1491460986313875456,1,1,0,0,2
3163936645,1,1,0,0,2
1253731723222765568,1,1,0,0,2
4440595215,0,2,0,0,2
3110232323,0,2,0,0,2
4501434974,0,2,0,0,2
1212249442218176512,0,2,0,0,2
4466886377,0,2,0,0,2
3111536505,0,2,0,0,2
4564813040,0,2,0,0,2
4466613313,0,2,0,0,2
1212714006571409408,0,2,0,0,2
3112274653,0,2,0,0,2
4408240696,0,2,0,0,2
1212980328572153856,0,2,0,0,2
3114591309,0,2,0,0,2
1252531464857681920,0,2,0,0,2
1249035653670735872,0,2,0,0,2
104736957,0,2,0,0,2
3121360286,0,2,0,0,2
160454090,0,0,2,0,2
3128088058,0,2,0,0,2
3108495978,0,2,0,0,2
3107403726,0,2,0,0,2
104412957,0,2,0,0,2
1249926288711663616,2,0,0,0,2
1484203996135161856,1,0,0,1,2
3086579237,0,2,0,0,2
3088183988,0,2,0,0,2
159112626,0,2,0,0,2
103720099,0,2,0,0,2
1252180938978521088,1,1,0,0,2
1251387950731948032,0,2,0,0,2
1251276490278342656,0,2,0,0,2
104397513,0,2,0,0,2
3081628978,0,2,0,0,2
3080021160,0,2,0,0,2
3096655903,0,2,0,0,2
1252501950844882944,0,2,0,0,2
1251111378464772096,0,2,0,0,2
1484446508573683712,2,0,0,0,2
3076933611,2,0,0,0,2
3099841759,0,2,0,0,2
160522384,0,2,0,0,2
1252551747769217024,0,2,0,0,2
1491472337941647360,0,2,0,0,2
3061372766,0,2,0,0,2
1247162388232589312,0,2,0,0,2
1247145729866567680,0,2,0,0,2
106303576,0,2,0,0,2
1247096570870456320,0,2,0,0,2
1247025878892077056,2,0,0,0,2
4359734296,0,2,0,0,2
151851297,0,2,0,0,2
1253194916479545344,0,2,0,0,2
4575759733,0,2,0,0,2
1248162356686962688,0,2,0,0,2
4346330352,0,2,0,0,2
1253295492739416064,0,2,0,0,2
3053726486,0,2,0,0,2
4327364847,0,2,0,0,2
151367002,0,2,0,0,2
1485210582924263424,1,1,0,0,2
3087491573,0,2,0,0,2
3164098435,2,0,0,0,2
3148645705,0,2,0,0,2
3148619200,0,2,0,0,2
152694800,0,2,0,0,2
1247297832287195136,0,2,0,0,2
3136770179,0,2,0,0,2
3071601897,0,2,0,0,2
1484163998564040704,1,0,1,0,2
4221885645,0,2,0,0,2
1247752684855160832,0,2,0,0,2
106069949,0,2,0,0,2
103106629,0,2,0,0,2
3141135952,0,2,0,0,2
3143275082,0,2,0,0,2
1252721816532992000,0,2,0,0,2
3067171311,0,1,1,0,2
4574283912,0,2,0,0,2
1213254905349038080,0,2,0,0,2
3065181529,2,0,0,0,2
106085434,0,2,0,0,2
152920293,0,2,0,0,2
3146315662,2,0,0,0,2
3228913891,0,2,0,0,2
3675240072,0,2,0,0,2
3229217006,0,2,0,0,2
1490268976777428992,0,2,0,0,2
1231178053843324928,0,2,0,0,2
3900688275,0,2,0,0,2
3375577557,0,2,0,0,2
3380511171,0,2,0,0,2
1229751734391771136,0,2,0,0,2
3899337568,0,2,0,0,2
1229093555924168704,2,0,0,0,2
1229008920418693120,2,0,0,0,2
1488907016877711360,0,1,0,1,2
3893255361,0,2,0,0,2
129219792,0,2,0,0,2
3885806474,0,2,0,0,2
3400897287,0,2,0,0,2
3866521153,1,1,0,0,2
3404422394,2,0,0,0,2
3405720553,0,2,0,0,2
129130976,0,2,0,0,2
1227838083430633472,1,1,0,0,2
128414115,0,2,0,0,2
1220373926598959104,0,2,0,0,2
3420022900,0,0,0,2,2
3370500687,0,2,0,0,2
3369652703,0,2,0,0,2
3368018859,0,2,0,0,2
3344341453,0,2,0,0,2
3944865754,0,2,0,0,2
1219503623874498560,2,0,0,0,2
3926417657,0,2,0,0,2
3336425339,0,2,0,0,2
131229750,0,2,0,0,2
131056491,0,2,0,0,2
3920622809,0,1,0,1,2
1488550246737379328,2,0,0,0,2
117137247,0,2,0,0,2
1233215349149048832,0,2,0,0,2
3366221427,2,0,0,0,2
3345786909,0,2,0,0,2
1233094620592181248,0,2,0,0,2
1488626034820149248,0,2,0,0,2
130349411,0,2,0,0,2
1232143018821439488,0,2,0,0,2
1219868369295462400,0,2,0,0,2
1219997000038436864,1,0,0,1,2
3360960238,0,2,0,0,2
1488820231715893248,2,0,0,0,2
128171724,0,2,0,0,2
1489069569801338880,0,2,0,0,2
1486248268128714752,0,2,0,0,2
1227190985320321024,0,2,0,0,2
1489315473720496128,2,0,0,0,2
3498477623,0,2,0,0,2
1224825929639198720,2,0,0,0,2
120151540,1,1,0,0,2
3513956295,0,2,0,0,2
1224749444727357440,1,1,0,0,2
1224566569319239680,0,2,0,0,2
1222877194734776320,1,1,0,0,2
3528564315,0,2,0,0,2
3539282472,0,2,0,0,2
1489502302826336256,0,2,0,0,2
3573191833,0,2,0,0,2
3584184200,0,2,0,0,2
1223581600581148672,1,1,0,0,2
1223572581418094592,0,2,0,0,2
3646356376,0,2,0,0,2
1489675852610957312,0,2,0,0,2
3690598643,0,2,0,0,2
3657174254,0,2,0,0,2
3657929232,0,2,0,0,2
1489909208816689152,2,0,0,0,2
119725805,0,2,0,0,2
3469703714,0,2,0,0,2
1489213923455041536,0,2,0,0,2
1226320407562784768,0,2,0,0,2
3421791370,0,2,0,0,2
119072336,0,2,0,0,2
3827183967,0,2,0,0,2
1226929396319014912,0,2,0,0,2
1226504364275183616,0,2,0,0,2
1221546811535446016,0,2,0,0,2
1221621206316486656,2,0,0,0,2
1489163590376505344,1,1,0,0,2
3812731402,0,2,0,0,2
1489191288364998656,0,2,0,0,2
126101497,0,2,0,0,2
1489204146444058624,1,1,0,0,2
119354182,0,2,0,0,2
3791906593,0,2,0,0,2
3785941347,0,2,0,0,2
3774736227,0,2,0,0,2
3448984879,2,0,0,0,2
1222460820451295232,0,2,0,0,2
3449590998,0,2,0,0,2
1489213472617340928,0,2,0,0,2
1234409092271112192,0,2,0,0,2
168111953,0,2,0,0,2
1219498364980662272,0,2,0,0,2
1488242300895514624,0,2,0,0,2
3257063269,0,2,0,0,2
3257652889,1,0,0,1,2
3258024343,0,2,0,0,2
1491046283322466304,1,1,0,0,2
4151665535,0,2,0,0,2
1241263686905462784,1,0,0,1,2
3260585540,0,2,0,0,2
1241074064753557504,0,2,0,0,2
1490999559182753792,0,1,1,0,2
4148109734,2,0,0,0,2
3266602596,0,2,0,0,2
4135841608,0,2,0,0,2
112664833,0,2,0,0,2
141940558,0,2,0,0,2
1240355988047183872,0,2,0,0,2
141640691,0,2,0,0,2
112689889,0,2,0,0,2
141513369,0,2,0,0,2
141009810,0,2,0,0,2
1239913172242296832,0,2,0,0,2
1239899594630336512,2,0,0,0,2
111664824,0,2,0,0,2
4177068274,2,0,0,0,2
1241266801385672704,0,2,0,0,2
1241823881050161152,0,2,0,0,2
1214949396258816000,0,1,1,0,2
3230920029,0,1,0,1,2
1491222265081462784,2,0,0,0,2
1215115866129432576,0,2,0,0,2
145165838,0,2,0,0,2
145058470,0,2,0,0,2
1486652318812495872,0,2,0,0,2
3242697430,2,0,0,0,2
3244146769,0,2,0,0,2
3247686929,0,2,0,0,2
3677117839,0,2,0,0,2
1241666955205120000,1,0,1,0,2
1241618760039051264,0,2,0,0,2
4190106072,0,2,0,0,2
3249281125,0,2,0,0,2
111543933,0,2,0,0,2
3251234804,0,2,0,0,2
4185002991,0,2,0,0,2
4183529480,0,2,0,0,2
3255660043,2,0,0,0,2
1217109281788424192,0,2,0,0,2
140844443,0,2,0,0,2
3285515346,0,2,0,0,2
1236861646120706048,0,2,0,0,2
135216045,0,2,0,0,2
3303088676,0,2,0,0,2
135059909,0,2,0,0,2
3304510392,0,2,0,0,2
134688294,2,0,0,0,2
4028449035,0,2,0,0,2
114972517,0,2,0,0,2
134504385,0,2,0,0,2
134409587,0,2,0,0,2
1236637542578962432,0,2,0,0,2
1487871308624916480,0,2,0,0,2
3308526488,0,2,0,0,2
3309781579,1,1,0,0,2
3954554592,1,1,0,0,2
3953839642,0,2,0,0,2
3315606818,0,2,0,0,2
3318813642,0,2,0,0,2
133397127,0,2,0,0,2
3322690593,1,1,0,0,2
132518232,0,2,0,0,2
135337013,0,2,0,0,2
136218376,0,2,0,0,2
1239605934101594112,0,2,0,0,2
3293267364,0,0,0,2,2
1239578754911023104,0,2,0,0,2
1217511997622743040,0,2,0,0,2
1487707470357164032,0,2,0,0,2
138518329,0,2,0,0,2
1218093984989569024,0,2,0,0,2
1218177067730206720,0,2,0,0,2
3291315249,0,2,0,0,2
137614375,0,2,0,0,2
3293002253,0,2,0,0,2
1238708516568924160,0,2,0,0,2
136225245,0,2,0,0,2
1238696034156466176,0,1,0,1,2
1238551714501976064,0,2,0,0,2
1487770349655949312,0,2,0,0,2
137028044,0,2,0,0,2
1238299446011551744,0,2,0,0,2
3297714729,0,2,0,0,2
1218310482085523456,1,1,0,0,2
4038396377,0,2,0,0,2
1487854276022267904,0,2,0,0,2
3256327868,0,2,0,0,2
2942121530,0,2,0,0,2
1257808704608460800,0,2,0,0,2
1289371174720303104,0,2,0,0,2
245750555,0,2,0,0,2
1291438221210062848,0,2,0,0,2
2521484937,0,2,0,0,2
2523360169,2,0,0,0,2
244941790,0,2,0,0,2
2528998652,0,2,0,0,2
2530048261,0,2,0,0,2
1289638693767012352,1,1,0,0,2
1471715573432078336,0,2,0,0,2
2534603834,0,2,0,0,2
2534670623,0,2,0,0,2
2535065565,0,2,0,0,2
1289252748492451840,0,2,0,0,2
2564171462,0,2,0,0,2
2537793781,0,2,0,0,2
243839975,0,2,0,0,2
2543229818,0,2,0,0,2
2544518762,2,0,0,0,2
1288889433484230656,0,2,0,0,2
2544589878,2,0,0,0,2
2545059021,0,2,0,0,2
243543397,0,2,0,0,2
2550766506,0,2,0,0,2
243492952,1,0,0,1,2
2556117764,1,1,0,0,2
2560710709,0,2,0,0,2
1291667386551226368,0,2,0,0,2
1291838937900687360,0,2,0,0,2
1292025269482471424,0,2,0,0,2
2506025500,0,2,0,0,2
1470376169988055040,0,2,0,0,2
2473833206,0,2,0,0,2
249227352,0,2,0,0,2
1294344799542079488,0,2,0,0,2
2477012413,0,2,0,0,2
2479159384,0,2,0,0,2
1470635636126330880,0,2,0,0,2
1294189701939597312,0,2,0,0,2
1293956001570287616,0,2,0,0,2
1470650892001046528,0,2,0,0,2
1470728778326634496,0,2,0,0,2
1293758608430125056,2,0,0,0,2
248597185,0,2,0,0,2
2486645795,0,2,0,0,2
248326821,0,2,0,0,2
1470813705994522624,0,2,0,0,2
1293426260752732160,0,2,0,0,2
1293425355504615424,0,2,0,0,2
247744426,0,2,0,0,2
247606369,0,2,0,0,2
2495438810,0,2,0,0,2
1470861061985341440,2,0,0,0,2
2496647126,0,2,0,0,2
2499309088,0,2,0,0,2
246635724,0,2,0,0,2
1288402398537375744,0,2,0,0,2
1288136851149258752,1,1,0,0,2
2722863769,0,2,0,0,2
1475754603635425280,2,0,0,0,2
1284495150161571840,0,2,0,0,2
233213435,0,2,0,0,2
1475213189118054400,0,2,0,0,2
2660326016,2,0,0,0,2
1283485092837351424,0,2,0,0,2
2665017757,0,2,0,0,2
1283372059528060928,0,2,0,0,2
232722042,0,2,0,0,2
1283178030311997440,0,2,0,0,2
2678021005,0,2,0,0,2
1282995606160637952,2,0,0,0,2
2687350262,0,2,0,0,2
2691204877,0,2,0,0,2
2573331648,0,2,0,0,2
231390130,1,0,0,1,2
2696614196,0,2,0,0,2
2700660692,1,1,0,0,2
1475813211450474496,0,2,0,0,2
2704965173,0,2,0,0,2
230236529,0,2,0,0,2
2707728270,0,2,0,0,2
1281599128636620800,0,2,0,0,2
2708895492,0,2,0,0,2
1281303947857113088,0,1,1,0,2
230048463,0,2,0,0,2
2718750568,0,2,0,0,2
233943121,0,2,0,0,2
1285163159431479296,2,0,0,0,2
2622018129,0,2,0,0,2
1285200781637894144,0,2,0,0,2
1287506952864448512,0,2,0,0,2
2576425886,0,2,0,0,2
240903720,1,1,0,0,2
1287397956539183104,0,2,0,0,2
2577457657,0,2,0,0,2
1472497796095741952,0,2,0,0,2
240637003,0,2,0,0,2
239140810,1,1,0,0,2
2589551880,0,2,0,0,2
2589587030,0,2,0,0,2
2590147053,0,2,0,0,2
2593074158,0,2,0,0,2
2598357146,0,2,0,0,2
1286486521705570304,0,2,0,0,2
2599950680,2,0,0,0,2
237056401,0,1,1,0,2
2601872593,0,2,0,0,2
237045706,1,1,0,0,2
1285911735942049792,0,0,2,0,2
1285876242521247744,1,1,0,0,2
2609692498,0,2,0,0,2
2611110809,0,2,0,0,2
2611431416,0,2,0,0,2
2611604700,0,2,0,0,2
1285239879266377728,0,2,0,0,2
2469065406,0,2,0,0,2
1295263023938953216,0,2,0,0,2
1295579131535482880,0,2,0,0,2
1301773814922051584,1,0,1,0,2
268881635,0,2,0,0,2
268167026,1,1,0,0,2
2336431904,0,2,0,0,2
2336697621,0,2,0,0,2
1466451229903523840,0,2,0,0,2
2338093123,0,2,0,0,2
1466658918264754176,0,2,0,0,2
1466661527503532032,2,0,0,0,2
1466684407528394752,0,2,0,0,2
2344648615,0,2,0,0,2
265739465,0,2,0,0,2
1466699264608768000,0,2,0,0,2
1301492626990878720,0,2,0,0,2
2463109588,0,2,0,0,2
1301468710172008448,0,2,0,0,2
265461503,0,2,0,0,2
2362385928,2,0,0,0,2
262014457,0,2,0,0,2
2363894840,1,1,0,0,2
1300628572747362304,0,2,0,0,2
1300468762538205184,0,2,0,0,2
1300446331991764992,0,2,0,0,2
1300421739999121408,0,2,0,0,2
1300421541390237696,0,2,0,0,2
261296510,2,0,0,0,2
1300133815742939136,0,2,0,0,2
1302917210994651136,0,2,0,0,2
2330341389,0,2,0,0,2
2330040696,0,2,0,0,2
2328820555,0,2,0,0,2
2289096968,2,0,0,0,2
1306294821368352768,2,0,0,0,2
1306259261647761408,0,2,0,0,2
1306160342695907328,0,2,0,0,2
275100593,2,0,0,0,2
1305790360845778944,0,2,0,0,2
2299352593,1,0,1,0,2
273953205,1,0,0,1,2
273288605,0,2,0,0,2
1304726144508280832,0,2,0,0,2
1463782061337051136,2,0,0,0,2
2310662821,0,2,0,0,2
1304454789619539968,2,0,0,0,2
1304371714424410112,1,0,0,1,2
1304370522809982976,2,0,0,0,2
1304347684245995520,2,0,0,0,2
2316440479,0,2,0,0,2
1304201468761657344,0,2,0,0,2
1303935590447095808,0,2,0,0,2
1303603127573073920,0,2,0,0,2
270921976,0,2,0,0,2
2326846419,0,2,0,0,2
1303586489926705152,2,0,0,0,2
1466291749853138944,0,2,0,0,2
2328637353,0,2,0,0,2
260981899,0,2,0,0,2
2385745835,0,2,0,0,2
1299925463628873728,0,2,0,0,2
1297454966760775680,0,2,0,0,2
2425475401,0,2,0,0,2
2427052446,0,2,0,0,2
1297375397902815232,0,2,0,0,2
254452480,0,2,0,0,2
2428664117,0,2,0,0,2
2430740328,0,2,0,0,2
1297202898602868736,2,0,0,0,2
253830702,0,2,0,0,2
2436757268,0,2,0,0,2
1296740373784600576,0,2,0,0,2
252964664,0,2,0,0,2
252572395,0,2,0,0,2
252353889,0,2,0,0,2
1296132067978293248,0,2,0,0,2
2452103678,0,2,0,0,2
1469558384336814080,0,2,0,0,2
1296006171862667264,0,2,0,0,2
1295965743759134720,0,2,0,0,2
1295949138731859968,0,2,0,0,2
1295833175911018496,0,2,0,0,2
1469882338758647808,2,0,0,0,2
1469975691160702976,0,0,2,0,2
250143521,0,2,0,0,2
2460810307,2,0,0,0,2
1295651070073602048,0,2,0,0,2
1297443369589776384,0,2,0,0,2
254565033,0,2,0,0,2
2386503786,0,2,0,0,2
254609823,0,2,0,0,2
260346753,0,2,0,0,2
2391059814,2,0,0,0,2
2392597286,0,2,0,0,2
1299302634461868032,0,2,0,0,2
2394755678,0,2,0,0,2
2395214774,0,2,0,0,2
1299134568201687040,1,0,0,1,2
2395739449,0,2,0,0,2
2402719399,1,1,0,0,2
2403271687,0,2,0,0,2
1298562046456258560,2,0,0,0,2
1468386524160999424,0,2,0,0,2
2405068562,0,2,0,0,2
1468564220606562304,0,2,0,0,2
1298410825674153984,0,2,0,0,2
1298239233673461760,0,2,0,0,2
1298185335248224256,2,0,0,0,2
1297987912219291648,1,1,0,0,2
2413779882,0,2,0,0,2
2414913756,0,2,0,0,2
1297750581495308288,0,2,0,0,2
1468614387501965312,2,0,0,0,2
255681617,0,2,0,0,2
2417035395,0,2,0,0,2
255160831,0,2,0,0,2
1476433577545928704,0,2,0,0,2
228378417,0,2,0,0,2
1483258173784215552,0,2,0,0,2
186143353,0,2,0,0,2
1265583957955010560,1,0,0,1,2
2923534360,0,2,0,0,2
189556112,2,0,0,0,2
1481227989698363392,1,1,0,0,2
2926939681,0,2,0,0,2
189336597,0,2,0,0,2
2927701133,2,0,0,0,2
1481335313394020352,0,2,0,0,2
2933092680,0,2,0,0,2
2935940073,1,0,0,1,2
2936027541,0,2,0,0,2
186226178,0,2,0,0,2
2941102014,0,2,0,0,2
2955622573,0,2,0,0,2
1264311489986347008,0,2,0,0,2
2941930350,0,2,0,0,2
1209428388164833280,0,2,0,0,2
1264130977074417664,2,0,0,0,2
2945140487,0,2,0,0,2
1263960566281973760,0,2,0,0,2
185366736,0,2,0,0,2
2946686555,0,2,0,0,2
1263905262412259328,0,2,0,0,2
1481955547339497472,0,2,0,0,2
2950848085,0,2,0,0,2
183753455,0,2,0,0,2
1265884093658644480,0,2,0,0,2
189890404,0,2,0,0,2
2916646212,0,2,0,0,2
2916627870,0,2,0,0,2
197021891,0,2,0,0,2
196699217,0,2,0,0,2
1268391120528125952,0,2,0,0,2
2887203109,0,2,0,0,2
2893168371,0,2,0,0,2
195870839,0,2,0,0,2
195853015,0,2,0,0,2
2894757369,0,2,0,0,2
195553045,0,2,0,0,2
2896158090,0,2,0,0,2
2896567768,2,0,0,0,2
1267662839365488640,2,0,0,0,2
195164494,1,0,1,0,2
194600582,1,1,0,0,2
1480247441538502656,0,2,0,0,2
194118414,0,2,0,0,2
2905369549,0,2,0,0,2
1267093274910572544,0,2,0,0,2
2905913526,0,2,0,0,2
1480455793098903552,1,1,0,0,2
193310773,0,2,0,0,2
2911019156,0,2,0,0,2
191467176,0,2,0,0,2
191457469,0,2,0,0,2
1481148923481772032,0,0,0,2,2
2954559328,1,0,0,1,2
2955641099,0,2,0,0,2
1476957766337974272,0,2,0,0,2
3003886063,0,2,0,0,2
1482645083040145408,0,2,0,0,2
173097287,0,2,0,0,2
2997322255,0,2,0,0,2
1259831088869830656,1,1,0,0,2
2997788818,0,2,0,0,2
2999756338,1,1,0,0,2
1259532605726179328,0,2,0,0,2
172338200,2,0,0,0,2
1259400814595993600,2,0,0,0,2
1259145475099291648,0,2,0,0,2
3002446154,0,2,0,0,2
1259042575312285696,2,0,0,0,2
171954269,0,2,0,0,2
182058939,0,2,0,0,2
1258935704903536640,0,2,0,0,2
3004785390,0,2,0,0,2
1258765708281827328,0,2,0,0,2
171481198,0,2,0,0,2
1483049074534273024,0,2,0,0,2
170954045,0,2,0,0,2
3011322340,0,2,0,0,2
170521692,2,0,0,0,2
3013421305,0,2,0,0,2
3013507063,0,2,0,0,2
1258068505406169088,0,2,0,0,2
3016061814,0,2,0,0,2
2992906642,0,2,0,0,2
2989668585,0,2,0,0,2
1260184545824997376,1,1,0,0,2
175042044,0,2,0,0,2
2956552615,0,2,0,0,2
1482227523513913344,2,0,0,0,2
2956893668,0,2,0,0,2
180215784,0,2,0,0,2
1262481394548293632,0,2,0,0,2
2965132426,0,2,0,0,2
2966082358,0,2,0,0,2
180111748,0,2,0,0,2
2968186857,0,2,0,0,2
2971865177,0,2,0,0,2
1261731042626465792,0,2,0,0,2
2973976941,0,2,0,0,2
1261499414188707840,0,2,0,0,2
2975232586,0,2,0,0,2
1261484245496688640,0,2,0,0,2
1261402927182352384,0,2,0,0,2
1261359421336064000,2,0,0,0,2
1261338989388132352,0,2,0,0,2
2979452835,0,2,0,0,2
2980887521,0,2,0,0,2
1261176900308750336,0,2,0,0,2
2984584848,0,2,0,0,2
1482596324801671168,0,2,0,0,2
1260942392875552768,0,2,0,0,2
176292487,0,2,0,0,2
2885609502,0,2,0,0,2
1479999170161233920,0,2,0,0,2
1268793298996559872,0,2,0,0,2
1276492849555443712,0,2,0,0,2
2765536356,0,1,1,0,2
223634403,0,2,0,0,2
2766558457,0,2,0,0,2
2766603077,0,2,0,0,2
1277653859301801984,0,2,0,0,2
1277392351514619904,1,0,0,1,2
2770199492,2,0,0,0,2
1277321659385409536,1,0,0,1,2
2771448095,0,2,0,0,2
222753306,0,2,0,0,2
1477556103026151424,1,1,0,0,2
1276857112694415360,0,2,0,0,2
2778721921,0,2,0,0,2
1479900995773730816,0,2,0,0,2
2778741031,1,1,0,0,2
1275853871420563456,0,2,0,0,2
2780688660,0,2,0,0,2
1275487911262085120,0,2,0,0,2
1275415882823372800,0,2,0,0,2
2784397760,1,1,0,0,2
2785667130,0,2,0,0,2
1275304490938142720,0,2,0,0,2
2786457504,0,2,0,0,2
1275149110086037504,2,0,0,0,2
1274698794198679552,0,2,0,0,2
1274643649666486272,0,2,0,0,2
2765242626,0,2,0,0,2
1277897930104541184,1,1,0,0,2
2763527634,0,2,0,0,2
2763329466,0,2,0,0,2
2730823872,0,2,0,0,2
226678645,0,2,0,0,2
2730952840,0,2,0,0,2
1279724839767437312,2,0,0,0,2
2734629534,2,0,0,0,2
1477174821721149440,0,2,0,0,2
1279285367284174848,0,2,0,0,2
2740464796,0,1,0,1,2
1279108834036862976,0,2,0,0,2
2745546675,0,2,0,0,2
2746660000,0,2,0,0,2
2748428095,0,2,0,0,2
1278971537186590720,0,2,0,0,2
2750144598,2,0,0,0,2
2752322939,0,2,0,0,2
2752812483,0,2,0,0,2
2753622690,1,1,0,0,2
2753956353,1,1,0,0,2
1278293139820695552,0,2,0,0,2
225779417,1,1,0,0,2
2758100255,0,2,0,0,2
1278161339039408128,0,2,0,0,2
2760394401,0,2,0,0,2
1477494986606190592,2,0,0,0,2
1477517079221780480,0,2,0,0,2
1274422010043654144,0,1,1,0,2
2794951337,0,2,0,0,2
2796386420,0,2,0,0,2
2842034452,0,2,0,0,2
1272206493836816384,0,2,0,0,2
1271390578161471488,0,2,0,0,2
1271335145258184704,0,2,0,0,2
1271270015300329472,0,2,0,0,2
1479486637000179712,0,2,0,0,2
206608613,0,2,0,0,2
206327748,0,2,0,0,2
2855730904,0,2,0,0,2
2856133189,0,2,0,0,2
206086913,0,2,0,0,2
2865537238,0,2,0,0,2
205046843,2,0,0,0,2
204534066,0,2,0,0,2
1479724148335120384,0,2,0,0,2
1479773759737249792,0,2,0,0,2
1270053286108966912,0,2,0,0,2
1269933538708725760,0,2,0,0,2
1269627323399180288,0,2,0,0,2
1479785631530115072,2,0,0,0,2
1269255240924176384,0,1,1,0,2
1479823340802039808,0,2,0,0,2
2877552057,0,2,0,0,2
199179301,1,1,0,0,2
198462461,0,2,0,0,2
1268945062932725760,0,2,0,0,2
1479396754311114752,1,1,0,0,2
209540813,0,2,0,0,2
216949253,0,2,0,0,2
2839369681,0,2,0,0,2
1274399472957743104,0,2,0,0,2
1478311469964050432,0,2,0,0,2
216385540,0,2,0,0,2
1478424712887820288,0,1,0,1,2
2807223738,0,2,0,0,2
1273923505310982144,1,1,0,0,2
2811476424,1,1,0,0,2
1478714269906751488,0,2,0,0,2
212566126,0,2,0,0,2
1273459689276100608,0,2,0,0,2
1273450719719206912,0,2,0,0,2
2822491770,0,2,0,0,2
1478975861780930560,0,2,0,0,2
2824498135,0,2,0,0,2
2826954699,0,2,0,0,2
2828301327,0,2,0,0,2
2828727288,0,2,0,0,2
211159724,0,2,0,0,2
210995742,0,2,0,0,2
1272636312038903808,2,0,0,0,2
210628907,0,2,0,0,2
210517351,0,2,0,0,2
1272453277829849088,0,2,0,0,2
1479139343868567552,1,1,0,0,2
2836437775,0,2,0,0,2
1209438575856513024,0,2,0,0,2
1416253100466139136,2,0,0,0,2
1209305755410501632,2,0,0,0,2
1086976235329253376,0,2,0,0,2
27364266,0,2,0,0,2
906120522739597312,0,2,0,0,2
906836297922129920,2,0,0,0,2
1086287005460291584,0,2,0,0,2
1086143603288621056,0,2,0,0,2
1499131356248702976,1,1,0,0,2
907382831130857472,0,2,0,0,2
907415354929930240,0,2,0,0,2
1085505534852239360,0,2,0,0,2
1499181751260053504,2,0,0,0,2
908025525570084864,1,1,0,0,2
1499221873783361536,2,0,0,0,2
1085092428112187392,0,2,0,0,2
1084827900967309312,0,2,0,0,2
909511904841883648,0,2,0,0,2
1499253496268214272,1,1,0,0,2
910015266318192640,0,2,0,0,2
910823084558446592,0,2,0,0,2
910917691870912512,0,2,0,0,2
1499264722893684736,0,0,0,2,2
911090199437787136,2,0,0,0,2
1083271352587440128,0,2,0,0,2
911869530867150848,1,1,0,0,2
25286008,0,2,0,0,2
1082981982848585728,0,2,0,0,2
912357063673761792,0,2,0,0,2
1082962075532517376,0,2,0,0,2
905426873332580352,0,2,0,0,2
904857139277160448,0,2,0,0,2
1082278272610770944,0,2,0,0,2
1087611593117089792,0,2,0,0,2
1093855309951614976,0,2,0,0,2
895178886350241792,0,2,0,0,2
895243173135474688,0,2,0,0,2
1093240179425447936,2,0,0,0,2
29973860,0,2,0,0,2
1092753985679835136,0,2,0,0,2
896658434480717824,0,2,0,0,2
29417540,0,2,0,0,2
29247510,0,2,0,0,2
896920313920991232,0,2,0,0,2
897643936990220288,0,2,0,0,2
29204625,0,2,0,0,2
29198219,0,2,0,0,2
1498940217986011136,0,0,0,2,2
898924140589182976,1,0,0,1,2
1498942471296139264,2,0,0,0,2
1089848494460932096,2,0,0,0,2
28595549,0,2,0,0,2
899666335818366976,2,0,0,0,2
1498968327670353920,2,0,0,0,2
901277712735641600,0,2,0,0,2
28524601,0,2,0,0,2
902131160188207104,0,2,0,0,2
1088458469299052544,2,0,0,0,2
1088167731776626688,0,2,0,0,2
28277980,0,2,0,0,2
903859716740263936,0,2,0,0,2
1499284088284323840,0,1,1,0,2
24733117,1,1,0,0,2
39282932,0,2,0,0,2
1499628570305572864,0,2,0,0,2
1076274653130379264,0,2,0,0,2
1076229948879253504,0,2,0,0,2
926003738350780416,0,2,0,0,2
926112236023812096,0,2,0,0,2
926138392890327040,0,2,0,0,2
22924291,0,2,0,0,2
926675778875539456,0,2,0,0,2
22877371,0,2,0,0,2
927438789584343040,0,2,0,0,2
927904735486607360,2,0,0,0,2
928260270203445248,0,2,0,0,2
22440945,0,2,0,0,2
1073997759978426368,0,2,0,0,2
931412595797643264,0,2,0,0,2
22149904,0,2,0,0,2
932048245450313728,0,2,0,0,2
1073499584658206720,0,1,0,1,2
22079338,1,0,0,1,2
932436882667048960,0,2,0,0,2
932479434543656960,0,2,0,0,2
932493110629847040,0,2,0,0,2
22061225,0,2,0,0,2
1500325198918078464,0,2,0,0,2
933560937575059456,1,1,0,0,2
1072194322752188416,0,2,0,0,2
934105328140120064,0,2,0,0,2
1071669204129120256,0,2,0,0,2
925542908303953920,0,2,0,0,2
924627713104609280,1,0,1,0,2
914757555351629824,0,2,0,0,2
924495933416591360,1,0,0,1,2
1081516301896564736,2,0,0,0,2
1499310647976382464,0,2,0,0,2
915989342467878912,0,2,0,0,2
24322106,0,2,0,0,2
1499320528422715392,0,2,0,0,2
917417760975736832,0,2,0,0,2
918047269588369408,0,2,0,0,2
918781062200872960,0,2,0,0,2
919234016166813696,0,2,0,0,2
1499370108254400512,0,2,0,0,2
1079000939372183552,0,2,0,0,2
1499383458724032512,1,1,0,0,2
1078861385767907328,0,2,0,0,2
921244405100462080,0,2,0,0,2
1499431468698845184,0,2,0,0,2
922031511997530112,0,2,0,0,2
1077596234536243200,0,2,0,0,2
922482182207053824,0,2,0,0,2
1499437281853202432,1,1,0,0,2
922788347176656896,0,2,0,0,2
922889011605262336,0,2,0,0,2
1499455551872598016,2,0,0,0,2
23554832,1,1,0,0,2
1499507490144518144,0,0,0,2,2
923704345362759680,0,2,0,0,2
1076584979180605440,0,2,0,0,2
1076550344048488448,0,2,0,0,2
893499089744277504,0,2,0,0,2
893299346367692800,0,2,0,0,2
1094713876132872192,2,0,0,0,2
1110340762976337920,2,0,0,0,2
1110166782914887680,0,2,0,0,2
1110157873227710464,2,0,0,0,2
36656007,0,2,0,0,2
1109886523808202752,1,0,0,1,2
1498321490042834944,0,2,0,0,2
1109478350718824448,0,2,0,0,2
36548978,0,2,0,0,2
36513063,0,2,0,0,2
863258909796032512,0,2,0,0,2
863977983358500864,1,1,0,0,2
1108423043775254528,0,2,0,0,2
35865703,0,2,0,0,2
864596311689097216,0,2,0,0,2
1107890319952101376,0,2,0,0,2
864775329612677120,1,1,0,0,2
35849210,0,2,0,0,2
864825002805280768,0,2,0,0,2
1107692048180760576,0,2,0,0,2
1498370455404752896,0,2,0,0,2
1498380370982707200,0,2,0,0,2
865764283656884224,1,0,0,1,2
865912530610380800,0,2,0,0,2
866340177400152064,0,2,0,0,2
866705457527877632,0,2,0,0,2
1106549023681458176,0,2,0,0,2
1106460109616701440,1,1,0,0,2
869139607862071296,0,2,0,0,2
1498298873114210304,1,0,0,1,2
860277317498585088,0,2,0,0,2
892286168833732608,0,2,0,0,2
37202992,0,2,0,0,2
1118541565218250752,1,0,0,1,2
1118261506087342080,0,2,0,0,2
38870718,1,1,0,0,2
1117886496311336960,0,0,0,2,2
1117866832331862016,0,2,0,0,2
1117756327499943936,0,0,0,2,2
1117701815414296576,0,2,0,0,2
1498198080872755200,0,2,0,0,2
1117266192115220480,0,2,0,0,2
1498219300875911168,0,2,0,0,2
1116507720138387456,0,2,0,0,2
1115897686262210560,0,2,0,0,2
1115668588826742784,0,2,0,0,2
1115642377597640704,0,1,0,1,2
853789085072113664,1,0,1,0,2
853851105436073984,0,2,0,0,2
854013079293759488,0,2,0,0,2
854332329455648768,0,1,1,0,2
1114065286792208384,0,2,0,0,2
1113444926602141696,2,0,0,0,2
856549010366095360,1,1,0,0,2
857416689490829312,0,2,0,0,2
858269365925548032,0,2,0,0,2
1498276733665034240,0,2,0,0,2
1110795246114242560,0,2,0,0,2
37212840,0,2,0,0,2
859318445149761536,0,2,0,0,2
869201868433444864,0,2,0,0,2
869321938258325504,0,2,0,0,2
35175680,0,2,0,0,2
870932257095241728,0,2,0,0,2
32456965,0,1,1,0,2
1100583390674178048,2,0,0,0,2
882248325252218880,0,2,0,0,2
882390841397960704,0,2,0,0,2
1100303829235572736,0,2,0,0,2
883529255853867008,0,2,0,0,2
884331038557822976,0,2,0,0,2
884402748590096384,0,2,0,0,2
32283017,2,0,0,0,2
884820953326206976,2,0,0,0,2
1098305897749565440,0,2,0,0,2
1498694552013602816,0,2,0,0,2
1098235514853965824,1,1,0,0,2
885725230563434496,1,1,0,0,2
1097929522995814400,0,2,0,0,2
1498720760478973952,1,1,0,0,2
1097725509260070912,0,1,0,1,2
31251948,0,2,0,0,2
1097485611500519424,0,2,0,0,2
889193462767075328,2,0,0,0,2
889413312189833216,2,0,0,0,2
1096443838653218816,2,0,0,0,2
1096440676416290816,0,2,0,0,2
30858986,0,2,0,0,2
1096096461186625536,0,2,0,0,2
1095606637270917120,0,2,0,0,2
1095586254026993664,0,2,0,0,2
32517594,0,2,0,0,2
1100680794090004480,2,0,0,0,2
1100778863326416896,0,2,0,0,2
33590010,1,1,0,0,2
1105163342551777280,0,2,0,0,2
1105072361718595584,0,2,0,0,2
871439294677737472,1,1,0,0,2
872877195068354560,0,2,0,0,2
872940151969693696,0,2,0,0,2
1103393680021434368,0,2,0,0,2
34092386,0,2,0,0,2
875290423756967936,2,0,0,0,2
1498551461214826496,0,2,0,0,2
33662804,0,2,0,0,2
33640553,0,2,0,0,2
875962912308908032,1,1,0,0,2
876476081917878272,1,1,0,0,2
1498650581308624896,0,0,0,2,2
876530275924164608,2,0,0,0,2
33411018,0,2,0,0,2
1102519446889914368,0,2,0,0,2
877521347961802752,2,0,0,0,2
877642537699123200,0,2,0,0,2
32981486,0,1,0,1,2
878686022363627520,0,2,0,0,2
32820396,0,2,0,0,2
879539283815653376,0,2,0,0,2
879696446328631296,0,2,0,0,2
1498597819183075328,0,2,0,0,2
880630999075373056,2,0,0,0,2
1500468553828675584,0,2,0,0,2
934444714794741760,0,2,0,0,2
934517509440536576,0,2,0,0,2
1032560127738564608,0,2,0,0,2
984103105901064192,2,0,0,0,2
1526473900191645696,2,0,0,0,2
984294620698824704,0,2,0,0,2
16039871,0,2,0,0,2
985550506331226112,0,2,0,0,2
16039109,0,2,0,0,2
15998753,0,2,0,0,2
1526897082501836800,2,0,0,0,2
1527713494094991360,2,0,0,0,2
986454426628927488,0,2,0,0,2
15925111,0,2,0,0,2
1030734587478138880,1,1,0,0,2
1030523769213857792,0,2,0,0,2
1528193212275367936,0,0,0,2,2
15814107,0,2,0,0,2
15784401,0,2,0,0,2
1030126608328212480,0,2,0,0,2
1030081561767628800,0,2,0,0,2
15661546,1,1,0,0,2
1529071715229192192,2,0,0,0,2
1029488813222113280,0,2,0,0,2
1529760311367979008,2,0,0,0,2
15546850,0,2,0,0,2
1028833401250275328,0,2,0,0,2
990061357276938240,1,1,0,0,2
1529802921281470464,2,0,0,0,2
990185512798433280,0,2,0,0,2
983653490525462528,1,0,0,1,2
1525448733428957184,2,0,0,0,2
1043541815217930240,2,0,0,0,2
982519836176801792,0,2,0,0,2
1520328998521352192,2,0,0,0,2
1520337226302849024,2,0,0,0,2
974735959244722176,0,2,0,0,2
974942788927270912,1,1,0,0,2
1042614177603436544,0,2,0,0,2
1042501835083468800,0,2,0,0,2
975761754847416320,0,2,0,0,2
1041942792203919360,0,2,0,0,2
1041289813029056512,0,2,0,0,2
1521746603375271936,0,2,0,0,2
977884595097161728,0,2,0,0,2
1038459718878945280,0,2,0,0,2
1037126087871016960,0,2,0,0,2
1036305905434877952,0,2,0,0,2
1522644817980928000,0,2,0,0,2
1522997723137548288,0,2,0,0,2
16531257,0,2,0,0,2
16457324,2,0,0,0,2
1034598319350312960,0,2,0,0,2
980772831591129088,0,2,0,0,2
1033993296203472896,0,2,0,0,2
981381261129379840,2,0,0,0,2
1524101850223591424,1,1,0,0,2
981437624568156160,2,0,0,0,2
981831720587718656,1,1,0,0,2
982298693213630464,0,2,0,0,2
982516757695938560,0,2,0,0,2
1530049602652581888,2,0,0,0,2
1530096328230977536,0,2,0,0,2
990482627953078272,0,2,0,0,2
990494753711063040,0,2,0,0,2
1532731598323519488,2,0,0,0,2
1532946813635989504,2,0,0,0,2
1003205498278170624,0,2,0,0,2
1533023054086844416,2,0,0,0,2
1003805110399655936,0,2,0,0,2
1004006432943980544,0,0,0,2,2
1020353264032903168,0,2,0,0,2
14134526,0,2,0,0,2
1006058948485570560,0,2,0,0,2
1018048368797511680,0,2,0,0,2
1007327013907165184,0,2,0,0,2
1017765415810813952,0,2,0,0,2
1538773631358017536,1,1,0,0,2
8404632,0,0,2,0,2
1017047384625483776,0,2,0,0,2
7262682,0,2,0,0,2
1017002442846818304,1,1,0,0,2
5516892,0,2,0,0,2
1010738477519069184,0,2,0,0,2
4937061,0,2,0,0,2
1016045038315372544,0,2,0,0,2
1012785276450689024,0,2,0,0,2
1014787110539231232,0,2,0,0,2
1013064471441313792,0,2,0,0,2
1013402387787247616,0,2,0,0,2
1013476641174097920,0,2,0,0,2
1551258331498823680,0,2,0,0,2
14583466,2,0,0,0,2
1001903085420208128,0,2,0,0,2
1000578104895590400,0,2,0,0,2
994134752524369920,0,2,0,0,2
1530259389172420608,2,0,0,0,2
991504084623441920,0,2,0,0,2
992015019318697984,0,2,0,0,2
1531176308621086720,2,0,0,0,2
992101463395635200,0,2,0,0,2
992247472192868352,0,2,0,0,2
1531760845516345344,2,0,0,0,2
15218919,2,0,0,0,2
1531910178274267136,2,0,0,0,2
993741550348681216,0,2,0,0,2
994060526333423616,0,2,0,0,2
994117492866998272,0,2,0,0,2
994723590993047552,0,2,0,0,2
14730760,0,2,0,0,2
994901528526835712,2,0,0,0,2
1532055063107076096,2,0,0,0,2
995852051392352256,1,0,0,1,2
996455243721277440,0,2,0,0,2
996853284429336576,0,2,0,0,2
1532087659132096512,2,0,0,0,2
14944543,0,2,0,0,2
14939695,0,2,0,0,2
1024230207643938816,0,2,0,0,2
1532360059271155712,2,0,0,0,2
999644732589465600,0,2,0,0,2
1000056611271036928,0,2,0,0,2
973601906084823040,0,2,0,0,2
1043570469109084160,0,2,0,0,2
21743945,0,2,0,0,2
20533352,1,1,0,0,2
942722614040104960,0,2,0,0,2
20479730,0,2,0,0,2
20443388,0,2,0,0,2
20311385,0,2,0,0,2
1502852178666573824,1,1,0,0,2
1502937036256432128,1,1,0,0,2
946509959776296960,0,2,0,0,2
20238770,0,2,0,0,2
20230475,0,2,0,0,2
1503955187308044288,1,0,0,1,2
947695438445940736,0,2,0,0,2
947750337104007168,0,2,0,0,2
1061974584801419264,0,2,0,0,2
1061895715985731584,0,2,0,0,2
1504444747733082112,0,2,0,0,2
948463823555502080,2,0,0,0,2
1061316610223296512,0,2,0,0,2
19888843,0,2,0,0,2
949162399109533696,0,2,0,0,2
949657780159467520,0,2,0,0,2
1060852075175665664,0,2,0,0,2
1060243938148315136,0,2,0,0,2
1505649376538025984,2,0,0,0,2
19664367,0,2,0,0,2
1059090130907074560,0,2,0,0,2
1059023936803885056,1,1,0,0,2
951447299967762432,0,2,0,0,2
942702543825788928,0,2,0,0,2
20565828,0,2,0,0,2
16976078,0,2,0,0,2
941932641770598400,0,2,0,0,2
1070968274781958144,0,2,0,0,2
935406296055943168,1,1,0,0,2
935417381878489088,0,2,0,0,2
935719917499723776,0,2,0,0,2
936130248139329536,0,2,0,0,2
936205837139243008,0,0,0,2,2
936804422587260928,0,2,0,0,2
937939363429744640,0,2,0,0,2
1501465967271899136,1,0,1,0,2
21265939,0,2,0,0,2
21064725,2,0,0,0,2
1067325939003154432,0,2,0,0,2
21039114,0,2,0,0,2
939245477735944192,0,2,0,0,2
939472757577998336,1,1,0,0,2
21006074,0,1,1,0,2
20964739,0,2,0,0,2
20919324,0,2,0,0,2
940422656939114496,0,2,0,0,2
940599830769934336,0,2,0,0,2
940639255373721600,0,2,0,0,2
941005074943311872,0,2,0,0,2
941019558680424448,0,2,0,0,2
1066325689287229440,0,2,0,0,2
941206532598915072,1,0,1,0,2
1502008867714068480,0,2,0,0,2
1065898691540803584,2,0,0,0,2
952241493657505792,0,2,0,0,2
952281436391985152,0,2,0,0,2
1058266166978924544,0,2,0,0,2
19147224,0,2,0,0,2
18335624,2,0,0,0,2
1051042172991168512,0,2,0,0,2
964520169472253952,0,2,0,0,2
1050071486080409600,2,0,0,0,2
1050031300457902080,0,2,0,0,2
966317644218585088,0,2,0,0,2
17861058,0,2,0,0,2
966640820945383424,0,2,0,0,2
966711182374547456,0,2,0,0,2
1518686362211430400,0,2,0,0,2
1047627146091515904,0,2,0,0,2
17611642,0,2,0,0,2
968863866527670272,0,2,0,0,2
1046330837501964288,2,0,0,0,2
1045845961430294528,0,2,0,0,2
969389077173649408,0,2,0,0,2
1045664314500079616,0,2,0,0,2
17378581,0,2,0,0,2
971069988609118208,0,2,0,0,2
971094876119945216,0,2,0,0,2
971275501984735232,0,2,0,0,2
1519737324019593216,0,2,0,0,2
17135484,0,2,0,0,2
1519913458858598400,0,2,0,0,2
17012173,0,2,0,0,2
17002185,2,0,0,0,2
972788148706127872,0,2,0,0,2
1052534804095197184,2,0,0,0,2
1052539980088627200,2,0,0,0,2
1052554355352723456,0,2,0,0,2
19060353,0,2,0,0,2
19123904,0,2,0,0,2
1057887727524302848,0,2,0,0,2
954296415408111616,0,2,0,0,2
954742763760873472,0,2,0,0,2
1057299163807854592,0,2,0,0,2
955250263178260480,0,2,0,0,2
955321766917832704,0,2,0,0,2
1056907454221451264,0,2,0,0,2
955531931692670976,2,0,0,0,2
955648377643065344,0,0,1,1,2
1511420275958632448,2,0,0,0,2
955856167242121216,2,0,0,0,2
1056098461106520064,0,2,0,0,2
1516256367367139328,2,0,0,0,2
956843979995201536,1,1,0,0,2
1511928281800626176,1,0,1,0,2
1055442674784837632,2,0,0,0,2
1055309060667392000,2,0,0,0,2
1055146001055531008,0,2,0,0,2
1054816333605392384,0,1,0,1,2
959224042137047040,0,2,0,0,2
959802563393654784,0,2,0,0,2
18616259,1,1,0,0,2
18481086,0,2,0,0,2
1053894115652337664,0,2,0,0,2
18345103,0,2,0,0,2
39282539,0,1,1,0,2
1119219150415716352,2,0,0,0,2
1492051052690288640,0,2,0,0,2
76636200,2,0,0,0,2
745283414983581696,0,2,0,0,2
76387825,0,2,0,0,2
76387272,0,2,0,0,2
76357758,0,2,0,0,2
1178733452260192256,0,2,0,0,2
1178494512798167040,2,0,0,0,2
1495245008173162496,0,2,0,0,2
1495253440716742656,1,1,0,0,2
747809730362490880,0,2,0,0,2
748316675183808512,0,2,0,0,2
74810575,0,2,0,0,2
1177995240499601408,0,2,0,0,2
749085590335795200,1,1,0,0,2
1177986205708902400,0,2,0,0,2
749918077337346048,0,2,0,0,2
1495307750141612032,0,2,0,0,2
1177652811800051712,0,2,0,0,2
751445968252383232,0,2,0,0,2
752032877223772160,2,0,0,0,2
1176736196543664128,0,2,0,0,2
1176661810969079808,0,2,0,0,2
1176184237831180288,0,2,0,0,2
1176077888782622720,0,2,0,0,2
1495735958477619200,0,2,0,0,2
754455561417089024,0,2,0,0,2
73641576,0,2,0,0,2
73328873,0,2,0,0,2
745216160900120576,0,2,0,0,2
744793639918788608,0,2,0,0,2
755609377386532864,0,2,0,0,2
1180114953836978176,0,2,0,0,2
1183458422295056384,0,2,0,0,2
80417338,0,2,0,0,2
734214553916018688,0,2,0,0,2
1494660291849768960,0,2,0,0,2
79769567,0,2,0,0,2
1182489120200769536,1,1,0,0,2
736029146199924736,2,0,0,0,2
1182317267704516608,0,2,0,0,2
1494670065328791552,0,2,0,0,2
1181899867049869312,2,0,0,0,2
1494748094810189824,0,2,0,0,2
1181739729395408896,0,2,0,0,2
1181711490396631040,0,2,0,0,2
1494749039291940864,0,2,0,0,2
739099915943448576,0,2,0,0,2
740444427668324352,2,0,0,0,2
78926047,0,2,0,0,2
78384148,0,2,0,0,2
1181212906521845760,0,2,0,0,2
741232959999610880,0,2,0,0,2
741599488242900992,2,0,0,0,2
1494896065312886784,0,2,0,0,2
741922517699305472,0,2,0,0,2
741934963122135040,0,2,0,0,2
742410461321306112,0,2,0,0,2
742597539325607936,1,1,0,0,2
743309031867985920,0,2,0,0,2
755505688168665088,0,2,0,0,2
755740225889046528,0,2,0,0,2
849448663546040320,0,2,0,0,2
1170369737051820032,0,0,2,0,2
69175925,0,2,0,0,2
1169583290828779520,0,2,0,0,2
1169098506004553728,0,2,0,0,2
69097408,0,2,0,0,2
766878593007792128,1,1,0,0,2
767112848069824512,0,2,0,0,2
767444621383311360,0,2,0,0,2
1168972419933122560,2,0,0,0,2
1168887281459105792,0,2,0,0,2
768023993026748416,0,2,0,0,2
768826676117704704,1,0,0,1,2
1168161060378906624,0,2,0,0,2
769536285631389696,1,1,0,0,2
1167479743761006592,2,0,0,0,2
1167474159015710720,0,2,0,0,2
770230889120985088,0,2,0,0,2
770641015195697152,0,2,0,0,2
770907964681035776,2,0,0,0,2
1496450379084709888,0,2,0,0,2
1166703155221954560,2,0,0,0,2
772361408956731392,0,2,0,0,2
773335646605893632,0,2,0,0,2
773588845891842048,0,2,0,0,2
1165901116602638336,0,2,0,0,2
773724120039260160,0,2,0,0,2
66365462,0,2,0,0,2
774208814576828416,0,2,0,0,2
1169840567464775680,2,0,0,0,2
1170376458549780480,0,2,0,0,2
756353997716332544,0,2,0,0,2
69676093,0,2,0,0,2
1174634556332265472,0,2,0,0,2
1174135066227703808,0,2,0,0,2
73050826,0,2,0,0,2
757619175036682240,0,2,0,0,2
758114193895665664,0,2,0,0,2
1173562209257082880,0,2,0,0,2
1173555177724567552,0,2,0,0,2
72490342,0,2,0,0,2
758579990782889984,2,0,0,0,2
1495931090414022656,0,2,0,0,2
758710427874394112,0,2,0,0,2
1172944665026260992,0,2,0,0,2
1496011067582992384,1,1,0,0,2
1172209889940164608,0,2,0,0,2
71145463,0,2,0,0,2
1171850528084480000,0,2,0,0,2
760694335356690432,0,2,0,0,2
70887348,0,2,0,0,2
1496053044362223616,0,0,0,2,2
69853989,0,2,0,0,2
761300873284816896,0,2,0,0,2
1171661427658100736,0,2,0,0,2
1171654017451212800,2,0,0,0,2
1171279832228827136,0,2,0,0,2
1171133172152770560,0,2,0,0,2
762061186166849536,0,2,0,0,2
762690083782848512,0,2,0,0,2
732869688846340096,0,2,0,0,2
1183707687420342272,0,2,0,0,2
1183945355068628992,0,2,0,0,2
97764463,0,2,0,0,2
4829619250,0,2,0,0,2
1203005219816108032,0,2,0,0,2
1202606040040300544,0,2,0,0,2
1202240943451078656,0,2,0,0,2
4850543650,0,2,0,0,2
1492693902607978496,0,2,0,0,2
1492745730305720320,0,2,0,0,2
95790678,0,2,0,0,2
1492774470494433280,0,2,0,0,2
4873454285,0,2,0,0,2
1200303416364261376,0,2,0,0,2
1200221920282591232,0,2,0,0,2
94432285,0,2,0,0,2
4887507747,0,2,0,0,2
94143125,1,1,0,0,2
1492931614455779328,1,1,0,0,2
4897390433,0,2,0,0,2
4904336182,0,0,0,2,2
1198680956045078528,0,2,0,0,2
93697257,0,2,0,0,2
1493055553307881472,2,0,0,0,2
695262109471342592,0,2,0,0,2
701512046534234112,0,2,0,0,2
93160106,2,0,0,0,2
702838935093956608,0,2,0,0,2
1493169634878828544,0,2,0,0,2
703362735854198784,0,2,0,0,2
4827295135,0,2,0,0,2
4824152675,0,2,0,0,2
732577159739383808,0,2,0,0,2
4792927420,0,2,0,0,2
1208488978720141312,0,2,0,0,2
4657017676,0,2,0,0,2
1208084714466107392,0,2,0,0,2
4677553274,0,2,0,0,2
1207367037250441216,2,0,0,0,2
1207184127654539264,0,2,0,0,2
1207087326003752960,1,0,0,1,2
4690167451,0,2,0,0,2
100987374,1,1,0,0,2
4712155208,0,2,0,0,2
1206666709056274432,0,2,0,0,2
4713370633,0,2,0,0,2
1206505095266852864,0,2,0,0,2
1206278619112325120,2,0,0,0,2
1206265869237514240,0,2,0,0,2
4731929655,0,2,0,0,2
100946275,0,2,0,0,2
1205769293939515392,0,2,0,0,2
4744193302,0,2,0,0,2
4751330773,0,2,0,0,2
1205051086664433664,0,2,0,0,2
1492435287716216832,0,2,0,0,2
4771594249,0,2,0,0,2
1204454754090242048,0,2,0,0,2
1492456098296565760,0,2,0,0,2
1492461237128491008,0,1,0,1,2
1492471618894974976,2,0,0,0,2
1196717593484120064,2,0,0,0,2
704641311148642304,2,0,0,0,2
705284330931802112,0,2,0,0,2
90379747,0,2,0,0,2
719624962504581120,0,2,0,0,2
720590474361364480,2,0,0,0,2
1187349014280146944,0,2,0,0,2
722873719891177472,0,2,0,0,2
1494144334891188224,0,2,0,0,2
723496982485020672,0,2,0,0,2
723544656726896640,0,2,0,0,2
723883928411582464,0,2,0,0,2
724107612980166656,0,2,0,0,2
724273645875531776,0,2,0,0,2
724520585917804544,0,2,0,0,2
724682215297155072,0,2,0,0,2
725433061865836544,0,2,0,0,2
1494238554423271424,0,2,0,0,2
1186425639261200384,0,2,0,0,2
726325781153087488,0,2,0,0,2
82817137,0,2,0,0,2
727484648620724224,0,2,0,0,2
1494356727285780480,2,0,0,0,2
1185781608084697088,2,0,0,0,2
727907758331338752,0,2,0,0,2
82309200,0,2,0,0,2
728576765799501824,1,1,0,0,2
1494411447853809664,0,2,0,0,2
730831654885806080,1,0,1,0,2
731221873791541248,0,2,0,0,2
1184164051137351680,0,2,0,0,2
84847032,0,2,0,0,2
1189114318522060800,0,2,0,0,2
1189304828297531392,0,2,0,0,2
711979823095267328,0,2,0,0,2
2286644240,0,2,0,0,2
1493393135753261056,0,2,0,0,2
1194801500498931712,0,2,0,0,2
708711755673952256,0,2,0,0,2
708712844225806336,0,2,0,0,2
708714309354967040,2,0,0,0,2
709584082179502080,0,2,0,0,2
88869834,0,2,0,0,2
1193421199495356416,2,0,0,0,2
1193142395497517056,0,2,0,0,2
1193003750312398848,0,2,0,0,2
88499592,0,2,0,0,2
712026016168984576,0,2,0,0,2
85460092,1,1,0,0,2
1192858145392975872,0,1,1,0,2
713139614597255168,0,2,0,0,2
87741755,1,1,0,0,2
86810384,0,2,0,0,2
716557160822362112,1,1,0,0,2
716659285007183872,0,2,0,0,2
86209556,1,1,0,0,2
1493826444287365120,0,2,0,0,2
717243937258409984,0,2,0,0,2
1189883716480335872,0,1,1,0,2
1189848452437426176,0,2,0,0,2
85728516,2,0,0,0,2
1165272330785808384,0,2,0,0,2
774946171878080512,0,2,0,0,2
65910935,0,2,0,0,2
1497441728625725440,0,2,0,0,2
48298722,0,2,0,0,2
48260520,0,2,0,0,2
48174338,0,2,0,0,2
1497511678510080000,0,2,0,0,2
1134529020064915456,0,1,1,0,2
1134389655552442368,0,2,0,0,2
823663695037337600,0,2,0,0,2
1134106780366180352,0,2,0,0,2
824172032959139840,0,2,0,0,2
824205979101184000,0,2,0,0,2
47547199,0,2,0,0,2
1133147746159009792,0,2,0,0,2
47485480,0,2,0,0,2
47298584,0,2,0,0,2
826224204165021696,0,2,0,0,2
1497593477059649536,0,2,0,0,2
826725243205062656,2,0,0,0,2
1497653464583008256,0,2,0,0,2
1497687262687277056,0,2,0,0,2
828001920577060864,2,0,0,0,2
828030159932395520,0,2,0,0,2
1131506932211015680,0,2,0,0,2
46478528,0,2,0,0,2
828497011129384960,0,2,0,0,2
828524372985946112,0,2,0,0,2
829824700448542720,0,2,0,0,2
1130006536783245312,0,0,0,2,2
822132611137105920,0,2,0,0,2
1135622885635108864,0,2,0,0,2
50658483,1,0,0,1,2
1136382527667560448,0,2,0,0,2
50601646,0,2,0,0,2
813530307089592320,0,2,0,0,2
814158548670222336,0,2,0,0,2
1141184741955080192,0,2,0,0,2
1497249185133121536,1,1,0,0,2
814526412749086720,2,0,0,0,2
50272660,0,2,0,0,2
1140499622109962240,0,2,0,0,2
815329570198994944,0,2,0,0,2
1139810668037623808,2,0,0,0,2
50013926,0,2,0,0,2
49920475,1,0,0,1,2
816301389101998080,2,0,0,0,2
49900308,0,2,0,0,2
816406404684652544,0,2,0,0,2
816770404366708736,0,2,0,0,2
817073086071709696,0,2,0,0,2
49422239,0,2,0,0,2
818269347420536832,1,1,0,0,2
1137661652436967424,0,2,0,0,2
49191742,0,2,0,0,2
48959540,0,2,0,0,2
1137386117118824448,2,0,0,0,2
1497392023531368448,1,1,0,0,2
1136608249157902336,0,0,0,2,2
820624322146410496,0,1,0,1,2
820709145615728640,2,0,0,0,2
1497747405839601664,2,0,0,0,2
1497776777434857472,0,2,0,0,2
1497821062461112320,1,1,0,0,2
831695714056953856,0,2,0,0,2
40601473,0,2,0,0,2
1498088927554539520,2,0,0,0,2
1123489230095900672,2,0,0,0,2
1498097416305848320,0,2,0,0,2
844214050854780928,0,2,0,0,2
1122931228108308480,0,2,0,0,2
844988494405664768,2,0,0,0,2
1122547546503569408,0,2,0,0,2
1122357330690154496,0,2,0,0,2
40345175,0,2,0,0,2
845624048314859520,2,0,0,0,2
845647378837192704,0,2,0,0,2
40155868,0,2,0,0,2
39897583,0,2,0,0,2
845955605504372736,2,0,0,0,2
1498118928974823424,2,0,0,0,2
846384039896535040,0,2,0,0,2
846432354851794944,0,2,0,0,2
846563268055437312,0,2,0,0,2
39666268,0,2,0,0,2
1498132555048103936,0,2,0,0,2
847918942131769344,0,2,0,0,2
1119611240530071552,0,2,0,0,2
848119968180948992,0,2,0,0,2
848768147763208192,0,1,1,0,2
848880154642403328,0,2,0,0,2
1498166184654831616,0,2,0,0,2
843907821599121408,0,2,0,0,2
1123560424778158080,2,0,0,0,2
841701064118284288,0,2,0,0,2
835690350031290368,0,2,0,0,2
832045581115600896,0,2,0,0,2
1497824842174791680,2,0,0,0,2
1127959232890859520,0,2,0,0,2
832912829040713728,1,0,0,1,2
1127487158690828288,0,2,0,0,2
45159239,0,2,0,0,2
1497841408824197120,0,2,0,0,2
834007610319896576,0,2,0,0,2
834014019354820608,0,2,0,0,2
44686891,0,2,0,0,2
1126553316790378496,1,1,0,0,2
835156485424435200,0,2,0,0,2
835810656167157760,0,2,0,0,2
841545540416487424,0,2,0,0,2
835957378411544576,0,0,0,2,2
836173128858537984,0,2,0,0,2
43922668,0,2,0,0,2
836856888574816256,1,0,0,1,2
838067024895016960,0,2,0,0,2
839531700623294464,0,2,0,0,2
839942015966146560,0,2,0,0,2
840257964279713792,0,2,0,0,2
1124980552510181376,0,2,0,0,2
42250714,0,2,0,0,2
1124386583963029504,0,2,0,0,2
1124290282441170944,2,0,0,0,2
813157123290963968,0,2,0,0,2
812643839060148224,0,2,0,0,2
1496706565306392576,2,0,0,0,2
1161851353909661696,2,0,0,0,2
784650359683878912,0,2,0,0,2
1161236674233475072,0,2,0,0,2
60093362,1,0,1,0,2
60041122,0,2,0,0,2
59515655,0,2,0,0,2
59390482,0,2,0,0,2
59099983,1,0,0,1,2
1159570498092539904,0,2,0,0,2
1159411516812288000,0,2,0,0,2
1496805523773353984,2,0,0,0,2
1159334854632210432,0,2,0,0,2
1496806673780035584,0,2,0,0,2
787819496048201728,0,2,0,0,2
58337417,0,2,0,0,2
58003462,0,2,0,0,2
57963539,0,2,0,0,2
1158129717515472896,1,0,1,0,2
1496815482779107328,0,1,0,1,2
790194902588018688,1,1,0,0,2
790948209585774592,0,1,0,1,2
1157608308577992704,0,2,0,0,2
791807204185825280,0,2,0,0,2
1496838227910860800,0,2,0,0,2
792067303391191040,1,1,0,0,2
792561912445743104,0,2,0,0,2
1156706785656373248,0,2,0,0,2
793024616407138304,1,1,0,0,2
60925423,0,2,0,0,2
1496757624196726784,0,2,0,0,2
1142424032794406912,0,2,0,0,2
1162289711542521856,0,2,0,0,2
1164993211561140224,0,2,0,0,2
65520805,0,2,0,0,2
775784151257587712,0,2,0,0,2
776741089579442176,0,2,0,0,2
777001009889415168,0,2,0,0,2
65437222,0,2,0,0,2
1164252775770779648,0,2,0,0,2
777775879472680960,0,2,0,0,2
777845514364604416,0,2,0,0,2
777871391752351744,2,0,0,0,2
1496725135625097216,0,2,0,0,2
778198578338471936,0,2,0,0,2
1163840955704860672,0,2,0,0,2
64523172,0,2,0,0,2
780076557033349120,1,1,0,0,2
780155430412574720,0,2,0,0,2
64145834,0,2,0,0,2
1163324065056088064,0,2,0,0,2
1496741432375209984,2,0,0,0,2
781145216875200512,0,2,0,0,2
781200163008290816,0,2,0,0,2
781208488575991808,0,2,0,0,2
62868276,0,1,0,1,2
781869665773424640,1,0,0,1,2
781915757466755072,2,0,0,0,2
782754418492071936,0,2,0,0,2
783006754648887296,2,0,0,0,2
793310876535140352,0,2,0,0,2
1496871276987633664,0,2,0,0,2
1156256995122376704,0,2,0,0,2
794283826092666880,0,1,0,1,2
1151351450125008896,2,0,0,0,2
1151021501048598528,0,2,0,0,2
1151015358767099904,2,0,0,0,2
801665102281740288,0,2,0,0,2
802860579354542080,2,0,0,0,2
802996814588809216,0,2,0,0,2
53179643,0,2,0,0,2
1148960578213482496,0,2,0,0,2
1497099671998992384,2,0,0,0,2
805345210557493248,0,2,0,0,2
1497112915530645504,0,2,0,0,2
52251052,0,2,0,0,2
51757895,0,2,0,0,2
807302367423168512,0,2,0,0,2
51639017,0,2,0,0,2
1497159757383311360,0,1,0,1,2
808221323377807360,2,0,0,0,2
51495188,0,2,0,0,2
1145307244130496512,2,0,0,0,2
808883991558307840,0,2,0,0,2
1144584929872764928,0,2,0,0,2
809689621558861824,0,2,0,0,2
1143831666357604352,1,0,0,1,2
1497208608362319872,0,2,0,0,2
50963331,0,0,0,2,2
1142476759838990336,1,1,0,0,2
50833706,0,1,1,0,2
1151572426167209984,0,2,0,0,2
53549560,0,2,0,0,2
1151897708266844160,0,2,0,0,2
1153865980029931520,0,2,0,0,2
1496874032087531520,0,2,0,0,2
794936666293149696,0,2,0,0,2
795569152576647168,0,2,0,0,2
796707530336407552,0,2,0,0,2
797057227785957376,0,2,0,0,2
797164623350919168,0,2,0,0,2
1496895122763501568,0,2,0,0,2
797344865117872128,0,2,0,0,2
55797411,2,0,0,0,2
797558647731654656,0,2,0,0,2
797716846489300992,0,2,0,0,2
1154082549674774528,0,2,0,0,2
1153773471207497728,0,2,0,0,2
1497006737110482944,2,0,0,0,2
55762356,0,2,0,0,2
798166496069423104,0,2,0,0,2
798174081229160448,0,2,0,0,2
55563609,0,2,0,0,2
798388993566056448,2,0,0,0,2
799152503098986496,0,2,0,0,2
1153093675540504576,0,2,0,0,2
54222811,0,2,0,0,2
799918447517790208,0,2,0,0,2
799926050528563200,0,2,0,0,2
54199693,0,2,0,0,2
1496948351899779072,2,0,0,0,2
707063508492390400,0,1,0,1,2
2213122164,0,1,0,1,2
1884977676,0,2,0,0,2
1592279192,2,0,0,0,2
407418136,0,2,0,0,2
407065731,0,2,0,0,2
1423739359077883904,2,0,0,0,2
1392630769,2,0,0,0,2
1319193888507179008,0,2,0,0,2
579287636,0,2,0,0,2
1347912048588455936,0,2,0,0,2
1429692504648060928,0,2,0,0,2
1457891226246656000,0,2,0,0,2
1591286180,0,2,0,0,2
1397409468992958464,0,2,0,0,2
299071087,0,2,0,0,2
946545414,0,2,0,0,2
464149366,0,2,0,0,2
580951769,0,2,0,0,2
581132916,2,0,0,0,2
581151880,2,0,0,0,2
940573358,0,2,0,0,2
1362706370584342528,0,2,0,0,2
1592750904,1,1,0,0,2
581697643,0,2,0,0,2
712365073,0,2,0,0,2
1396719554361925632,0,2,0,0,2
1392089065,0,2,0,0,2
1458016292489859072,0,2,0,0,2
715003607,0,2,0,0,2
711077922,0,2,0,0,2
1318544081140674560,0,2,0,0,2
389629361,2,0,0,0,2
1348570142729523200,0,2,0,0,2
1969073916,0,2,0,0,2
570842895,0,2,0,0,2
1339220252488577024,0,2,0,0,2
1398531420931301376,0,2,0,0,2
717452845,0,2,0,0,2
1386578453831557120,0,2,0,0,2
1318519891146792960,0,2,0,0,2
1444529410988814336,1,1,0,0,2
1371298362079604736,0,2,0,0,2
716521562,0,2,0,0,2
715444829,0,2,0,0,2
1963097234,0,2,0,0,2
1239865100,0,1,0,1,2
1362056053031059456,2,0,0,0,2
1436746834756575232,2,0,0,0,2
1398276937496219648,0,2,0,0,2
1386603053353103360,0,2,0,0,2
296509359,0,2,0,0,2
1444562179567484928,0,2,0,0,2
848044670,0,2,0,0,2
1956994968,0,2,0,0,2
1394164196,0,2,0,0,2
583948102,0,2,0,0,2
299213783,0,2,0,0,2
705841901,0,2,0,0,2
1923454140,0,2,0,0,2
1599428166,0,2,0,0,2
1320030260801437696,0,2,0,0,2
1370332350891106304,1,1,0,0,2
1927089254,0,2,0,0,2
300297349,0,2,0,0,2
1329008798380527616,0,2,0,0,2
1328994232275791872,0,2,0,0,2
1340268883459125248,1,1,0,0,2
1265727487,0,2,0,0,2
1363111213840936960,0,2,0,0,2
1447237054509682688,0,2,0,0,2
1606494044,0,2,0,0,2
1453538008490143744,0,2,0,0,2
1363152594340700160,0,2,0,0,2
589546563,1,0,0,1,2
1395480376957562880,0,2,0,0,2
1606908458,0,2,0,0,2
1320561350058397696,0,2,0,0,2
1320601903512780800,0,2,0,0,2
317414715,0,2,0,0,2
1453728700353024000,0,2,0,0,2
1271342508,0,2,0,0,2
1346671808293040128,0,2,0,0,2
301048344,0,2,0,0,2
1347250655099056128,0,2,0,0,2
1932887886,0,2,0,0,2
584509214,0,1,0,1,2
1937323765,0,1,1,0,2
320252434,0,2,0,0,2
1391974237,0,2,0,0,2
1347673537121804288,0,2,0,0,2
1251108020,0,2,0,0,2
1319550128961835008,0,2,0,0,2
709363765,0,2,0,0,2
853826982,2,0,0,0,2
1370640626308558848,0,2,0,0,2
1387290700262170624,0,2,0,0,2
1444659153247608832,0,2,0,0,2
1453423508352946176,0,2,0,0,2
1319589203605409792,0,2,0,0,2
1932972084,0,2,0,0,2
359031202,0,2,0,0,2
1935760333,0,2,0,0,2
1319596855894835200,2,0,0,0,2
1444708659599007744,0,2,0,0,2
358270300,0,2,0,0,2
1429442387898773504,0,2,0,0,2
1444750059426533376,0,2,0,0,2
586086243,0,2,0,0,2
855218317,0,2,0,0,2
300247585,0,2,0,0,2
586743892,2,0,0,0,2
1399397983,0,2,0,0,2
1348583013207011328,0,2,0,0,2
1444299548826877952,0,2,0,0,2
842021364,0,2,0,0,2
363070453,0,2,0,0,2
1452334002241744896,0,2,0,0,2
841472581,0,2,0,0,2
1421233216359444480,0,1,1,0,2
966347094,0,2,0,0,2
1404315104,0,2,0,0,2
294760200,0,2,0,0,2
362996199,0,2,0,0,2
1458674142824185856,0,2,0,0,2
1349520508971323392,1,1,0,0,2
2159952507,0,2,0,0,2
434706682,0,2,0,0,2
1193147964,2,0,0,0,2
560572487,0,2,0,0,2
295057247,0,2,0,0,2
1400547430123376640,0,2,0,0,2
723786164,0,2,0,0,2
560817896,0,2,0,0,2
434860205,0,2,0,0,2
471546763,0,2,0,0,2
561822505,0,2,0,0,2
1437346401235709952,0,2,0,0,2
1338697856249688064,0,2,0,0,2
1402285495,0,2,0,0,2
1338103072480890880,2,0,0,0,2
1401079043735187456,1,1,0,0,2
468851612,0,2,0,0,2
1359743505703313408,0,2,0,0,2
556881837,0,2,0,0,2
556902767,0,2,0,0,2
2173143605,0,2,0,0,2
556975452,0,2,0,0,2
431244195,0,2,0,0,2
1443183990802825216,0,2,0,0,2
1315980136886411264,0,2,0,0,2
2172508827,0,2,0,0,2
1410666828,2,0,0,0,2
1350146153199751168,0,2,0,0,2
556998480,2,0,0,0,2
557432619,0,2,0,0,2
968097385,0,2,0,0,2
1401399324290936832,2,0,0,0,2
475708025,0,2,0,0,2
1433402797760806912,0,2,0,0,2
1076175968,0,2,0,0,2
1331174255749316608,0,2,0,0,2
1187610630,0,2,0,0,2
1458792308598525952,0,2,0,0,2
1316303815583227904,2,0,0,0,2
1359756994622730240,0,2,0,0,2
386184164,0,2,0,0,2
1359816147609223168,0,2,0,0,2
1317093548697645056,0,2,0,0,2
362546622,0,2,0,0,2
1360708098541821952,0,2,0,0,2
345966786,0,2,0,0,2
1399453268527489024,1,1,0,0,2
435526795,1,1,0,0,2
1399437252275556352,0,2,0,0,2
1422174968045965312,0,2,0,0,2
324843866,0,2,0,0,2
721064268,0,2,0,0,2
1575101684,1,0,0,1,2
956010348,0,2,0,0,2
1317715029521727488,0,2,0,0,2
345879428,0,2,0,0,2
1225185229,0,2,0,0,2
296335208,0,2,0,0,2
562547660,0,2,0,0,2
720543326,0,2,0,0,2
296367001,0,2,0,0,2
1227190020,2,0,0,0,2
468927482,0,0,0,2,2
1371393322820980736,1,1,0,0,2
846078295,0,2,0,0,2
388679736,0,2,0,0,2
1348826410610089984,2,0,0,0,2
1348826202426007552,0,2,0,0,2
1399041821267820544,0,2,0,0,2
361191615,0,2,0,0,2
435260935,0,2,0,0,2
1317712256277254144,0,2,0,0,2
470351587,0,2,0,0,2
2151130880,0,2,0,0,2
1209970615,0,2,0,0,2
325016010,0,2,0,0,2
1400154696225017856,0,2,0,0,2
1437260912142979072,0,2,0,0,2
563814929,0,2,0,0,2
361939671,0,2,0,0,2
1430025887651700736,0,2,0,0,2
2156598128,0,2,0,0,2
1217028908,0,2,0,0,2
1217487751,0,2,0,0,2
1371416579787911168,0,2,0,0,2
1399732096164237312,0,2,0,0,2
295314138,0,2,0,0,2
1361133918389436416,0,2,0,0,2
361683816,0,2,0,0,2
324908476,0,2,0,0,2
2152737563,1,0,0,1,2
1452625026214096896,0,2,0,0,2
387781361,0,2,0,0,2
387818632,0,2,0,0,2
1317703640467976192,0,0,2,0,2
957490261,0,2,0,0,2
361668999,0,2,0,0,2
1913790068,0,2,0,0,2
1457284125224673280,2,0,0,0,2
1337751682168487936,0,2,0,0,2
1373745446,0,2,0,0,2
1334031374,0,2,0,0,2
1324424832382078976,0,2,0,0,2
1324468419127873536,0,0,0,2,2
1696319107,0,2,0,0,2
1374387062,0,2,0,0,2
1389223360085725184,2,0,0,0,2
1324637095214735360,0,2,0,0,2
306208516,0,2,0,0,2
611005408,1,1,0,0,2
1392101336112578560,0,2,0,0,2
1690042452,2,0,0,0,2
611699921,0,2,0,0,2
403634372,0,2,0,0,2
1389230435998203904,2,0,0,0,2
1389295333595885568,0,2,0,0,2
1366031977392955392,0,2,0,0,2
1435294659706867712,2,0,0,0,2
879923462,0,2,0,0,2
1339760053,0,2,0,0,2
1367806970934095872,0,2,0,0,2
1389447345738113024,0,2,0,0,2
1391935005614481408,0,2,0,0,2
1446194511152046080,0,2,0,0,2
613617732,1,0,1,0,2
1700771629,1,1,0,0,2
1446028860995223552,0,2,0,0,2
1391451038301962240,0,2,0,0,2
399937119,0,2,0,0,2
350348171,0,2,0,0,2
1323375663420710912,0,2,0,0,2
1392657158509060096,0,2,0,0,2
1341643908673982464,0,2,0,0,2
453151525,0,2,0,0,2
1327175988166369280,0,2,0,0,2
631486246,0,2,0,0,2
1344559481120845824,0,2,0,0,2
1329876728,1,1,0,0,2
1392441527733948416,0,2,0,0,2
885722677,0,2,0,0,2
884483719,1,0,0,1,2
1333377348,0,2,0,0,2
1323882972857036800,0,2,0,0,2
1456022028255776768,0,2,0,0,2
1367821289264738304,2,0,0,0,2
1326896048644747264,1,1,0,0,2
1455907327622750208,0,2,0,0,2
883421593,0,2,0,0,2
1640043805,0,2,0,0,2
1434417985653968896,2,0,0,0,2
1341722572149370880,0,2,0,0,2
1324297444490989568,0,2,0,0,2
609374869,0,2,0,0,2
1324971825034489856,0,2,0,0,2
1343906844402720768,0,2,0,0,2
1429234888473866240,2,0,0,0,2
621162264,1,1,0,0,2
1359121879,0,2,0,0,2
1427196317294596096,0,2,0,0,2
1434895116423028736,0,2,0,0,2
1367154486,0,2,0,0,2
351245806,0,2,0,0,2
1390403040432119808,0,2,0,0,2
351346086,0,2,0,0,2
1649077038,2,0,0,0,2
623505075,0,2,0,0,2
1427078711644409856,0,0,2,0,2
309422920,0,1,0,1,2
874015542,0,2,0,0,2
1366783765532540928,0,2,0,0,2
1362172682,0,2,0,0,2
1389917838211788800,0,2,0,0,2
351477130,0,2,0,0,2
1390191699192733696,0,0,2,0,2
1362535214,2,0,0,0,2
1326047097515175936,2,0,0,0,2
1390007738067939328,0,2,0,0,2
1362822391,0,2,0,0,2
1455114882223722496,1,1,0,0,2
1326004888833286144,0,2,0,0,2
621629917,0,2,0,0,2
1660358396,0,2,0,0,2
308698101,0,2,0,0,2
1367405463785009152,0,2,0,0,2
616742231,0,2,0,0,2
1324997161667485696,0,2,0,0,2
352023956,1,1,0,0,2
403584420,0,2,0,0,2
879039415,0,2,0,0,2
306612313,0,2,0,0,2
1427322067200921600,0,2,0,0,2
1645564814,0,2,0,0,2
1391114606639153152,0,2,0,0,2
616635716,0,2,0,0,2
1366245438349737984,0,2,0,0,2
1668169393,0,2,0,0,2
617170251,2,0,0,0,2
625012609,0,2,0,0,2
1666873268,0,2,0,0,2
1666368044,0,2,0,0,2
1391080959316008960,0,2,0,0,2
1665449125,0,2,0,0,2
1664210994,1,1,0,0,2
1351541984,0,2,0,0,2
1647206444,0,2,0,0,2
878052200,0,2,0,0,2
1326372686193336320,2,0,0,0,2
1342296052364275712,1,1,0,0,2
1366509415575257088,0,2,0,0,2
886304527,1,1,0,0,2
1392706499512705024,0,2,0,0,2
446586825,0,2,0,0,2
1345517363731435520,0,2,0,0,2
1445068992943517696,0,2,0,0,2
1385485956,1,1,0,0,2
1454018734134157312,1,1,0,0,2
1286905933,0,2,0,0,2
1340679385507098624,0,0,1,1,2
594678526,0,2,0,0,2
396011927,0,2,0,0,2
858984690,0,2,0,0,2
594760191,0,2,0,0,2
1340718626840698880,0,2,0,0,2
908909312,0,2,0,0,2
596066155,0,2,0,0,2
316788501,0,2,0,0,2
1435935531867721728,0,2,0,0,2
1867736041,0,2,0,0,2
1623095144,0,2,0,0,2
1864336380,2,0,0,0,2
907115786,0,2,0,0,2
1328161641674858496,0,2,0,0,2
906320918,0,2,0,0,2
1364180275060695040,0,2,0,0,2
406004417,0,2,0,0,2
457743272,0,2,0,0,2
1445097083653009408,2,0,0,0,2
858983617,2,0,0,0,2
1386138584,0,2,0,0,2
1321863097,0,2,0,0,2
1321151212490608640,0,2,0,0,2
1911880195,2,0,0,0,2
1424611638276235264,0,2,0,0,2
1910785134,0,2,0,0,2
301131496,1,1,0,0,2
459438278,0,2,0,0,2
316943954,0,2,0,0,2
1457251771915538432,1,1,0,0,2
1394846721587302400,2,0,0,0,2
357429574,0,2,0,0,2
1321145696477609984,0,2,0,0,2
592697955,0,2,0,0,2
1277880908,0,2,0,0,2
858890498,0,2,0,0,2
857921504,2,0,0,0,2
1896661898,0,2,0,0,2
395134466,0,1,0,1,2
1612267592,2,0,0,0,2
1363636002691026944,1,1,0,0,2
1279623896,0,2,0,0,2
1363686659175317504,0,2,0,0,2
1613146248,0,2,0,0,2
1894605858,0,2,0,0,2
593612691,0,2,0,0,2
302125568,0,2,0,0,2
446318129,0,2,0,0,2
1860275101,0,2,0,0,2
1445098126621171712,0,2,0,0,2
1316251351,0,2,0,0,2
1729758474,0,2,0,0,2
304142538,0,2,0,0,2
1364808461129715712,0,2,0,0,2
1364955946464722944,0,2,0,0,2
398149620,0,2,0,0,2
349478692,0,1,0,1,2
1393080700870569984,0,2,0,0,2
1445298925775122432,2,0,0,0,2
354993695,0,2,0,0,2
604043193,0,2,0,0,2
1445328901689991168,0,2,0,0,2
633903178,0,2,0,0,2
1364447257496489984,0,2,0,0,2
1322815698666663936,0,2,0,0,2
1316744550,0,2,0,0,2
633086382,0,2,0,0,2
1344902315413671936,2,0,0,0,2
349660067,0,2,0,0,2
1327273689268715520,2,0,0,0,2
1435599096266432512,0,2,0,0,2
863200668,0,2,0,0,2
1445620453968531456,0,2,0,0,2
1319968548,2,0,0,0,2
1320760494,0,2,0,0,2
454808056,0,2,0,0,2
1322432209928728576,0,2,0,0,2
1735067082,0,2,0,0,2
1735370179,0,2,0,0,2
597654292,0,2,0,0,2
700499022,0,2,0,0,2
597750048,0,2,0,0,2
1304720396,2,0,0,0,2
898265239,0,2,0,0,2
598973191,0,2,0,0,2
600356823,0,2,0,0,2
1456476519275053056,0,2,0,0,2
356546958,0,2,0,0,2
601007144,0,1,0,1,2
601528014,0,2,0,0,2
601639957,0,2,0,0,2
601837459,0,2,0,0,2
1856846454,0,2,0,0,2
1309833674,0,2,0,0,2
314733699,0,2,0,0,2
356411775,0,2,0,0,2
637003328,0,2,0,0,2
1393436851600560128,0,2,0,0,2
1322375426015174656,0,2,0,0,2
1748486132,0,2,0,0,2
1388326825873625088,0,2,0,0,2
1310569981,0,2,0,0,2
1451933798514368512,0,2,0,0,2
723515274,0,2,0,0,2
556550175,1,1,0,0,2
1417793824601038848,0,2,0,0,2
526125131,0,2,0,0,2
279665930,1,0,0,1,2
422509335,2,0,0,0,2
1410540831409283072,0,2,0,0,2
1438959422139731968,0,2,0,0,2
1333560804046680064,0,2,0,0,2
491908916,0,0,0,2,2
490764827,0,2,0,0,2
1417853311990996992,0,2,0,0,2
1410154583662415872,0,2,0,0,2
1353194231595028480,0,2,0,0,2
2239223041,0,2,0,0,2
1441956486,0,2,0,0,2
2236983040,0,2,0,0,2
1410087976416075776,0,2,0,0,2
1380876398198321152,0,2,0,0,2
1440635012,0,0,0,2,2
1353023186795958272,0,2,0,0,2
1410068071427891200,0,2,0,0,2
1357915367721566208,0,2,0,0,2
531462643,0,2,0,0,2
1017531362,2,0,0,0,2
1311143689373220864,0,2,0,0,2
525783599,1,1,0,0,2
1023649345,0,2,0,0,2
1373491115706392576,0,2,0,0,2
1502892860,0,2,0,0,2
1379611280256942080,0,2,0,0,2
1335975004475969536,0,2,0,0,2
1447725913,0,2,0,0,2
279145405,0,2,0,0,2
520056480,0,2,0,0,2
1119259136,2,0,0,0,2
1431777463399591936,1,0,0,1,2
1417372582802706432,0,2,0,0,2
1379891749070413824,0,2,0,0,2
2246689699,0,2,0,0,2
1336007546222465024,0,2,0,0,2
1380022853395828736,0,2,0,0,2
1029101293,0,2,0,0,2
1357648499077091328,1,1,0,0,2
1411195601665069056,0,2,0,0,2
1448882893426548736,0,2,0,0,2
1353366187791560704,0,2,0,0,2
2243449399,0,2,0,0,2
492281780,0,2,0,0,2
492010683,0,2,0,0,2
422366914,0,2,0,0,2
279358548,0,2,0,0,2
1333609690664603648,0,2,0,0,2
280592005,0,2,0,0,2
1409418799103807488,0,2,0,0,2
1510896829,0,2,0,0,2
1132485474,0,2,0,0,2
1406220117638266880,0,2,0,0,2
1312235074939760640,1,1,0,0,2
1141416996,0,2,0,0,2
283968635,0,2,0,0,2
330953174,2,0,0,0,2
423345445,0,2,0,0,2
1442426775653347328,0,2,0,0,2
1442467530577100800,0,2,0,0,2
1460859884723793920,0,2,0,0,2
487423198,0,2,0,0,2
1312349113531285504,0,2,0,0,2
340846867,0,2,0,0,2
1519419480,0,2,0,0,2
1001194417,0,2,0,0,2
1000473584,0,2,0,0,2
1451047683729264640,0,2,0,0,2
1333222155237154816,0,2,0,0,2
1358740274378395648,0,2,0,0,2
541435594,0,2,0,0,2
330294866,0,2,0,0,2
286320383,0,2,0,0,2
998369394,0,2,0,0,2
998247186,0,2,0,0,2
1432999711758241792,2,0,0,0,2
1448484540478074880,0,2,0,0,2
1438532133723590656,0,2,0,0,2
489229399,0,1,1,0,2
1350215427226390528,0,2,0,0,2
827333887,0,2,0,0,2
1133232445,0,2,0,0,2
1408268242813001728,1,1,0,0,2
767149267,2,0,0,0,2
1408085260638711808,2,0,0,0,2
281394750,0,0,0,2,2
1407844362659241984,0,2,0,0,2
381437577,0,2,0,0,2
340530532,0,2,0,0,2
1407691324468477952,0,2,0,0,2
1406289667721334784,1,1,0,0,2
381718987,0,2,0,0,2
381939565,0,2,0,0,2
1008250932,0,2,0,0,2
1008184428,1,1,0,0,2
331902433,0,2,0,0,2
1352886864122933248,0,2,0,0,2
381993090,2,0,0,0,2
827885630,0,2,0,0,2
1006389108,0,2,0,0,2
1461209977448660992,0,2,0,0,2
1439636014113329152,0,2,0,0,2
1117450170,0,2,0,0,2
1493029153,0,2,0,0,2
1354347946054197248,0,2,0,0,2
503852386,1,1,0,0,2
1065985200,2,0,0,0,2
1065190608,0,2,0,0,2
1307290374705086464,2,0,0,0,2
1307485284217450496,0,2,0,0,2
2272479539,0,2,0,0,2
1334869895616466944,0,2,0,0,2
1335300632127754240,0,2,0,0,2
1440898941441040384,0,2,0,0,2
505419689,1,1,0,0,2
1458135666,0,2,0,0,2
416583838,0,2,0,0,2
1063284314,0,2,0,0,2
1087283598,0,2,0,0,2
1355135545576329216,0,2,0,0,2
1355124990396432384,0,2,0,0,2
376160953,2,0,0,0,2
1357000330899116032,0,2,0,0,2
1093015957,0,2,0,0,2
2269036550,0,1,0,1,2
376188803,0,2,0,0,2
418092094,0,2,0,0,2
1335513286159327232,0,2,0,0,2
375088178,0,2,0,0,2
804430039,0,2,0,0,2
373301091,0,2,0,0,2
810031381,0,2,0,0,2
1356131641903738880,0,2,0,0,2
498678989,0,2,0,0,2
1375855478819934208,0,2,0,0,2
1356144520379965440,0,2,0,0,2
2283916915,0,2,0,0,2
1355886984884056064,0,2,0,0,2
1376041280145289216,0,2,0,0,2
1078191404,0,2,0,0,2
1376250360730243072,2,0,0,0,2
497144229,0,2,0,0,2
1306645454348673024,0,2,0,0,2
1306934902227521536,2,0,0,0,2
1355751982905044992,0,2,0,0,2
815871284,0,2,0,0,2
1465430660,0,2,0,0,2
1082271409,0,2,0,0,2
496659256,0,2,0,0,2
374714661,0,2,0,0,2
1356553434955206656,2,0,0,0,2
335469402,0,1,1,0,2
1375170296601210880,1,1,0,0,2
275973411,0,2,0,0,2
1354579978332024832,0,2,0,0,2
1378198274574852096,0,2,0,0,2
1334014664045432832,0,2,0,0,2
1060660339,0,2,0,0,2
418716437,0,2,0,0,2
1357222187984322560,1,1,0,0,2
1357275843836456960,0,2,0,0,2
2251984159,2,0,0,0,2
514198973,0,2,0,0,2
1448992004441055232,0,2,0,0,2
1309774912530202624,0,2,0,0,2
1379341414887219200,0,2,0,0,2
1450239225694064640,2,0,0,0,2
332735676,0,2,0,0,2
1412819634647027712,0,2,0,0,2
376452407,0,2,0,0,2
1334040930530127872,0,1,0,1,2
1431941530911232000,0,2,0,0,2
1412674224121171968,0,2,0,0,2
377284790,0,2,0,0,2
826489476,0,2,0,0,2
1033317714,0,2,0,0,2
1412003895967105024,0,2,0,0,2
1114314823,0,2,0,0,2
1411655854344916992,0,2,0,0,2
369527867,0,2,0,0,2
1439651064060399616,0,2,0,0,2
822847315,2,0,0,0,2
1049608874,1,1,0,0,2
1353829769817841664,0,2,0,0,2
494755752,0,2,0,0,2
2267188294,0,2,0,0,2
1308460183736193024,0,2,0,0,2
1441056860610596864,0,2,0,0,2
508192147,0,2,0,0,2
1378234386169008128,1,1,0,0,2
1414195405928079360,0,2,0,0,2
1308787221634449408,0,0,1,1,2
277049262,0,2,0,0,2
1451767268,2,0,0,0,2
1357079921307320320,0,2,0,0,2
1478398656,0,2,0,0,2
512830524,0,2,0,0,2
277930276,1,1,0,0,2
1309130446643638272,0,2,0,0,2
1357107183712878592,0,2,0,0,2
1354018938930126848,0,2,0,0,2
333251264,0,2,0,0,2
493965369,0,2,0,0,2
1451601433,0,2,0,0,2
2260495150,0,2,0,0,2
1050211021,0,2,0,0,2
1374758356900933632,0,2,0,0,2
286348171,0,2,0,0,2
1461508473036972032,0,2,0,0,2
1651208408,0,2,0,0,2
549568874,0,2,0,0,2
411419084,0,2,0,0,2
482769309,2,0,0,0,2
384246350,0,2,0,0,2
384852760,0,2,0,0,2
1420116685193760768,0,2,0,0,2
1382485728949506048,0,2,0,0,2
411133921,0,2,0,0,2
1438352894525382656,0,2,0,0,2
481545248,1,1,0,0,2
545150768,0,2,0,0,2
1315243489353969664,1,1,0,0,2
1447876388711718912,0,2,0,0,2
836946007,0,2,0,0,2
1359370838756126720,0,2,0,0,2
1427698806,0,2,0,0,2
384937139,2,0,0,0,2
550212309,0,2,0,0,2
2198976906,0,2,0,0,2
2202052600,0,2,0,0,2
411085443,0,2,0,0,2
1402399889976352768,0,2,0,0,2
975378367,0,2,0,0,2
1526965790,0,2,0,0,2
1442721894487105536,0,2,0,0,2
385594792,0,2,0,0,2
1404745353107165184,0,2,0,0,2
2203182643,0,2,0,0,2
292850470,0,2,0,0,2
1382181486850359296,1,1,0,0,2
1527797556,0,2,0,0,2
1154334030,0,2,0,0,2
1404527023901585408,0,2,0,0,2
974629878,0,0,0,2,2
1336956592164630528,0,2,0,0,2
1314837216863100928,0,2,0,0,2
477048627,0,2,0,0,2
1382204768928604160,2,0,0,0,2
1420258349627498496,1,1,0,0,2
1451483765428064256,0,2,0,0,2
751778144,0,2,0,0,2
2186338837,0,2,0,0,2
291734211,2,0,0,0,2
1405429128250028032,0,2,0,0,2
1314466164949446656,2,0,0,0,2
1314467252737957888,0,2,0,0,2
292330204,0,2,0,0,2
1539378523,1,1,0,0,2
427137482,0,2,0,0,2
1534593613,0,2,0,0,2
1383093348064321536,0,2,0,0,2
1162478245,2,0,0,0,2
292407186,0,2,0,0,2
480355662,0,2,0,0,2
1447992167344054272,0,2,0,0,2
1161457548,1,1,0,0,2
838110434,0,2,0,0,2
2190644169,0,2,0,0,2
1536690787,0,2,0,0,2
743228448,0,2,0,0,2
742755824,0,2,0,0,2
837948372,0,2,0,0,2
1159888928,0,2,0,0,2
1315176748154265600,0,2,0,0,2
1314415546457370624,0,2,0,0,2
980583553,0,2,0,0,2
1384458389728768000,2,0,0,0,2
1403234499534721024,2,0,0,0,2
980060347,0,2,0,0,2
385162111,0,2,0,0,2
365394915,0,2,0,0,2
1437857907136086016,0,0,0,2,2
478493013,0,2,0,0,2
1541003394,0,2,0,0,2
1540529606,1,1,0,0,2
1159155564,0,2,0,0,2
2197716355,0,2,0,0,2
1431071045864284160,2,0,0,0,2
1314873979971141632,0,2,0,0,2
1351811236866887680,0,2,0,0,2
342563323,0,2,0,0,2
291862171,0,2,0,0,2
989798900,0,2,0,0,2
1404353054879670272,0,2,0,0,2
410319755,0,2,0,0,2
1549760503,1,1,0,0,2
1150174112,0,2,0,0,2
431001825,0,2,0,0,2
1312657786514403328,0,2,0,0,2
2181552121,0,2,0,0,2
1460046067769167872,2,0,0,0,2
1430958999822811136,0,2,0,0,2
1460246270757552128,0,2,0,0,2
973792490,0,2,0,0,2
1332990245525045248,0,2,0,0,2
1315706462337822720,0,2,0,0,2
1552752516,0,2,0,0,2
973379065,0,2,0,0,2
1315727667014955008,0,2,0,0,2
541666727,0,2,0,0,2
973025802,0,0,0,2,2
1429652280,0,2,0,0,2
1442589814449078272,0,2,0,0,2
994800241,2,0,0,0,2
1431781172,0,2,0,0,2
1433262887099764736,2,0,0,0,2
410218198,0,2,0,0,2
1331346325716295680,0,2,0,0,2
1145990178,0,2,0,0,2
330145442,0,2,0,0,2
1350442087209181184,0,2,0,0,2
1437604686975184896,0,2,0,0,2
2212498952,0,2,0,0,2
1412517673,0,2,0,0,2
384028767,0,2,0,0,2
1551211375,0,2,0,0,2
553164876,0,2,0,0,2
292865569,0,2,0,0,2
1359014403543285760,0,2,0,0,2
1373239908651958272,0,2,0,0,2
1431312358429925376,0,2,0,0,2
1337058369425780736,0,1,0,1,2
1420584434,0,2,0,0,2
1312888423418605568,0,2,0,0,2
1170451458,0,2,0,0,2
544869113,0,2,0,0,2
1151323981,0,2,0,0,2
1130045612685111296,0,1,0,0,1
1142657984243179520,0,1,0,0,1
1497977483408265216,0,1,0,0,1
1433406424885993472,0,1,0,0,1
1497266982084829184,0,1,0,0,1
1124105230809886720,0,1,0,0,1
1368004303869382656,1,0,0,0,1
1141407250163961856,0,1,0,0,1
1141308256838512640,0,1,0,0,1
1129098916388122624,0,1,0,0,1
1128642320893665280,0,1,0,0,1
1432769984539893760,0,1,0,0,1
1497748384697966592,0,1,0,0,1
1435099057945387008,0,1,0,0,1
1497723369197740032,1,0,0,0,1
1140217368511041536,1,0,0,0,1
1140339478453805056,0,1,0,0,1
1130046320184446976,0,1,0,0,1
1123538643576995840,0,1,0,0,1
1497711025759698944,0,1,0,0,1
1129310378075181056,0,1,0,0,1
1372551587818840064,0,1,0,0,1
1142754157721468928,0,1,0,0,1
1124870862765789184,0,1,0,0,1
1130536057328373760,0,1,0,0,1
1497959855255998464,0,1,0,0,1
1124723788468219904,1,0,0,0,1
1131079619631828992,0,0,0,1,1
1141702413532852224,1,0,0,0,1
1374732530683887616,1,0,0,0,1
1124291184069894144,0,1,0,0,1
1139176837551144960,0,1,0,0,1
1141663489498501120,0,1,0,0,1
1371710509968461824,0,1,0,0,1
1122873114088673280,1,0,0,0,1
1435098850038095872,0,1,0,0,1
1372096785372561408,0,1,0,0,1
1498082573691813888,0,1,0,0,1
1129773171278696448,0,1,0,0,1
1139603338197004288,0,1,0,0,1
1128438032833622016,0,1,0,0,1
1497276415821103104,0,1,0,0,1
1139769510205042688,0,1,0,0,1
1366954564507889664,0,1,0,0,1
1367346562242904064,0,1,0,0,1
1141512552666451968,0,1,0,0,1
1375741688442978304,0,1,0,0,1
1434040205405605888,1,0,0,0,1
1123142988924764160,0,1,0,0,1
1367489172827758592,0,1,0,0,1
1367224691920941056,0,1,0,0,1
1140867215526256640,0,1,0,0,1
1375042661749559296,0,1,0,0,1
1123660390649303040,0,1,0,0,1
1367078278561992704,0,1,0,0,1
1142036007686008832,0,1,0,0,1
1434526382239858688,0,1,0,0,1
1131499124451241984,1,0,0,0,1
1141071682536218624,0,1,0,0,1
1131403212701876224,0,1,0,0,1
1130350676540776448,0,1,0,0,1
1130073857958797312,0,1,0,0,1
1131201304083206144,0,1,0,0,1
1140613812560621568,1,0,0,0,1
1372440742988185600,0,1,0,0,1
1129250441001295872,0,1,0,0,1
1498031802153422848,0,1,0,0,1
1142022000115736576,0,1,0,0,1
1130211700165226496,0,1,0,0,1
1497258302211694592,1,0,0,0,1
1140933358060331008,0,1,0,0,1
1497813008764256256,0,1,0,0,1
1129493810520698880,0,1,0,0,1
1497777376826204160,0,1,0,0,1
1367809405421580288,0,1,0,0,1
1432707583589105664,0,1,0,0,1
1375101556127903744,0,1,0,0,1
1123526920006557696,1,0,0,0,1
1497261312069431296,0,1,0,0,1
1123197853357101056,1,0,0,0,1
1140450757050687488,0,1,0,0,1
1497738878278455296,1,0,0,0,1
1497984776762171392,0,1,0,0,1
1123264029080870912,0,1,0,0,1
1497993475773452288,0,1,0,0,1
1497215352303808512,1,0,0,0,1
1129615706952261632,0,1,0,0,1
1142385002820321280,0,1,0,0,1
1497218580307333120,0,0,1,0,1
1124029531654848512,1,0,0,0,1
1498039958451462144,0,1,0,0,1
1142193036648222720,0,1,0,0,1
1130790133085683712,0,1,0,0,1
1432742643834970112,0,1,0,0,1
1498031485281968128,0,1,0,0,1
1123627233187385344,0,1,0,0,1
1497822847997480960,0,1,0,0,1
1497238514743844864,0,1,0,0,1
1123961671377129472,0,1,0,0,1
1375594183860363264,0,1,0,0,1
1375493182968975360,1,0,0,0,1
1123878092513206272,1,0,0,0,1
1433399433149001728,0,1,0,0,1
1498087142223876096,0,1,0,0,1
1433105598485250048,1,0,0,0,1
1434034093352574976,0,1,0,0,1
1497570621110333440,0,1,0,0,1
1135610265972727808,0,1,0,0,1
1126185901132926976,0,1,0,0,1
1135601393874509824,1,0,0,0,1
1497835462362374144,0,1,0,0,1
1135563636988997632,0,1,0,0,1
1497886896218910720,0,1,0,0,1
1126191354844012544,0,1,0,0,1
1135526454324842496,0,1,0,0,1
1126270024224858112,0,1,0,0,1
1133314923923103744,1,0,0,0,1
1135449846683447296,1,0,0,0,1
1371086200262430720,0,1,0,0,1
1127220954936094720,0,1,0,0,1
1497457463712698368,1,0,0,0,1
1497837433140178944,0,1,0,0,1
1133768849902333952,0,1,0,0,1
1133114087116873728,0,1,0,0,1
1371109575391375360,0,1,0,0,1
1371137853606957056,1,0,0,0,1
1371256381056151552,0,1,0,0,1
1132702981445574656,0,1,0,0,1
1433304602720538624,0,1,0,0,1
1497888328699547648,0,1,0,0,1
1136195130292092928,0,1,0,0,1
1497405004415909888,0,1,0,0,1
1135804402684481536,1,0,0,0,1
1497431877002530816,1,0,0,0,1
1125925873595629568,1,0,0,0,1
1132737274616135680,1,0,0,0,1
1132818869310099456,0,1,0,0,1
1497437396979556352,1,0,0,0,1
1132963410063314944,1,0,0,0,1
1370268708443103232,0,1,0,0,1
1370306232708440064,0,0,0,1,1
1125946437261512704,0,0,1,0,1
1497570559059763200,0,1,0,0,1
1133786644371218432,0,1,0,0,1
1371506112709586944,0,1,0,0,1
1134461683806588928,0,1,0,0,1
1371073377297858560,0,1,0,0,1
1433084260819210240,0,1,0,0,1
1134875894441488384,0,1,0,0,1
1497567707985846272,0,1,0,0,1
1126545418714734592,0,1,0,0,1
1373872483506515968,1,0,0,0,1
1497521718080208896,0,0,0,1,1
1497849002259550208,0,1,0,0,1
1432839346764275712,0,1,0,0,1
1497863819473096704,0,1,0,0,1
1126772535297576960,1,0,0,0,1
1497857016294899712,1,0,0,0,1
1126740597115506688,0,1,0,0,1
1497556677880467456,0,1,0,0,1
1373374018225532928,0,1,0,0,1
1370824519653416960,0,1,0,0,1
1497506498926510080,0,1,0,0,1
1126460465129885696,0,1,0,0,1
1135161037773246464,0,1,0,0,1
1497498417417043968,0,1,0,0,1
1497877104960368640,0,1,0,0,1
1432940039168794624,1,0,0,0,1
1133858349311811584,0,1,0,0,1
1126397603845771264,0,1,0,0,1
1133866478585823232,0,1,0,0,1
1133950849057562624,0,1,0,0,1
1373879163581460480,1,0,0,0,1
1126932059396526080,0,1,0,0,1
1126398260178931712,0,1,0,0,1
1433697499152277504,0,1,0,0,1
1370443965351129088,0,1,0,0,1
1370556655486836736,1,0,0,0,1
1134124733908303872,0,1,0,0,1
1497495524693401600,0,1,0,0,1
1135259996701302784,0,1,0,0,1
1136232145368674304,0,1,0,0,1
1497888353340981248,0,1,0,0,1
1497592233519894528,0,1,0,0,1
1372554127302008832,1,0,0,0,1
1138694667501916160,0,1,0,0,1
1128161681283018752,0,1,0,0,1
1368719783668056064,0,1,0,0,1
1497926648703766528,1,0,0,0,1
1368898711938547712,1,0,0,0,1
1497365347938222080,0,1,0,0,1
1127966007211974656,1,0,0,0,1
1138579665293987840,1,0,0,0,1
1132496694795390976,0,0,1,0,1
1138440706811281408,0,1,0,0,1
1138407089703927808,0,1,0,0,1
1432775283216637952,0,1,0,0,1
1138401480895938560,0,1,0,0,1
1127953951339491328,0,1,0,0,1
1127852847452827648,0,1,0,0,1
1497369319818153984,0,1,0,0,1
1138929832044171264,0,1,0,0,1
1497657267415568384,1,0,0,0,1
1139033398108860416,0,1,0,0,1
1125039243154223104,0,1,0,0,1
1374625499872325632,0,1,0,0,1
1368193777425285120,0,0,0,1,1
1497662914248937472,0,0,0,1,1
1497660541912981504,0,1,0,0,1
1124939261730443264,0,1,0,0,1
1433970806447554560,0,1,0,0,1
1139164970715963392,0,1,0,0,1
1374555533219270656,0,1,0,0,1
1497937144177836032,1,0,0,0,1
1433880979920146432,0,1,0,0,1
1497276570964467712,0,1,0,0,1
1497930028096659456,0,1,0,0,1
1497305661197385728,1,0,0,0,1
1433873440319102976,1,0,0,0,1
1497347798890688512,0,1,0,0,1
1125113985475522560,0,1,0,0,1
1131854274223366144,0,1,0,0,1
1125412154558025728,0,1,0,0,1
1125664655395835904,0,1,0,0,1
1497894446792253440,0,1,0,0,1
1137129085673410560,0,1,0,0,1
1497393691136524288,0,1,0,0,1
1374357416695988224,0,1,0,0,1
1137056023145897984,1,0,0,0,1
1136918318210867200,0,1,0,0,1
1136882538771730432,0,1,0,0,1
1497891400331182080,0,1,0,0,1
1127541121972932608,1,0,0,0,1
1370030744937107456,0,1,0,0,1
1371346405411979264,0,1,0,0,1
1370246118701944832,0,1,0,0,1
1125725860902899712,0,1,0,0,1
1497890988886421504,0,1,0,0,1
1497404177344991232,1,0,0,0,1
1497606798311772160,0,1,0,0,1
1137138195563462656,0,1,0,0,1
1432822876793679872,0,1,0,0,1
1127795886212280320,0,1,0,0,1
1138311632537378816,1,0,0,0,1
1138283566880575488,1,0,0,0,1
1125440833099112448,0,1,0,0,1
1131926657189654528,1,0,0,0,1
1497894861798010880,0,1,0,0,1
1137751031159197696,0,1,0,0,1
1132185176598077440,1,0,0,0,1
1369190914602659840,0,1,0,0,1
1125551357962768384,0,1,0,0,1
1433747214170476544,0,1,0,0,1
1137618440263491584,0,1,0,0,1
1369672194570088448,0,1,0,0,1
1497641458911768576,1,0,0,0,1
1137392092446167040,0,1,0,0,1
1497614971622068224,1,0,0,0,1
1497929299793485824,0,0,0,1,1
1463046730715389952,1,0,0,0,1
1142797987325722624,1,0,0,0,1
1496308203117817856,0,1,0,0,1
1496226849571184640,0,1,0,0,1
1169739725525135360,0,1,0,0,1
1169662493511208960,0,1,0,0,1
1169378764133941248,0,1,0,0,1
1359289502880190464,0,1,0,0,1
1168997112312422400,0,1,0,0,1
1438140707781414912,1,0,0,0,1
1168803280228687872,0,1,0,0,1
1496270616063737856,1,0,0,0,1
1168560238963974144,0,1,0,0,1
1168370346816200704,1,0,0,0,1
1168339002132508672,1,0,0,0,1
1496282789498716160,0,1,0,0,1
1168223417415479296,0,1,0,0,1
1496223788035297280,0,1,0,0,1
1496312990349414400,1,0,0,0,1
1438091132483739648,0,1,0,0,1
1168168001096552448,0,1,0,0,1
1496359210845900800,0,1,0,0,1
1438045751330820096,0,1,0,0,1
1496380101835083776,0,1,0,0,1
1168140077752639488,0,1,0,0,1
1496387663930212352,1,0,0,0,1
1437955397822812160,1,0,0,0,1
1167883755106852864,0,1,0,0,1
1167709817387081728,0,1,0,0,1
1167695888795537408,0,0,0,1,1
1167644064143028224,0,1,0,0,1
1359148652942532608,1,0,0,0,1
1496174106944978944,0,1,0,0,1
1167441315807846400,0,1,0,0,1
1496067311886737408,1,0,0,0,1
1172662978166120448,0,1,0,0,1
1172471676329705472,0,1,0,0,1
1358671533414076416,1,0,0,0,1
1172424208585904128,0,1,0,0,1
1496036798245400576,0,1,0,0,1
1171852530948685824,1,0,0,0,1
1358716547406077952,0,1,0,0,1
1171800803801104384,0,1,0,0,1
1496042943290957824,0,1,0,0,1
1438417836913926144,0,1,0,0,1
1358785747126419456,0,1,0,0,1
1358787485443235840,0,1,0,0,1
1171449242331860992,0,1,0,0,1
1358809917704916992,0,1,0,0,1
1170177528268328960,0,1,0,0,1
1358946674060775424,0,1,0,0,1
1171079367352406016,0,1,0,0,1
1496085220533338112,1,0,0,0,1
1359006829381001216,1,0,0,0,1
1170977230656176128,1,0,0,0,1
1496117895234871296,0,1,0,0,1
1170633435552968704,0,1,0,0,1
1170613533349994496,0,1,0,0,1
1170579566705950720,0,1,0,0,1
1170564139590332416,1,0,0,0,1
1359059059794673664,0,1,0,0,1
1438409319905730560,0,1,0,0,1
1170202746051387392,0,1,0,0,1
1359413180250865664,0,1,0,0,1
1359425769278083072,0,1,0,0,1
1358657612481495040,1,0,0,0,1
1164627571041947648,1,0,0,0,1
1496704810657390592,1,0,0,0,1
1165120465922220032,0,1,0,0,1
1165042929901211648,0,1,0,0,1
1359755857051832320,0,1,0,0,1
1164972876530946048,0,1,0,0,1
1164906049352216576,0,1,0,0,1
1496711453000495104,0,1,0,0,1
1164905564033490944,0,1,0,0,1
1164892044940259328,0,0,0,1,1
1164864823882067968,0,1,0,0,1
1164803334772891648,0,1,0,0,1
1164739393954828288,0,1,0,0,1
1360061870800044032,1,0,0,0,1
1496715733711011840,0,1,0,0,1
1496697129875951616,1,0,0,0,1
1360152286367010816,0,1,0,0,1
1496722189688909824,0,1,0,0,1
1360301169306836992,0,1,0,0,1
1496723659586564096,0,1,0,0,1
1164232273379467264,0,1,0,0,1
1164161642176716800,1,0,0,0,1
1360386400647020544,0,0,0,1,1
1164082568767164416,0,1,0,0,1
1360568077809639424,0,1,0,0,1
1164072857023868928,0,1,0,0,1
1437299287658938368,0,1,0,0,1
1496728282414342144,1,0,0,0,1
1496728431865696256,0,1,0,0,1
1496699523070324736,0,1,0,0,1
1496694116885090304,0,1,0,0,1
1167419531037270016,1,0,0,0,1
1166483458220351488,1,0,0,0,1
1496425818704261120,0,1,0,0,1
1167405709572661248,0,1,0,0,1
1496430270760857600,0,1,0,0,1
1167278900088582144,1,0,0,0,1
1167123528555974656,0,1,0,0,1
1166874394242797568,0,1,0,0,1
1359457747461410816,0,1,0,0,1
1496465022234636288,1,0,0,0,1
1166641402987593728,0,1,0,0,1
1166589608370548736,0,1,0,0,1
1496567600591294464,0,1,0,0,1
1496574200819113984,0,1,0,0,1
1359560422064553984,1,0,0,0,1
1166374658431696896,0,1,0,0,1
1165234923705446400,0,1,0,0,1
1166276426573783040,1,0,0,0,1
1166022565610999808,0,1,0,0,1
1359574941012738048,0,1,0,0,1
1496654474475352064,0,1,0,0,1
1359708400272171008,0,1,0,0,1
1496679233824849920,1,0,0,0,1
1165678284182605824,0,1,0,0,1
1165632877054373888,0,0,0,1,1
1165298733908709376,0,1,0,0,1
1437473050317008896,0,1,0,0,1
1359743157446017024,0,1,0,0,1
1165265551037358080,0,1,0,0,1
1496688322005159936,0,1,0,0,1
1172744818230886400,0,1,0,0,1
1173172978735095808,0,1,0,0,1
1163820146290388992,0,1,0,0,1
1179387256131293184,0,1,0,0,1
1180498950320578560,0,1,0,0,1
1180405698225741824,0,1,0,0,1
1180168573970452480,1,0,0,0,1
1495009250032115712,1,0,0,0,1
1495080603141623808,1,0,0,0,1
1357064831698784256,0,1,0,0,1
1180102732520275968,0,1,0,0,1
1179863570756112384,0,1,0,0,1
1179690163590569984,0,1,0,0,1
1179606646831513600,1,0,0,0,1
1357106169622319104,0,1,0,0,1
1179455208708952064,0,1,0,0,1
1357189207387635712,1,0,0,0,1
1179337375102558208,0,1,0,0,1
1180697091619917824,0,1,0,0,1
1495080951033970688,1,0,0,0,1
1179263830347702272,0,1,0,0,1
1179186742982844416,0,1,0,0,1
1178919049389985792,0,1,0,0,1
1178860051118907392,0,1,0,0,1
1439980497782837248,0,1,0,0,1
1178616903369216000,0,1,0,0,1
1178523941842776064,0,0,0,1,1
1357235211256270848,0,1,0,0,1
1495192459978104832,0,0,0,1,1
1357312130752540672,0,0,1,0,1
1178357290086338560,0,1,0,0,1
1357366755195240448,1,0,0,0,1
1494969661997338624,0,0,1,0,1
1180738594723418112,0,1,0,0,1
1495266147461120000,0,1,0,0,1
1494878778660581376,1,0,0,0,1
1182314517780295680,0,1,0,0,1
1494661211681538048,0,1,0,0,1
1494746571216461824,0,1,0,0,1
1182168285200019456,0,1,0,0,1
1182010813458071552,0,1,0,0,1
1356173897318637568,0,1,0,0,1
1181867531663020032,0,1,0,0,1
1181820313899692032,1,0,0,0,1
1181763845947346944,0,1,0,0,1
1356297361270525952,0,1,0,0,1
1440425111299911680,1,0,0,0,1
1181698016501272576,0,1,0,0,1
1181697898922336256,1,0,0,0,1
1356586000156401664,0,1,0,0,1
1494938537220730880,1,0,0,0,1
1181656749750853632,0,1,0,0,1
1181630577180626944,0,1,0,0,1
1181587003244236800,0,1,0,0,1
1181331485472825344,0,1,0,0,1
1440314286832640000,1,0,0,0,1
1494886837520781312,0,1,0,0,1
1181094183206940672,0,1,0,0,1
1440245513102626816,0,1,0,0,1
1180837692772356096,0,1,0,0,1
1440006778507259904,0,1,0,0,1
1494891860392767488,0,1,0,0,1
1356852013296934912,1,0,0,0,1
1494900205669568512,0,1,0,0,1
1178329235661959168,0,1,0,0,1
1178311339971956736,0,1,0,0,1
1173198869082996736,0,1,0,0,1
1438874918712643584,0,1,0,0,1
1495752325641928704,0,1,0,0,1
1175110009169924096,0,1,0,0,1
1175054768332369920,0,1,0,0,1
1175052561268609024,1,0,0,0,1
1174998746456678400,0,1,0,0,1
1174919794073538560,0,1,0,0,1
1174714632776208384,0,1,0,0,1
1174691396080590848,0,1,0,0,1
1357955399836569600,0,0,0,1,1
1438908942122422272,0,1,0,0,1
1358079120286994432,0,1,0,0,1
1495785290019270656,0,1,0,0,1
1174661598423724032,0,1,0,0,1
1438547091253383168,0,1,0,0,1
1357734853882519552,1,0,0,0,1
1173915460514877440,0,1,0,0,1
1173834203143630848,1,0,0,0,1
1173701547492028416,0,1,0,0,1
1495818438547177472,0,1,0,0,1
1495882870363389952,1,0,0,0,1
1358368235029024768,0,1,0,0,1
1173523930688233472,0,1,0,0,1
1358438815308783616,0,1,0,0,1
1173469211525443584,0,1,0,0,1
1495970816122822656,1,0,0,0,1
1358617820712607744,0,1,0,0,1
1495982462853615616,1,0,0,0,1
1173273450632241152,0,1,0,0,1
1357753886182899712,0,1,0,0,1
1175693805544255488,1,0,0,0,1
1495294468949708800,0,1,0,0,1
1495324220704047104,0,0,0,1,1
1439937544897110016,1,0,0,0,1
1178205782501777408,0,1,0,0,1
1178128563452575744,0,1,0,0,1
1357445124851171328,0,1,0,0,1
1439855748184301568,0,1,0,0,1
1495307746610413568,1,0,0,0,1
1177921138850242560,0,1,0,0,1
1357550968003563520,1,0,0,0,1
1177887259598544896,1,0,0,0,1
1177660086933700608,0,1,0,0,1
1439561437270233088,1,0,0,0,1
1177315453179293696,0,1,0,0,1
1177292095050190848,0,1,0,0,1
1177208638252998656,0,1,0,0,1
1495694467793309696,0,1,0,0,1
1495327552680108032,0,1,0,0,1
1495332971637010432,0,1,0,0,1
1357607770426638336,0,1,0,0,1
1176846391068581888,0,1,0,0,1
1495361854587437056,0,1,0,0,1
1439172274079285248,0,1,0,0,1
1495534742800060416,0,1,0,0,1
1176554590461997056,0,1,0,0,1
1439164058243158016,1,0,0,0,1
1495637453809590272,1,0,0,0,1
1357658684315168768,0,1,0,0,1
1495646527720771584,1,0,0,0,1
1175775858113548288,0,1,0,0,1
1437242674965327872,0,0,0,1,1
1163785267565813760,0,1,0,0,1
1142872594242265088,0,1,0,0,1
1151624182381383680,0,1,0,0,1
1152849278320238592,1,0,0,0,1
1152597931444166656,1,0,0,0,1
1496937971265814528,0,1,0,0,1
1152447914368802816,0,1,0,0,1
1364791303003758592,1,0,0,0,1
1364862779174264832,0,1,0,0,1
1152195212250419200,0,1,0,0,1
1152039308657876992,0,1,0,0,1
1496963757037207552,0,1,0,0,1
1364989082766610432,0,1,0,0,1
1497017790498287616,0,1,0,0,1
1365380430904635392,0,1,0,0,1
1435848305930641408,1,0,0,0,1
1365485615060549632,0,1,0,0,1
1152893162823802880,0,1,0,0,1
1151514071008546816,0,1,0,0,1
1497033287948451840,0,1,0,0,1
1151232480424452096,0,0,0,1,1
1151194454146994176,1,0,0,0,1
1151025484924428288,0,1,0,0,1
1435502395178381312,0,1,0,0,1
1150751883566493696,0,1,0,0,1
1435481871245135872,1,0,0,0,1
1150696280110313472,0,1,0,0,1
1150667049808482304,0,1,0,0,1
1150647758384054272,0,1,0,0,1
1497034725755695104,1,0,0,0,1
1150583203540787200,0,1,0,0,1
1496937231470460928,0,1,0,0,1
1152908164758745088,0,1,0,0,1
1497062371151736832,0,1,0,0,1
1154313665903906816,1,0,0,0,1
1363698604800532480,1,0,0,0,1
1154812383711207424,1,0,0,0,1
1363805235756617728,0,1,0,0,1
1154777152614588416,0,1,0,0,1
1154701416344064000,0,1,0,0,1
1154663143404126208,0,1,0,0,1
1363917110343163904,0,1,0,0,1
1363938708358004736,0,1,0,0,1
1496896659745214464,0,1,0,0,1
1154522505656377344,0,1,0,0,1
1435946954140180480,0,1,0,0,1
1154419525833646080,0,1,0,0,1
1154326232131153920,0,1,0,0,1
1154283898358001664,0,1,0,0,1
1364549575457972224,1,0,0,0,1
1154206849094180864,1,0,0,0,1
1364156292336668672,0,1,0,0,1
1153697754989912064,0,1,0,0,1
1364228222464966656,1,0,0,0,1
1364419899972489216,0,1,0,0,1
1435923513097994240,0,1,0,0,1
1364453318035050496,0,1,0,0,1
1496929975014166528,0,0,0,1,1
1153193869514661888,1,0,0,0,1
1153161238052069376,0,1,0,0,1
1496933090526392320,0,1,0,0,1
1153133073975803904,1,0,0,0,1
1364480404963532800,0,1,0,0,1
1150488507158343680,0,1,0,0,1
1497068356192641024,0,1,0,0,1
1155477720651980800,0,1,0,0,1
1144879235951202304,0,1,0,0,1
1497155016657940480,0,1,0,0,1
1145706217643233280,0,1,0,0,1
1366307775136079872,0,1,0,0,1
1145633686747877376,0,1,0,0,1
1366376640759103488,0,1,0,0,1
1366459649197625344,1,0,0,0,1
1145417629596880896,0,1,0,0,1
1145353414047457280,1,0,0,0,1
1145314909233848320,0,1,0,0,1
1145281209414537216,0,1,0,0,1
1497161924009627648,0,1,0,0,1
1145030700992626688,0,1,0,0,1
1144943993433706496,0,1,0,0,1
1144762817347772416,0,1,0,0,1
1145879930779160576,0,1,0,0,1
1497168147593703424,0,1,0,0,1
1435282794666627072,1,0,0,0,1
1144541655871250432,0,0,0,1,1
1497192364934242304,0,1,0,0,1
1144508157496123392,0,1,0,0,1
1144491971186003968,0,1,0,0,1
1366793715143032832,0,1,0,0,1
1144447170507972608,0,1,0,0,1
1143888390083010560,0,1,0,0,1
1435201267391991808,0,1,0,0,1
1366846257231245312,1,0,0,0,1
1143462658009706496,1,0,0,0,1
1143296723638337536,0,1,0,0,1
1497150099637825536,0,1,0,0,1
1497147132398211072,1,0,0,0,1
1497084292710944768,0,1,0,0,1
1497091893255348224,1,0,0,0,1
1150060262281633792,0,1,0,0,1
1150050065194586112,0,1,0,0,1
1497091739634790400,0,1,0,0,1
1149538951859851264,0,1,0,0,1
1149285957016985600,1,0,0,0,1
1149269992107585536,0,1,0,0,1
1149217427659481088,0,1,0,0,1
1149042166590844928,0,1,0,0,1
1148980310429839360,0,1,0,0,1
1435361922728087552,0,1,0,0,1
1148913532202713088,0,1,0,0,1
1148823736134451200,1,0,0,0,1
1148816771492843520,0,1,0,0,1
1148770469832790016,0,1,0,0,1
1146341459500646400,0,1,0,0,1
1148521697139744768,0,1,0,0,1
1365966144239251456,0,1,0,0,1
1147859590383427584,1,0,0,0,1
1497118990040285184,0,1,0,0,1
1497120280455569408,0,1,0,0,1
1497126857141276672,0,1,0,0,1
1366190918068555776,0,1,0,0,1
1497131730549239808,0,1,0,0,1
1146695196106731520,1,0,0,0,1
1146560007665795072,0,1,0,0,1
1146492669826220032,0,1,0,0,1
1497132690193420288,0,1,0,0,1
1146457227726737408,0,1,0,0,1
1155419555726004224,1,0,0,0,1
1155487451739238400,1,0,0,0,1
1163726162809511936,0,1,0,0,1
1160317249971994624,0,1,0,0,1
1362024562989404160,0,1,0,0,1
1362028831142535168,0,1,0,0,1
1496772886576599040,1,0,0,0,1
1161573665764466688,0,1,0,0,1
1436694668205383680,0,1,0,0,1
1496776041280544768,0,1,0,0,1
1496782332233064448,1,0,0,0,1
1496784534045605888,0,1,0,0,1
1161073103428104192,1,0,0,0,1
1362362693458477056,1,0,0,0,1
1160905582120984576,1,0,0,0,1
1436569542755434496,1,0,0,0,1
1160594566573121536,0,1,0,0,1
1160165020233285632,0,0,0,1,1
1161901362398941184,0,1,0,0,1
1362468356893253632,0,1,0,0,1
1159932581183279104,0,1,0,0,1
1362543363908591616,0,1,0,0,1
1496786513262112768,1,0,0,0,1
1159813921718456320,0,1,0,0,1
1159662259712344064,0,1,0,0,1
1362553543975084032,1,0,0,0,1
1496788830611025920,0,1,0,0,1
1496789638157012992,0,1,0,0,1
1159426778470875136,0,1,0,0,1
1496791179983298560,0,1,0,0,1
1159418573707595776,1,0,0,0,1
1362636712304726016,0,1,0,0,1
1161860835955765248,0,1,0,0,1
1436855909033066496,0,1,0,0,1
1362646648728342528,0,1,0,0,1
1361584035571642368,0,1,0,0,1
1163678613691961344,0,1,0,0,1
1360867989994758144,0,1,0,0,1
1163600289485582336,0,1,0,0,1
1496731699870375936,0,1,0,0,1
1163512540518707200,0,1,0,0,1
1496738294595571712,0,1,0,0,1
1361196607811715072,1,0,0,0,1
1163133150890876928,0,1,0,0,1
1163119024290426880,0,1,0,0,1
1162954565055995904,0,1,0,0,1
1496742893016748032,0,1,0,0,1
1162947428393185280,0,1,0,0,1
1361276743374540800,0,1,0,0,1
1361626138984939520,0,1,0,0,1
1161983825032822784,0,1,0,0,1
1162839005869891584,1,0,0,0,1
1496749886527598592,1,0,0,0,1
1436922843925729280,0,1,0,0,1
1162777442525884416,0,1,0,0,1
1162625504639242240,0,1,0,0,1
1162578098086457344,1,0,0,0,1
1162386846040694784,0,1,0,0,1
1162338943175712768,0,1,0,0,1
1361828254110334976,0,1,0,0,1
1361928179124826112,0,1,0,0,1
1162218051342757888,0,1,0,0,1
1162140975172640768,1,0,0,0,1
1496755420475580416,0,1,0,0,1
1159364756945248256,1,0,0,0,1
1362694556764921856,0,1,0,0,1
1155819649256189952,0,1,0,0,1
1496857610607284224,0,0,0,1,1
1157219082720219136,0,1,0,0,1
1156892295104360448,0,1,0,0,1
1436231124821286912,0,1,0,0,1
1156878067492622336,0,1,0,0,1
1156792912841023488,1,0,0,0,1
1363228493060993024,0,1,0,0,1
1156634068156592128,0,1,0,0,1
1436191166706421760,1,0,0,0,1
1363233365869154304,1,0,0,0,1
1496849036468490240,0,1,0,0,1
1496853637272064000,0,1,0,0,1
1156438585597235200,0,1,0,0,1
1363298622440357888,0,1,0,0,1
1156411728541835264,1,0,0,0,1
1362962246423339008,0,1,0,0,1
1496867085720645632,0,1,0,0,1
1363374110257025024,0,1,0,0,1
1496872539691184128,0,1,0,0,1
1363436485190451200,1,0,0,0,1
1363444428296323072,0,1,0,0,1
1155991028249313280,0,1,0,0,1
1363553574526070784,0,1,0,0,1
1155837248367222784,0,1,0,0,1
1436076012605947904,0,1,0,0,1
1496883228174553088,1,0,0,0,1
1155836486018904064,0,1,0,0,1
1496894068651327488,0,1,0,0,1
1122425973285109760,0,1,0,0,1
1157526242779774976,0,1,0,0,1
1362918877584269312,1,0,0,0,1
1158993828470304768,0,1,0,0,1
1496811478619410432,0,1,0,0,1
1496807589916688384,0,1,0,0,1
1158841136439427072,0,1,0,0,1
1362753625299288064,0,1,0,0,1
1158736011687419904,0,1,0,0,1
1158706866563604480,0,1,0,0,1
1158696257616896000,0,1,0,0,1
1496810089470042112,1,0,0,0,1
1496810513442873344,0,1,0,0,1
1362776387065688064,0,1,0,0,1
1436569025912336384,1,0,0,0,1
1158349355428077568,1,0,0,0,1
1158172655733956608,0,1,0,0,1
1436434314019880960,0,1,0,0,1
1158099323093057536,0,1,0,0,1
1496821755536568320,0,1,0,0,1
1158094911813455872,0,1,0,0,1
1158017472018014208,0,1,0,0,1
1362862699231784960,0,1,0,0,1
1157958294863929344,0,1,0,0,1
1436263459189141504,0,1,0,0,1
1496818775500345344,0,1,0,0,1
1157955318296580096,0,1,0,0,1
1157940075587674112,0,1,0,0,1
1157909196777676800,0,1,0,0,1
1496821530004803584,0,1,0,0,1
1436243831406669824,0,1,0,0,1
1157821950279835648,0,1,0,0,1
1157789804173676544,0,1,0,0,1
1122540879162617856,0,1,0,0,1
1385328588241526784,1,0,0,0,1
1122402057921671168,0,1,0,0,1
1057351984045387776,0,1,0,0,1
1421800244866584576,0,1,0,0,1
1421871112695083008,1,0,0,0,1
1056915371448561664,0,1,0,0,1
1056947953506500608,0,1,0,0,1
1400320657229975552,0,1,0,0,1
1511325786535436288,0,1,0,0,1
1057378496383717376,1,0,0,0,1
1058034763091623936,0,1,0,0,1
1057840570465484800,0,1,0,0,1
1400270562304434176,0,1,0,0,1
1057868340264386560,1,0,0,0,1
1421921881528016896,1,0,0,0,1
1421928862359998464,0,1,0,0,1
1057961940985667584,0,1,0,0,1
1400719196145680384,0,1,0,0,1
1056730162597896192,0,1,0,0,1
1056555760950247424,0,1,0,0,1
1056495832097153024,0,1,0,0,1
1056232082232479744,0,1,0,0,1
1400730922551582720,1,0,0,0,1
1056172582490304512,0,1,0,0,1
1421607761545150464,0,1,0,0,1
1511602027272589312,0,0,0,1,1
1055970327509970944,0,1,0,0,1
1055863542023360512,0,1,0,0,1
1400820677486075904,1,0,0,0,1
1055747681648181248,1,0,0,0,1
1055710216506011648,0,1,0,0,1
1055609908995985408,1,0,0,0,1
1513138846715854848,0,0,0,1,1
1401042186595041280,0,1,0,0,1
1058030052602826752,0,1,0,0,1
1510944533567188992,0,1,0,0,1
1424789007234371584,0,1,0,0,1
1060485026779947008,0,1,0,0,1
1059457282159841280,0,1,0,0,1
1399422754798014464,0,1,0,0,1
1505539517813608448,0,0,0,1,1
1399397056347729920,0,1,0,0,1
1060307576028459008,0,1,0,0,1
1060477602031382528,0,1,0,0,1
1422492765938651136,0,1,0,0,1
1510134042687315968,0,1,0,0,1
1060865309806972928,1,0,0,0,1
1399326340051050496,1,0,0,0,1
1504840810981953536,1,0,0,0,1
1060942264745095168,0,0,0,1,1
1504616875711512576,1,0,0,0,1
1399175931768360960,0,1,0,0,1
1059422014866259968,0,1,0,0,1
1059408749562085376,0,1,0,0,1
1505888188673318912,0,1,0,0,1
1058974222129811456,0,1,0,0,1
1058848887736279040,0,1,0,0,1
1506177601089511424,1,0,0,0,1
1399690137542430720,0,1,0,0,1
1058713281194426368,0,1,0,0,1
1058689635902050304,0,1,0,0,1
1506270795491913728,0,1,0,0,1
1509127231775383552,0,1,0,0,1
1509232779791585280,0,1,0,0,1
1058510955053809664,0,1,0,0,1
1399718953509916672,0,1,0,0,1
1422044514139602944,0,0,0,1,1
1422026789543686144,1,0,0,0,1
1058250191755571200,0,1,0,0,1
1513528966333800448,0,1,0,0,1
1401049220648521728,0,1,0,0,1
1513941807821897728,0,1,0,0,1
1049711387121868800,0,1,0,0,1
1518059336982929408,0,1,0,0,1
1517908383793352704,0,1,0,0,1
1048992626756616192,0,1,0,0,1
1049334940997799936,0,1,0,0,1
1049480817041465344,0,1,0,0,1
1517749313513963520,0,1,0,0,1
1049861154238021632,0,1,0,0,1
1421199088201068544,0,1,0,0,1
1402249440564482048,0,1,0,0,1
1517460325704032256,1,0,0,0,1
1420383802120187904,0,1,0,0,1
1050279770829873152,0,1,0,0,1
1050381084561731584,0,0,0,1,1
1420635072642883584,0,1,0,0,1
1518125798359810048,1,0,0,0,1
1048890264520146944,0,1,0,0,1
1048774901383847936,0,1,0,0,1
1402542755855798272,0,1,0,0,1
1518208424282107904,0,1,0,0,1
1518224419810058240,1,0,0,0,1
1518233563723935744,1,0,0,0,1
1048296125458001920,0,1,0,0,1
1048182339258314752,1,0,0,0,1
1048120035506442240,0,1,0,0,1
1047802270153207808,1,0,0,0,1
1518711196496531456,1,0,0,0,1
1419907968200478720,0,1,0,0,1
1047619733682630656,0,1,0,0,1
1047378562288762880,0,1,0,0,1
1518755788558327808,0,1,0,0,1
1047195300623011840,0,1,0,0,1
1050696794559184896,0,1,0,0,1
1050703553478692864,0,1,0,0,1
1050772718625288192,0,1,0,0,1
1053241007964327936,0,1,0,0,1
1054621173705695232,0,1,0,0,1
1401136390557995008,0,1,0,0,1
1514158553074122752,1,0,0,0,1
1421129324309139456,0,1,0,0,1
1054567805553700864,0,1,0,0,1
1515599329800888320,0,1,0,0,1
1054406410845319168,0,1,0,0,1
1054381313371688960,0,1,0,0,1
1054299398413250560,0,1,0,0,1
1054273486875701248,0,1,0,0,1
1053885961149575168,1,0,0,0,1
1053655949200818176,0,1,0,0,1
1053334841767288832,1,0,0,0,1
1053310107776364544,0,1,0,0,1
1053063936172421120,0,1,0,0,1
1402041529045176320,0,1,0,0,1
1052786911385935872,0,1,0,0,1
1052564272943955968,0,1,0,0,1
1420691239817515008,1,0,0,0,1
1052108214920200192,0,1,0,0,1
1517035991596371968,0,0,0,1,1
1051888913894297600,0,1,0,0,1
1051820309198884864,0,1,0,0,1
1051799089451593728,0,1,0,0,1
1517114460149891072,0,1,0,0,1
1517354794004135936,0,0,0,1,1
1517376452513218560,1,0,0,0,1
1051354345210605568,0,1,0,0,1
1401419321780232192,0,1,0,0,1
1051023121119997952,1,0,0,0,1
1061131176423895040,0,1,0,0,1
1399047749836939264,0,1,0,0,1
1061528628578660352,1,0,0,0,1
1424016155644030976,0,1,0,0,1
1070399007980179456,0,1,0,0,1
1423959139009667072,1,0,0,0,1
1500628655713701888,0,1,0,0,1
1500537020816539648,1,0,0,0,1
1070626582052560896,0,1,0,0,1
1396328792457728000,1,0,0,0,1
1500525336446246912,1,0,0,0,1
1423862842978095104,1,0,0,0,1
1070742463776808960,0,1,0,0,1
1070757176728272896,0,1,0,0,1
1396041268560498688,1,0,0,0,1
1071055911119011840,0,1,0,0,1
1500510604146130944,1,0,0,0,1
1395786798068953088,1,0,0,0,1
1070318881376473088,0,1,0,0,1
1500698675479080960,0,1,0,0,1
1396341770707816448,0,1,0,0,1
1500839160302964736,1,0,0,0,1
1069804233443045376,1,0,0,0,1
1069795130889170944,0,1,0,0,1
1069669254537072640,0,1,0,0,1
1500865205798158336,0,0,0,1,1
1069551263673712640,0,1,0,0,1
1069387662719574016,1,0,0,0,1
1068446160908509184,1,0,0,0,1
1396410221363449856,0,1,0,0,1
1068188764361670656,0,1,0,0,1
1500922161657446400,0,1,0,0,1
1068081311276048384,1,0,0,0,1
1068002275451256832,0,1,0,0,1
1501369260224008192,1,0,0,0,1
1071258677070286848,1,0,0,0,1
1071592736363409408,0,1,0,0,1
1395716188848619520,1,0,0,0,1
1073460716273774592,0,0,0,1,1
1074355405482946560,0,1,0,0,1
1500082385651572736,0,0,0,1,1
1394261245465747456,0,0,0,1,1
1074178582749032448,0,1,0,0,1
1074120965024432128,0,1,0,0,1
1500085979276668928,0,1,0,0,1
1500092894883074048,0,1,0,0,1
1074001636907831296,0,1,0,0,1
1500095909111029760,0,1,0,0,1
1394582286176194560,0,1,0,0,1
1394606488383942656,0,1,0,0,1
1073954766344994816,0,1,0,0,1
1424707246848675840,0,1,0,0,1
1424689977389109248,0,1,0,0,1
1073432375525367808,0,1,0,0,1
1395695147753553920,0,1,0,0,1
1073287112206766080,0,1,0,0,1
1394955765836750848,0,1,0,0,1
1395273351954931712,0,1,0,0,1
1500182860854145024,0,0,0,1,1
1072923510014660608,0,1,0,0,1
1072661284330516480,0,1,0,0,1
1395376931906854912,0,1,0,0,1
1424399238566449152,0,1,0,0,1
1072396032019845120,0,1,0,0,1
1424222957010886656,0,1,0,0,1
1072273712328642560,1,0,0,0,1
1395414764638150656,0,1,0,0,1
1500344953230221312,0,1,0,0,1
1395679147201024000,0,1,0,0,1
1067894766325633024,0,1,0,0,1
1067767303956250624,0,1,0,0,1
1061599373338046464,0,1,0,0,1
1064136539163295744,1,0,0,0,1
1503278233399136256,1,0,0,0,1
1503274603770171392,0,1,0,0,1
1503027069051146240,1,0,0,0,1
1063488165829373952,0,1,0,0,1
1423170655390949376,1,0,0,0,1
1064013336952459264,0,1,0,0,1
1423178416602427392,1,0,0,0,1
1396457623650635776,1,0,0,0,1
1502541866570375168,0,1,0,0,1
1064400051710058496,1,0,0,0,1
1064434030987350016,0,1,0,0,1
1064806930663817216,0,1,0,0,1
1502519775435509760,0,1,0,0,1
1398118753846448128,0,1,0,0,1
1398490608659013632,0,1,0,0,1
1503459995639160832,1,0,0,0,1
1062638604504195072,0,1,0,0,1
1062607835450826752,0,1,0,0,1
1062516643782369280,0,1,0,0,1
1423100693196406784,0,0,1,0,1
1398585420968075264,0,1,0,0,1
1423067425625546752,0,0,0,1,1
1062041910963884032,0,1,0,0,1
1422833356006322176,1,0,0,0,1
1422774887605805056,0,1,0,0,1
1504309353847095296,0,0,0,1,1
1398609777047990272,0,1,0,0,1
1504363003688665088,0,1,0,0,1
1398621843444047872,0,1,0,0,1
1061626842686271488,0,1,0,0,1
1504575622428962816,0,1,0,0,1
1064837377741348864,0,1,0,0,1
1423188928862040064,0,1,0,0,1
1502501427167604736,0,1,0,0,1
1501689389042200576,1,0,0,0,1
1067543127941103616,1,0,0,0,1
1396472896269127680,0,1,0,0,1
1067416223502270464,0,1,0,0,1
1396525952566538240,0,1,0,0,1
1396550398706544640,0,1,0,0,1
1396664377709826048,0,1,0,0,1
1423800332149215232,0,1,0,0,1
1067133301452730368,0,1,0,0,1
1397389643310637056,0,0,0,1,1
1066581436524679168,0,1,0,0,1
1066555311769731072,0,1,0,0,1
1501648021481742336,0,1,0,0,1
1397766006227968000,0,1,0,0,1
1423771098907295744,0,1,0,0,1
1501804016375943168,0,1,0,0,1
1502398247872376832,0,1,0,0,1
1066036620019798016,0,1,0,0,1
1423239763474141184,0,1,0,0,1
1065644674667474944,0,1,0,0,1
1502184121765875712,0,1,0,0,1
1065630071929548800,0,1,0,0,1
1065464810496765952,0,1,0,0,1
1423226774561959936,1,0,0,0,1
1502191069051633664,0,1,0,0,1
1397884398809255936,0,1,0,0,1
1065194134586183680,0,1,0,0,1
1397914225905864704,1,0,0,0,1
1397977268480217088,0,1,0,0,1
1397992296444989440,1,0,0,0,1
1065119098206593024,0,1,0,0,1
1047154542947786752,0,1,0,0,1
1047119045613387776,0,1,0,0,1
1047114104664707072,0,1,0,0,1
1025296598140694528,0,1,0,0,1
1024067503809548288,0,1,0,0,1
1413533168385339392,0,1,0,0,1
1416732852591284224,0,1,0,0,1
1024691065868247040,0,1,0,0,1
1024873850347999232,0,1,0,0,1
1413056548071428096,0,1,0,0,1
1412857122304442368,0,1,0,0,1
1414056167358156800,1,0,0,0,1
1025335987222798336,0,1,0,0,1
1025338661838016512,0,1,0,0,1
1025394875901112320,0,1,0,0,1
1412687045248565248,0,1,0,0,1
1025688451184615424,1,0,0,0,1
1026087434226991104,0,1,0,0,1
1023929146660061184,0,1,0,0,1
1413580847966564352,0,1,0,0,1
1023809527341350912,0,1,0,0,1
1023670843266748416,0,1,0,0,1
1413732692189921280,0,1,0,0,1
1023618611225612288,0,1,0,0,1
1023230992323158016,0,1,0,0,1
1023124878080319488,0,1,0,0,1
1022910398511673344,0,1,0,0,1
1532649243139268608,1,0,0,0,1
1532713016604917760,1,0,0,0,1
1413889145248919552,0,1,0,0,1
1022406998346932224,0,1,0,0,1
1022377077503352832,1,0,0,0,1
1022232310341677056,0,1,0,0,1
1022210033327792128,0,1,0,0,1
1022186583997313024,0,1,0,0,1
1026203432556720128,0,1,0,0,1
1412672594449424384,0,1,0,0,1
1026261268737347584,0,1,0,0,1
1417077499469516800,0,1,0,0,1
1410952155121455104,0,1,0,0,1
1028408148401512448,0,1,0,0,1
1411021766898503680,0,1,0,0,1
1027784895056236544,0,1,0,0,1
1411149985773621248,0,1,0,0,1
1411209064051249152,0,1,0,0,1
1417398905910620160,0,1,0,0,1
1027617273090109440,0,1,0,0,1
1027513691892318208,0,1,0,0,1
1027508410374340608,0,1,0,0,1
1027242953608257536,0,1,0,0,1
1027177583278866432,0,1,0,0,1
1411256352530444288,0,1,0,0,1
1417096463285460992,0,1,0,0,1
1531185366258040832,1,0,0,0,1
1412317056410820608,0,1,0,0,1
1417049070296780800,0,1,0,0,1
1411314270772465664,0,1,0,0,1
1026861343876558848,0,1,0,0,1
1531960482076184576,1,0,0,0,1
1026835556863537152,0,1,0,0,1
1026718982123020288,0,1,0,0,1
1026688672769486848,0,1,0,0,1
1026666504538841088,1,0,0,0,1
1417043552048140288,0,1,0,0,1
1026374307855917056,1,0,0,0,1
1026360330765705216,0,1,0,0,1
1411894055735226368,0,1,0,0,1
1026282888474443776,0,1,0,0,1
1412191985398685696,0,1,0,0,1
1413964458213392384,1,0,0,0,1
1414101285637218304,0,1,0,0,1
1410627599236173824,0,1,0,0,1
1416366983369699328,0,1,0,0,1
1415523558302765056,0,1,0,0,1
1016698348550541312,1,0,0,0,1
1415433756949745664,0,1,0,0,1
1016944673540018176,0,1,0,0,1
1542021274179969024,0,0,1,0,1
1541167379673235456,0,1,0,0,1
1541120968101433344,0,1,0,0,1
1021720161596964864,0,1,0,0,1
1416409299165741056,1,0,0,0,1
1539483183955161088,0,0,0,1,1
1017022955056959488,0,1,0,0,1
1415386460459573248,0,1,0,0,1
1017187925182869504,0,1,0,0,1
1415357524639879168,0,1,0,0,1
1016573537719496704,0,1,0,0,1
1016061777715580928,1,0,0,0,1
1415744507832938496,0,1,0,0,1
1015968770232205312,0,1,0,0,1
1545108705171177472,0,1,0,0,1
1546533185848311808,0,0,0,1,1
1547673246811639808,1,0,0,0,1
1015304749615407104,0,1,0,0,1
1015165560324272128,0,1,0,0,1
1415782590817181696,0,1,0,0,1
1415838561665011712,0,1,0,0,1
1014474841104273408,0,1,0,0,1
1416053449108508672,0,1,0,0,1
1547757272876531712,1,0,0,0,1
1549802907947507712,1,0,0,0,1
1549913004539617280,1,0,0,0,1
1416089136377696256,0,1,0,0,1
1017376944655159296,0,1,0,0,1
1415167241776033792,0,1,0,0,1
1416544825931927552,0,0,0,1,1
1533609957207441408,1,0,0,0,1
1021570438357385216,0,1,0,0,1
1021380026690924544,0,1,0,0,1
1414168543260680192,0,1,0,0,1
1020864287160655872,0,1,0,0,1
1533018958147727360,0,1,0,0,1
1020857154293514240,0,1,0,0,1
1020494944501411840,0,1,0,0,1
1414282780251361280,1,0,0,0,1
1414423624489054208,0,1,0,0,1
1414469396647579648,0,1,0,0,1
1416621674187870208,1,0,0,0,1
1020171300894109696,0,1,0,0,1
1020157995257421824,0,0,0,1,1
1019850169465139200,0,0,0,1,1
1019293875549196288,0,1,0,0,1
1537686212378562560,0,0,0,1,1
1019244482422824960,0,1,0,0,1
1534405790454407168,0,1,0,0,1
1416598874924462080,0,0,0,1,1
1019131526590672896,0,1,0,0,1
1535889573363953664,0,1,0,0,1
1019102833185054720,0,1,0,0,1
1018733595433660416,0,1,0,0,1
1537406516575227904,0,1,0,0,1
1018498347429171200,1,0,0,0,1
1414905967192403968,0,1,0,0,1
1414914057589731328,0,1,0,0,1
1018204089161781248,0,1,0,0,1
1018098820062826496,0,1,0,0,1
1414962564556021760,0,1,0,0,1
1410861272514457600,1,0,0,0,1
1028897616799694848,0,0,0,1,1
1518767239532621824,0,1,0,0,1
1418999348025827328,0,1,0,0,1
1041937668911718400,1,0,0,0,1
1405152426911485952,0,1,0,0,1
1042115743603744768,1,0,0,0,1
1405123693051891712,0,1,0,0,1
1042257751504695296,0,1,0,0,1
1418609107066662912,0,1,0,0,1
1042861888588185600,0,1,0,0,1
1037356610526633984,0,1,0,0,1
1419025087836086272,1,0,0,0,1
1042983989055606784,1,0,0,0,1
1404799307979632640,1,0,0,0,1
1520180521174675456,0,1,0,0,1
1404738058059141120,1,0,0,0,1
1404686456753377280,1,0,0,0,1
1041551628673802240,0,1,0,0,1
1418575199415513088,0,1,0,0,1
1520520657024466944,1,0,0,0,1
1040801837945774080,0,1,0,0,1
1521597309284499456,1,0,0,0,1
1040366111265570816,0,0,0,1,1
1040258520908611584,1,0,0,0,1
1039708100071022592,1,0,0,0,1
1039591818759995392,0,1,0,0,1
1039309395610361856,0,1,0,0,1
1521620525331750912,0,1,0,0,1
1405406461568503808,0,1,0,0,1
1038680063120531456,0,1,0,0,1
1418536297430351872,1,0,0,0,1
1038323503949393920,1,0,0,0,1
1038165963798134784,0,1,0,0,1
1037864715131793408,1,0,0,0,1
1043743385440243712,0,1,0,0,1
1404296827302821888,0,1,0,0,1
1404086002252091392,0,1,0,0,1
1519215547229028352,0,1,0,0,1
1046487717729591296,0,0,0,1,1
1046467964617330688,0,1,0,0,1
1518814418062172160,0,0,0,1,1
1419828550778212352,1,0,0,0,1
1046261752889892864,0,1,0,0,1
1518886233363173376,0,0,0,1,1
1402713310286385152,0,1,0,0,1
1519086946189856768,0,1,0,0,1
1402927176828305408,0,1,0,0,1
1403016465113047040,0,1,0,0,1
1045657342925144064,0,1,0,0,1
1045608196805660672,0,1,0,0,1
1045466205329543168,0,1,0,0,1
1403091155772796928,0,1,0,0,1
1045465186172162048,0,1,0,0,1
1520012566466113536,1,0,0,0,1
1045251903599316992,0,1,0,0,1
1519349684690731008,0,1,0,0,1
1519692789537067008,0,1,0,0,1
1419323988270931968,0,1,0,0,1
1045019347872350208,0,1,0,0,1
1044991682457071616,0,1,0,0,1
1044880456464965632,1,0,0,0,1
1519731295781277696,1,0,0,0,1
1044839720906297344,0,1,0,0,1
1519752479814348800,1,0,0,0,1
1403975765226557440,0,1,0,0,1
1044474913002639360,0,1,0,0,1
1044057768032755712,0,1,0,0,1
1043788675203649536,0,1,0,0,1
1037810024259706880,0,1,0,0,1
1522180672814985216,0,1,0,0,1
1029016764313554944,1,0,0,0,1
1526630923810312192,0,1,0,0,1
1031777417919123456,0,1,0,0,1
1409560701392261120,0,1,0,0,1
1418227468876582912,1,0,0,0,1
1031946762959765504,0,1,0,0,1
1031962836900036608,0,1,0,0,1
1032049315814891520,0,1,0,0,1
1408136454149083136,0,0,0,1,1
1405433148830269440,0,1,0,0,1
1032276916168998912,0,1,0,0,1
1526180030912471040,0,0,0,1,1
1407587985059565568,1,0,0,0,1
1032648026450325504,0,1,0,0,1
1525377871149162496,1,0,0,0,1
1032661669154115584,0,1,0,0,1
1031670521514082304,0,1,0,0,1
1409949128507813888,0,1,0,0,1
1031157850792386560,0,1,0,0,1
1031033028221358080,0,1,0,0,1
1410087697922723840,0,1,0,0,1
1030764851445092352,0,1,0,0,1
1418167887399985152,0,1,0,0,1
1030486082205442048,0,1,0,0,1
1030389628392689664,0,1,0,0,1
1030317908184977408,0,1,0,0,1
1030312375105343488,0,1,0,0,1
1410208004981637120,1,0,0,0,1
1528306135203295232,0,1,0,0,1
1410495840804876288,0,1,0,0,1
1528962191919140864,1,0,0,0,1
1029940670855827456,0,1,0,0,1
1529217395432235008,0,1,0,0,1
1032698888883511296,1,0,0,0,1
1407257829560537088,1,0,0,0,1
1406901250126274560,1,0,0,0,1
1034454893719941120,0,1,0,0,1
1036141078989217792,0,1,0,0,1
1418507150461214720,0,1,0,0,1
1035662976689340416,1,0,0,0,1
1035592586377887744,0,1,0,0,1
1405723183026622464,0,1,0,0,1
1035566189546799104,0,1,0,0,1
1035523692963483648,0,0,0,1,1
1035434797131341824,1,0,0,0,1
1035414260409622528,0,1,0,0,1
1523337928902160384,0,0,0,1,1
1405858350705766400,0,1,0,0,1
1405903743007166464,1,0,0,0,1
1523430829740941312,1,0,0,0,1
1405935319824936960,0,0,0,1,1
1034281952478523392,0,1,0,0,1
1525142359343878144,0,1,0,0,1
1034113601957576704,0,1,0,0,1
1406096053099761664,0,1,0,0,1
1033751995184762880,0,1,0,0,1
1033596865596534784,1,0,0,0,1
1033501807715090432,0,1,0,0,1
1033014413983461376,0,1,0,0,1
1406234920821821440,1,0,0,0,1
1406243535368732672,0,1,0,0,1
1418228710650519552,0,1,0,0,1
1524181399313731584,0,1,0,0,1
1406514619313627136,0,1,0,0,1
1032843521663885312,0,1,0,0,1
1406661591869784064,1,0,0,0,1
1032815672982560768,0,1,0,0,1
1074361335876595712,0,0,0,1,1
1074533736467841024,0,1,0,0,1
1376037895937609728,1,0,0,0,1
1386268028497768448,0,1,0,0,1
1429906331117445120,0,1,0,0,1
1498571277170540544,0,1,0,0,1
1103283216415219712,1,0,0,0,1
1386391841877204992,0,1,0,0,1
1103323329023430656,1,0,0,0,1
1498568945342853120,0,1,0,0,1
1103354767756025856,1,0,0,0,1
1103925890088546304,0,1,0,0,1
1498567957542170624,0,1,0,0,1
1498560408646418432,1,0,0,0,1
1386240398415208448,0,1,0,0,1
1498544502214070272,0,1,0,0,1
1430405637490585600,1,0,0,0,1
1103668994102476800,0,1,0,0,1
1498577209266688000,0,1,0,0,1
1103237716198723584,0,1,0,0,1
1103177153028341760,0,1,0,0,1
1103019644477042688,0,1,0,0,1
1103016319685967872,1,0,0,0,1
1102906583862792192,0,1,0,0,1
1386415957250232320,0,1,0,0,1
1429826845919358976,0,1,0,0,1
1102363232692396032,0,1,0,0,1
1498586725320249344,0,1,0,0,1
1102181199907340288,0,1,0,0,1
1102102254042181632,0,1,0,0,1
1101823053569368064,1,0,0,0,1
1429795361653096448,1,0,0,0,1
1101673034568495104,0,1,0,0,1
1498597081132548096,0,1,0,0,1
1101631084368867328,0,1,0,0,1
1103882280748015616,0,1,0,0,1
1103940803104305152,0,1,0,0,1
1500037029186445312,0,0,0,1,1
1106429006423957504,0,1,0,0,1
1430945284687810560,0,0,0,1,1
1498405525125537792,0,0,1,0,1
1385322691431845888,0,1,0,0,1
1106087272288604160,0,1,0,0,1
1106190986437451776,0,1,0,0,1
1106219359280730112,0,1,0,0,1
1106448250796687360,0,1,0,0,1
1104002076047278080,0,1,0,0,1
1106464308257583104,0,1,0,0,1
1498403308456882176,0,0,0,1,1
1106695783812784128,0,0,1,0,1
1106842359642218496,1,0,0,0,1
1384892733932937216,0,1,0,0,1
1106855406905839616,0,1,0,0,1
1498434312085159936,0,1,0,0,1
1498445587720589312,1,0,0,0,1
1498453394796818432,0,1,0,0,1
1498502253073866752,1,0,0,0,1
1430930908769513472,0,1,0,0,1
1498510198373117952,1,0,0,0,1
1430922273645543424,1,0,0,0,1
1385621981828165632,0,1,0,0,1
1385722566539681792,1,0,0,0,1
1105012726059872256,1,0,0,0,1
1104709271906893824,0,1,0,0,1
1104685565948190720,0,1,0,0,1
1430507022462726144,0,1,0,0,1
1385896389964533760,0,1,0,0,1
1104417788506955776,1,0,0,0,1
1498514163144003584,0,1,0,0,1
1104031587463659520,0,1,0,0,1
1429788853771014144,0,1,0,0,1
1101511207436075008,0,1,0,0,1
1101508360929796096,0,1,0,0,1
1387609872791973888,0,0,1,0,1
1097782979471032320,0,1,0,0,1
1498707157738393600,0,1,0,0,1
1498704609455611904,0,1,0,0,1
1429187211354902528,0,1,0,0,1
1097987775008292864,0,1,0,0,1
1098084571038461952,0,1,0,0,1
1498687872500912128,1,0,0,0,1
1386604518046113792,0,1,0,0,1
1429421852867186688,0,1,0,0,1
1387487198304481280,0,1,0,0,1
1387464523620265984,0,1,0,0,1
1498677577674014720,1,0,0,0,1
1498673904109469696,0,0,0,1,1
1098492510916141056,0,1,0,0,1
1498710204644749312,0,1,0,0,1
1498713947716923392,1,0,0,0,1
1498718362834456576,1,0,0,0,1
1097764913085214720,0,1,0,0,1
1097742226979905536,1,0,0,0,1
1429159394147594240,0,1,0,0,1
1388031883498323968,0,1,0,0,1
1428989089341050880,0,1,0,0,1
1097591937165516800,1,0,0,0,1
1428966723567370240,0,1,0,0,1
1388051790621417472,1,0,0,0,1
1428667405803393024,0,1,0,0,1
1097394225732300800,0,1,0,0,1
1097321496161136640,0,1,0,0,1
1498720992067473408,0,1,0,0,1
1498723729735847936,0,1,0,0,1
1096766566279073792,0,1,0,0,1
1098824943381372928,0,1,0,0,1
1098863757323849728,0,1,0,0,1
1498668547928911872,0,1,0,0,1
1100779189148532736,1,0,0,0,1
1101479077431656448,0,1,0,0,1
1386652167046680576,0,1,0,0,1
1101311120445505536,0,1,0,0,1
1101307491713990656,0,1,0,0,1
1101307193435947008,0,1,0,0,1
1101243162759258112,1,0,0,0,1
1101097779567431680,0,1,0,0,1
1498603032640167936,1,0,0,0,1
1429778673339674624,0,1,0,0,1
1498608203747442688,0,1,0,0,1
1100948727374594048,0,1,0,0,1
1429759541512740864,0,1,0,0,1
1100819774345494528,0,1,0,0,1
1429745975497723904,0,1,0,0,1
1386960488953630720,0,1,0,0,1
1387355544621666304,0,1,0,0,1
1387239949171249152,0,1,0,0,1
1100584184681136128,0,1,0,0,1
1100413862665510912,0,1,0,0,1
1100347200557596672,0,1,0,0,1
1429481911311683584,1,0,0,0,1
1100333740700696576,1,0,0,0,1
1100309103048622080,0,1,0,0,1
1498668209381076992,0,1,0,0,1
1099676795052396544,0,1,0,0,1
1429461073435013120,0,1,0,0,1
1099613892622385152,0,1,0,0,1
1098996214618615808,1,0,0,0,1
1098968602869411840,0,1,0,0,1
1098890933129695232,1,0,0,0,1
1384864879069171712,0,1,0,0,1
1107117364959535104,0,1,0,0,1
1107186768883974144,0,1,0,0,1
1498191883612295168,0,1,0,0,1
1379502243167170560,0,1,0,0,1
1379379538103263232,0,1,0,0,1
1117851184755347456,0,1,0,0,1
1379379240869715968,1,0,0,0,1
1498195744255324160,0,1,0,0,1
1118181967252602880,0,1,0,0,1
1379335152631906304,0,1,0,0,1
1498252054036643840,0,1,0,0,1
1431957387557097472,0,1,0,0,1
1378782988926734336,0,1,0,0,1
1118814314444546048,0,1,0,0,1
1118896057193127936,0,1,0,0,1
1118964780495142912,0,1,0,0,1
1432080401649049600,0,1,0,0,1
1431937408006639616,0,1,0,0,1
1498217662442541056,0,1,0,0,1
1379590256450658304,0,1,0,0,1
1117171863149514752,1,0,0,0,1
1116621233410334720,0,1,0,0,1
1379669921278218240,0,1,0,0,1
1116395440000372736,0,1,0,0,1
1498228395569827840,0,1,0,0,1
1498232090218881024,0,1,0,0,1
1431636452727660544,0,1,0,0,1
1380101471149027328,0,1,0,0,1
1380163528984772608,0,1,0,0,1
1115636358456864768,0,1,0,0,1
1115485903617572864,0,1,0,0,1
1115337773739794432,0,1,0,0,1
1115127117715525632,0,1,0,0,1
1114940909240479744,0,1,0,0,1
1498188656158593024,0,1,0,0,1
1378755235418681344,0,1,0,0,1
1378736082443964416,0,1,0,0,1
1376769343820795904,0,1,0,0,1
1122137688017076224,0,1,0,0,1
1498110794797809664,0,1,0,0,1
1498115285009588224,1,0,0,0,1
1376411200045641728,0,1,0,0,1
1121352464165408768,0,1,0,0,1
1121338194576850944,0,1,0,0,1
1376551278763909120,0,1,0,0,1
1376572141680869376,0,1,0,0,1
1121042263373680640,1,0,0,0,1
1432683486805217280,0,1,0,0,1
1432597159426154496,0,0,0,1,1
1120954110881218560,1,0,0,0,1
1120813716893655040,0,1,0,0,1
1120727148384309248,0,1,0,0,1
1120251553917620224,1,0,0,0,1
1432200042149040128,0,1,0,0,1
1432525300278169600,1,0,0,0,1
1120079106027216896,0,1,0,0,1
1432507104372330496,0,1,0,0,1
1120047183808438272,0,1,0,0,1
1119983825780727808,0,1,0,0,1
1119938957800640512,1,0,0,0,1
1119778555389534208,0,1,0,0,1
1378202882030231552,1,0,0,0,1
1498147970008633344,0,1,0,0,1
1119605199583305728,0,1,0,0,1
1119602941269135360,1,0,0,0,1
1119578236105764864,0,1,0,0,1
1378657205591810048,0,1,0,0,1
1498161491694190592,1,0,0,0,1
1114802978119196672,0,1,0,0,1
1114442347016667136,0,1,0,0,1
1498391428954738688,1,0,0,0,1
1382118163488313344,0,1,0,0,1
1109393348601790464,0,1,0,0,1
1109442921533718528,0,1,0,0,1
1431292126566830080,0,1,0,0,1
1498330802966306816,0,1,0,0,1
1109536709165801472,0,1,0,0,1
1109759649241153536,0,1,0,0,1
1498302938623655936,0,1,0,0,1
1114287189003833344,0,1,0,0,1
1110093039257575424,1,0,0,0,1
1381837779638775808,1,0,0,0,1
1381828427464863744,0,1,0,0,1
1110213552328065024,0,1,0,0,1
1498302466386841600,0,1,0,0,1
1381748933186048000,0,1,0,0,1
1109184765813358592,0,1,0,0,1
1382505342177738752,0,1,0,0,1
1109120532467892224,0,1,0,0,1
1108849979538325504,1,0,0,0,1
1108603108207276032,0,1,0,0,1
1431099858119757824,0,1,0,0,1
1382917228467654656,1,0,0,0,1
1108277494292115456,0,0,0,1,1
1383119842958405632,0,1,0,0,1
1383203209938927616,0,1,0,0,1
1384423285656535040,0,1,0,0,1
1384437153548029952,0,1,0,0,1
1107665056647438336,1,0,0,0,1
1384514163901353984,0,1,0,0,1
1384529705261469696,0,1,0,0,1
1107194858588917760,0,1,0,0,1
1384593828154249216,0,1,0,0,1
1381745335152779264,0,1,0,0,1
1110402006777135104,0,1,0,0,1
1110609156954902528,0,1,0,0,1
1498271826337841152,1,0,0,0,1
1114247657646632960,0,1,0,0,1
1113561440181420032,0,1,0,0,1
1113519995609161728,0,1,0,0,1
1498254625421479936,1,0,0,0,1
1381171598577766400,0,1,0,0,1
1113311620212490240,0,1,0,0,1
1113110298330836992,1,0,0,0,1
1498256725945708544,0,1,0,0,1
1112704605744521216,0,0,0,1,1
1112673456309587968,0,1,0,0,1
1112200723553488896,0,1,0,0,1
1112175977860194304,0,1,0,0,1
1431623664001224704,0,1,0,0,1
1111910544762507264,1,0,0,0,1
1111649020429197312,0,1,0,0,1
1110668736137056256,0,1,0,0,1
1111401607315492864,0,1,0,0,1
1111336359317262336,0,1,0,0,1
1111234912575737856,0,1,0,0,1
1381185014570774528,1,0,0,0,1
1111179646538842112,0,1,0,0,1
1110880984835284992,0,1,0,0,1
1110814141567119360,0,1,0,0,1
1381291816549408768,1,0,0,0,1
1431387350815363072,0,1,0,0,1
1381611030325948416,0,1,0,0,1
1110694681917059072,0,1,0,0,1
1431359030337937408,1,0,0,0,1
1498287379567710208,1,0,0,0,1
1381673527506522112,1,0,0,0,1
1096730275273297920,0,1,0,0,1
1498780359667773440,1,0,0,0,1
1096663632237088768,0,1,0,0,1
1081270773443190784,0,1,0,0,1
1080367817864761344,0,1,0,0,1
1080452666038386688,0,1,0,0,1
1080999914451161088,0,1,0,0,1
1081060018210844672,0,1,0,0,1
1392587715451908096,0,1,0,0,1
1081204847322398720,0,1,0,0,1
1426157458079293440,1,0,0,0,1
1079276154006061056,0,1,0,0,1
1426311073276170240,0,1,0,0,1
1499308387535781888,1,0,0,0,1
1081468730251595776,0,1,0,0,1
1081468790536392704,1,0,0,0,1
1499301685063262208,1,0,0,0,1
1081631826152706048,0,1,0,0,1
1080360732682727424,0,1,0,0,1
1080353997360451584,0,1,0,0,1
1080239878321905664,0,1,0,0,1
1080151105282011136,0,1,0,0,1
1392863763410440192,0,1,0,0,1
1499327386940178432,1,0,0,0,1
1080090605328482304,0,1,0,0,1
1080090124325552128,1,0,0,0,1
1079685417589444608,1,0,0,0,1
1079382152163160064,0,1,0,0,1
1392944476298096640,0,1,0,0,1
1079374752224030720,1,0,0,0,1
1079345378846109696,0,1,0,0,1
1499332748615753728,1,0,0,0,1
1393030234002264064,1,0,0,0,1
1499343342894784512,0,1,0,0,1
1499354855273603072,0,1,0,0,1
1392419191622275072,0,1,0,0,1
1426318067873763328,1,0,0,0,1
1499290609269747712,0,1,0,0,1
1499267937571676160,0,1,0,0,1
1084437199301632000,0,1,0,0,1
1499259351445377024,0,1,0,0,1
1426383067791466496,0,1,0,0,1
1391983983517265920,0,1,0,0,1
1084358480788709376,0,1,0,0,1
1084284920325984256,0,1,0,0,1
1084087131717292032,1,0,0,0,1
1392013268638601216,0,1,0,0,1
1083611535035883520,0,1,0,0,1
1392024963440316416,0,1,0,0,1
1392064158582116352,0,1,0,0,1
1083354015390416896,0,1,0,0,1
1083285319640731648,1,0,0,0,1
1392080780705206272,1,0,0,0,1
1426326912486584320,0,1,0,0,1
1082136281629540352,0,1,0,0,1
1392116248704598016,1,0,0,0,1
1082933081701416960,0,1,0,0,1
1426319694290583552,0,1,0,0,1
1499276284819808256,0,1,0,0,1
1082826050130923520,0,1,0,0,1
1082743226694389760,0,1,0,0,1
1082731737753489408,0,1,0,0,1
1499285147832758272,0,1,0,0,1
1082621062188335104,0,0,1,0,1
1082549365384728576,0,1,0,0,1
1392121241889214464,0,1,0,0,1
1499286069363482624,1,0,0,0,1
1499286597602189312,0,1,0,0,1
1392352816228933632,0,1,0,0,1
1499360454551822336,0,1,0,0,1
1079242670785073152,0,1,0,0,1
1084525988250353664,0,1,0,0,1
1075775287344984064,0,1,0,0,1
1075683332317478912,1,0,0,0,1
1424847347243159552,0,1,0,0,1
1425015373842190336,0,1,0,0,1
1075695344636362752,0,1,0,0,1
1394201182038593536,0,1,0,0,1
1394156378709577728,0,1,0,0,1
1075846886580502528,0,1,0,0,1
1393080586827411456,1,0,0,0,1
1076082087709442048,0,0,1,0,1
1076129354432819200,0,1,0,0,1
1393908815146463232,0,1,0,0,1
1393783478244679680,0,1,0,0,1
1076342953839419392,1,0,0,0,1
1076390276216877056,0,1,0,0,1
1394222868960092160,1,0,0,0,1
1499678647992659968,0,1,0,0,1
1075198080830582784,0,1,0,0,1
1499708168800116736,1,0,0,0,1
1499731896019955712,0,1,0,0,1
1499751248333094912,0,1,0,0,1
1075139392195432448,1,0,0,0,1
1075017674009272320,0,1,0,0,1
1394238919311433728,0,1,0,0,1
1075007968062726144,0,1,0,0,1
1499764041560039424,0,1,0,0,1
1499791685626339328,1,0,0,0,1
1499807518343770112,1,0,0,0,1
1074749851617910784,0,1,0,0,1
1499845968124125184,0,1,0,0,1
1074557766453379072,0,1,0,0,1
1500020501733064704,1,0,0,0,1
1499659608444391424,1,0,0,0,1
1499636820971487232,0,1,0,0,1
1499636516238381056,0,1,0,0,1
1393422473077481472,0,1,0,0,1
1079117266753445888,0,1,0,0,1
1499382876412190720,1,0,0,0,1
1078967110737514496,1,0,0,0,1
1426041036489433088,0,1,0,0,1
1393089571999473664,0,1,0,0,1
1499385168708177920,0,1,0,0,1
1499402693852696576,1,0,0,0,1
1499407600269492224,0,1,0,0,1
1499423786814349312,0,1,0,0,1
1499429880827576320,0,1,0,0,1
1425751741270736896,0,1,0,0,1
1077980400855658496,0,1,0,0,1
1077740308195094528,0,1,0,0,1
1077667882635575296,0,1,0,0,1
1077455067580489728,1,0,0,0,1
1076431766175371264,0,1,0,0,1
1425558981385261056,0,1,0,0,1
1077388210039283712,0,1,0,0,1
1393543020776071168,0,1,0,0,1
1077258843489472512,0,1,0,0,1
1499447348874956800,0,1,0,0,1
1077215893661380608,0,1,0,0,1
1077009615722696704,0,1,0,0,1
1499460581954314240,1,0,0,0,1
1393590801079447552,0,1,0,0,1
1499543989518667776,0,1,0,0,1
1425143732765020160,1,0,0,0,1
1425132671286616064,0,1,0,0,1
1393668860738523136,0,1,0,0,1
1499615002877399040,1,0,0,0,1
1499252311444815872,0,1,0,0,1
1391347671399485440,0,1,0,0,1
1096662127107022848,1,0,0,0,1
1093178723409580032,0,1,0,0,1
1093088465783185408,0,1,0,0,1
1498930151513489408,0,1,0,0,1
1498926570110881792,0,1,0,0,1
1093125223019438080,0,0,1,0,1
1427627243359113216,0,1,0,0,1
1427932880571830272,0,1,0,0,1
1389099877423108096,0,0,0,1,1
1427286238986481664,1,0,0,0,1
1389075901065826304,0,1,0,0,1
1093562288643149824,0,1,0,0,1
1093677524884742144,1,0,0,0,1
1093701129215438848,0,1,0,0,1
1093780920568594432,0,0,0,1,1
1093804955297857536,0,1,0,0,1
1093075346889588736,0,1,0,0,1
1092583804105940992,0,1,0,0,1
1389317233382363136,0,1,0,0,1
1092335867769741312,0,1,0,0,1
1389423604308217856,0,1,0,0,1
1092089312559157248,0,1,0,0,1
1498932631903571968,0,0,0,1,1
1091439109040680960,0,1,0,0,1
1389492958068711424,0,1,0,0,1
1090900909129908224,1,0,0,0,1
1090855855606640640,0,1,0,0,1
1389517324823277568,0,1,0,0,1
1090659897522470912,0,1,0,0,1
1090655387810856960,0,1,0,0,1
1090567958055866368,1,0,0,0,1
1090429759702601728,0,1,0,0,1
1389545546856108032,0,1,0,0,1
1093839293615878144,0,1,0,0,1
1388792445224296448,0,1,0,0,1
1093951337585356800,0,1,0,0,1
1095388067588964352,0,0,0,1,1
1428644275642904576,0,1,0,0,1
1388122425854816256,1,0,0,0,1
1096480462887825408,0,1,0,0,1
1428447476328116224,0,1,0,0,1
1096394656605184000,1,0,0,0,1
1498788005900955648,0,1,0,0,1
1388164459697483776,0,1,0,0,1
1498804392757284864,0,1,0,0,1
1498817403123159040,0,1,0,0,1
1388225951142711296,0,1,0,0,1
1498834610830000128,1,0,0,0,1
1095794262162067456,0,1,0,0,1
1095761027679936512,0,1,0,0,1
1498848575266390016,0,1,0,0,1
1498875859708805120,0,1,0,0,1
1094027680138313728,0,1,0,0,1
1498904563977539584,0,1,0,0,1
1095255278679937024,0,1,0,0,1
1095252374392897536,1,0,0,0,1
1388371216428322816,0,1,0,0,1
1095239941163008000,0,1,0,0,1
1095156495056957440,0,1,0,0,1
1388401125393674240,0,1,0,0,1
1094924033534115840,0,1,0,0,1
1388468395440545792,0,1,0,0,1
1094291648597508096,0,1,0,0,1
1388560966137249792,1,0,0,0,1
1498923907541508096,0,1,0,0,1
1094253615420706816,0,1,0,0,1
1094089280777928704,0,1,0,0,1
1090257927640895488,0,0,0,1,1
1498946361051418624,0,0,1,0,1
1085012255488516096,0,1,0,0,1
1390781028189368320,0,1,0,0,1
1086299575890018304,0,1,0,0,1
1086537164089888768,0,1,0,0,1
1499122818885492736,0,1,0,0,1
1499118330564730880,1,0,0,0,1
1499104687769141248,0,1,0,0,1
1499085259128057856,0,1,0,0,1
1086663103079624704,0,1,0,0,1
1498959085059944448,0,1,0,0,1
1427012746273492992,0,1,0,0,1
1086761984807194624,1,0,0,0,1
1086842022672031744,1,0,0,0,1
1427052491565264896,0,1,0,0,1
1499080644781285376,0,1,0,0,1
1390505730839568384,0,1,0,0,1
1390857157583818752,0,1,0,0,1
1390958050996113408,1,0,0,0,1
1086236892385837056,0,1,0,0,1
1086232539096862720,0,1,0,0,1
1391021436245057536,0,1,0,0,1
1085849880818376704,1,0,0,0,1
1499135903826071552,0,1,0,0,1
1391166088071634944,0,1,0,0,1
1499204198184984576,0,1,0,0,1
1085399115020808192,0,1,0,0,1
1426871813393420288,0,1,0,0,1
1499249234708631552,0,1,0,0,1
1085290065490632704,0,1,0,0,1
1085270774988984320,0,1,0,0,1
1499251055217061888,1,0,0,0,1
1426663556804661248,0,1,0,0,1
1391244481576374272,1,0,0,0,1
1499078771613204480,0,0,0,1,1
1499056314429100032,0,1,0,0,1
1390457978629677056,0,1,0,0,1
1088153253639016448,0,1,0,0,1
1498962271673876480,0,0,0,1,1
1089889594206810112,0,1,0,0,1
1427199555720916992,0,1,0,0,1
1389739814547689472,0,1,0,0,1
1089483105029611520,1,0,0,0,1
1089373784836956160,0,1,0,0,1
1089273821918576640,1,0,0,0,1
1089186782573457408,0,1,0,0,1
1498988460845432832,0,1,0,0,1
1498992902357209088,0,1,0,0,1
1389797678901514240,0,1,0,0,1
1427165799802806272,1,0,0,0,1
1088460807464275968,0,1,0,0,1
1389973540225515520,0,1,0,0,1
1088140144547385344,0,1,0,0,1
1087278112352681984,0,1,0,0,1
1088112311498358784,0,1,0,0,1
1088107047093100544,0,1,0,0,1
1498993319149453312,0,1,0,0,1
1088044211348402176,1,0,0,0,1
1499008061993730048,1,0,0,0,1
1087832694501724160,0,1,0,0,1
1499014575483621376,0,1,0,0,1
1499030378946113536,0,0,0,1,1
1390216321632194560,0,1,0,0,1
1087628966171537408,0,0,1,0,1
1499031697177907200,0,1,0,0,1
1499042988818944000,0,1,0,0,1
1499050830682476544,1,0,0,0,1
1087582975838076928,0,1,0,0,1
1440606043629768704,0,1,0,0,1
1195288599710912512,0,1,0,0,1
1182483753009942528,0,1,0,0,1
1272260836472561664,0,1,0,0,1
1272189027672715264,0,1,0,0,1
1323191039251771392,0,0,0,1,1
1272228150748098560,0,1,0,0,1
1322983076784447488,0,1,0,0,1
1272235804308299776,0,1,0,0,1
1479317689483071488,0,1,0,0,1
1272299776503984128,0,1,0,0,1
1271980682554769408,0,1,0,0,1
1272351667560710144,0,1,0,0,1
1479296082366451712,0,1,0,0,1
1322757067774529536,0,1,0,0,1
1456139248223105024,1,0,0,0,1
1479208608500006912,0,1,0,0,1
1456146372965515264,0,1,0,0,1
1272113183868796928,0,1,0,0,1
1271728473317339136,0,1,0,0,1
1323523688986193920,1,0,0,0,1
1456114338415226880,0,1,0,0,1
1271125990257778688,0,1,0,0,1
1323488042900881408,0,1,0,0,1
1323445468165251072,0,1,0,0,1
1323386043312328704,0,1,0,0,1
1271255950381535232,0,1,0,0,1
1479537824529633280,0,1,0,0,1
1323324885263765504,0,1,0,0,1
1271594359306072064,0,1,0,0,1
1323262849024548864,0,1,0,0,1
1323229634721386496,0,1,0,0,1
1271368790366920704,0,1,0,0,1
1323191689561825280,1,0,0,0,1
1271491330233888768,0,1,0,0,1
1271507028662521856,0,1,0,0,1
1479147186680213504,0,1,0,0,1
1322552532640567296,1,0,0,0,1
1322543443105603584,0,1,0,0,1
1273584448001339392,0,1,0,0,1
1322201475297144832,1,0,0,0,1
1478778736031928320,0,1,0,0,1
1456342494413672448,1,0,0,0,1
1478768212791775232,0,1,0,0,1
1273525745654968320,1,0,0,0,1
1478764566993674240,0,1,0,0,1
1273587279336886272,0,1,0,0,1
1479101612329029632,0,1,0,0,1
1273591525352648704,1,0,0,0,1
1273686137433780224,0,1,0,0,1
1478719582303145984,0,1,0,0,1
1273796012042186752,0,1,0,0,1
1456521920501850112,0,1,0,0,1
1478541417718841344,0,1,0,0,1
1273290308831207424,0,1,0,0,1
1478897977276219392,0,1,0,0,1
1322254534639603712,0,1,0,0,1
1273202520702087168,0,1,0,0,1
1322343714698743808,0,1,0,0,1
1272952925824757760,0,1,0,0,1
1322379881439584256,0,1,0,0,1
1272940202172878848,1,0,0,0,1
1272849026266718208,0,1,0,0,1
1272752232622985216,1,0,0,0,1
1322517815631384576,0,1,0,0,1
1272596653858451456,0,1,0,0,1
1479020687759224832,1,0,0,0,1
1272520434588811264,0,1,0,0,1
1272475263192965120,0,1,0,0,1
1322526573312921600,0,1,0,0,1
1456175164668928000,1,0,0,0,1
1271108496839368704,1,0,0,0,1
1479576021649219584,1,0,0,0,1
1280845076462219264,0,1,0,0,1
1480070129165631488,0,1,0,0,1
1268274425582850048,0,1,0,0,1
1268306644095709184,0,1,0,0,1
1455782377964326912,1,0,0,0,1
1268373306240929792,0,1,0,0,1
1455783573794000896,0,1,0,0,1
1268472595080450048,0,1,0,0,1
1324941782057054208,0,1,0,0,1
1268195816763723776,0,1,0,0,1
1324911342839496704,0,1,0,0,1
1480040635776180224,0,1,0,0,1
1268483328027488256,0,1,0,0,1
1268650879537700864,0,1,0,0,1
1480007817738141696,0,1,0,0,1
1324854633471381504,0,1,0,0,1
1268269151048564736,0,1,0,0,1
1268188779942227968,0,1,0,0,1
1323702879610429440,0,1,0,0,1
1267951224466354176,0,1,0,0,1
1480253290986164224,1,0,0,0,1
1325257149564424192,0,1,0,0,1
1325187125092868096,0,1,0,0,1
1480191180726059008,0,1,0,0,1
1267836871033475072,0,1,0,0,1
1267946139115978752,0,1,0,0,1
1325154201664565248,1,0,0,0,1
1480095769428332544,0,1,0,0,1
1325139952875696128,0,1,0,0,1
1455775770408751104,0,1,0,0,1
1268169337531011072,0,1,0,0,1
1268172004261330944,0,1,0,0,1
1325086898725904384,0,1,0,0,1
1268178790599077888,0,1,0,0,1
1479960183178629120,1,0,0,0,1
1455794915837825024,1,0,0,0,1
1268718516313698304,0,1,0,0,1
1270582736152154112,0,1,0,0,1
1270365480629362688,0,1,0,0,1
1324286289986777088,0,1,0,0,1
1270444349080436736,1,0,0,0,1
1270449605533040640,0,1,0,0,1
1324059586387611648,0,1,0,0,1
1270572569771507712,0,1,0,0,1
1479681949878865920,0,1,0,0,1
1324778431679209472,0,1,0,0,1
1479632618392014848,0,1,0,0,1
1479596371334381568,0,1,0,0,1
1323842351815516160,0,1,0,0,1
1270667274337296384,0,1,0,0,1
1270800343383904256,0,1,0,0,1
1479593952130920448,0,0,0,1,1
1270340347231682560,0,1,0,0,1
1479772536523177984,0,1,0,0,1
1270165338026643456,0,1,0,0,1
1270070244862648320,1,0,0,0,1
1324359194242248704,0,1,0,0,1
1324364528906199040,0,1,0,0,1
1269645913418395648,0,1,0,0,1
1269598733878079488,1,0,0,0,1
1455821491543683072,0,1,0,0,1
1324631608150798336,0,1,0,0,1
1269247261869031424,0,1,0,0,1
1269211413890732032,0,1,0,0,1
1269189925058023424,1,0,0,0,1
1269146423796342784,0,1,0,0,1
1268885427324362752,0,1,0,0,1
1268867908613988352,0,1,0,0,1
1324641650363101184,0,1,0,0,1
1322072135750266880,1,0,0,0,1
1478473783619031040,0,0,0,1,1
1273940576073740288,1,0,0,0,1
1457323846630260736,1,0,0,0,1
1477321888481304576,0,0,0,1,1
1278313235041734656,0,1,0,0,1
1278319486924238848,0,1,0,0,1
1278326349086765056,0,1,0,0,1
1320277708840996864,0,1,0,0,1
1278347715856994304,0,1,0,0,1
1278588327608954880,0,1,0,0,1
1320374560064114688,0,1,0,0,1
1278605799393308672,1,0,0,0,1
1278982779611439104,0,0,1,0,1
1319876922000723968,0,1,0,0,1
1319852790517096448,1,0,0,0,1
1477264712886677504,1,0,0,0,1
1279001684367179776,0,1,0,0,1
1320340688987410432,0,1,0,0,1
1477331819389353984,0,1,0,0,1
1273989930981617664,0,1,0,0,1
1277911042023198720,0,1,0,0,1
1277743108101300224,0,1,0,0,1
1277799045633728512,0,1,0,0,1
1277890544266629120,0,1,0,0,1
1457296002692497408,0,1,0,0,1
1457304101851582464,0,1,0,0,1
1320633716419350528,0,1,0,0,1
1477501473131048960,1,0,0,0,1
1278222683348463616,0,1,0,0,1
1320557393932021760,1,0,0,0,1
1457320980326412288,0,1,0,0,1
1278118274178441216,1,0,0,0,1
1278160649080766464,0,1,0,0,1
1320525483977703424,0,1,0,0,1
1477433616250589184,1,0,0,0,1
1279034305394720768,0,1,0,0,1
1279053545644449792,0,1,0,0,1
1319643203427995648,0,1,0,0,1
1319355339213422592,0,1,0,0,1
1280398977511370752,0,1,0,0,1
1457419136787693568,0,1,0,0,1
1476926475181846528,0,1,0,0,1
1280407412671803392,1,0,0,0,1
1476896424222609408,1,0,0,0,1
1280473370283454464,1,0,0,0,1
1280548192124145664,0,1,0,0,1
1279243075672584192,0,1,0,0,1
1280708215576178688,0,1,0,0,1
1319348459443544064,0,1,0,0,1
1319266178435461120,0,1,0,0,1
1476540916781359104,0,1,0,0,1
1476535372905598976,0,1,0,0,1
1280807291130974208,0,1,0,0,1
1280058876260306944,0,1,0,0,1
1476968421602598912,0,1,0,0,1
1319391380695756800,0,1,0,0,1
1319538545510518784,0,1,0,0,1
1279877667630665728,0,1,0,0,1
1279841495743332352,0,1,0,0,1
1279805253446037504,1,0,0,0,1
1319581140341043200,0,1,0,0,1
1279628479508541440,0,1,0,0,1
1477003378748051456,0,1,0,0,1
1477172441688379392,0,0,0,1,1
1279475325928214528,1,0,0,0,1
1279420985637171200,1,0,0,0,1
1279373588030803968,0,1,0,0,1
1477192571893911552,0,1,0,0,1
1279347548243652608,0,1,0,0,1
1279338164029661184,0,1,0,0,1
1320781853679255552,0,1,0,0,1
1320789508443443200,1,0,0,0,1
1277403815507922944,0,1,0,0,1
1456587132630351872,0,1,0,0,1
1456547514275213312,0,1,0,0,1
1274456718785892352,0,1,0,0,1
1274468685286178816,1,0,0,0,1
1478192406352699392,0,1,0,0,1
1274546056584298496,0,1,0,0,1
1478181074417045504,0,1,0,0,1
1478076831538593792,0,1,0,0,1
1456660298367078400,0,1,0,0,1
1321791301629566976,0,1,0,0,1
1477948420123987968,0,1,0,0,1
1274952062330179584,0,1,0,0,1
1477904414253862912,0,1,0,0,1
1274980393767190528,0,1,0,0,1
1275060624586731520,0,1,0,0,1
1321836028118798336,0,1,0,0,1
1478236934103347200,1,0,0,0,1
1321920849474179072,0,1,0,0,1
1274400113310515200,0,0,0,1,1
1321968528581398528,0,1,0,0,1
1274385134435917824,0,1,0,0,1
1478299883962388480,1,0,0,0,1
1322048650726572032,0,1,0,0,1
1456537479251742720,0,1,0,0,1
1274285031880486912,1,0,0,0,1
1478417240785629184,0,0,0,1,1
1274096514051252224,1,0,0,0,1
1274057188462428160,0,1,0,0,1
1274024159039930368,0,1,0,0,1
1322065714375774208,0,1,0,0,1
1478430946034606080,0,1,0,0,1
1478460853519142912,1,0,0,0,1
1275076783545573376,1,0,0,0,1
1275146789813977088,0,1,0,0,1
1320807145210892288,0,1,0,0,1
1276582257579319296,0,1,0,0,1
1321318392402378752,1,0,0,0,1
1275900024816189440,0,1,0,0,1
1276150539785469952,0,1,0,0,1
1276190686648446976,0,1,0,0,1
1457142426305449984,0,1,0,0,1
1477575659090178048,0,1,0,0,1
1276804935657467904,0,1,0,0,1
1321774301499084800,1,0,0,0,1
1321115423534927872,0,1,0,0,1
1321060470690926592,0,0,0,1,1
1477524054458306560,0,1,0,0,1
1321023981806379008,1,0,0,0,1
1277248432332300288,0,1,0,0,1
1320980306384465920,1,0,0,0,1
1321393881011945472,0,1,0,0,1
1275817733288914944,0,1,0,0,1
1477726605657128960,0,1,0,0,1
1275589243042136064,0,1,0,0,1
1477733127120322560,0,1,0,0,1
1321417208547938304,0,1,0,0,1
1275425344401571840,0,1,0,0,1
1275424353740611584,0,0,0,1,1
1275395285078822912,1,0,0,0,1
1275320195935076352,0,1,0,0,1
1477857483611938816,0,1,0,0,1
1321629717276041216,0,1,0,0,1
1477891010264854528,1,0,0,0,1
1456996789161275392,0,1,0,0,1
1456896465452748800,0,1,0,0,1
1321759564061028352,0,1,0,0,1
1477898468349861888,0,1,0,0,1
1267499784283148288,1,0,0,0,1
1480307953303490560,0,1,0,0,1
1267490610161881088,0,1,0,0,1
1259787942651809792,0,1,0,0,1
1482789173115326464,0,1,0,0,1
1329327146125430784,0,1,0,0,1
1259756858346221568,0,1,0,0,1
1259764247296274432,0,1,0,0,1
1482743972753981440,0,1,0,0,1
1329176308098756608,0,1,0,0,1
1482704333946957824,1,0,0,0,1
1453367029243645952,1,0,0,0,1
1259792427960995840,0,1,0,0,1
1259810300305571840,0,1,0,0,1
1329110482830061568,0,1,0,0,1
1482641098669535232,1,0,0,0,1
1260029275618467840,0,1,0,0,1
1260063131612508160,0,1,0,0,1
1259449986938437632,0,1,0,0,1
1329381976961286144,1,0,0,0,1
1262244369882628096,0,1,0,0,1
1483001904062156800,0,1,0,0,1
1483020216217055232,0,1,0,0,1
1258664772054073344,0,1,0,0,1
1258669439140192256,0,1,0,0,1
1453190347304079360,0,1,0,0,1
1258775756567609344,0,1,0,0,1
1483011411181977600,1,0,0,0,1
1258992792493264896,0,1,0,0,1
1259391507926220800,0,1,0,0,1
1259000703781146624,1,0,0,0,1
1453277105928744960,0,1,0,0,1
1482796945710194688,0,1,0,0,1
1259133202511396864,0,1,0,0,1
1329479028185595904,0,1,0,0,1
1453362466692419584,1,0,0,0,1
1482637470831423488,1,0,0,0,1
1260087929323601920,0,1,0,0,1
1482630611068194816,0,1,0,0,1
1453992168876650496,0,1,0,0,1
1328595771764170752,1,0,0,0,1
1261355445282672640,0,1,0,0,1
1453809573735903232,0,1,0,0,1
1328334983275053056,0,1,0,0,1
1328315231093870592,0,1,0,0,1
1328288666188349440,1,0,0,0,1
1261601020540522496,0,1,0,0,1
1260132559314395136,0,1,0,0,1
1261952835068891136,0,1,0,0,1
1454059875831533568,1,0,0,0,1
1328216128749879296,0,1,0,0,1
1261990661420548096,1,0,0,0,1
1482412496229216256,0,1,0,0,1
1262169438628933632,0,1,0,0,1
1482428822389948416,0,0,0,1,1
1482443225495478272,0,1,0,0,1
1328679308634669056,0,1,0,0,1
1482574777063976960,0,1,0,0,1
1482585627551952896,0,1,0,0,1
1261134337551949824,0,1,0,0,1
1261005509479391232,0,1,0,0,1
1328709530872651776,0,1,0,0,1
1453809267786465280,1,0,0,0,1
1328937694924328960,0,1,0,0,1
1260893964045082624,0,1,0,0,1
1260417513709604864,0,1,0,0,1
1328976764899524608,1,0,0,0,1
1260228945615740928,0,0,0,1,1
1260210162284945408,0,1,0,0,1
1482630147962556416,0,1,0,0,1
1260151305215098880,0,1,0,0,1
1329633646332973056,0,1,0,0,1
1329841526944370688,0,1,0,0,1
1258644638048501760,0,1,0,0,1
1483396972266799104,0,1,0,0,1
1483482059071193088,0,1,0,0,1
1483429512759382016,1,0,0,0,1
1330775677373620224,0,1,0,0,1
1256079903847399424,0,1,0,0,1
1256163895087161344,0,1,0,0,1
1256625344938942464,0,1,0,0,1
1330666263933235200,0,1,0,0,1
1483343531985215488,1,0,0,0,1
1452637430465458176,0,1,0,0,1
1257002909457362944,0,1,0,0,1
1483345692517351424,0,1,0,0,1
1257160421762465792,0,1,0,0,1
1257207860758372352,0,1,0,0,1
1257244752904249344,0,1,0,0,1
1255976327062016000,0,1,0,0,1
1483570661016715264,0,1,0,0,1
1452425736569110528,0,1,0,0,1
1255555588685103104,0,1,0,0,1
1255179816195821568,0,1,0,0,1
1255084569939845120,0,1,0,0,1
1255052849274212352,0,1,0,0,1
1483734665634922496,0,1,0,0,1
1330884302024757248,1,0,0,0,1
1254975146831593472,0,1,0,0,1
1254478531675000832,0,1,0,0,1
1254454333845929984,0,1,0,0,1
1483736876377055232,1,0,0,0,1
1254366076055564288,0,1,0,0,1
1254302922130591744,1,0,0,0,1
1452354848876204032,0,0,0,1,1
1330894219863617536,0,1,0,0,1
1257287465448075264,0,1,0,0,1
1257528487012732928,0,1,0,0,1
1329969839297982464,0,0,0,1,1
1258406689465872384,0,1,0,0,1
1453155411620765696,0,1,0,0,1
1258094811535548416,0,1,0,0,1
1453157503127093248,0,1,0,0,1
1330223066346115072,0,1,0,0,1
1258187483008950272,0,1,0,0,1
1258387505126109184,0,1,0,0,1
1453188359052955648,1,0,0,0,1
1257623546047725568,0,1,0,0,1
1258435391637553152,0,1,0,0,1
1258479722066931712,0,1,0,0,1
1258482705047707648,0,1,0,0,1
1483125157040435200,0,0,0,1,1
1258587873147748352,0,1,0,0,1
1258627536763752448,0,1,0,0,1
1330362234011230208,0,1,0,0,1
1453031734908391424,0,1,0,0,1
1330436304258166784,0,1,0,0,1
1258048349040783360,0,1,0,0,1
1258020514297151488,0,1,0,0,1
1258020369526652928,0,0,0,1,1
1483127203848417280,1,0,0,0,1
1258015693049602048,0,1,0,0,1
1257977631829417984,0,1,0,0,1
1257923105290285056,0,1,0,0,1
1483203285351731200,1,0,0,0,1
1452917884196425728,0,1,0,0,1
1483299204542111744,0,1,0,0,1
1452882803096363008,0,1,0,0,1
1257816516181086208,0,1,0,0,1
1452709519973289984,1,0,0,0,1
1483341337055408128,0,1,0,0,1
1482393535433547776,0,1,0,0,1
1262272712979951616,0,1,0,0,1
1267469203096756224,0,1,0,0,1
1326084052764545024,1,0,0,0,1
1265406318493544448,0,1,0,0,1
1265458451943092224,0,1,0,0,1
1481287264961454080,1,0,0,0,1
1265550952372862976,1,0,0,0,1
1326126142668103680,1,0,0,0,1
1455010389691822080,0,1,0,0,1
1481171248558518272,1,0,0,0,1
1326357966757404672,0,1,0,0,1
1265627530414956544,0,1,0,0,1
1265634016293601280,0,1,0,0,1
1265695205719601152,1,0,0,0,1
1265944098504159232,1,0,0,0,1
1455252375413813248,1,0,0,0,1
1455254034550566912,1,0,0,0,1
1326235595018956800,0,1,0,0,1
1265209909391523840,0,1,0,0,1
1262309591691538432,0,1,0,0,1
1264842424393715712,0,1,0,0,1
1481431746369716224,1,0,0,0,1
1454845197565661184,0,1,0,0,1
1454913033843662848,0,1,0,0,1
1481352759941156864,0,1,0,0,1
1264679008953790464,0,1,0,0,1
1264808417866244096,0,1,0,0,1
1481348102170705920,1,0,0,0,1
1265197255956426752,0,1,0,0,1
1264873740955004928,0,1,0,0,1
1264895157364719616,1,0,0,0,1
1264899045606281216,1,0,0,0,1
1481312945032560640,0,1,0,0,1
1481306206803316736,0,1,0,0,1
1265165462041575424,0,1,0,0,1
1265986652272549888,0,1,0,0,1
1266078117367595008,1,0,0,0,1
1481137251061010432,0,0,1,0,1
1480403731787116544,1,0,0,0,1
1325478090831761408,0,0,1,0,1
1267005409090392064,0,1,0,0,1
1267008314103209984,0,1,0,0,1
1267068137922584576,0,1,0,0,1
1267084148390326272,1,0,0,0,1
1325398873452515328,0,1,0,0,1
1267316450508800000,0,1,0,0,1
1481129704166141952,1,0,0,0,1
1455570822156853248,0,1,0,0,1
1480351177011126272,1,0,0,0,1
1325343168888369152,0,1,0,0,1
1267359381542375424,1,0,0,0,1
1267433789271269376,0,1,0,0,1
1267463579114123264,0,1,0,0,1
1266998257496006656,0,1,0,0,1
1455467465178116096,0,1,0,0,1
1480457310594121728,0,1,0,0,1
1480665553484369920,0,1,0,0,1
1266937261830135808,0,1,0,0,1
1266854904838176768,0,1,0,0,1
1266841736191660032,0,1,0,0,1
1325610680280440832,1,0,0,0,1
1266795198933164032,1,0,0,0,1
1325656098649612288,0,1,0,0,1
1266653843279970304,0,1,0,0,1
1325782206749437952,0,1,0,0,1
1266602600641642496,0,1,0,0,1
1266563237132156928,0,1,0,0,1
1480878134945742848,1,0,0,0,1
1266431598078996480,1,0,0,0,1
1325898365830385664,0,1,0,0,1
1481458499431325696,0,1,0,0,1
1481487747886227456,0,1,0,0,1
1264638718092218368,0,1,0,0,1
1454308406098071552,0,1,0,0,1
1263109750155350016,1,0,0,0,1
1327766177423114240,0,1,0,0,1
1327637531526131712,0,1,0,0,1
1327576785408696320,0,1,0,0,1
1454274746778939392,0,1,0,0,1
1263233161179197440,0,1,0,0,1
1327516705116008448,0,1,0,0,1
1454309261765455872,0,1,0,0,1
1482115924425596928,0,1,0,0,1
1263293973713629184,0,1,0,0,1
1327411605202677760,0,1,0,0,1
1482098685437747200,0,1,0,0,1
1263359532853583872,0,1,0,0,1
1482049464743473152,0,1,0,0,1
1263074119207325696,0,1,0,0,1
1482289373299326976,1,0,0,0,1
1263066576070144000,0,1,0,0,1
1482305349952622592,0,1,0,0,1
1482322648415842304,1,0,0,0,1
1482389243343568896,0,1,0,0,1
1482391776631885824,1,0,0,0,1
1262987183570518016,0,1,0,0,1
1262803793005228032,0,1,0,0,1
1262743887807836160,0,1,0,0,1
1262636536144760832,0,1,0,0,1
1262631396914483200,0,1,0,0,1
1327985090757091328,0,1,0,0,1
1328065920909127680,0,1,0,0,1
1262403336046702592,1,0,0,0,1
1262334454837719040,0,1,0,0,1
1454221219537068032,0,1,0,0,1
1482040001948958720,0,1,0,0,1
1263477802164031488,0,1,0,0,1
1264527884435066880,0,1,0,0,1
1326595627703218176,0,1,0,0,1
1264203516513419264,0,1,0,0,1
1264273653673283584,1,0,0,0,1
1326827767955066880,0,1,0,0,1
1481593991040753664,0,1,0,0,1
1326818324659908608,0,1,0,0,1
1326668262298574848,0,1,0,0,1
1481589127464247296,0,1,0,0,1
1263605163824201728,0,1,0,0,1
1481565195260489728,0,1,0,0,1
1326581445209583616,1,0,0,0,1
1454811446202839040,0,1,0,0,1
1264440684565590016,0,1,0,0,1
1264523155177115648,0,1,0,0,1
1454816652495888384,0,1,0,0,1
1264185796682104832,0,1,0,0,1
1454620945461678080,0,1,0,0,1
1264091563258523648,0,1,0,0,1
1264075396590571520,0,1,0,0,1
1263997126448689152,0,1,0,0,1
1326892694858297344,1,0,0,0,1
1263941778870120448,0,1,0,0,1
1481802894512992256,0,1,0,0,1
1326942591741390848,0,1,0,0,1
1481892760089247744,1,0,0,0,1
1326955497090547712,1,0,0,0,1
1263889865634131968,0,1,0,0,1
1454413672156176384,0,1,0,0,1
1327168253282709504,0,1,0,0,1
1263778616263036928,0,1,0,0,1
1263762571036725248,0,1,0,0,1
1263747936644739072,0,1,0,0,1
1280826529900113920,0,1,0,0,1
1476522450389192704,0,1,0,0,1
1182552721473196032,0,1,0,0,1
1468214572469432320,0,1,0,0,1
1468543698359226368,0,1,0,0,1
1461714827395551232,1,0,0,0,1
1311159682384396288,0,1,0,0,1
1298590668760252416,0,1,0,0,1
1298591053130485760,0,1,0,0,1
1468277304371687424,0,1,0,0,1
1298660001959927808,0,1,0,0,1
1298521570143424512,0,1,0,0,1
1461744661098205184,1,0,0,0,1
1298688811010936832,1,0,0,0,1
1298702880363425792,0,1,0,0,1
1298815526613839872,0,1,0,0,1
1468153312801222656,1,0,0,0,1
1461770378825633792,0,1,0,0,1
1461690390881341440,1,0,0,0,1
1311357436930990080,0,1,0,0,1
1297843840217276416,0,1,0,0,1
1298158587429244928,0,1,0,0,1
1461397896411041792,1,0,0,0,1
1297928450951413760,0,1,0,0,1
1297941178713640960,0,1,0,0,1
1311522822477365248,0,0,0,1,1
1298018699870232576,0,1,0,0,1
1298043420783415296,0,1,0,0,1
1461407559416352768,0,1,0,0,1
1468565660879839232,0,1,0,0,1
1298194601530912768,0,1,0,0,1
1311441603324715008,0,1,0,0,1
1298311463782608896,0,1,0,0,1
1468603269199331328,0,0,0,1,1
1298462528117207040,0,1,0,0,1
1298496081848745984,0,1,0,0,1
1310964371124817920,0,1,0,0,1
1299169046831804416,1,0,0,0,1
1468075811345371136,1,0,0,0,1
1310478385223786496,0,1,0,0,1
1461864458637037568,0,1,0,0,1
1299986496829689856,1,0,0,0,1
1467754089702301696,0,1,0,0,1
1300020521971732480,0,1,0,0,1
1300056462769754112,0,0,0,1,1
1300065587918323712,1,0,0,0,1
1310471911990652928,0,1,0,0,1
1461792989001388032,1,0,0,0,1
1300150753865027584,0,1,0,0,1
1300165727186554880,0,1,0,0,1
1300247557734424576,0,1,0,0,1
1300280658619588608,0,1,0,0,1
1300333748576120832,1,0,0,0,1
1300382977759772672,1,0,0,0,1
1299912712793718784,0,1,0,0,1
1310621057900896256,0,1,0,0,1
1467836565875421184,0,1,0,0,1
1299904288257265664,0,1,0,0,1
1299877337148936192,1,0,0,0,1
1467912517917691904,0,1,0,0,1
1299794101714464768,0,1,0,0,1
1299681993366540288,0,1,0,0,1
1310639089729724416,0,1,0,0,1
1299671548001808384,0,1,0,0,1
1299598339692847104,0,1,0,0,1
1461810055871934464,1,0,0,0,1
1467931536062222336,0,1,0,0,1
1468055130603806720,0,1,0,0,1
1299366846177574912,0,0,1,0,1
1299337516139520000,0,1,0,0,1
1310922039923036160,0,1,0,0,1
1461394621209014272,0,1,0,0,1
1311913126917476352,0,1,0,0,1
1319232784368451584,0,1,0,0,1
1312429364009742336,0,1,0,0,1
1460432638066393088,0,0,0,1,1
1296229028853174272,0,1,0,0,1
1296302241771597824,0,1,0,0,1
1296331150370037760,0,1,0,0,1
1460517697167499264,1,0,0,0,1
1296439506246217728,1,0,0,0,1
1469380870213709824,1,0,0,0,1
1469483213575921664,0,1,0,0,1
1296524761095340032,0,1,0,0,1
1296600587039997952,1,0,0,0,1
1296642133584158720,0,1,0,0,1
1296697525575938048,0,1,0,0,1
1296742882737520640,0,1,0,0,1
1013659114210189312,0,1,0,0,1
1460331644481646592,0,1,0,0,1
1296092496175325184,0,1,0,0,1
1297829358661378048,0,1,0,0,1
1312755274424352768,0,1,0,0,1
1295658060870905856,1,0,0,0,1
1313058262745571328,0,1,0,0,1
1313031570056515584,0,1,0,0,1
1295722698132332544,0,1,0,0,1
1312780883301146624,0,1,0,0,1
1295800820617711616,0,1,0,0,1
1295903273057099776,1,0,0,0,1
1312485365001801728,1,0,0,0,1
1469689949532344320,1,0,0,0,1
1312734118220791808,0,1,0,0,1
1312705170900348928,0,1,0,0,1
1295971835784204288,0,1,0,0,1
1469612890390945792,0,1,0,0,1
1296068293212557312,0,1,0,0,1
1296776858042851328,0,1,0,0,1
1469355783666253824,0,1,0,0,1
1469224640518234112,0,1,0,0,1
1468738831834775552,0,1,0,0,1
1468827083073900544,0,1,0,0,1
1461060599404797952,1,0,0,0,1
1461088811417546752,0,1,0,0,1
1297471631565000704,0,1,0,0,1
1468796709598035968,0,1,0,0,1
1312167839311122432,1,0,0,0,1
1468678834295816192,0,1,0,0,1
1469130042315886592,0,1,0,0,1
1297505346831884288,0,1,0,0,1
1297545392003792896,1,0,0,0,1
1461145548866654208,0,1,0,0,1
1468656610973302784,0,1,0,0,1
1461252240644063232,0,1,0,0,1
1461313996812808192,0,1,0,0,1
1312262982173253632,1,0,0,0,1
1461033115107921920,0,1,0,0,1
1461008836647555072,1,0,0,0,1
1460872772771479552,0,1,0,0,1
1468857333086404608,0,1,0,0,1
1297346878506295296,1,0,0,0,1
1468894700102815744,1,0,0,0,1
1297245453801553920,0,1,0,0,1
1468897706869510144,0,1,0,0,1
1312350563372163072,0,1,0,0,1
1297190218559356928,0,1,0,0,1
1297169660580753408,0,1,0,0,1
1297166698743832576,0,1,0,0,1
1460783029962645504,0,1,0,0,1
1460661465975721984,0,1,0,0,1
1469126343124082688,0,1,0,0,1
1297089961993424896,0,1,0,0,1
1300391388744282112,0,1,0,0,1
1310355908288032768,0,1,0,0,1
1310178307237801984,0,1,0,0,1
1303983696521949184,0,1,0,0,1
1303810264685522944,0,1,0,0,1
1464626184290025472,0,0,0,1,1
1464605471919296512,0,1,0,0,1
1303923097716875264,0,1,0,0,1
1307989660686114816,1,0,0,0,1
1462789248478629888,0,0,0,1,1
1462847844226793472,0,1,0,0,1
1464890829894348800,1,0,0,0,1
1464328681824923648,0,1,0,0,1
1307890408622612480,0,1,0,0,1
1304294296649048064,0,1,0,0,1
1307620743019212800,0,1,0,0,1
1304301575779659776,0,1,0,0,1
1307228364445372416,1,0,0,0,1
1303724179200462848,0,1,0,0,1
1465571873366765568,1,0,0,0,1
1462033065388109824,1,0,0,0,1
1303292419849334784,0,1,0,0,1
1308482576504385536,0,1,0,0,1
1302989836240863232,0,1,0,0,1
1466308969195098112,0,1,0,0,1
1303184426843672576,1,0,0,0,1
1303220848845713408,0,1,0,0,1
1308309847759179776,1,0,0,0,1
1466237719844065280,1,0,0,0,1
1465626032770277376,0,0,0,1,1
1462742815016767488,0,1,0,0,1
1308297231775207424,0,1,0,0,1
1466188073209937920,0,1,0,0,1
1303588700413026304,0,1,0,0,1
1308268360518467584,0,1,0,0,1
1303616589611237376,0,1,0,0,1
1464324918959828992,0,1,0,0,1
1464207501721804800,0,1,0,0,1
1463866597605462016,0,1,0,0,1
1306115982113603584,0,1,0,0,1
1305512976439484416,0,1,0,0,1
1305523968137457664,0,1,0,0,1
1306599477596180480,0,1,0,0,1
1305837474615144448,0,1,0,0,1
1305841102377816064,0,1,0,0,1
1305929642084151296,1,0,0,0,1
1306118763000090624,0,1,0,0,1
1463797726563508224,0,1,0,0,1
1306136164596944896,1,0,0,0,1
1463033413141549056,0,1,0,0,1
1463162159009984512,0,1,0,0,1
1306284342579093504,1,0,0,0,1
1306555960912039936,1,0,0,0,1
1306518534722330624,0,1,0,0,1
1306779940851916800,0,1,0,0,1
1463360075418902528,0,1,0,0,1
1462992606049169408,0,1,0,0,1
1305411204546998272,0,1,0,0,1
1305408550282424320,0,1,0,0,1
1463419072880603136,0,1,0,0,1
1463442148016197632,0,1,0,0,1
1306785765100343296,0,1,0,0,1
1305118959281352704,0,1,0,0,1
1463541900183359488,0,1,0,0,1
1305008289697034240,0,1,0,0,1
1304995588895772672,0,1,0,0,1
1462954387769200640,0,1,0,0,1
1304861136626438144,0,1,0,0,1
1463768447586865152,1,0,0,0,1
1462889054542778368,1,0,0,0,1
1307023371285258240,1,0,0,0,1
1462691574693961728,0,1,0,0,1
1466320291613888512,1,0,0,0,1
1302912399863721984,0,1,0,0,1
1301112499681468416,0,1,0,0,1
1300770090720194560,0,1,0,0,1
1467427278791405568,0,1,0,0,1
1467397078376538112,0,1,0,0,1
1467340971096817664,0,1,0,0,1
1467305623922618368,0,1,0,0,1
1467293903917223936,0,1,0,0,1
1467229515361525760,0,1,0,0,1
1301368012247838720,0,1,0,0,1
1301122760001818624,0,1,0,0,1
1301155229774131200,0,1,0,0,1
1301198161474584576,0,1,0,0,1
1301203140428140544,0,1,0,0,1
1301205313949806592,0,1,0,0,1
1467101201946845184,0,1,0,0,1
1467510084590788608,0,1,0,0,1
1300748430139101184,1,0,0,0,1
1309853039080214528,0,1,0,0,1
1300747336126169088,0,1,0,0,1
1467550861526126592,0,1,0,0,1
1462396798341836800,0,1,0,0,1
1309868057410572288,0,1,0,0,1
1300699134047920128,0,1,0,0,1
1309946194722877440,0,1,0,0,1
1467749929582051328,0,1,0,0,1
1300665890078298112,0,1,0,0,1
1300656100765646848,1,0,0,0,1
1300654721061928960,0,1,0,0,1
1300525080003383296,0,1,0,0,1
1467751544183533568,1,0,0,0,1
1300471411463479296,0,1,0,0,1
1462054730335756288,0,1,0,0,1
1467071552537579520,0,0,0,1,1
1301417828101189632,0,1,0,0,1
1308964080582045696,0,1,0,0,1
1309242073095254016,1,0,0,0,1
1309244191332085760,0,1,0,0,1
1302570158892834816,0,1,0,0,1
1302593819834187776,0,1,0,0,1
1302610802046771200,1,0,0,0,1
1466504627441090560,0,1,0,0,1
1466493711328677888,0,1,0,0,1
1302680731534065664,0,1,0,0,1
1466824740589375488,0,1,0,0,1
1462596594537279488,0,1,0,0,1
1462602627577827328,0,1,0,0,1
1302824663999893504,0,1,0,0,1
1302825325793914880,0,1,0,0,1
1466436475017437184,0,1,0,0,1
1302832031030706176,0,1,0,0,1
1302445261856350208,0,1,0,0,1
1302432010191863808,0,1,0,0,1
1309298969361567744,0,1,0,0,1
1302329559132573696,0,1,0,0,1
1462512662785445888,0,1,0,0,1
1309632991073763328,0,1,0,0,1
1302241325085945856,0,1,0,0,1
1302225711348895744,0,1,0,0,1
1462481019580342272,1,0,0,0,1
1301999575490793472,0,1,0,0,1
1466732825948790784,0,1,0,0,1
1301779568508825600,0,1,0,0,1
1309669511495327744,0,1,0,0,1
1301618459944644608,0,1,0,0,1
1466736987440779264,0,0,0,1,1
1462426665355673600,0,1,0,0,1
1466788412082503680,0,1,0,0,1
1313132193309360128,0,1,0,0,1
1295654297833574400,0,1,0,0,1
1295624372883828736,1,0,0,0,1
1286068362045317120,0,1,0,0,1
1285710390014296064,0,1,0,0,1
1285739904933167104,0,1,0,0,1
1317698271964323840,0,1,0,0,1
1317492322859245568,0,1,0,0,1
1285970330280919040,0,1,0,0,1
1286013321125048320,0,1,0,0,1
1286191224567681024,0,1,0,0,1
1473531956272893952,0,1,0,0,1
1286218453196578816,0,1,0,0,1
1458433128532434944,0,1,0,0,1
1286314063711141888,0,1,0,0,1
1286332486977429504,0,1,0,0,1
1317360123313082368,0,1,0,0,1
1286372260006199296,0,1,0,0,1
1458207679675912192,0,1,0,0,1
1285523337066811392,0,1,0,0,1
1316723650897289216,0,1,0,0,1
1317797308927561728,0,1,0,0,1
1474442655148875776,0,1,0,0,1
1474405780082372608,0,1,0,0,1
1474346099972337664,0,1,0,0,1
1318034835315724288,1,0,0,0,1
1474276291763322880,1,0,0,0,1
1285184499840618496,0,1,0,0,1
1474158689137225728,0,1,0,0,1
1473691381721976832,1,0,0,0,1
1285460749674934272,0,1,0,0,1
1285466535570452480,0,1,0,0,1
1285499493249671168,0,1,0,0,1
1474102147193393152,0,0,1,0,1
1473893033204596736,0,1,0,0,1
1473764056393674752,0,0,0,1,1
1317350385133228032,0,1,0,0,1
1317223558083416064,0,1,0,0,1
1473462702656098304,1,0,0,0,1
1317003508651118592,0,1,0,0,1
1287105591186464768,0,1,0,0,1
1287118605625171968,1,0,0,0,1
1458510036628553728,0,1,0,0,1
1458511931996790784,0,1,0,0,1
1317025689120444416,0,1,0,0,1
1472697071970963456,0,1,0,0,1
1287256311495884800,1,0,0,0,1
1286566788029800448,1,0,0,0,1
1316928605906071552,0,1,0,0,1
1472530353025867776,0,1,0,0,1
1316843214184370176,0,1,0,0,1
1316809278574002176,1,0,0,0,1
1316726201034182656,0,1,0,0,1
1287685619964157952,0,1,0,0,1
1472752527628070912,0,1,0,0,1
1472762289820364800,0,1,0,0,1
1472843843670212608,0,1,0,0,1
1472894196742856704,0,0,0,1,1
1472972586619396096,0,1,0,0,1
1317118629410897920,0,1,0,0,1
1473209991553331200,0,1,0,0,1
1317126904051367936,0,1,0,0,1
1473413379566051328,0,1,0,0,1
1317134144330137600,0,1,0,0,1
1458469788141989888,0,1,0,0,1
1286962180324306944,0,1,0,0,1
1286907267795660800,0,1,0,0,1
1286789195089010688,0,1,0,0,1
1286767547270852608,0,1,0,0,1
1286603442832777216,0,1,0,0,1
1286582058731466752,0,1,0,0,1
1458170673277259776,0,1,0,0,1
1285068185323151360,0,1,0,0,1
1474763081792180224,0,1,0,0,1
1318812647501029376,0,1,0,0,1
1281971657188372480,0,0,0,1,1
1281974710880935936,0,1,0,0,1
1318912804728926208,0,1,0,0,1
1318901283248459776,0,1,0,0,1
1282048591016734720,0,1,0,0,1
1282198607878172672,0,1,0,0,1
1282302182667108352,0,1,0,0,1
1282973375837532160,0,1,0,0,1
1282319340591710208,0,1,0,0,1
1282369892176388096,0,1,0,0,1
1458093484481683456,0,1,0,0,1
1282544336538746880,0,1,0,0,1
1282685618590384128,0,1,0,0,1
1318734557504438272,1,0,0,0,1
1281932301451046912,0,1,0,0,1
1458046286519697408,0,1,0,0,1
1318926165176852480,0,1,0,0,1
1281757523062611968,0,1,0,0,1
1457986183540006912,0,1,0,0,1
1281707766432890880,0,1,0,0,1
1281639692090454016,0,1,0,0,1
1457937527420108800,0,1,0,0,1
1319177422126788608,0,1,0,0,1
1281459250221518848,0,1,0,0,1
1281372953557508096,0,1,0,0,1
1475872925467267072,0,1,0,0,1
1319201360949239808,0,1,0,0,1
1281143757346426880,0,1,0,0,1
1281133149230116864,0,0,0,1,1
1475982552481472512,0,1,0,0,1
1476402945889488896,0,1,0,0,1
1282743677408796672,1,0,0,0,1
1318566502807740416,0,1,0,0,1
1318249806196768768,0,1,0,0,1
1474985432182046720,0,1,0,0,1
1283605508633444352,0,1,0,0,1
1283708092195037184,0,1,0,0,1
1458145312594227200,0,1,0,0,1
1284190862856138752,0,1,0,0,1
1284197430507053056,0,0,0,1,1
1475082887519109120,0,1,0,0,1
1284298990368911360,0,1,0,0,1
1283101519248863232,0,1,0,0,1
1284356205322829824,1,0,0,0,1
1284401966114910208,0,1,0,0,1
1318356221984792576,0,1,0,0,1
1318317589903396864,1,0,0,0,1
1284659123313799168,0,1,0,0,1
1474788386862866432,0,1,0,0,1
1475313813515689984,1,0,0,0,1
1318421598613999616,1,0,0,0,1
1283506449809903616,0,1,0,0,1
1283488611615285248,0,1,0,0,1
1318473219205115904,0,0,1,0,1
1283411204761776128,0,1,0,0,1
1318478863152930816,0,1,0,0,1
1318519451134889984,1,0,0,0,1
1283229323625816064,0,1,0,0,1
1475320193345736704,0,1,0,0,1
1475355617573281792,0,1,0,0,1
1475549833779990528,0,1,0,0,1
1283207144599240704,0,1,0,0,1
1283171787803688960,1,0,0,0,1
1475579237130289152,0,1,0,0,1
1475639090829742080,0,1,0,0,1
1318566415834689536,0,1,0,0,1
1472478428913823744,0,1,0,0,1
1316654933190479872,0,1,0,0,1
1313147611596034048,0,1,0,0,1
1314822453382840320,0,1,0,0,1
1470982475052511232,0,1,0,0,1
1459452802636333056,0,1,0,0,1
1292702690523230208,0,1,0,0,1
1459496693116796928,0,1,0,0,1
1293025098639667200,0,1,0,0,1
1293304672019718144,0,1,0,0,1
1314745061427482624,0,1,0,0,1
1471018966101471232,1,0,0,0,1
1314643527150628864,1,0,0,0,1
1293430193860644864,0,1,0,0,1
1314609785799618560,1,0,0,0,1
1293466603590311936,1,0,0,0,1
1293613491811540992,1,0,0,0,1
1293693312847749120,1,0,0,0,1
1292669737898356736,0,1,0,0,1
1292499121417461760,0,1,0,0,1
1472471363042508800,1,0,0,0,1
1291647782495965184,0,1,0,0,1
1471400086177341440,0,1,0,0,1
1459385581847207936,0,1,0,0,1
1291549110806355968,0,1,0,0,1
1471354089615151104,0,1,0,0,1
1471092873026232320,0,1,0,0,1
1291644034319093760,1,0,0,0,1
1291739082704318464,0,1,0,0,1
1471081347103875072,0,1,0,0,1
1291763274854174720,0,1,0,0,1
1314949932537831424,0,1,0,0,1
1314936531803541504,0,1,0,0,1
1292312628665225216,0,1,0,0,1
1292355176125198336,0,1,0,0,1
1471089349613604864,0,1,0,0,1
1293809146027036672,0,0,1,0,1
1293815077645307904,0,1,0,0,1
1314424618002726912,1,0,0,0,1
1459939145112072192,0,1,0,0,1
1294793359341441024,0,1,0,0,1
1459646676843569152,0,1,0,0,1
1294982748491440128,1,0,0,0,1
1459724477894299648,0,1,0,0,1
1295097590816444416,0,1,0,0,1
1470355804872007680,0,1,0,0,1
1295199909532950528,0,1,0,0,1
1293956625867386880,0,1,0,0,1
1295255342020870144,0,1,0,0,1
1459953425467133952,0,1,0,0,1
1295295751954870272,1,0,0,0,1
1295375692507619328,0,1,0,0,1
1295384716670054400,0,1,0,0,1
1313171628000378880,0,1,0,0,1
1294745777407791104,0,1,0,0,1
1294634600115961856,0,1,0,0,1
1294634126755020800,0,1,0,0,1
1294563516620238848,0,1,0,0,1
1459629474945847296,0,1,0,0,1
1294450045803102208,0,1,0,0,1
1294387684287356928,0,1,0,0,1
1313790845372555264,0,1,0,0,1
1294297039434522624,0,1,0,0,1
1313895140390436864,0,1,0,0,1
1314104641852977152,1,0,0,0,1
1294293820960657408,0,1,0,0,1
1294277954797580288,0,1,0,0,1
1470594027947020288,0,1,0,0,1
1314163906865254400,0,1,0,0,1
1294119392700178432,0,1,0,0,1
1294031824486883328,0,1,0,0,1
1315371512925487104,0,1,0,0,1
1291380889209860096,0,1,0,0,1
1291365364434186240,0,1,0,0,1
1288749104764526592,0,1,0,0,1
1472067092358696960,0,1,0,0,1
1288556192185319424,1,0,0,0,1
1316277231883186176,0,1,0,0,1
1288744652984561664,0,1,0,0,1
1316241911976353792,0,0,0,1,1
1316109905892261888,0,1,0,0,1
1288776122390339584,1,0,0,0,1
1289118431413821440,0,0,1,0,1
1472055149245857792,0,1,0,0,1
1288858424273334272,1,0,0,0,1
1316076532507373568,0,1,0,0,1
1458843974328721408,0,1,0,0,1
1316001729360453632,0,1,0,0,1
1458863308354719744,0,1,0,0,1
1472200549822914560,0,1,0,0,1
1316302390128123904,0,1,0,0,1
1288549064674549760,0,1,0,0,1
1472203359813877760,0,1,0,0,1
1316475212393852928,0,1,0,0,1
1458769728227315712,1,0,0,0,1
1288395977024389120,0,1,0,0,1
1472441895582371840,0,1,0,0,1
1288343548446703616,0,1,0,0,1
1472446535501815808,0,1,0,0,1
1288172931869102080,0,1,0,0,1
1316532688678006784,0,0,0,1,1
1288080594425937920,0,1,0,0,1
1288067867393458176,0,1,0,0,1
1288005665869291520,0,1,0,0,1
1287734120857112576,0,1,0,0,1
1287731218893746176,1,0,0,0,1
1289032101585727488,0,1,0,0,1
1315949787032612864,0,1,0,0,1
1291302785292492800,0,1,0,0,1
1290643849853800448,1,0,0,0,1
1290075845449703424,0,1,0,0,1
1471409868456161280,0,0,0,1,1
1290181507097583616,0,1,0,0,1
1290331505634377728,0,0,0,1,1
1315547193206476800,0,1,0,0,1
1290594651389308928,0,1,0,0,1
1290905771740463104,0,1,0,0,1
1289176130465992704,0,1,0,0,1
1290907398224240640,0,1,0,0,1
1290942049189900288,0,1,0,0,1
1290987847131058176,0,1,0,0,1
1315382330878353408,0,1,0,0,1
1291215218815598592,1,0,0,0,1
1291274969515687936,0,1,0,0,1
1315584816562139136,1,0,0,0,1
1289961139816681472,0,1,0,0,1
1289953770403704832,0,1,0,0,1
1471431368316002304,0,0,0,1,1
1289628941318123520,0,1,0,0,1
1471565705430458368,0,1,0,0,1
1459102016874049536,0,1,0,0,1
1471789037711208448,0,1,0,0,1
1315883573371531264,0,1,0,0,1
1315884583108272128,0,1,0,0,1
1315909662353494016,0,1,0,0,1
1471802322678272000,0,1,0,0,1
1289505538783543296,0,1,0,0,1
1471949596070924288,0,1,0,0,1
1289444860202647552,0,1,0,0,1
1459096347047432192,0,1,0,0,1
1459029050304118784,1,0,0,0,1
1254282152893542400,1,0,0,0,1
1483759184701280256,0,1,0,0,1
1331013775370059776,0,1,0,0,1
1212283236539195392,0,1,0,0,1
1212108866827112448,0,1,0,0,1
1212141478434103296,0,1,0,0,1
1212158285412880384,0,1,0,0,1
1491739018190594048,0,1,0,0,1
1348280064606052352,0,1,0,0,1
1348250465742385152,0,1,0,0,1
1212283984064892928,1,0,0,0,1
1212081866414538752,0,1,0,0,1
1212286444871380992,1,0,0,0,1
1212292647659814912,0,1,0,0,1
1212337269173977088,0,1,0,0,1
1212459929455362048,0,1,0,0,1
1348198591077240832,1,0,0,0,1
1212825977329315840,0,1,0,0,1
1491753371849695232,1,0,0,0,1
1212073015019573248,0,1,0,0,1
1211008318413475840,0,1,0,0,1
1211745958452576256,0,1,0,0,1
1211098289375858688,0,1,0,0,1
1211332460933287936,0,1,0,0,1
1211419183163924480,0,1,0,0,1
1211588404082692096,0,1,0,0,1
1491829322071830528,0,1,0,0,1
1211634868594991104,0,1,0,0,1
1211841050370641920,0,1,0,0,1
1348347879568535552,0,1,0,0,1
1348564603635077120,0,1,0,0,1
1211949237316964352,0,1,0,0,1
1491761492194390016,1,0,0,0,1
1491753850377703424,0,1,0,0,1
1211977257520001024,0,1,0,0,1
1348354909129691136,0,1,0,0,1
1348147297515933696,0,1,0,0,1
1212973076826050560,1,0,0,0,1
1348076177534156800,0,1,0,0,1
1213692808906674176,0,1,0,0,1
1213616247205548032,0,1,0,0,1
1213657747264176128,0,1,0,0,1
1491609350858698752,1,0,0,0,1
1491604361180434432,1,0,0,0,1
1491573371045171200,0,1,0,0,1
1444624819480268800,0,1,0,0,1
1347530915749257216,0,1,0,0,1
1348064870474903552,0,1,0,0,1
1491512063700742144,0,1,0,0,1
1213737714916265984,0,1,0,0,1
1491493365191426048,1,0,0,0,1
1491476930046009344,0,1,0,0,1
1213883578200625152,0,1,0,0,1
1213900091959861248,1,0,0,0,1
1213458451042463744,0,1,0,0,1
1491645716451983360,0,1,0,0,1
1213439616369344512,0,1,0,0,1
1491659664370638848,0,1,0,0,1
1213435741214167040,0,1,0,0,1
1347704691761704960,0,1,0,0,1
1213311863313715200,0,1,0,0,1
1444613882077667328,0,1,0,0,1
1213161350270111744,0,1,0,0,1
1213158492791459840,1,0,0,0,1
1444607693453365248,0,1,0,0,1
1213133427207069696,0,1,0,0,1
1347921496866516992,1,0,0,0,1
1213127721275969536,0,1,0,0,1
1347942802504568832,0,1,0,0,1
1213047555652648960,0,1,0,0,1
1491735066434805760,0,1,0,0,1
1444479519977578496,0,1,0,0,1
1210924243195551744,0,1,0,0,1
1331144263657287680,0,1,0,0,1
1206669365820526592,0,1,0,0,1
1206529836472131584,0,1,0,0,1
1492337293624942592,0,1,0,0,1
1206597575236677632,0,1,0,0,1
1206631682180341760,0,1,0,0,1
1492331101603258368,0,1,0,0,1
1349500369706119168,1,0,0,0,1
1349428656909651968,0,1,0,0,1
1443776059581685760,0,1,0,0,1
1206823604752506880,0,1,0,0,1
1492294735070912512,0,1,0,0,1
1206986236138622976,0,1,0,0,1
1206986499104727040,0,1,0,0,1
1492269875158568960,0,1,0,0,1
1207023852691345408,0,1,0,0,1
1206354729451868160,0,1,0,0,1
1443475654297587712,0,1,0,0,1
1444220576927731712,0,1,0,0,1
1443208867370782720,1,0,0,0,1
1205027417577799680,0,1,0,0,1
1205180283718234112,0,1,0,0,1
1492422492253609984,0,1,0,0,1
1205218988344655872,0,1,0,0,1
1492421284013408256,0,1,0,0,1
1492404978354434048,0,1,0,0,1
1205419281049096192,0,1,0,0,1
1349551839574953984,0,1,0,0,1
1492397520986652672,1,0,0,0,1
1492396901748162560,1,0,0,0,1
1349601666325241856,0,1,0,0,1
1492368591731425280,1,0,0,0,1
1492363247248461824,0,0,0,1,1
1206118366076796928,0,1,0,0,1
1492167844393795584,0,1,0,0,1
1349393753673400320,1,0,0,0,1
1349325339353378816,0,1,0,0,1
1209761907433000960,0,1,0,0,1
1349173305207619584,1,0,0,0,1
1209465562570489856,0,1,0,0,1
1492003192611221504,0,1,0,0,1
1209513630007513088,0,1,0,0,1
1349131671392673792,0,1,0,0,1
1348851935911280640,1,0,0,0,1
1209837985228705792,0,1,0,0,1
1207686845066289152,0,1,0,0,1
1491962330409693184,0,1,0,0,1
1209961083655598080,0,1,0,0,1
1210626973573120000,0,1,0,0,1
1491894368265211904,0,0,1,0,1
1210724519905812480,0,1,0,0,1
1210908166017310720,0,1,0,0,1
1349187939570487296,0,1,0,0,1
1209212300734763008,0,1,0,0,1
1208942480663699456,0,1,0,0,1
1208830527127670784,0,1,0,0,1
1208783261477982208,0,1,0,0,1
1492027000097492992,0,1,0,0,1
1208723633440321536,0,1,0,0,1
1444154267405856768,0,1,0,0,1
1208302279989678080,0,0,1,0,1
1208299477531951104,0,1,0,0,1
1492067789728849920,0,1,0,0,1
1208037029126135808,0,1,0,0,1
1492074366309638144,0,1,0,0,1
1207702248840744960,0,1,0,0,1
1443795216901685248,0,1,0,0,1
1349321033866641408,0,1,0,0,1
1207688276871540736,0,1,0,0,1
1444707839306469376,0,1,0,0,1
1347510431363989504,0,1,0,0,1
1491445799980392448,1,0,0,0,1
1490723882390589440,1,0,0,0,1
1218779699972755456,1,0,0,0,1
1218879662291636224,0,1,0,0,1
1218927948398460928,0,1,0,0,1
1219181151484628992,0,1,0,0,1
1445212931507961856,1,0,0,0,1
1219222286403887104,0,1,0,0,1
1219417208218144768,1,0,0,0,1
1218635305940467712,0,1,0,0,1
1490708307568480256,1,0,0,0,1
1490650755061231616,1,0,0,0,1
1219483770870362112,0,1,0,0,1
1219487756474372096,1,0,0,0,1
1490640673397424128,0,1,0,0,1
1445360120637149184,0,1,0,0,1
1218750472829440000,0,1,0,0,1
1218541117303554048,0,1,0,0,1
1213901721459519488,0,1,0,0,1
1218300702327476224,0,1,0,0,1
1217772143389421568,0,1,0,0,1
1490938742244208640,1,0,0,0,1
1490912803284262912,0,1,0,0,1
1445119903502118912,0,1,0,0,1
1490892331863932928,0,1,0,0,1
1345346115835723776,0,1,0,0,1
1345319606802640896,0,1,0,0,1
1490780498133766144,0,1,0,0,1
1218314532122243072,0,1,0,0,1
1490812504972627968,0,1,0,0,1
1218350926764724224,0,1,0,0,1
1218446253165568000,0,1,0,0,1
1218457270855634944,0,1,0,0,1
1218465107564474368,0,1,0,0,1
1490596845134909440,0,1,0,0,1
1219596650391449600,0,1,0,0,1
1219801840839036928,0,1,0,0,1
1344383749010710528,0,1,0,0,1
1344519677469368320,0,1,0,0,1
1221127348709396480,0,1,0,0,1
1490229957154516992,0,1,0,0,1
1221246701136007168,0,1,0,0,1
1344445514029400064,1,0,0,0,1
1490207248265752576,0,1,0,0,1
1221557239409856512,0,1,0,0,1
1344878392865390592,0,1,0,0,1
1446021868339793920,0,1,0,0,1
1490203551787741184,0,1,0,0,1
1221723140696334336,0,1,0,0,1
1344245232733327360,0,1,0,0,1
1221777780737638400,1,0,0,0,1
1490163137265692672,1,0,0,0,1
1220874462494691328,1,0,0,0,1
1220775809155137536,0,1,0,0,1
1220619737144553472,0,1,0,0,1
1220283439296983040,0,1,0,0,1
1446000573493379072,1,0,0,0,1
1220277903994175488,0,1,0,0,1
1490305050505322496,0,1,0,0,1
1490310994073108480,0,1,0,0,1
1220211766400970752,0,1,0,0,1
1445662621428957184,0,0,0,1,1
1445659270154911744,0,1,0,0,1
1490475115955601408,1,0,0,0,1
1220038365736665088,0,0,0,1,1
1490523640911257600,1,0,0,0,1
1344726896882438144,0,1,0,0,1
1490572960679481344,1,0,0,0,1
1490586842303176704,0,0,1,0,1
1217762955674169344,0,1,0,0,1
1217486515451895808,1,0,0,0,1
1217473086867591168,0,1,0,0,1
1346400741506822144,0,1,0,0,1
1214799507377938432,0,1,0,0,1
1346717996316651520,0,1,0,0,1
1346683862395531264,0,1,0,0,1
1214911213777440768,0,1,0,0,1
1346542288894365696,0,1,0,0,1
1346457818828664832,1,0,0,0,1
1214946304872157184,0,0,0,1,1
1215196657739976704,0,1,0,0,1
1346391325747212288,0,1,0,0,1
1214954649221918720,0,1,0,0,1
1346377774760529920,0,1,0,0,1
1214958656879378432,0,1,0,0,1
1214987091223793664,0,1,0,0,1
1346148190882394112,0,1,0,0,1
1346759645994446848,0,1,0,0,1
1214746877251354624,1,0,0,0,1
1444964878691835904,0,1,0,0,1
1491254479274262528,0,1,0,0,1
1346923229202558976,0,1,0,0,1
1347080153319362560,1,0,0,0,1
1444961128413466624,0,1,0,0,1
1347121787767812096,0,1,0,0,1
1214515779904905216,0,1,0,0,1
1491284951836545024,1,0,0,0,1
1214311738578878464,0,1,0,0,1
1347164806436933632,0,1,0,0,1
1347207063517097984,1,0,0,0,1
1347213489199149056,0,1,0,0,1
1491404507045154816,0,1,0,0,1
1214155758197035008,0,1,0,0,1
1491433962899603456,0,1,0,0,1
1215194131342848000,1,0,0,0,1
1445007934925250560,0,1,0,0,1
1490940557908189184,0,1,0,0,1
1216584263061012480,0,1,0,0,1
1216304695129493504,0,1,0,0,1
1490947567219535872,0,1,0,0,1
1345759766673547264,0,0,1,0,1
1345655479955935232,0,1,0,0,1
1216326626851610624,0,1,0,0,1
1345607453057183744,0,1,0,0,1
1217059358892265472,0,1,0,0,1
1215280069876146176,0,1,0,0,1
1345404984670654464,0,1,0,0,1
1490942717861318656,0,1,0,0,1
1217369918305234944,1,0,0,0,1
1490942338784534528,0,1,0,0,1
1490941515652292608,0,1,0,0,1
1345371696702713856,0,1,0,0,1
1345980018363572224,0,1,0,0,1
1216280182639775744,0,1,0,0,1
1216232832055382016,0,1,0,0,1
1491002332317945856,0,1,0,0,1
1215714619651710976,0,1,0,0,1
1345982517535379456,0,1,0,0,1
1491049492204113920,0,1,0,0,1
1215679683020410880,0,1,0,0,1
1215676352956858368,0,1,0,0,1
1215538018154663936,0,1,0,0,1
1491158721396883456,0,1,0,0,1
1491217513719513088,0,1,0,0,1
1346011194058891264,0,1,0,0,1
1445066217782267904,0,1,0,0,1
1215512791836176384,0,1,0,0,1
1346073677494939648,1,0,0,0,1
1215322752770379776,0,1,0,0,1
1350155093610520576,0,1,0,0,1
1204624218555478016,0,1,0,0,1
1204547403593871360,0,0,1,0,1
1493878435009073152,0,1,0,0,1
1189089526217502720,0,1,0,0,1
1189474355073314816,1,0,0,0,1
1493892118426779648,0,1,0,0,1
1189530181788229632,1,0,0,0,1
1189584059816562688,0,1,0,0,1
1189755696197312512,1,0,0,0,1
1441660049609265152,0,1,0,0,1
1493901625328824320,1,0,0,0,1
1353674366479958016,0,1,0,0,1
1189853310456487936,0,1,0,0,1
1189984970732949504,0,1,0,0,1
1190138623196303360,0,1,0,0,1
1190183815685132288,0,1,0,0,1
1190221964130078720,1,0,0,0,1
1441637813628198912,0,1,0,0,1
1189010410197770240,0,1,0,0,1
1192899660056186880,0,1,0,0,1
1353704252187815936,1,0,0,0,1
1187925053482008576,0,1,0,0,1
1187970426326016000,0,1,0,0,1
1187983101194059776,0,1,0,0,1
1188005030219124736,0,1,0,0,1
1188042632448139264,0,1,0,0,1
1494047246765244416,0,0,1,0,1
1188489223591972864,0,1,0,0,1
1441427727186219008,0,1,0,0,1
1188501306689937408,0,1,0,0,1
1188703439318065152,1,0,0,0,1
1188711296918867968,0,1,0,0,1
1493941259978739712,0,1,0,0,1
1188777599545294848,0,1,0,0,1
1189006812688855040,0,1,0,0,1
1353609846247972864,0,1,0,0,1
1190354822551232512,0,1,0,0,1
1353389662874656768,0,1,0,0,1
1192484938278428672,0,0,0,1,1
1191904167024939008,0,1,0,0,1
1493564208356728832,0,1,0,0,1
1192347718330408960,0,1,0,0,1
1192356768107515904,0,1,0,0,1
1192419796857450496,0,1,0,0,1
1192460877137612800,0,1,0,0,1
1353019037186363392,0,1,0,0,1
1353374506950135808,1,0,0,0,1
1493556735881388032,0,1,0,0,1
1493551633841758208,1,0,0,0,1
1441921909482868736,0,1,0,0,1
1352987537241849856,0,1,0,0,1
1192865083573051392,0,1,0,0,1
1493540133991292928,0,1,0,0,1
1191801031060905984,0,1,0,0,1
1493625460135137280,1,0,0,0,1
1353319300132708352,0,1,0,0,1
1191616758093758464,0,1,0,0,1
1493650466936606720,0,1,0,0,1
1191285508158185472,0,1,0,0,1
1191269502496804864,1,0,0,0,1
1191125994809118720,0,1,0,0,1
1493690264745123840,0,1,0,0,1
1353364029880889344,0,1,0,0,1
1190902997624197120,0,1,0,0,1
1493697751904776192,0,1,0,0,1
1190795199754252288,0,1,0,0,1
1493723317324619776,0,1,0,0,1
1441870855559024640,0,1,0,0,1
1190565044288921600,0,1,0,0,1
1190380830914465792,1,0,0,0,1
1187378540469198848,0,1,0,0,1
1353754633466949632,0,1,0,0,1
1187315726140477440,0,0,1,0,1
1185019073354178560,0,1,0,0,1
1494575732617621504,1,0,0,0,1
1494564930321793024,0,1,0,0,1
1184888367944736768,0,1,0,0,1
1494546703047086080,0,1,0,0,1
1355165751796064256,0,1,0,0,1
1184903335478026240,0,0,0,1,1
1494454827329327104,0,1,0,0,1
1185503905687445504,0,1,0,0,1
1494450110570319872,0,1,0,0,1
1185180574266335232,0,1,0,0,1
1494401245808844800,0,1,0,0,1
1185192151723978752,0,1,0,0,1
1185224341664890880,0,1,0,0,1
1185281847565127680,0,1,0,0,1
1494580764452667392,0,1,0,0,1
1184388991203905536,0,1,0,0,1
1184239735922774016,0,1,0,0,1
1440839380789198848,0,1,0,0,1
1184147629673988096,0,1,0,0,1
1184045616751529984,0,1,0,0,1
1355456175412801536,0,0,0,1,1
1440746906670358528,1,0,0,0,1
1355614508849508352,0,1,0,0,1
1183601537102176256,1,0,0,0,1
1440615073005801472,0,1,0,0,1
1355800314876743680,1,0,0,0,1
1183353593405067264,0,1,0,0,1
1183246953775325184,1,0,0,0,1
1494659140899065856,1,0,0,0,1
1182911836481449984,0,1,0,0,1
1355932726860386304,0,1,0,0,1
1185419897121042432,0,1,0,0,1
1354826386066837504,0,1,0,0,1
1494059816737591296,0,1,0,0,1
1494154515540770816,0,1,0,0,1
1354159275581562880,0,0,0,1,1
1494234774067884032,1,0,0,0,1
1441395139130363904,0,1,0,0,1
1494221186330513408,0,1,0,0,1
1494196135166189568,0,1,0,0,1
1186907347777490944,0,1,0,0,1
1353988796203884544,0,1,0,0,1
1354747129042935808,0,1,0,0,1
1353986840391376896,0,1,0,0,1
1353947958841135104,0,1,0,0,1
1187016552303869952,0,1,0,0,1
1441411157764493312,0,1,0,0,1
1187104267359752192,0,1,0,0,1
1187300771789824000,0,1,0,0,1
1186852077949075456,0,1,0,0,1
1354203453367705600,0,1,0,0,1
1186751163389173760,0,1,0,0,1
1354229659932753920,1,0,0,0,1
1494236652067299328,1,0,0,0,1
1186581426738728960,0,1,0,0,1
1186570239099703296,0,1,0,0,1
1354294016817442816,0,1,0,0,1
1441032620884770816,0,1,0,0,1
1494262123601743872,0,1,0,0,1
1440945062645354496,1,0,0,0,1
1494283572294860800,0,1,0,0,1
1186327991552544768,0,1,0,0,1
1494337427128733696,0,1,0,0,1
1185901935913832448,1,0,0,0,1
1185832478726086656,0,1,0,0,1
1354681487711416320,1,0,0,0,1
1442089310702825472,1,0,0,0,1
1352982390981931008,0,1,0,0,1
1350159684934754304,0,1,0,0,1
1201815896294977536,0,1,0,0,1
1201339677904490496,0,1,0,0,1
1201512180803194880,0,1,0,0,1
1201684633269653504,0,1,0,0,1
1492822841909071872,0,1,0,0,1
1492799609986555904,0,1,0,0,1
1201804153187639296,0,1,0,0,1
1351734477563846656,0,1,0,0,1
1200971507557486592,1,0,0,0,1
1442939609273544704,0,1,0,0,1
1202163464199913472,0,1,0,0,1
1492689554566168576,0,1,0,0,1
1492617007103102976,0,1,0,0,1
1351569182362628096,0,1,0,0,1
1492594589240541184,0,1,0,0,1
1201221227177598976,0,1,0,0,1
1492832341735395328,0,1,0,0,1
1352915255421259776,0,1,0,0,1
1442759119878823936,0,1,0,0,1
1351888993546223616,0,1,0,0,1
1199531128975065088,0,1,0,0,1
1199626939679379456,0,1,0,0,1
1492930285696135168,0,1,0,0,1
1351873965980086272,0,1,0,0,1
1199756915049295872,0,1,0,0,1
1200039727195467776,1,0,0,0,1
1200567379517825024,0,1,0,0,1
1200057427816640512,0,1,0,0,1
1442790633022783488,0,1,0,0,1
1492895832911323136,0,1,0,0,1
1200245508037599232,0,1,0,0,1
1492845312150437888,0,1,0,0,1
1200420327081283584,0,1,0,0,1
1492593079425323008,0,1,0,0,1
1202412558168268800,0,1,0,0,1
1202475957505839104,0,1,0,0,1
1492534364781289472,0,1,0,0,1
1203961356812242944,0,1,0,0,1
1492549466867449856,1,0,0,0,1
1204036111946993664,0,1,0,0,1
1204047686015619072,1,0,0,0,1
1204101542342807552,1,0,0,0,1
1492535542184960000,0,1,0,0,1
1492527548013572096,0,1,0,0,1
1492582110456070144,0,1,0,0,1
1492525050691735552,0,1,0,0,1
1443112848733786112,1,0,0,0,1
1350362464827932672,1,0,0,0,1
1350331184711086080,1,0,0,0,1
1204256768534040576,0,1,0,0,1
1492448623266865152,0,1,0,0,1
1492567651507445760,0,1,0,0,1
1443052613776199680,0,1,0,0,1
1350828146241777664,0,1,0,0,1
1203760312941502464,1,0,0,0,1
1203756106494857216,0,1,0,0,1
1203737943128469504,0,1,0,0,1
1492570653911916544,1,0,0,0,1
1351129182248513536,0,1,0,0,1
1203007504843595776,0,1,0,0,1
1351146037176635392,0,1,0,0,1
1492570785940004864,0,1,0,0,1
1202975478925185024,1,0,0,0,1
1202921702533083136,0,1,0,0,1
1202879056200355840,1,0,0,0,1
1202687995934953472,0,0,1,0,1
1202667002428579840,0,1,0,0,1
1351547892838903808,0,1,0,0,1
1199008584203288576,0,1,0,0,1
1199004257392848896,0,1,0,0,1
1198881099570483200,1,0,0,0,1
1493346027365089280,1,0,0,0,1
1194687561295421440,0,1,0,0,1
1493434562889883648,0,1,0,0,1
1352541237195153408,0,1,0,0,1
1194863368705720320,1,0,0,0,1
1194929705297829888,0,1,0,0,1
1442530049689743360,1,0,0,0,1
1194952310838956032,0,1,0,0,1
1352303823214178304,1,0,0,0,1
1194958987587833856,0,1,0,0,1
1493320062119268352,1,0,0,0,1
1195156964029825024,0,1,0,0,1
1493306115295449088,1,0,0,0,1
1195257026474962944,0,0,0,1,1
1306380597523353600,0,1,0,0,1
1194667073676312576,0,1,0,0,1
1493485651827650560,0,1,0,0,1
1352560884925796352,0,1,0,0,1
1352569709061754880,0,1,0,0,1
1442231394680250368,1,0,0,0,1
1442205942242635776,0,1,0,0,1
1194500250054119424,0,1,0,0,1
1194292161430331392,1,0,0,0,1
1352852705790750720,0,1,0,0,1
1194105834269114368,0,1,0,0,1
1193980941494079488,0,1,0,0,1
1193888012570112000,0,1,0,0,1
1352893548887207936,0,1,0,0,1
1193878280472018944,0,1,0,0,1
1193690420728872960,0,1,0,0,1
1352899972006637568,0,1,0,0,1
1493518611432054784,0,1,0,0,1
1493260805059530752,0,1,0,0,1
1195933487720804352,0,0,0,1,1
1351993328166846464,0,1,0,0,1
1492968142791925760,0,1,0,0,1
1197564487034753024,0,1,0,0,1
1493129589081755648,0,1,0,0,1
1197833350204911616,0,1,0,0,1
1197937409880662016,0,1,0,0,1
1198164650249994240,0,1,0,0,1
1352094899399610368,0,1,0,0,1
1198601666649448448,0,1,0,0,1
1493257609587015680,0,1,0,0,1
1198605830615994368,1,0,0,0,1
1352046721120010240,0,1,0,0,1
1492939130183036928,1,0,0,0,1
1492934466909749248,0,1,0,0,1
1198746698345922560,0,1,0,0,1
1352004820303925248,0,1,0,0,1
1197397019553419264,0,1,0,0,1
1352151057300742144,0,1,0,0,1
1197190341230649344,1,0,0,0,1
1197117707407093760,0,1,0,0,1
1493168454647496704,0,1,0,0,1
1352213507165585408,1,0,0,0,1
1352221364602728448,1,0,0,0,1
1196997838787362816,0,1,0,0,1
1196956036554473472,1,0,0,0,1
1493205569905250304,0,1,0,0,1
1196734566897090560,0,1,0,0,1
1442547385775767552,0,1,0,0,1
1196467504840884224,0,1,0,0,1
1352286553347919872,0,1,0,0,1
1196402985708015616,0,1,0,0,1
1493228692562227200,1,0,0,0,1
1196149724925042688,0,1,0,0,1
1344133974227111936,0,1,0,0,1
1490138864899727360,0,1,0,0,1
1221797851258163200,0,1,0,0,1
1449781563734913024,0,1,0,0,1
1243790750959034368,1,0,0,0,1
1485813028419698688,0,1,0,0,1
1485560059824586752,0,1,0,0,1
1335085882601160704,0,1,0,0,1
1485539830607978496,1,0,0,0,1
1244127208890744832,0,1,0,0,1
1485528559263395840,0,0,0,1,1
1243771284707659776,0,0,1,0,1
1244152234633396224,0,1,0,0,1
1485484810084950016,0,1,0,0,1
1244201655320694784,0,1,0,0,1
1244253946278887424,0,1,0,0,1
1244278142480547840,0,1,0,0,1
1244318891901251584,0,1,0,0,1
1449570826655764480,0,1,0,0,1
1243516336732393472,0,1,0,0,1
1246487953662021632,0,1,0,0,1
1486030640286171136,0,1,0,0,1
1449377661587968000,0,1,0,0,1
1242809647536300032,0,1,0,0,1
1242817015372492800,0,1,0,0,1
1242818981758631936,0,1,0,0,1
1486034745469566976,0,1,0,0,1
1335112715543592960,0,1,0,0,1
1335107127174565888,0,1,0,0,1
1243460169566056448,0,1,0,0,1
1242880156399779840,0,1,0,0,1
1449414909503094784,0,1,0,0,1
1243045704987107328,0,1,0,0,1
1243061396599906304,0,1,0,0,1
1486009713091551232,0,0,0,1,1
1243169164027736064,0,1,0,0,1
1449788875170148352,0,1,0,0,1
1449833466254839808,0,1,0,0,1
1485404081091137536,0,1,0,0,1
1485306803491868672,0,0,0,1,1
1450057719377903616,0,1,0,0,1
1334380405235957760,0,1,0,0,1
1245979175799808000,0,1,0,0,1
1246019854647296000,1,0,0,0,1
1246140073558437888,0,1,0,0,1
1450111344854777856,0,1,0,0,1
1485250182904176640,1,0,0,0,1
1449993010989740032,0,1,0,0,1
1246144127395233792,0,1,0,0,1
1334319943106486272,1,0,0,0,1
1485247766205014016,0,1,0,0,1
1450120128474005504,0,1,0,0,1
1485247159532462080,0,1,0,0,1
1334299906782072832,0,1,0,0,1
1245721531088605184,0,1,0,0,1
1245705338898153472,0,1,0,0,1
1245704173665931264,0,1,0,0,1
1485321082731364352,0,1,0,0,1
1245545164552015872,0,1,0,0,1
1245532849186508800,0,1,0,0,1
1245526240154378240,0,1,0,0,1
1245011654640721920,0,1,0,0,1
1244991357183115264,0,1,0,0,1
1244977727486246912,0,1,0,0,1
1244919349539987456,0,1,0,0,1
1450026216522719232,1,0,0,0,1
1334700409512841216,0,1,0,0,1
1334726623640301568,1,0,0,0,1
1334813333883658240,1,0,0,0,1
1244608035122601984,1,0,0,0,1
1244537119789314048,0,1,0,0,1
1486045580636082176,0,1,0,0,1
1335113162866167808,1,0,0,0,1
1335200359115943936,1,0,0,0,1
1241372283672735744,0,1,0,0,1
1336223106453676032,0,1,0,0,1
1448615768401186816,1,0,0,0,1
1448676484743249920,0,1,0,0,1
1241339797215391744,0,1,0,0,1
1241345848136663040,0,1,0,0,1
1241346054756286464,0,1,0,0,1
1487131843388448768,0,1,0,0,1
1335986212507627520,0,1,0,0,1
1241396775803588608,0,1,0,0,1
1487091583627689984,0,1,0,0,1
1487032399498297344,1,0,0,0,1
1241593038385766400,0,1,0,0,1
1487031616790622208,0,1,0,0,1
1241593140966035456,0,1,0,0,1
1448579249330221056,1,0,0,0,1
1336310890904346624,0,1,0,0,1
1241246185882390528,0,1,0,0,1
1241167117535322112,0,1,0,0,1
1487220457266941952,0,1,0,0,1
1241118317043204096,1,0,0,0,1
1336387560730484736,0,1,0,0,1
1487278271444434944,0,1,0,0,1
1487305936356413440,0,0,0,1,1
1487345403615981568,0,1,0,0,1
1487359978482683904,0,1,0,0,1
1336552929017421824,1,0,0,0,1
1241015871159635968,0,1,0,0,1
1240922415367991296,0,1,0,0,1
1240700854744674304,0,1,0,0,1
1336579290691940352,1,0,0,0,1
1240624670799310848,0,1,0,0,1
1336011722633715712,1,0,0,0,1
1241823527889702912,1,0,0,0,1
1242749974330384384,0,1,0,0,1
1242467903045165056,0,1,0,0,1
1242365110435356672,0,1,0,0,1
1242397358123442176,0,1,0,0,1
1486277125070286848,1,0,0,0,1
1242454798651338752,0,1,0,0,1
1335586307876130816,0,1,0,0,1
1486262582189207552,0,1,0,0,1
1242514774425874432,0,1,0,0,1
1335861249784098816,0,1,0,0,1
1486233590178643968,1,0,0,0,1
1449075780466577408,1,0,0,0,1
1449174003508207616,0,1,0,0,1
1449266297557106688,0,1,0,0,1
1242709697397952512,0,1,0,0,1
1335394724878970880,0,1,0,0,1
1242254303617662976,1,0,0,0,1
1242190530513076224,0,1,0,0,1
1242159890606575616,0,1,0,0,1
1242150222828101632,0,1,0,0,1
1486287178028179456,0,1,0,0,1
1486368814757564416,0,1,0,0,1
1486377460015181824,0,1,0,0,1
1242089940143538176,0,1,0,0,1
1486395724934041600,1,0,0,0,1
1486574062914584576,0,1,0,0,1
1448973726263939072,0,1,0,0,1
1242048034772410368,0,1,0,0,1
1486698525496791040,0,1,0,0,1
1335620766159822848,0,0,0,1,1
1242035549445251072,0,1,0,0,1
1486760155177914368,0,1,0,0,1
1241889098442260480,1,0,0,0,1
1334199452899319808,0,1,0,0,1
1246592178782117888,0,1,0,0,1
1487413613422059520,0,1,0,0,1
1484241488297213952,0,1,0,0,1
1251553100629856256,0,1,0,0,1
1251594745828093952,0,1,0,0,1
1484282230797402112,0,1,0,0,1
1484275239647604736,0,1,0,0,1
1251818953044897792,0,1,0,0,1
1251881895161401344,0,1,0,0,1
1451379816188428288,0,1,0,0,1
1251519276944691200,0,1,0,0,1
1252120779421966336,0,1,0,0,1
1332320255872479232,0,1,0,0,1
1332249768668635136,1,0,0,0,1
1252201206727929856,0,1,0,0,1
1252227378522226688,0,1,0,0,1
1252313225011449856,0,1,0,0,1
1451376176040009728,1,0,0,0,1
1451275665815347200,0,1,0,0,1
1246850523954724864,1,0,0,0,1
1250825548756107264,0,1,0,0,1
1250382098906693632,0,1,0,0,1
1250415948256776192,1,0,0,0,1
1416117918681632768,0,1,0,0,1
1484575463729156096,0,1,0,0,1
1484490540469342208,0,1,0,0,1
1250736569297895424,0,1,0,0,1
1250938217487986688,0,1,0,0,1
1251364772592775168,0,1,0,0,1
1251110456116166656,0,1,0,0,1
1332952927879655424,1,0,0,0,1
1332758493149990912,0,1,0,0,1
1251151708366860288,0,1,0,0,1
1484411719716057088,1,0,0,0,1
1332703610287788032,1,0,0,0,1
1332152814307459072,0,1,0,0,1
1484196384412942336,0,1,0,0,1
1252393084605923328,1,0,0,0,1
1483966360967335936,0,0,0,1,1
1253284754134315008,0,1,0,0,1
1253287826088550400,0,1,0,0,1
1331262195074699264,0,1,0,0,1
1253324543843696640,0,1,0,0,1
1253552426109599744,1,0,0,0,1
1253564357415444480,1,0,0,0,1
1253686666977374208,0,1,0,0,1
1451429747188244480,0,1,0,0,1
1253689257840873472,0,1,0,0,1
1451940736132259840,0,1,0,0,1
1483917628033110016,0,1,0,0,1
1451958028761288704,1,0,0,0,1
1452310686651101184,0,1,0,0,1
1483872514820698112,1,0,0,0,1
1253231540924035072,0,1,0,0,1
1451822212751630336,0,1,0,0,1
1253038948470972416,0,1,0,0,1
1253029139021365248,1,0,0,0,1
1484012157658628096,0,1,0,0,1
1451735657034960896,0,1,0,0,1
1484159319969234944,0,1,0,0,1
1331461500309946368,0,1,0,0,1
1252606784583409664,0,1,0,0,1
1484171773310828544,1,0,0,0,1
1252579737597177856,0,1,0,0,1
1451601885652078592,0,1,0,0,1
1252561275286097920,0,1,0,0,1
1451505791094034432,0,1,0,0,1
1331973220757622784,0,1,0,0,1
1331973830387003392,1,0,0,0,1
1332022940565532672,1,0,0,0,1
1484586875847204864,0,1,0,0,1
1484631534598787072,1,0,0,0,1
1249824249877069824,0,1,0,0,1
1247772363145371648,0,1,0,0,1
1247355343774134272,0,1,0,0,1
1333648512052056064,1,0,0,0,1
1485164574542561280,0,0,0,1,1
1247454086481481728,0,1,0,0,1
1247519723786559488,0,1,0,0,1
1247617954453139456,0,1,0,0,1
1485137757425274880,1,0,0,0,1
1485116538692993024,0,0,1,0,1
1247908440783142912,0,1,0,0,1
1247924025872887808,0,1,0,0,1
1248024520167952384,0,1,0,0,1
1248099690807062528,0,1,0,0,1
1485128226246905856,0,1,0,0,1
1485128008004513792,0,1,0,0,1
1247311613687816192,0,1,0,0,1
1333655862951505920,0,1,0,0,1
1450852953028366336,1,0,0,0,1
1333665699869364224,0,1,0,0,1
1333682053762740224,1,0,0,0,1
1333686267494735872,0,0,0,1,1
1333708253440708608,0,1,0,0,1
1485202323161104384,1,0,0,0,1
1247289664001753088,1,0,0,0,1
1485210055653920768,1,0,0,0,1
1333804297629224960,0,1,0,0,1
1333926099659628544,1,0,0,0,1
1247074497578049536,0,1,0,0,1
1246997192352489472,0,1,0,0,1
1334020369234145280,0,1,0,0,1
1246959095338266624,0,1,0,0,1
1246860667178582016,0,1,0,0,1
1333455191996297216,0,1,0,0,1
1333392722892267520,0,1,0,0,1
1484771654303727616,1,0,0,0,1
1249496955958353920,0,1,0,0,1
1249209631441743872,1,0,0,0,1
1450950265859985408,0,1,0,0,1
1249312504536338432,0,1,0,0,1
1484949962811064320,0,1,0,0,1
1249427956184702976,0,1,0,0,1
1450959485816684544,0,1,0,0,1
1249576578595442688,0,1,0,0,1
1485060918002257920,1,0,0,0,1
1451150195790516224,0,1,0,0,1
1249617946449567744,1,0,0,0,1
1484937051611234304,0,1,0,0,1
1484821910961545216,0,1,0,0,1
1484778270398857216,1,0,0,0,1
1249732925584740352,0,1,0,0,1
1249012084605693952,0,1,0,0,1
1248947743281811456,0,1,0,0,1
1248898896706723840,1,0,0,0,1
1248854051162222592,0,1,0,0,1
1484972876944252928,1,0,0,0,1
1450910145236676608,0,1,0,0,1
1333303093589663744,0,1,0,0,1
1248740895375200256,0,1,0,0,1
1248549643560128512,1,0,0,0,1
1248548201239433216,1,0,0,0,1
1248546638395633664,0,1,0,0,1
1248453501350338560,0,1,0,0,1
1333329315308531712,1,0,0,0,1
1484975156032598016,1,0,0,0,1
1248281239821471744,0,1,0,0,1
1248232201759723520,0,1,0,0,1
1248172519799975936,0,1,0,0,1
1240464855339065344,1,0,0,0,1
1336603731295657984,0,1,0,0,1
1344076053069717504,0,1,0,0,1
1489010226087219200,1,0,0,0,1
1227350087094939648,1,0,0,0,1
1341746247103774720,0,1,0,0,1
1227662043764883456,0,1,0,0,1
1489015709514543104,0,1,0,0,1
1227709406839619584,0,1,0,0,1
1227731213793648640,0,1,0,0,1
1446914842716041216,0,1,0,0,1
1341777384828223488,0,1,0,0,1
1488946378915344384,0,1,0,0,1
1488944758613499904,1,0,0,0,1
1227954110843904000,0,1,0,0,1
1446961000427687936,0,1,0,0,1
1228169781108334592,0,1,0,0,1
1341410094001647616,1,0,0,0,1
1489067452185157632,0,1,0,0,1
1341782398187540480,0,1,0,0,1
1340580181119885312,1,0,0,0,1
1226471981899505664,0,1,0,0,1
1226149593869672448,0,1,0,0,1
1489169371952205824,0,1,0,0,1
1342022277303586816,1,0,0,0,1
1446898405410844672,0,1,0,0,1
1226446911739179008,0,1,0,0,1
1489085305596567552,0,1,0,0,1
1226482310918242304,0,1,0,0,1
1227112625072308224,0,1,0,0,1
1489082577830961152,0,1,0,0,1
1226487768181702656,1,0,0,0,1
1341836910465933312,1,0,0,0,1
1226524884718825472,1,0,0,0,1
1341785744151629824,0,1,0,0,1
1227079948659314688,0,1,0,0,1
1341409849939283968,0,1,0,0,1
1228438871685251072,1,0,0,0,1
1228910955972591616,0,1,0,0,1
1231564306589851648,0,0,1,0,1
1341012344697139200,1,0,0,0,1
1231126435504500736,0,1,0,0,1
1231177800121487360,0,1,0,0,1
1341009538326155264,0,1,0,0,1
1231393084459622400,0,1,0,0,1
1447162020759891968,0,1,0,0,1
1231867215433142272,0,1,0,0,1
1228917559572996096,0,1,0,0,1
1340710636158935040,0,1,0,0,1
1488840206950170624,0,1,0,0,1
1231942870644314112,0,1,0,0,1
1231944053496913920,0,1,0,0,1
1231944324641783808,1,0,0,0,1
1488640465796689920,0,0,0,1,1
1231099052915220480,1,0,0,0,1
1230471128319049728,0,1,0,0,1
1230387268994523136,1,0,0,0,1
1230103342673801216,0,1,0,0,1
1230073068455899136,0,1,0,0,1
1341193813981839360,0,1,0,0,1
1230040061577748480,0,1,0,0,1
1230017776393293824,1,0,0,0,1
1229952670313508864,0,1,0,0,1
1229866015531634688,0,0,1,0,1
1229781442902675456,0,1,0,0,1
1447086976172183552,0,1,0,0,1
1229714603728224256,0,1,0,0,1
1229647779846213632,1,0,0,0,1
1229179817792360448,0,1,0,0,1
1341230472098004992,0,1,0,0,1
1488896270437523456,0,1,0,0,1
1226108242624946176,0,1,0,0,1
1342041624012984320,1,0,0,0,1
1342128799022985216,0,1,0,0,1
1343604633621565440,0,1,0,0,1
1343696585436372992,0,1,0,0,1
1223316519846842368,0,1,0,0,1
1223336866805452800,1,0,0,0,1
1489861010794356736,1,0,0,0,1
1343655029711003648,0,1,0,0,1
1343608552066150400,0,1,0,0,1
1489746408789852160,0,1,0,0,1
1489620386274705408,1,0,0,0,1
1343598687419826176,0,1,0,0,1
1489668853294837760,1,0,0,0,1
1343538987974025216,0,1,0,0,1
1343519233406357504,0,1,0,0,1
1446821858532372480,1,0,0,0,1
1223684195257589760,0,1,0,0,1
1223260083062108160,0,1,0,0,1
1343802327908626432,0,1,0,0,1
1446736919925121024,0,1,0,0,1
1489948653779365888,0,1,0,0,1
1343894767663337472,0,1,0,0,1
1222893967282302976,0,1,0,0,1
1446708945578496000,0,1,0,0,1
1343974675219689472,0,1,0,0,1
1222746108482293760,1,0,0,0,1
1446055037520662528,1,0,0,0,1
1222692822152691712,0,1,0,0,1
1490006556737667072,1,0,0,0,1
1222427224374235136,0,1,0,0,1
1344059327146033152,0,1,0,0,1
1222199648061812736,0,1,0,0,1
1222043429816819712,1,0,0,0,1
1221811289183309824,1,0,0,0,1
1489660566461243392,1,0,0,0,1
1489608202547347456,0,1,0,0,1
1225921913324654592,0,1,0,0,1
1342666448469159936,0,1,0,0,1
1224793652968353792,0,1,0,0,1
1224895752926830592,0,1,0,0,1
1342895995726622720,0,1,0,0,1
1489316305505243136,0,0,0,1,1
1224902615797907456,0,1,0,0,1
1224922738185269248,0,1,0,0,1
1342646648372006912,0,1,0,0,1
1489608150055485440,0,1,0,0,1
1225237036249964544,0,1,0,0,1
1342454887683121152,0,1,0,0,1
1225571217672933376,1,0,0,0,1
1225642096985440256,0,1,0,0,1
1225813738646753280,0,1,0,0,1
1342449988383727616,0,1,0,0,1
1224617542356029440,0,1,0,0,1
1224534612199669760,0,1,0,0,1
1342942539872043008,0,1,0,0,1
1343240216157425664,0,1,0,0,1
1224500231892418560,0,1,0,0,1
1224461719042428928,0,0,1,0,1
1489355344660869120,0,1,0,0,1
1489466720456949760,0,1,0,0,1
1224441067929505792,0,1,0,0,1
1343245701992521728,0,1,0,0,1
1224411898675957760,0,0,1,0,1
1343343875537076224,0,1,0,0,1
1224149873978527744,0,1,0,0,1
1224083653287870464,0,1,0,0,1
1343492027376312320,0,1,0,0,1
1489550804340011008,0,0,0,1,1
1223843656924192768,0,1,0,0,1
1232007717402894336,1,0,0,0,1
1447186176406917120,1,0,0,0,1
1240332331228884992,1,0,0,0,1
1337985005016948736,0,1,0,0,1
1338029752444211200,0,1,0,0,1
1487867312929931264,1,0,0,0,1
1237817349023006720,1,0,0,0,1
1337998434972798976,0,1,0,0,1
1237893552832540672,0,1,0,0,1
1238005497187323904,1,0,0,0,1
1238075336849608704,0,1,0,0,1
1237402177464758272,0,1,0,0,1
1337776193790226432,0,1,0,0,1
1337692706596904960,0,1,0,0,1
1238341584258621440,0,1,0,0,1
1487811220065378304,0,1,0,0,1
1337315155286351872,0,1,0,0,1
1447582852103606272,1,0,0,0,1
1447457262746759168,0,1,0,0,1
1237286823879159808,0,1,0,0,1
1232206488321454080,0,1,0,0,1
1447447394581426176,0,0,1,0,1
1236483972403613696,0,1,0,0,1
1236504733831041024,0,1,0,0,1
1339068633352458240,0,1,0,0,1
1236512849037574144,0,1,0,0,1
1236527849575600128,0,0,0,1,1
1488061295291428864,0,1,0,0,1
1338769564385984512,0,1,0,0,1
1237246071887278080,0,1,0,0,1
1236987792237838336,0,1,0,0,1
1237109051575668736,0,1,0,0,1
1338485013902397440,0,1,0,0,1
1338206317412945920,0,1,0,0,1
1487887600815906816,0,0,0,1,1
1338166960186675200,0,1,0,0,1
1238507622984122368,0,1,0,0,1
1337299112023093248,0,1,0,0,1
1447838191269003264,1,0,0,0,1
1239951303746506752,0,1,0,0,1
1239781976271282176,0,1,0,0,1
1336690076550512640,0,1,0,0,1
1239784815940911104,0,1,0,0,1
1239794812351438848,1,0,0,0,1
1448237495087505408,0,1,0,0,1
1448263646094639104,0,1,0,0,1
1336638305211920384,1,0,0,0,1
1336954789867913216,0,1,0,0,1
1240121577347452928,0,1,0,0,1
1240160927233839104,0,1,0,0,1
1240177875434831872,0,1,0,0,1
1487414637188587520,0,1,0,0,1
1240225035953963008,0,1,0,0,1
1240310322461728768,1,0,0,0,1
1487429196557479936,1,0,0,0,1
1487448675190116352,0,1,0,0,1
1487667119672406016,0,1,0,0,1
1487698945606311936,0,1,0,0,1
1336690373582721024,0,1,0,0,1
1239581869449949184,0,1,0,0,1
1239577675091468288,1,0,0,0,1
1239260230770294784,0,1,0,0,1
1239256562469765120,0,1,0,0,1
1239216548147060736,0,1,0,0,1
1487716361233367040,0,1,0,0,1
1239203699748040704,1,0,0,0,1
1239186604486316032,1,0,0,0,1
1487723091304148992,0,1,0,0,1
1336871445243207680,1,0,0,0,1
1487731251796758528,0,1,0,0,1
1238760464433033216,0,1,0,0,1
1488078858478063616,0,1,0,0,1
1236444535657508864,0,1,0,0,1
1236304023784955904,0,1,0,0,1
1233567086817005568,0,1,0,0,1
1233224942323486720,0,1,0,0,1
1340268807915331584,0,1,0,0,1
1339938943702188032,0,1,0,0,1
1447247803772776448,0,1,0,0,1
1233393410435944448,0,0,0,1,1
1233497126505734144,0,1,0,0,1
1488543965154398208,0,1,0,0,1
1234189840586964992,1,0,0,0,1
1233633380513828864,0,1,0,0,1
1233670811300401152,0,1,0,0,1
1233679546848882688,0,1,0,0,1
1233699981946650624,0,1,0,0,1
1233715134633107456,1,0,0,0,1
1233733994488967168,0,1,0,0,1
1340280940443025408,0,1,0,0,1
1340285962350260224,0,0,1,0,1
1233087713945038848,0,1,0,0,1
1488595504556564480,0,1,0,0,1
1233068918455046144,0,1,0,0,1
1233065293271859200,0,0,0,1,1
1232839611795333120,1,0,0,0,1
1232713740048404480,0,1,0,0,1
1232696987868434432,0,1,0,0,1
1232620917706153984,0,1,0,0,1
1232554289358426112,0,1,0,0,1
1232536206526664704,0,1,0,0,1
1232532170616516608,0,0,0,1,1
1232266030875119616,0,1,0,0,1
1488601031839821824,0,0,0,1,1
1340306443396898816,1,0,0,0,1
1232260083645636608,1,0,0,0,1
1233893915859849216,1,0,0,0,1
1234318469862023168,0,1,0,0,1
1236303537358979072,0,1,0,0,1
1488120103753424896,1,0,0,0,1
1339427893634461696,1,0,0,0,1
1235621897796280320,0,1,0,0,1
1339360822938636288,0,1,0,0,1
1235678393741570048,0,1,0,0,1
1235828678233227264,0,1,0,0,1
1235902830600306688,0,1,0,0,1
1235914274591014912,0,1,0,0,1
1447252673464520704,0,1,0,0,1
1235937254692003840,0,1,0,0,1
1235940869812809728,0,1,0,0,1
1236162142430277632,0,1,0,0,1
1339197397470208000,0,1,0,0,1
1488103596315103232,0,1,0,0,1
1236292005807915008,0,1,0,0,1
1235512027629711360,0,1,0,0,1
1488135145307602944,0,1,0,0,1
1235155716287193088,0,1,0,0,1
1234910932985356288,0,1,0,0,1
1488142958532919296,0,1,0,0,1
1488229906131652608,0,1,0,0,1
1234792043785924608,0,1,0,0,1
1234670295346274304,1,0,0,0,1
1234540721174126592,0,1,0,0,1
1234499434949435392,0,1,0,0,1
1234466818837880832,0,1,0,0,1
1339573924451942400,0,1,0,0,1
1339719811484532736,1,0,0,0,1
1488348087315996672,0,1,0,0,1
1488496550775226368,1,0,0,0,1
1339918729845432320,0,1,0,0,1
1234434487355871232,0,1,0,0,1
1484581376993406976,0,1,0,0,1
802467414994808832,0,1,0,0,1
1013527093735559168,0,1,0,0,1
847170074,0,1,0,0,1
570311919,0,1,0,0,1
570475820,0,1,0,0,1
570640048,1,0,0,0,1
572553669,0,1,0,0,1
572666792,0,1,0,0,1
573037074,0,1,0,0,1
573413114,0,1,0,0,1
573571224,0,1,0,0,1
573829733,0,1,0,0,1
573835580,0,1,0,0,1
575869303,0,1,0,0,1
576275730,0,1,0,0,1
576874557,0,1,0,0,1
577653607,0,1,0,0,1
578396588,0,1,0,0,1
579860518,1,0,0,0,1
579896529,0,1,0,0,1
580128170,0,1,0,0,1
581645262,0,1,0,0,1
582065859,0,1,0,0,1
582897130,0,1,0,0,1
582984655,0,1,0,0,1
583144668,1,0,0,0,1
570269636,0,1,0,0,1
570154321,0,1,0,0,1
570021350,0,1,0,0,1
562749507,0,1,0,0,1
558560470,0,1,0,0,1
558605467,1,0,0,0,1
559192261,0,1,0,0,1
559356907,0,1,0,0,1
559670449,1,0,0,0,1
559901348,1,0,0,0,1
560147875,0,1,0,0,1
560188360,1,0,0,0,1
560682638,0,1,0,0,1
562184945,1,0,0,0,1
563549001,0,1,0,0,1
569999743,0,1,0,0,1
563962034,0,1,0,0,1
564052050,0,1,0,0,1
564756538,0,1,0,0,1
565231577,1,0,0,0,1
565339946,0,1,0,0,1
565933318,0,1,0,0,1
566284102,0,1,0,0,1
566421760,0,1,0,0,1
567413819,0,1,0,0,1
568685865,0,0,1,0,1
584151751,0,1,0,0,1
584641805,0,1,0,0,1
584795132,0,1,0,0,1
602827060,0,1,0,0,1
596998774,0,0,0,1,1
597136449,1,0,0,0,1
597305658,0,1,0,0,1
597313428,0,1,0,0,1
598830024,0,1,0,0,1
600817422,0,1,0,0,1
601154240,0,1,0,0,1
602051893,0,1,0,0,1
602565289,0,1,0,0,1
602769720,0,1,0,0,1
603199675,0,1,0,0,1
596257747,0,1,0,0,1
603424354,0,1,0,0,1
603507992,0,1,0,0,1
603963962,0,1,0,0,1
603995863,0,1,0,0,1
604551516,0,1,0,0,1
604625208,0,1,0,0,1
604854665,0,1,0,0,1
605542859,0,1,0,0,1
605667542,0,1,0,0,1
605943178,0,1,0,0,1
596302565,0,1,0,0,1
596063522,0,1,0,0,1
585827398,0,1,0,0,1
590000420,0,1,0,0,1
586017553,1,0,0,0,1
588096982,1,0,0,0,1
588219819,0,1,0,0,1
588256182,1,0,0,0,1
588732151,0,1,0,0,1
589156899,1,0,0,0,1
589430368,0,1,0,0,1
589796636,0,1,0,0,1
589808574,0,1,0,0,1
589872968,0,1,0,0,1
591016687,0,1,0,0,1
595152592,0,1,0,0,1
591297698,0,1,0,0,1
591852907,0,1,0,0,1
591982462,0,1,0,0,1
592038796,0,1,0,0,1
592077328,0,1,0,0,1
592466122,1,0,0,0,1
592726651,0,1,0,0,1
592785522,0,1,0,0,1
593173577,0,1,0,0,1
594660789,0,1,0,0,1
558207176,0,1,0,0,1
557756984,0,1,0,0,1
556969755,0,1,0,0,1
529462015,0,1,0,0,1
521301666,0,1,0,0,1
521620495,0,1,0,0,1
524001499,0,1,0,0,1
524051098,0,1,0,0,1
524413098,0,1,0,0,1
526219723,0,1,0,0,1
527087498,0,1,0,0,1
527112327,0,1,0,0,1
527573215,1,0,0,0,1
529028579,0,1,0,0,1
529487878,0,1,0,0,1
520655566,1,0,0,0,1
529791118,0,1,0,0,1
529836471,0,1,0,0,1
530967968,0,1,0,0,1
531458507,0,0,1,0,1
531618878,0,0,0,1,1
531659498,0,1,0,0,1
532457186,0,1,0,0,1
532876187,0,1,0,0,1
533039912,1,0,0,0,1
533141393,0,1,0,0,1
521043027,0,1,0,0,1
520253358,0,1,0,0,1
533347011,0,1,0,0,1
516452320,0,1,0,0,1
510480837,0,0,0,1,1
512268603,0,1,0,0,1
512465595,0,1,0,0,1
512512840,0,1,0,0,1
513051520,0,1,0,0,1
513309961,0,1,0,0,1
513534321,0,1,0,0,1
513958244,0,1,0,0,1
514714179,0,1,0,0,1
516137699,0,1,0,0,1
516994455,0,1,0,0,1
520018112,1,0,0,0,1
517246976,0,1,0,0,1
517295547,0,1,0,0,1
517563071,0,1,0,0,1
517692984,0,1,0,0,1
518051255,0,1,0,0,1
518163795,0,1,0,0,1
518394501,1,0,0,0,1
518585537,0,1,0,0,1
518970201,1,0,0,0,1
519242837,0,1,0,0,1
533330971,0,1,0,0,1
533499339,0,1,0,0,1
556224141,0,1,0,0,1
551289061,0,1,0,0,1
546781189,0,1,0,0,1
547712780,0,1,0,0,1
547753243,1,0,0,0,1
547912678,0,1,0,0,1
548852571,0,1,0,0,1
549531065,0,1,0,0,1
550182903,0,1,0,0,1
550544813,1,0,0,0,1
550748981,0,1,0,0,1
550979727,0,1,0,0,1
551573734,1,0,0,0,1
546128407,0,1,0,0,1
552342881,0,1,0,0,1
552918005,0,1,0,0,1
553691103,0,1,0,0,1
553740112,1,0,0,0,1
553952886,0,1,0,0,1
554115646,0,1,0,0,1
554988167,0,1,0,0,1
555136170,0,1,0,0,1
555450691,0,1,0,0,1
556078064,0,1,0,0,1
546680554,0,1,0,0,1
545599532,1,0,0,0,1
533588637,0,1,0,0,1
540543234,0,1,0,0,1
533600766,1,0,0,0,1
534529673,0,1,0,0,1
534630009,0,1,0,0,1
534858822,0,1,0,0,1
535097455,0,0,0,1,1
536201119,0,1,0,0,1
536359978,0,1,0,0,1
538163623,0,0,0,1,1
538212742,0,1,0,0,1
538938762,0,1,0,0,1
540903074,0,1,0,0,1
545492506,0,1,0,0,1
541121097,1,0,0,0,1
541319020,1,0,0,0,1
541563078,0,1,0,0,1
541648588,0,1,0,0,1
542143434,0,1,0,0,1
544463535,0,1,0,0,1
544521637,0,1,0,0,1
544639215,0,1,0,0,1
544848920,0,1,0,0,1
544900205,1,0,0,0,1
606207422,0,1,0,0,1
606527066,0,1,0,0,1
607328678,1,0,0,0,1
775650612,0,1,0,0,1
767326038,0,1,0,0,1
767675142,0,1,0,0,1
767803314,0,1,0,0,1
768783769,0,1,0,0,1
769334215,0,1,0,0,1
769830710,0,1,0,0,1
772871988,0,1,0,0,1
772939207,0,1,0,0,1
774672882,0,1,0,0,1
774729824,0,1,0,0,1
777280321,0,1,0,0,1
765363750,0,1,0,0,1
777739488,1,0,0,0,1
779901156,0,1,0,0,1
780119348,0,1,0,0,1
780129434,0,1,0,0,1
780167222,0,1,0,0,1
781984435,0,1,0,0,1
782276521,0,1,0,0,1
783012049,0,1,0,0,1
789758190,1,0,0,0,1
789964417,1,0,0,0,1
766547376,0,1,0,0,1
764142572,0,1,0,0,1
792651643,0,1,0,0,1
750413341,0,1,0,0,1
739009470,0,1,0,0,1
739689780,1,0,0,0,1
740985096,0,1,0,0,1
741271117,0,1,0,0,1
747866178,0,1,0,0,1
747866820,0,1,0,0,1
749273556,0,1,0,0,1
749857962,0,1,0,0,1
749908850,0,1,0,0,1
750171446,0,1,0,0,1
751933482,1,0,0,0,1
763010018,1,0,0,0,1
752439026,0,1,0,0,1
753358988,0,1,0,0,1
753656228,1,0,0,0,1
756965726,0,1,0,0,1
757095884,0,1,0,0,1
758352751,0,1,0,0,1
758648268,0,1,0,0,1
758840592,0,1,0,0,1
762329330,0,1,0,0,1
762867913,0,1,0,0,1
792119786,0,1,0,0,1
792803593,0,1,0,0,1
738824491,0,1,0,0,1
837831954,0,1,0,0,1
829858160,0,1,0,0,1
829905602,0,1,0,0,1
831633110,0,1,0,0,1
831891056,0,1,0,0,1
832819514,0,1,0,0,1
833395676,0,1,0,0,1
833651436,0,1,0,0,1
833784134,0,1,0,0,1
833887783,0,1,0,0,1
835786237,0,1,0,0,1
840455929,0,1,0,0,1
826568376,0,1,0,0,1
842237982,0,1,0,0,1
842287706,0,1,0,0,1
843148568,0,1,0,0,1
843337472,0,1,0,0,1
843529218,0,1,0,0,1
844631388,0,1,0,0,1
844813154,0,1,0,0,1
846201024,1,0,0,0,1
846280230,0,1,0,0,1
846466404,0,1,0,0,1
827195166,0,1,0,0,1
825168276,0,1,0,0,1
795986803,0,1,0,0,1
811121437,0,1,0,0,1
796177964,0,1,0,0,1
796501458,0,1,0,0,1
796585778,0,1,0,0,1
800354000,0,1,0,0,1
802717111,0,1,0,0,1
803560250,0,1,0,0,1
809348970,0,0,1,0,1
809359548,0,1,0,0,1
809505366,0,1,0,0,1
811016425,0,1,0,0,1
812572676,0,1,0,0,1
824874241,0,1,0,0,1
815213509,0,1,0,0,1
815457330,1,0,0,0,1
816124796,0,1,0,0,1
817693393,0,1,0,0,1
817714476,0,1,0,0,1
817764446,0,1,0,0,1
817973346,0,1,0,0,1
820877095,0,1,0,0,1
820981158,0,1,0,0,1
823541330,0,1,0,0,1
738966762,0,1,0,0,1
738614977,0,1,0,0,1
607668103,0,1,0,0,1
627188890,0,1,0,0,1
621355415,0,1,0,0,1
621384410,0,1,0,0,1
621552101,1,0,0,0,1
622574329,1,0,0,0,1
622705708,1,0,0,0,1
622969430,0,1,0,0,1
623622781,0,1,0,0,1
624131865,0,1,0,0,1
624163185,0,1,0,0,1
626267421,0,1,0,0,1
627375615,0,1,0,0,1
620460819,0,0,0,1,1
627610591,0,1,0,0,1
627712278,0,1,0,0,1
627732787,0,1,0,0,1
628776245,0,1,0,0,1
628810994,0,1,0,0,1
629359957,0,1,0,0,1
629393451,0,1,0,0,1
630319799,0,1,0,0,1
630518888,0,1,0,0,1
631380165,1,0,0,0,1
620742330,0,1,0,0,1
620094514,0,1,0,0,1
632814671,0,1,0,0,1
614554302,0,1,0,0,1
608952454,0,1,0,0,1
609244293,0,1,0,0,1
610480810,0,1,0,0,1
611538703,0,1,0,0,1
611641560,0,1,0,0,1
611871321,0,1,0,0,1
612549682,0,0,0,1,1
612817586,0,1,0,0,1
612933385,0,1,0,0,1
613588387,0,1,0,0,1
614658358,0,1,0,0,1
619170508,0,1,0,0,1
615544907,0,1,0,0,1
615868759,0,1,0,0,1
616289631,0,1,0,0,1
617171905,0,1,0,0,1
617941747,1,0,0,0,1
618390979,0,1,0,0,1
618620179,0,1,0,0,1
618899048,1,0,0,0,1
618956138,0,1,0,0,1
618977981,0,1,0,0,1
631640810,0,1,0,0,1
632927277,0,1,0,0,1
738537823,0,1,0,0,1
722731813,0,1,0,0,1
715626890,0,1,0,0,1
716055577,0,1,0,0,1
716905889,0,1,0,0,1
718408477,0,1,0,0,1
718487575,0,1,0,0,1
721026414,0,1,0,0,1
721238410,0,1,0,0,1
721724804,1,0,0,0,1
722297126,0,1,0,0,1
722468251,0,1,0,0,1
724521318,0,1,0,0,1
714936254,0,1,0,0,1
724596416,0,1,0,0,1
725556481,0,1,0,0,1
725729624,1,0,0,0,1
726448452,1,0,0,0,1
729053900,0,1,0,0,1
729896617,0,1,0,0,1
730436437,0,1,0,0,1
732509028,1,0,0,0,1
732743912,0,1,0,0,1
733991029,0,1,0,0,1
715559593,0,0,0,1,1
714917501,0,1,0,0,1
634055034,0,1,0,0,1
703392584,0,1,0,0,1
634719721,0,1,0,0,1
636123778,0,1,0,0,1
636490945,0,1,0,0,1
636865886,0,1,0,0,1
700139377,0,1,0,0,1
700181653,0,1,0,0,1
701265511,0,1,0,0,1
702535353,0,1,0,0,1
702667417,0,1,0,0,1
702914063,0,1,0,0,1
704538959,0,1,0,0,1
712739036,0,1,0,0,1
704743837,0,1,0,0,1
705733502,0,1,0,0,1
706120381,0,1,0,0,1
706366472,0,1,0,0,1
707075767,0,1,0,0,1
708283104,0,1,0,0,1
708309848,0,1,0,0,1
708836028,0,1,0,0,1
711284959,0,1,0,0,1
712723219,0,1,0,0,1
510416053,1,0,0,0,1
509257726,0,1,0,0,1
508863113,0,1,0,0,1
386167818,1,0,0,0,1
383795042,0,1,0,0,1
384183959,0,1,0,0,1
384457677,0,1,0,0,1
384860151,0,1,0,0,1
385116008,0,1,0,0,1
385236177,0,1,0,0,1
385335334,0,1,0,0,1
385450179,1,0,0,0,1
385457620,0,1,0,0,1
386024901,0,1,0,0,1
386395995,1,0,0,0,1
381508604,0,1,0,0,1
386496888,0,1,0,0,1
386970664,0,1,0,0,1
387226185,1,0,0,0,1
387259860,0,1,0,0,1
387371212,0,1,0,0,1
388022978,0,1,0,0,1
388371887,0,1,0,0,1
388705915,0,1,0,0,1
390416641,0,0,0,1,1
390463377,0,1,0,0,1
382318059,0,1,0,0,1
381450946,0,1,0,0,1
391591759,0,1,0,0,1
376426042,0,1,0,0,1
372937945,0,1,0,0,1
373408041,1,0,0,0,1
373589831,0,1,0,0,1
373612019,0,1,0,0,1
373967844,0,1,0,0,1
374495432,0,1,0,0,1
375158689,0,1,0,0,1
375216266,0,1,0,0,1
375457887,0,1,0,0,1
376305223,0,1,0,0,1
376922724,0,1,0,0,1
381087875,0,1,0,0,1
378153663,0,1,0,0,1
378354454,0,1,0,0,1
378467909,0,1,0,0,1
379017661,0,1,0,0,1
379583772,0,1,0,0,1
379785338,0,1,0,0,1
379813944,0,1,0,0,1
380664031,0,1,0,0,1
380711569,0,1,0,0,1
380919448,0,1,0,0,1
390616750,0,1,0,0,1
392297951,0,1,0,0,1
372385312,0,1,0,0,1
405925201,0,1,0,0,1
402091536,0,1,0,0,1
402274616,0,1,0,0,1
403118869,0,1,0,0,1
403347105,0,1,0,0,1
404053250,0,1,0,0,1
404698883,0,1,0,0,1
404832579,0,1,0,0,1
404897304,0,1,0,0,1
405058299,0,1,0,0,1
405316441,0,1,0,0,1
406317534,0,1,0,0,1
401409980,0,1,0,0,1
407616996,0,1,0,0,1
407953072,0,1,0,0,1
408612559,0,0,1,0,1
409430647,0,1,0,0,1
410444393,0,1,0,0,1
410828958,0,1,0,0,1
411720323,0,1,0,0,1
412036425,0,1,0,0,1
412041915,0,1,0,0,1
412303858,0,1,0,0,1
401412682,1,0,0,0,1
401371618,0,1,0,0,1
392391095,0,1,0,0,1
396958752,0,1,0,0,1
392678207,0,1,0,0,1
393642362,0,1,0,0,1
393784549,0,1,0,0,1
394131184,0,1,0,0,1
394149441,0,1,0,0,1
394366034,0,1,0,0,1
395154727,0,1,0,0,1
395295255,0,1,0,0,1
395529067,0,0,0,1,1
396609159,0,1,0,0,1
397121088,0,1,0,0,1
400811607,0,1,0,0,1
397545451,1,0,0,0,1
398398978,0,1,0,0,1
398595751,0,1,0,0,1
398656009,0,1,0,0,1
398677223,0,1,0,0,1
399178595,0,1,0,0,1
399482018,0,1,0,0,1
400006205,0,1,0,0,1
400089636,0,1,0,0,1
400092659,0,1,0,0,1
372494314,0,1,0,0,1
372321689,0,1,0,0,1
413121431,0,1,0,0,1
354755715,0,1,0,0,1
352446062,0,1,0,0,1
352600047,0,1,0,0,1
352627276,0,1,0,0,1
352847058,0,1,0,0,1
352899276,0,1,0,0,1
353009761,0,1,0,0,1
353019069,0,1,0,0,1
354042424,0,1,0,0,1
354681314,0,1,0,0,1
354721367,0,1,0,0,1
354856858,1,0,0,0,1
352394401,0,1,0,0,1
354864234,0,0,1,0,1
354966818,0,1,0,0,1
355299886,0,1,0,0,1
356018053,0,1,0,0,1
356357800,0,1,0,0,1
356426733,0,1,0,0,1
356618294,1,0,0,0,1
356723830,0,1,0,0,1
356735197,0,1,0,0,1
357018598,0,1,0,0,1
352422500,0,1,0,0,1
352284213,1,0,0,0,1
357222812,0,1,0,0,1
347972133,0,0,1,0,1
342750849,0,1,0,0,1
343953686,0,1,0,0,1
344230025,0,0,0,1,1
344760040,0,1,0,0,1
345365317,0,1,0,0,1
345462945,0,1,0,0,1
345669076,0,1,0,0,1
346607165,0,1,0,0,1
347454826,0,1,0,0,1
347943008,0,1,0,0,1
348268929,1,0,0,0,1
351871892,0,1,0,0,1
348423019,0,1,0,0,1
348737769,0,1,0,0,1
348799245,0,1,0,0,1
349108265,1,0,0,0,1
350350754,0,1,0,0,1
350446268,0,1,0,0,1
350954186,0,1,0,0,1
351012606,0,1,0,0,1
351336995,0,1,0,0,1
351557165,0,1,0,0,1
357040738,0,1,0,0,1
357483467,0,0,1,0,1
371949020,0,1,0,0,1
367830640,0,1,0,0,1
365555277,0,1,0,0,1
365616192,0,1,0,0,1
365780957,0,1,0,0,1
366006341,0,1,0,0,1
366498596,0,1,0,0,1
366644063,0,1,0,0,1
367040102,0,1,0,0,1
367051987,0,1,0,0,1
367052566,0,1,0,0,1
367562478,1,0,0,0,1
368110292,0,1,0,0,1
364157551,0,1,0,0,1
368166037,1,0,0,0,1
368244653,0,1,0,0,1
368380737,0,1,0,0,1
368651099,0,1,0,0,1
368793055,1,0,0,0,1
368872095,0,1,0,0,1
370135213,0,1,0,0,1
370352072,1,0,0,0,1
370368361,0,1,0,0,1
370530122,0,1,0,0,1
365047482,0,1,0,0,1
363665400,0,1,0,0,1
357626616,0,1,0,0,1
360159353,0,0,1,0,1
358077273,0,1,0,0,1
358383455,0,1,0,0,1
358506497,0,1,0,0,1
358838792,1,0,0,0,1
359092707,0,1,0,0,1
359172185,0,1,0,0,1
359279920,0,1,0,0,1
359494792,0,1,0,0,1
359893164,1,0,0,0,1
359916290,0,1,0,0,1
360398921,0,1,0,0,1
363539578,1,0,0,0,1
360936513,0,1,0,0,1
361300604,0,1,0,0,1
361498497,0,1,0,0,1
361914626,0,1,0,0,1
362084030,0,1,0,0,1
362389696,0,1,0,0,1
362429177,0,0,0,1,1
362441617,0,1,0,0,1
363454014,0,1,0,0,1
363536263,0,1,0,0,1
413108585,0,1,0,0,1
413212673,0,1,0,0,1
507877806,0,1,0,0,1
476983191,0,1,0,0,1
471554585,0,1,0,0,1
471638455,0,1,0,0,1
471774109,0,1,0,0,1
472308682,0,1,0,0,1
472929023,0,1,0,0,1
474106912,0,1,0,0,1
474710330,0,1,0,0,1
475697665,0,1,0,0,1
475901833,0,1,0,0,1
476410624,0,1,0,0,1
477038282,0,1,0,0,1
471062544,0,1,0,0,1
477329300,0,1,0,0,1
477906087,0,1,0,0,1
478748777,0,1,0,0,1
479467597,0,1,0,0,1
480309391,1,0,0,0,1
480749194,0,1,0,0,1
481499244,0,1,0,0,1
481583070,0,1,0,0,1
483330559,0,1,0,0,1
483880632,0,1,0,0,1
471412391,0,1,0,0,1
470834874,0,1,0,0,1
485164901,0,1,0,0,1
466198757,0,1,0,0,1
460411387,0,1,0,0,1
460657625,0,1,0,0,1
461888165,0,1,0,0,1
462249050,0,1,0,0,1
462547996,0,1,0,0,1
462752817,0,1,0,0,1
464260522,1,0,0,0,1
465125848,0,1,0,0,1
465453418,0,1,0,0,1
465561812,0,1,0,0,1
466319594,0,1,0,0,1
470762914,0,1,0,0,1
467119543,1,0,0,0,1
467665293,0,1,0,0,1
467667016,0,1,0,0,1
468648081,1,0,0,0,1
468751390,0,1,0,0,1
468822271,0,1,0,0,1
469354534,0,1,0,0,1
469582871,0,1,0,0,1
469985995,0,0,0,1,1
470047338,0,1,0,0,1
484857964,1,0,0,0,1
485777932,0,1,0,0,1
459768323,0,1,0,0,1
500154514,0,1,0,0,1
496019286,0,1,0,0,1
497268404,0,1,0,0,1
498006308,0,1,0,0,1
498316263,0,1,0,0,1
498939050,0,1,0,0,1
498946625,0,1,0,0,1
499355931,0,1,0,0,1
499460056,0,1,0,0,1
499701897,0,1,0,0,1
499944704,0,1,0,0,1
500564618,0,1,0,0,1
495014044,0,1,0,0,1
500843057,0,1,0,0,1
503468609,0,1,0,0,1
504323467,0,1,0,0,1
504706779,0,1,0,0,1
505983964,0,1,0,0,1
506007359,0,1,0,0,1
506071299,1,0,0,0,1
506078837,0,1,0,0,1
506790080,0,1,0,0,1
506813476,1,0,0,0,1
495412737,0,1,0,0,1
495011812,0,1,0,0,1
486326947,0,1,0,0,1
490630286,0,1,0,0,1
486546354,0,1,0,0,1
487450436,0,1,0,0,1
487702342,0,1,0,0,1
487921454,0,1,0,0,1
489146888,0,1,0,0,1
489331719,0,1,0,0,1
489433036,0,1,0,0,1
489994987,0,1,0,0,1
490328535,0,1,0,0,1
490366025,0,1,0,0,1
491986148,1,0,0,0,1
494872129,0,1,0,0,1
492699729,0,0,0,1,1
492908745,0,1,0,0,1
493023209,0,1,0,0,1
493212231,0,1,0,0,1
493385373,0,1,0,0,1
493432071,0,1,0,0,1
493508075,0,1,0,0,1
493580137,1,0,0,0,1
493613527,0,1,0,0,1
493949099,0,1,0,0,1
460208880,0,1,0,0,1
459517472,0,1,0,0,1
413261107,0,1,0,0,1
435089541,0,1,0,0,1
426611780,0,1,0,0,1
430554407,1,0,0,0,1
430763384,1,0,0,0,1
431117310,0,1,0,0,1
431766511,0,1,0,0,1
432186014,0,1,0,0,1
433410558,0,1,0,0,1
434159032,1,0,0,0,1
434890548,0,1,0,0,1
434899582,0,1,0,0,1
435597701,1,0,0,0,1
425810090,0,1,0,0,1
435619278,0,1,0,0,1
435818561,0,1,0,0,1
436213120,1,0,0,0,1
436438332,0,1,0,0,1
436530738,0,1,0,0,1
436591523,0,1,0,0,1
437326920,0,1,0,0,1
437853191,0,1,0,0,1
438042801,0,0,0,1,1
438215994,0,1,0,0,1
425847418,0,1,0,0,1
425747954,0,1,0,0,1
439876441,0,1,0,0,1
418379990,0,1,0,0,1
413896360,0,1,0,0,1
414010452,0,1,0,0,1
414062221,0,1,0,0,1
414675413,0,1,0,0,1
414997348,0,1,0,0,1
416223315,0,1,0,0,1
416439103,0,1,0,0,1
417758701,1,0,0,0,1
417837124,0,1,0,0,1
418124464,0,1,0,0,1
418479762,0,1,0,0,1
425133057,0,1,0,0,1
418624819,0,1,0,0,1
419610374,0,1,0,0,1
419751488,0,1,0,0,1
419927046,1,0,0,0,1
420961787,0,1,0,0,1
420974358,0,1,0,0,1
420980801,0,1,0,0,1
421584032,1,0,0,0,1
422756654,0,1,0,0,1
424537123,0,1,0,0,1
438668610,0,1,0,0,1
440825189,0,1,0,0,1
459271765,0,1,0,0,1
453440771,0,1,0,0,1
450076586,0,1,0,0,1
450498196,0,1,0,0,1
450599790,0,1,0,0,1
451222468,0,1,0,0,1
451326341,0,1,0,0,1
451538280,0,1,0,0,1
451894137,0,1,0,0,1
452089361,0,1,0,0,1
452848417,0,1,0,0,1
452971935,0,1,0,0,1
454867008,0,1,0,0,1
449591119,0,1,0,0,1
454909858,0,1,0,0,1
455140778,0,1,0,0,1
455323013,0,1,0,0,1
455444984,0,1,0,0,1
456050488,0,1,0,0,1
457729770,0,1,0,0,1
458338722,1,0,0,0,1
458801378,0,1,0,0,1
459089418,0,1,0,0,1
459120887,0,1,0,0,1
449860327,1,0,0,0,1
449551563,0,1,0,0,1
440857558,0,1,0,0,1
446547818,0,1,0,0,1
442749777,0,1,0,0,1
443115302,0,1,0,0,1
443844472,0,1,0,0,1
443878984,0,1,0,0,1
444067080,0,1,0,0,1
444841941,0,1,0,0,1
445028495,0,1,0,0,1
445222500,1,0,0,0,1
445411266,0,1,0,0,1
446049542,0,1,0,0,1
446754629,0,1,0,0,1
449315888,1,0,0,0,1
446982484,0,1,0,0,1
447244230,0,1,0,0,1
447831920,1,0,0,0,1
447930960,0,1,0,0,1
448822335,0,1,0,0,1
448864362,0,1,0,0,1
448935025,0,1,0,0,1
448983081,0,1,0,0,1
449039515,0,1,0,0,1
449128142,0,1,0,0,1
846962186,0,1,0,0,1
848326772,0,1,0,0,1
1013403741582712832,1,0,0,0,1
849282614,0,1,0,0,1
1548416174,0,1,0,0,1
1549677294,0,1,0,0,1
1551994398,0,1,0,0,1
1554914251,0,1,0,0,1
1556419213,0,1,0,0,1
1559841722,1,0,0,0,1
1566979742,0,1,0,0,1
1567433539,0,1,0,0,1
1568124685,0,1,0,0,1
1568994200,0,1,0,0,1
1569462584,0,1,0,0,1
1570809030,0,1,0,0,1
1571426593,0,1,0,0,1
1573752842,1,0,0,0,1
1574602434,0,1,0,0,1
1575511532,0,1,0,0,1
1575715022,0,1,0,0,1
1577384395,0,1,0,0,1
1579121173,1,0,0,0,1
1579305500,0,1,0,0,1
1579554109,0,1,0,0,1
1582845427,0,1,0,0,1
1584367615,0,1,0,0,1
1547222298,0,1,0,0,1
1544074237,0,1,0,0,1
1542420788,0,1,0,0,1
1524168474,0,1,0,0,1
1498359450,1,0,0,0,1
1498443950,0,1,0,0,1
1499091486,0,1,0,0,1
1503016058,0,1,0,0,1
1509465397,0,1,0,0,1
1510044290,0,1,0,0,1
1513140788,0,1,0,0,1
1514639766,0,1,0,0,1
1519115827,0,1,0,0,1
1521675126,0,1,0,0,1
1525285584,0,1,0,0,1
1542363728,0,1,0,0,1
1528342958,0,1,0,0,1
1528511708,0,1,0,0,1
1530238602,1,0,0,0,1
1530714462,1,0,0,0,1
1533051560,0,1,0,0,1
1537285776,0,1,0,0,1
1537818132,0,1,0,0,1
1542033073,0,1,0,0,1
1542166158,0,1,0,0,1
1542195302,0,1,0,0,1
1586711246,0,1,0,0,1
1587270518,0,1,0,0,1
1587676982,0,1,0,0,1
1639062068,0,1,0,0,1
1630290877,0,1,0,0,1
1630571383,0,1,0,0,1
1632755828,0,1,0,0,1
1634473694,0,1,0,0,1
1634621516,0,1,0,0,1
1634754552,0,1,0,0,1
1635231799,0,1,0,0,1
1635619574,0,1,0,0,1
1636096532,0,1,0,0,1
1638829039,0,0,0,1,1
1639605836,0,1,0,0,1
1629960799,0,1,0,0,1
1640756348,0,1,0,0,1
1641271261,0,1,0,0,1
1641654530,0,1,0,0,1
1642114802,0,1,0,0,1
1642124804,0,1,0,0,1
1642815073,0,1,0,0,1
1643240712,0,1,0,0,1
1643463025,0,1,0,0,1
1645146661,0,1,0,0,1
1647666583,0,1,0,0,1
1630047102,1,0,0,0,1
1628735084,0,1,0,0,1
1588392559,1,0,0,0,1
1612154292,0,1,0,0,1
1594164756,0,1,0,0,1
1595655330,0,1,0,0,1
1597556366,0,1,0,0,1
1597648710,0,1,0,0,1
1597792074,0,1,0,0,1
1601825364,0,1,0,0,1
1602679219,0,1,0,0,1
1605574513,0,1,0,0,1
1609849620,0,1,0,0,1
1611503244,0,1,0,0,1
1613332159,0,1,0,0,1
1623657032,0,1,0,0,1
1613350603,0,1,0,0,1
1613562120,0,1,0,0,1
1614178136,1,0,0,0,1
1614436734,0,1,0,0,1
1615846218,0,1,0,0,1
1616603263,0,1,0,0,1
1617214447,0,1,0,0,1
1619695669,1,0,0,0,1
1620010466,0,1,0,0,1
1620565309,0,1,0,0,1
1497497863,0,1,0,0,1
1495284991,0,1,0,0,1
1495108310,1,0,0,0,1
1406382151,0,1,0,0,1
1398528284,0,1,0,0,1
1399465350,0,1,0,0,1
1400015605,0,1,0,0,1
1400875652,0,1,0,0,1
1401433206,1,0,0,0,1
1401928849,0,0,0,1,1
1403224639,0,1,0,0,1
1403443513,0,1,0,0,1
1404231890,1,0,0,0,1
1405633634,0,1,0,0,1
1406869602,0,1,0,0,1
1397638838,0,1,0,0,1
1407048536,0,1,0,0,1
1409349180,0,1,0,0,1
1410511351,1,0,0,0,1
1411233132,0,1,0,0,1
1412080921,0,1,0,0,1
1415149603,0,1,0,0,1
1416114738,1,0,0,0,1
1418775942,0,1,0,0,1
1419197923,0,1,0,0,1
1420660507,1,0,0,0,1
1398027108,1,0,0,0,1
1394022559,0,0,0,1,1
1422306337,1,0,0,0,1
1382015293,0,1,0,0,1
1376916704,0,1,0,0,1
1377020934,0,1,0,0,1
1377958382,0,1,0,0,1
1377974166,0,1,0,0,1
1379384257,0,0,0,1,1
1380252702,0,1,0,0,1
1380338395,0,1,0,0,1
1380952794,0,1,0,0,1
1381577263,0,1,0,0,1
1381754197,0,1,0,0,1
1382889001,1,0,0,0,1
1394014164,0,1,0,0,1
1383647425,0,1,0,0,1
1383905040,0,1,0,0,1
1385691727,0,1,0,0,1
1386332545,0,1,0,0,1
1386803540,0,1,0,0,1
1388536580,0,1,0,0,1
1388574187,0,1,0,0,1
1388679715,0,1,0,0,1
1389669301,0,1,0,0,1
1393780544,0,1,0,0,1
1421052404,0,1,0,0,1
1423609249,0,1,0,0,1
1494890120,0,1,0,0,1
1474827432,0,1,0,0,1
1459832660,0,1,0,0,1
1460168426,0,1,0,0,1
1462312548,0,1,0,0,1
1463877786,0,1,0,0,1
1466009443,0,1,0,0,1
1469569568,1,0,0,0,1
1471195820,1,0,0,0,1
1472656208,0,1,0,0,1
1474274960,0,1,0,0,1
1474623270,0,1,0,0,1
1479502783,0,1,0,0,1
1459355784,0,1,0,0,1
1480270676,1,0,0,0,1
1482621210,0,1,0,0,1
1484123412,1,0,0,0,1
1486079425,0,1,0,0,1
1489124316,0,1,0,0,1
1491249138,0,1,0,0,1
1491795722,0,1,0,0,1
1492740504,0,1,0,0,1
1493721812,0,1,0,0,1
1493798233,0,1,0,0,1
1459827733,0,1,0,0,1
1458832958,0,1,0,0,1
1424845836,0,1,0,0,1
1437563413,0,1,0,0,1
1425968222,0,1,0,0,1
1426936788,1,0,0,0,1
1428238530,0,1,0,0,1
1428750848,0,0,0,1,1
1429384620,0,1,0,0,1
1432369292,0,1,0,0,1
1433499446,0,1,0,0,1
1434240264,0,1,0,0,1
1435650636,1,0,0,0,1
1436593424,0,1,0,0,1
1439570552,0,1,0,0,1
1456075650,0,1,0,0,1
1441186956,0,1,0,0,1
1442168893,0,1,0,0,1
1443408200,0,1,0,0,1
1444874916,0,1,0,0,1
1445760379,0,1,0,0,1
1447928358,0,1,0,0,1
1449796752,0,1,0,0,1
1449806725,0,1,0,0,1
1451895655,0,0,0,1,1
1452876200,0,0,0,1,1
1648464552,1,0,0,0,1
1648684718,0,1,0,0,1
1649395076,0,1,0,0,1
1965998389,0,1,0,0,1
1956573918,0,1,0,0,1
1956609788,0,1,0,0,1
1957610664,1,0,0,0,1
1957776048,0,1,0,0,1
1958386861,0,1,0,0,1
1959103584,0,1,0,0,1
1959316134,0,1,0,0,1
1963497451,0,1,0,0,1
1963887212,0,1,0,0,1
1965266412,0,1,0,0,1
1966458108,0,1,0,0,1
1952038178,0,1,0,0,1
1966608024,0,1,0,0,1
1969127310,0,1,0,0,1
1972656259,0,1,0,0,1
1972812913,1,0,0,0,1
1974188048,0,1,0,0,1
1975095553,0,1,0,0,1
1977806250,0,1,0,0,1
2147560046,0,1,0,0,1
2148317009,0,1,0,0,1
2148874381,0,1,0,0,1
1956128190,0,1,0,0,1
1951305830,0,1,0,0,1
2151231491,0,1,0,0,1
1939118838,0,1,0,0,1
1926381835,0,1,0,0,1
1926571112,0,1,0,0,1
1929624919,0,1,0,0,1
1933434396,1,0,0,0,1
1933974584,1,0,0,0,1
1935167622,0,1,0,0,1
1935488797,0,0,1,0,1
1935533382,0,1,0,0,1
1936008260,1,0,0,0,1
1938118614,1,0,0,0,1
1939363458,0,1,0,0,1
1951267423,0,1,0,0,1
1940123004,0,1,0,0,1
1940335674,0,1,0,0,1
1941829034,0,1,0,0,1
1942241203,0,1,0,0,1
1942268142,0,1,0,0,1
1942550096,0,1,0,0,1
1942931346,0,1,0,0,1
1947021120,0,1,0,0,1
1947665678,0,1,0,0,1
1949789970,0,1,0,0,1
2150780989,0,1,0,0,1
2151382419,0,1,0,0,1
1924165885,0,1,0,0,1
2179702384,0,1,0,0,1
2172355107,0,1,0,0,1
2172537020,0,1,0,0,1
2172771908,0,1,0,0,1
2172792596,0,1,0,0,1
2173135652,0,1,0,0,1
2175494289,1,0,0,0,1
2175541491,0,1,0,0,1
2176145596,0,1,0,0,1
2176980906,0,1,0,0,1
2178932921,0,1,0,0,1
2182161285,0,1,0,0,1
2171563669,0,1,0,0,1
2182945495,0,1,0,0,1
2183280949,0,1,0,0,1
2183831138,0,1,0,0,1
2187057823,0,1,0,0,1
2187326844,0,1,0,0,1
2187763662,1,0,0,0,1
2188834622,0,1,0,0,1
2189257184,0,1,0,0,1
2190334998,0,1,0,0,1
2190442219,0,1,0,0,1
2171684202,0,1,0,0,1
2171073004,0,1,0,0,1
2151411331,0,1,0,0,1
2158518749,0,1,0,0,1
2152260307,1,0,0,0,1
2154600757,1,0,0,0,1
2156117647,0,1,0,0,1
2156247954,0,0,0,1,1
2156568281,1,0,0,0,1
2156707217,0,1,0,0,1
2156996686,0,1,0,0,1
2157335518,0,1,0,0,1
2157993271,0,1,0,0,1
2158263224,1,0,0,0,1
2159182919,0,1,0,0,1
2170863705,0,1,0,0,1
2159724481,0,1,0,0,1
2159927317,0,1,0,0,1
2160115334,0,1,0,0,1
2161001936,0,1,0,0,1
2162247648,0,1,0,0,1
2162505121,0,1,0,0,1
2163038654,1,0,0,0,1
2165014755,0,1,0,0,1
2165292985,0,1,0,0,1
2169506769,0,1,0,0,1
1924302038,0,1,0,0,1
1923037316,0,1,0,0,1
1650852283,0,0,0,1,1
1708221920,0,1,0,0,1
1695055171,0,1,0,0,1
1697283991,0,1,0,0,1
1700235530,0,1,0,0,1
1700496414,0,1,0,0,1
1700839333,1,0,0,0,1
1703575711,0,1,0,0,1
1704803424,1,0,0,0,1
1705446878,0,1,0,0,1
1705555334,0,1,0,0,1
1706203484,0,1,0,0,1
1708818446,0,1,0,0,1
1686270774,0,1,0,0,1
1708850952,0,1,0,0,1
1709441216,1,0,0,0,1
1709623406,0,1,0,0,1
1710754548,0,1,0,0,1
1716011582,0,1,0,0,1
1716341844,0,1,0,0,1
1716689636,0,1,0,0,1
1717530120,0,1,0,0,1
1719413420,0,1,0,0,1
1720130736,0,1,0,0,1
1689445836,0,1,0,0,1
1680873980,0,1,0,0,1
1720624057,0,1,0,0,1
1660534129,0,1,0,0,1
1650852470,0,1,0,0,1
1651356026,0,1,0,0,1
1651593949,0,1,0,0,1
1653712531,0,1,0,0,1
1655332544,0,1,0,0,1
1656449802,0,1,0,0,1
1657315094,0,1,0,0,1
1657850532,0,1,0,0,1
1658840035,0,1,0,0,1
1659840019,0,1,0,0,1
1661746291,0,1,0,0,1
1680691602,0,1,0,0,1
1663788606,0,0,0,1,1
1665855062,0,1,0,0,1
1667551495,0,1,0,0,1
1668942228,0,1,0,0,1
1669662242,0,0,0,1,1
1670922901,1,0,0,0,1
1671240728,0,1,0,0,1
1671440533,0,1,0,0,1
1673642690,0,1,0,0,1
1675740746,0,1,0,0,1
1720530361,0,1,0,0,1
1721163391,0,1,0,0,1
1920862219,0,1,0,0,1
1905090132,0,0,0,1,1
1880752675,1,0,0,0,1
1881598274,0,1,0,0,1
1895389285,0,1,0,0,1
1895637186,0,1,0,0,1
1896310374,0,1,0,0,1
1898579287,0,1,0,0,1
1901064403,0,1,0,0,1
1901928318,0,1,0,0,1
1903190430,0,1,0,0,1
1904096227,0,1,0,0,1
1907464758,0,1,0,0,1
1875357092,1,0,0,0,1
1907887302,0,1,0,0,1
1909800750,0,1,0,0,1
1910077447,1,0,0,0,1
1913115854,0,1,0,0,1
1913520505,0,1,0,0,1
1913778362,0,1,0,0,1
1916130020,0,1,0,0,1
1916770142,0,0,0,1,1
1917952015,0,1,0,0,1
1920207108,1,0,0,0,1
1878779060,0,1,0,0,1
1870454846,0,1,0,0,1
1722820116,0,1,0,0,1
1751172308,0,1,0,0,1
1723748329,0,1,0,0,1
1725173785,0,1,0,0,1
1725434742,0,1,0,0,1
1727314639,0,1,0,0,1
1728203492,1,0,0,0,1
1728257502,0,1,0,0,1
1728476185,0,1,0,0,1
1731803408,0,1,0,0,1
1731878623,0,1,0,0,1
1745992820,0,1,0,0,1
1801216266,0,1,0,0,1
1867750286,0,1,0,0,1
1841823164,0,1,0,0,1
1853059508,0,1,0,0,1
1855483843,0,1,0,0,1
1857637051,0,1,0,0,1
1857753552,0,1,0,0,1
1858137038,0,1,0,0,1
1862733978,0,1,0,0,1
1864161151,0,1,0,0,1
1864353360,0,1,0,0,1
1864634510,1,0,0,0,1
1376496793,0,1,0,0,1
1376320862,0,1,0,0,1
1376118960,1,0,0,0,1
987139884,0,1,0,0,1
973800864,0,1,0,0,1
974256044,1,0,0,0,1
974321701,0,1,0,0,1
974633478,0,1,0,0,1
975693842,0,1,0,0,1
976559744,0,1,0,0,1
977965044,0,1,0,0,1
979473504,0,1,0,0,1
980954498,0,1,0,0,1
982767486,0,1,0,0,1
988770980,0,1,0,0,1
972777445,0,1,0,0,1
989520133,0,1,0,0,1
989966720,0,1,0,0,1
991539960,0,1,0,0,1
992675120,0,1,0,0,1
995623958,0,1,0,0,1
995702654,0,1,0,0,1
996626748,0,1,0,0,1
997275560,0,1,0,0,1
997933304,0,1,0,0,1
998607444,0,1,0,0,1
972951524,0,1,0,0,1
971985872,0,1,0,0,1
1003493924,0,0,0,1,1
960187993,0,1,0,0,1
950426113,0,1,0,0,1
950593608,0,1,0,0,1
950738846,0,1,0,0,1
950964804,0,1,0,0,1
951015428,0,1,0,0,1
952384224,0,1,0,0,1
953532840,0,1,0,0,1
954329431,0,1,0,0,1
954758785,0,1,0,0,1
956257160,0,1,0,0,1
960365364,0,1,0,0,1
970577438,0,1,0,0,1
961891465,0,1,0,0,1
962205138,0,1,0,0,1
962212218,0,1,0,0,1
962902706,1,0,0,0,1
964206074,0,1,0,0,1
964749355,0,1,0,0,1
966485550,0,1,0,0,1
967625413,0,1,0,0,1
968465732,0,1,0,0,1
968932484,0,1,0,0,1
999453985,0,1,0,0,1
1003697563,0,1,0,0,1
949242157,0,1,0,0,1
1063573248,0,1,0,0,1
1044907412,0,1,0,0,1
1052490656,0,1,0,0,1
1053690662,0,1,0,0,1
1054783375,0,1,0,0,1
1055423454,0,1,0,0,1
1056716616,0,1,0,0,1
1060795518,0,1,0,0,1
1061187211,0,1,0,0,1
1061475000,0,1,0,0,1
1062488071,0,1,0,0,1
1064601757,0,1,0,0,1
1042572835,0,1,0,0,1
1066544490,0,1,0,0,1
1068427057,0,1,0,0,1
1068587059,0,1,0,0,1
1068822073,0,1,0,0,1
1069218200,0,1,0,0,1
1071113982,0,1,0,0,1
1072651464,0,1,0,0,1
1074394117,0,1,0,0,1
1075830284,0,1,0,0,1
1076576528,1,0,0,0,1
1043343001,0,1,0,0,1
1041827383,0,1,0,0,1
1003715096,0,1,0,0,1
1020931404,0,1,0,0,1
1004422837,0,1,0,0,1
1005897374,0,1,0,0,1
1006761036,0,1,0,0,1
1009150550,0,1,0,0,1
1009726212,0,1,0,0,1
1013597078,0,1,0,0,1
1014959593,0,1,0,0,1
1015770067,0,1,0,0,1
1017962856,0,1,0,0,1
1020114060,0,1,0,0,1
1023523518,0,1,0,0,1
1039389408,0,1,0,0,1
1023976542,0,1,0,0,1
1025457560,0,1,0,0,1
1026931448,0,1,0,0,1
1026998827,0,1,0,0,1
1030023697,0,1,0,0,1
1032111450,0,1,0,0,1
1033441682,0,1,0,0,1
1035184014,0,1,0,0,1
1036849574,0,1,0,0,1
1038728899,0,1,0,0,1
950222971,1,0,0,0,1
949065049,0,1,0,0,1
1077644101,1,0,0,0,1
874127101,0,1,0,0,1
866520288,0,1,0,0,1
866588360,0,1,0,0,1
867104258,0,1,0,0,1
867343717,0,1,0,0,1
868730347,0,0,0,1,1
869539909,0,1,0,0,1
870427268,0,1,0,0,1
871827452,0,1,0,0,1
872928668,0,1,0,0,1
873281912,0,1,0,0,1
874655964,0,1,0,0,1
866219268,1,0,0,0,1
876494323,0,1,0,0,1
876495883,0,1,0,0,1
877279404,0,1,0,0,1
878225881,0,1,0,0,1
878498221,0,1,0,0,1
879785984,0,1,0,0,1
881956772,0,1,0,0,1
883141267,0,1,0,0,1
883343270,0,1,0,0,1
886229340,0,1,0,0,1
866479003,0,1,0,0,1
865539751,1,0,0,0,1
894085897,0,1,0,0,1
859245775,0,1,0,0,1
852203360,0,1,0,0,1
853224583,0,1,0,0,1
854153089,0,1,0,0,1
854614172,0,1,0,0,1
854719940,0,1,0,0,1
856133702,0,1,0,0,1
856458030,0,1,0,0,1
856714284,1,0,0,0,1
858042895,0,1,0,0,1
858411066,0,1,0,0,1
859872914,0,1,0,0,1
865027315,0,1,0,0,1
860678558,0,1,0,0,1
860686074,0,1,0,0,1
861508788,0,1,0,0,1
861541208,0,1,0,0,1
861757123,0,1,0,0,1
861927176,0,1,0,0,1
862168244,0,1,0,0,1
862567326,0,1,0,0,1
864058542,0,1,0,0,1
864610968,0,1,0,0,1
891891343,0,1,0,0,1
894437281,0,1,0,0,1
948978698,0,1,0,0,1
937995211,0,1,0,0,1
923714700,0,1,0,0,1
924271441,0,1,0,0,1
925060580,0,1,0,0,1
926632874,0,1,0,0,1
926907572,0,1,0,0,1
928163065,0,1,0,0,1
929716224,0,1,0,0,1
933592682,0,1,0,0,1
937076815,0,1,0,0,1
937798410,0,1,0,0,1
939239299,0,1,0,0,1
923439529,0,1,0,0,1
939985344,0,1,0,0,1
940368710,0,1,0,0,1
942041299,0,1,0,0,1
942447002,0,1,0,0,1
943126189,0,1,0,0,1
945392557,1,0,0,0,1
946694976,0,1,0,0,1
947698956,0,1,0,0,1
947861256,0,1,0,0,1
948575924,0,1,0,0,1
923535654,0,1,0,0,1
921163177,0,1,0,0,1
894808080,0,1,0,0,1
904408999,0,1,0,0,1
894848952,0,1,0,0,1
894989270,0,0,0,1,1
895255477,0,1,0,0,1
895278246,0,0,0,1,1
895543861,0,0,1,0,1
897250231,0,1,0,0,1
898979912,0,1,0,0,1
899480082,0,1,0,0,1
899937175,0,1,0,0,1
902250962,0,1,0,0,1
905134842,0,1,0,0,1
920257832,0,1,0,0,1
906931910,0,1,0,0,1
907209762,0,1,0,0,1
907559851,0,1,0,0,1
910821878,0,1,0,0,1
913383950,0,1,0,0,1
913573256,0,1,0,0,1
915837860,0,1,0,0,1
916926925,0,1,0,0,1
917733559,0,1,0,0,1
917902064,0,1,0,0,1
1077210452,0,1,0,0,1
1079789341,1,0,0,0,1
1375149396,0,1,0,0,1
1278878677,0,1,0,0,1
1268122225,0,1,0,0,1
1270981032,0,1,0,0,1
1271032176,0,1,0,0,1
1273053788,0,1,0,0,1
1275147924,0,1,0,0,1
1275629066,1,0,0,0,1
1275695197,0,1,0,0,1
1276308218,0,1,0,0,1
1276898760,0,1,0,0,1
1277401440,0,1,0,0,1
1279559982,0,1,0,0,1
1267055490,0,1,0,0,1
1280006689,0,1,0,0,1
1281485688,0,1,0,0,1
1283518398,0,1,0,0,1
1284024259,0,1,0,0,1
1287353113,1,0,0,0,1
1291036891,1,0,0,0,1
1291440763,1,0,0,0,1
1292215142,0,1,0,0,1
1292755668,0,1,0,0,1
1293369691,1,0,0,0,1
1267075441,0,1,0,0,1
1266059138,0,1,0,0,1
1304880222,0,1,0,0,1
1246335564,0,1,0,0,1
1239970512,0,1,0,0,1
1241224446,0,1,0,0,1
1241714936,0,1,0,0,1
1242015180,0,1,0,0,1
1242607230,0,1,0,0,1
1242631568,0,1,0,0,1
1243143362,0,1,0,0,1
1244628151,0,1,0,0,1
1244630864,0,1,0,0,1
1244750184,0,1,0,0,1
1247478678,0,1,0,0,1
1264568815,0,1,0,0,1
1248029941,0,1,0,0,1
1248395094,0,1,0,0,1
1249610618,0,1,0,0,1
1249806624,0,1,0,0,1
1252650084,0,1,0,0,1
1259805054,0,1,0,0,1
1261927339,0,1,0,0,1
1263649758,0,1,0,0,1
1264294789,0,1,0,0,1
1264393794,0,1,0,0,1
1294938084,0,1,0,0,1
1307408017,0,1,0,0,1
1238961846,0,1,0,0,1
1363188074,0,1,0,0,1
1355024335,0,1,0,0,1
1356012554,0,1,0,0,1
1356092868,0,1,0,0,1
1356553872,0,1,0,0,1
1359457279,0,1,0,0,1
1361122338,0,1,0,0,1
1361410190,1,0,0,0,1
1361603298,0,1,0,0,1
1361933204,0,1,0,0,1
1362305016,0,1,0,0,1
1363429915,0,1,0,0,1
1349706391,0,1,0,0,1
1364080664,0,1,0,0,1
1367214062,0,1,0,0,1
1368742524,0,1,0,0,1
1370038970,0,1,0,0,1
1370048533,0,1,0,0,1
1370130464,0,1,0,0,1
1372426416,0,1,0,0,1
1372854697,0,1,0,0,1
1372878385,0,1,0,0,1
1373462214,0,1,0,0,1
1351328335,0,1,0,0,1
1349658054,0,1,0,0,1
1309980157,0,1,0,0,1
1333995582,0,1,0,0,1
1313612964,0,1,0,0,1
1318582820,0,1,0,0,1
1319587080,0,1,0,0,1
1324265089,0,1,0,0,1
1326356436,0,1,0,0,1
1327101380,0,1,0,0,1
1330164980,0,1,0,0,1
1330955659,0,1,0,0,1
1331555330,0,1,0,0,1
1332583740,0,1,0,0,1
1338808598,0,1,0,0,1
1349076812,1,0,0,0,1
1339331474,0,1,0,0,1
1339745942,0,1,0,0,1
1340717149,0,1,0,0,1
1341532238,0,1,0,0,1
1343131488,0,1,0,0,1
1344185875,0,1,0,0,1
1345122001,1,0,0,0,1
1345222153,0,0,0,1,1
1346156984,0,1,0,0,1
1348681604,0,1,0,0,1
1239689173,0,1,0,0,1
1231213188,0,1,0,0,1
1080280674,0,1,0,0,1
1128905647,0,1,0,0,1
1111698085,1,0,0,0,1
1117702423,0,1,0,0,1
1118449106,0,1,0,0,1
1119372679,0,1,0,0,1
1119657254,0,1,0,0,1
1120323655,0,1,0,0,1
1123044792,0,1,0,0,1
1127145776,0,1,0,0,1
1128291102,0,1,0,0,1
1128799927,0,1,0,0,1
1129414574,0,1,0,0,1
1109691894,0,1,0,0,1
1132711926,0,1,0,0,1
1133876100,0,1,0,0,1
1133913066,0,1,0,0,1
1134550993,0,1,0,0,1
1135261376,0,1,0,0,1
1135452404,0,1,0,0,1
1135653278,1,0,0,0,1
1135655353,0,1,0,0,1
1138511886,1,0,0,0,1
1138727461,0,1,0,0,1
1111352851,1,0,0,0,1
1104959191,0,1,0,0,1
1141650284,0,1,0,0,1
1092543320,0,1,0,0,1
1080664074,0,1,0,0,1
1081762880,0,1,0,0,1
1082096378,0,1,0,0,1
1083504668,0,1,0,0,1
1085802114,0,1,0,0,1
1085833760,0,0,1,0,1
1089674138,0,1,0,0,1
1089888206,0,1,0,0,1
1090072544,0,1,0,0,1
1090886666,0,1,0,0,1
1094321378,1,0,0,0,1
1103800004,0,1,0,0,1
1096566492,0,1,0,0,1
1096914824,0,1,0,0,1
1098639504,0,1,0,0,1
1099297849,0,1,0,0,1
1100966820,0,1,0,0,1
1100974981,0,1,0,0,1
1102749780,0,1,0,0,1
1103337601,1,0,0,0,1
1103510845,0,1,0,0,1
1103549630,0,1,0,0,1
1141369946,0,1,0,0,1
1145033124,1,0,0,0,1
1230072889,1,0,0,0,1
1209852079,1,0,0,0,1
1186010353,0,1,0,0,1
1189015399,0,1,0,0,1
1190058655,0,1,0,0,1
1196511583,0,0,0,1,1
1197603300,0,1,0,0,1
1199596897,0,1,0,0,1
1202474442,0,1,0,0,1
1204486476,0,1,0,0,1
1207491504,1,0,0,0,1
1209775939,0,1,0,0,1
1213706269,0,1,0,0,1
1182840414,0,1,0,0,1
1214247134,0,1,0,0,1
1219866673,0,1,0,0,1
1220646702,0,1,0,0,1
1222227577,0,1,0,0,1
1222879957,0,1,0,0,1
1224247639,0,1,0,0,1
1228930686,0,0,0,1,1
1229024492,0,1,0,0,1
1229478308,0,1,0,0,1
1229560471,0,1,0,0,1
1185280417,0,1,0,0,1
1182577705,0,1,0,0,1
1145371765,0,1,0,0,1
1156784420,0,1,0,0,1
1145853367,0,1,0,0,1
1147593619,0,1,0,0,1
1148137772,0,1,0,0,1
1149293880,0,1,0,0,1
1151699862,0,1,0,0,1
1154178342,0,1,0,0,1
1155210126,0,1,0,0,1
1155227095,0,1,0,0,1
1155632521,0,1,0,0,1
1156528562,1,0,0,0,1
1159546070,0,1,0,0,1
1181753989,0,1,0,0,1
1163861083,0,1,0,0,1
1167179971,0,1,0,0,1
1167369853,0,1,0,0,1
1167793621,0,1,0,0,1
1170119918,0,1,0,0,1
1173123414,0,1,0,0,1
1176618985,0,1,0,0,1
1178897126,0,1,0,0,1
1180687520,0,1,0,0,1
1181702916,0,1,0,0,1
342712869,0,1,0,0,1
342578206,0,1,0,0,1
341805227,0,1,0,0,1
341713853,0,1,0,0,1
60307399,0,1,0,0,1
60308878,0,1,0,0,1
60410054,0,1,0,0,1
60520887,1,0,0,0,1
61399101,0,1,0,0,1
61711527,1,0,0,0,1
61768027,0,1,0,0,1
62096734,0,1,0,0,1
62158968,0,0,1,0,1
62905376,0,1,0,0,1
63117184,0,1,0,0,1
63793432,0,1,0,0,1
64076505,0,1,0,0,1
64413785,0,1,0,0,1
64430820,0,1,0,0,1
64660318,0,1,0,0,1
64668680,0,0,0,1,1
64783801,0,1,0,0,1
65096199,1,0,0,0,1
65294642,0,1,0,0,1
65484730,0,1,0,0,1
65499719,0,1,0,0,1
65603222,0,1,0,0,1
60262565,0,1,0,0,1
59296465,0,1,0,0,1
59044634,0,1,0,0,1
57253726,0,1,0,0,1
56070951,0,1,0,0,1
56144337,0,1,0,0,1
56312588,0,1,0,0,1
56516996,0,1,0,0,1
56546857,0,1,0,0,1
56711401,0,1,0,0,1
56798124,0,1,0,0,1
56817654,0,1,0,0,1
56952353,0,1,0,0,1
57069451,0,1,0,0,1
57290641,0,1,0,0,1
59029942,0,1,0,0,1
57361960,1,0,0,0,1
57363765,0,1,0,0,1
57774733,0,1,0,0,1
57868977,0,1,0,0,1
58247771,0,1,0,0,1
58290199,0,1,0,0,1
58594493,0,1,0,0,1
58598931,0,1,0,0,1
58627467,0,1,0,0,1
58974496,0,1,0,0,1
66042325,0,1,0,0,1
66109255,0,1,0,0,1
66132112,0,1,0,0,1
73678133,0,1,0,0,1
70994984,0,1,0,0,1
71610175,0,1,0,0,1
71624044,0,1,0,0,1
71843373,1,0,0,0,1
71895505,0,1,0,0,1
71977357,0,1,0,0,1
72577362,0,1,0,0,1
72866543,0,1,0,0,1
73262946,0,1,0,0,1
73355794,0,1,0,0,1
73922045,0,1,0,0,1
70166896,0,1,0,0,1
73922428,1,0,0,0,1
73973309,1,0,0,0,1
74138446,0,1,0,0,1
74149816,0,1,0,0,1
74155049,1,0,0,0,1
74219825,0,1,0,0,1
74221595,0,1,0,0,1
74234663,1,0,0,0,1
74311481,0,1,0,0,1
74418438,0,1,0,0,1
70654263,0,1,0,0,1
69863089,0,1,0,0,1
66344113,1,0,0,0,1
68256895,0,1,0,0,1
66360919,1,0,0,0,1
66550558,1,0,0,0,1
66680736,0,1,0,0,1
66747851,1,0,0,0,1
67101154,0,1,0,0,1
67169191,0,1,0,0,1
67269254,0,1,0,0,1
67498723,0,1,0,0,1
67860334,0,1,0,0,1
67871827,0,1,0,0,1
68387728,0,1,0,0,1
69822062,0,1,0,0,1
68397950,0,1,0,0,1
68474429,0,1,0,0,1
68548942,0,1,0,0,1
68761080,0,1,0,0,1
68945734,0,1,0,0,1
69324466,0,1,0,0,1
69365666,0,1,0,0,1
69553185,0,1,0,0,1
69686812,0,1,0,0,1
69816689,0,1,0,0,1
55912694,0,1,0,0,1
55875864,1,0,0,0,1
55671434,0,1,0,0,1
48038499,0,1,0,0,1
47233118,0,1,0,0,1
47271630,0,1,0,0,1
47496394,0,1,0,0,1
47498331,0,0,0,1,1
47548739,0,1,0,0,1
47567273,0,1,0,0,1
47572953,1,0,0,0,1
47844265,0,1,0,0,1
47863689,0,1,0,0,1
48009388,0,1,0,0,1
48104665,1,0,0,0,1
47096359,0,1,0,0,1
48139252,0,1,0,0,1
48238605,0,1,0,0,1
48339984,0,1,0,0,1
48391014,0,1,0,0,1
48393997,0,1,0,0,1
48404838,0,1,0,0,1
48508105,0,1,0,0,1
48599448,0,1,0,0,1
48668822,0,1,0,0,1
48691267,0,0,0,1,1
47215304,0,1,0,0,1
47074725,0,1,0,0,1
48815236,0,1,0,0,1
45998359,0,1,0,0,1
44844855,0,1,0,0,1
44961616,1,0,0,0,1
44983352,0,1,0,0,1
45321454,0,1,0,0,1
45345857,0,1,0,0,1
45413265,0,1,0,0,1
45690558,0,1,0,0,1
45874570,0,1,0,0,1
45895882,0,1,0,0,1
45983649,0,1,0,0,1
46079500,0,0,0,1,1
46960869,0,1,0,0,1
46225351,0,1,0,0,1
46369866,0,1,0,0,1
46463494,0,1,0,0,1
46512964,0,1,0,0,1
46681512,0,1,0,0,1
46712862,1,0,0,0,1
46868596,0,1,0,0,1
46892849,0,1,0,0,1
46914176,0,1,0,0,1
46921058,0,1,0,0,1
48704044,0,1,0,0,1
48967891,0,1,0,0,1
55430898,0,1,0,0,1
53408195,0,1,0,0,1
52284025,0,1,0,0,1
52315304,0,1,0,0,1
52316669,0,1,0,0,1
52481355,0,1,0,0,1
52627475,0,1,0,0,1
52732594,0,1,0,0,1
53266963,0,0,0,1,1
53272646,0,1,0,0,1
53303043,0,1,0,0,1
53388429,0,1,0,0,1
53503202,0,1,0,0,1
52098514,0,1,0,0,1
53546967,0,1,0,0,1
53548539,0,1,0,0,1
53716913,0,1,0,0,1
53794847,0,1,0,0,1
54029183,0,1,0,0,1
54170551,0,1,0,0,1
54452056,0,1,0,0,1
54472810,0,1,0,0,1
54516759,0,1,0,0,1
55000069,0,1,0,0,1
52260914,0,1,0,0,1
51985647,1,0,0,0,1
49225605,0,1,0,0,1
50768070,0,1,0,0,1
49363962,0,1,0,0,1
49524127,0,0,0,1,1
49635684,0,1,0,0,1
49662361,0,0,0,1,1
49990050,0,1,0,0,1
50124767,0,1,0,0,1
50172630,1,0,0,0,1
50492756,0,1,0,0,1
50559251,0,1,0,0,1
50701532,0,1,0,0,1
50780338,0,1,0,0,1
51827732,0,1,0,0,1
50999753,0,1,0,0,1
51036282,0,1,0,0,1
51051535,0,1,0,0,1
51292461,0,1,0,0,1
51335558,0,1,0,0,1
51378058,0,1,0,0,1
51581269,1,0,0,0,1
51719927,0,1,0,0,1
51726986,0,1,0,0,1
51813630,0,1,0,0,1
74490987,1,0,0,0,1
74721799,0,1,0,0,1
74955358,0,1,0,0,1
101641657,0,1,0,0,1
100986964,1,0,0,0,1
101017453,1,0,0,0,1
101047979,0,1,0,0,1
101189904,0,1,0,0,1
101210334,0,1,0,0,1
101231062,0,1,0,0,1
101336896,0,1,0,0,1
101479748,0,1,0,0,1
101490897,1,0,0,0,1
101525387,0,1,0,0,1
101690773,0,1,0,0,1
100878763,0,1,0,0,1
102243526,0,1,0,0,1
102668833,0,1,0,0,1
102681800,0,1,0,0,1
102766712,0,1,0,0,1
103407817,0,1,0,0,1
103433534,0,1,0,0,1
104112005,0,1,0,0,1
104312486,0,1,0,0,1
104357123,0,1,0,0,1
104424701,0,0,0,1,1
100949009,0,1,0,0,1
100746233,1,0,0,0,1
105132656,0,1,0,0,1
98799275,0,1,0,0,1
97250580,0,1,0,0,1
97308426,0,1,0,0,1
97463399,0,1,0,0,1
97488853,0,0,1,0,1
97847045,0,1,0,0,1
98183151,0,1,0,0,1
98264412,1,0,0,0,1
98279895,0,1,0,0,1
98585624,1,0,0,0,1
98608169,0,1,0,0,1
98877997,0,1,0,0,1
100678690,0,1,0,0,1
98903593,0,1,0,0,1
98926033,0,1,0,0,1
99296612,0,1,0,0,1
99709086,0,1,0,0,1
100146431,0,1,0,0,1
100174599,0,1,0,0,1
100222626,0,1,0,0,1
100224612,0,1,0,0,1
100246605,0,1,0,0,1
100384636,0,1,0,0,1
104531473,0,1,0,0,1
105403238,0,1,0,0,1
97199937,1,0,0,0,1
113181022,0,1,0,0,1
111803245,1,0,0,0,1
111947143,0,1,0,0,1
111974789,0,1,0,0,1
112065947,0,1,0,0,1
112225417,0,1,0,0,1
112263169,0,1,0,0,1
112456299,1,0,0,0,1
112538128,0,1,0,0,1
112743625,0,1,0,0,1
112826814,0,1,0,0,1
113422695,0,1,0,0,1
110799048,0,1,0,0,1
113462277,0,1,0,0,1
113669414,0,1,0,0,1
113726510,0,1,0,0,1
113744392,0,1,0,0,1
113896766,0,1,0,0,1
114055837,1,0,0,0,1
114555276,0,1,0,0,1
114699368,0,1,0,0,1
114794484,0,1,0,0,1
114822861,0,1,0,0,1
111321700,0,1,0,0,1
110471575,0,1,0,0,1
105792146,0,1,0,0,1
107693864,1,0,0,0,1
105881283,0,1,0,0,1
106118416,0,1,0,0,1
106126679,0,1,0,0,1
106340743,0,1,0,0,1
106550944,0,1,0,0,1
106687627,0,1,0,0,1
106698758,0,1,0,0,1
106852909,0,1,0,0,1
107288394,0,1,0,0,1
107499344,0,1,0,0,1
107823129,0,1,0,0,1
110470607,0,1,0,0,1
107944847,1,0,0,0,1
108262791,0,1,0,0,1
108399514,1,0,0,0,1
108521240,0,1,0,0,1
108646838,0,1,0,0,1
108658864,0,0,0,1,1
109005321,0,1,0,0,1
109005890,0,1,0,0,1
109767928,0,1,0,0,1
110362857,0,1,0,0,1
97221801,0,1,0,0,1
97163560,0,1,0,0,1
75155058,0,1,0,0,1
82953204,1,0,0,0,1
81179597,1,0,0,0,1
81499829,0,1,0,0,1
81781162,0,1,0,0,1
81932158,0,1,0,0,1
82104189,0,1,0,0,1
82146022,0,1,0,0,1
82154548,0,1,0,0,1
82517559,0,1,0,0,1
82679357,0,1,0,0,1
82722757,0,1,0,0,1
83382036,0,1,0,0,1
80778824,0,1,0,0,1
83567804,0,1,0,0,1
83574799,0,1,0,0,1
83710618,0,1,0,0,1
83928746,0,1,0,0,1
83991762,0,1,0,0,1
84024812,0,1,0,0,1
84337023,0,0,0,1,1
84549372,0,1,0,0,1
84560219,0,1,0,0,1
84685398,0,1,0,0,1
80994991,0,1,0,0,1
80737025,0,1,0,0,1
85321362,0,1,0,0,1
77753738,1,0,0,0,1
75212930,0,1,0,0,1
75262531,0,1,0,0,1
75525737,1,0,0,0,1
75605073,0,1,0,0,1
76025963,0,1,0,0,1
76532437,0,1,0,0,1
76897545,0,1,0,0,1
77007257,0,1,0,0,1
77187701,0,1,0,0,1
77559614,0,1,0,0,1
77939333,0,1,0,0,1
80529600,0,1,0,0,1
78040527,0,1,0,0,1
78266284,0,1,0,0,1
78944226,0,1,0,0,1
78963024,0,1,0,0,1
79076958,0,1,0,0,1
79442114,0,1,0,0,1
79476277,1,0,0,0,1
79746717,0,1,0,0,1
79966083,1,0,0,0,1
79983928,0,1,0,0,1
84730725,0,1,0,0,1
85678251,0,1,0,0,1
96716474,1,0,0,0,1
93885705,0,1,0,0,1
91865200,0,1,0,0,1
91885299,0,1,0,0,1
92496645,0,1,0,0,1
92795260,0,0,0,1,1
92833417,0,1,0,0,1
93174413,1,0,0,0,1
93425822,0,1,0,0,1
93558188,0,1,0,0,1
93590690,1,0,0,0,1
93617861,0,1,0,0,1
93900039,1,0,0,0,1
91810391,0,1,0,0,1
94092079,0,1,0,0,1
94183319,0,1,0,0,1
94980062,1,0,0,0,1
95262982,0,1,0,0,1
95346599,0,1,0,0,1
95383781,1,0,0,0,1
95438026,0,1,0,0,1
95670129,0,1,0,0,1
95802428,0,1,0,0,1
96402075,0,1,0,0,1
91820368,0,1,0,0,1
91543826,0,1,0,0,1
85888659,0,1,0,0,1
88251779,0,1,0,0,1
85912464,0,1,0,0,1
86527077,0,1,0,0,1
86620692,0,1,0,0,1
87148491,1,0,0,0,1
87698774,0,1,0,0,1
87813288,1,0,0,0,1
87876471,0,1,0,0,1
87951183,0,1,0,0,1
88161823,0,1,0,0,1
88164918,0,1,0,0,1
88366552,0,1,0,0,1
91517160,0,1,0,0,1
88620099,0,1,0,0,1
88759671,0,1,0,0,1
88960710,0,1,0,0,1
89379605,0,1,0,0,1
89474072,0,1,0,0,1
89636078,0,1,0,0,1
89748770,1,0,0,0,1
89769159,0,1,0,0,1
90523593,1,0,0,0,1
90591939,0,0,0,1,1
44840031,1,0,0,0,1
44673590,0,1,0,0,1
44624123,0,1,0,0,1
20213883,1,0,0,0,1
19533866,0,1,0,0,1
19536290,1,0,0,0,1
19665155,0,1,0,0,1
19795729,0,1,0,0,1
19855310,0,1,0,0,1
19868010,0,1,0,0,1
19872670,0,1,0,0,1
20146126,0,1,0,0,1
20173094,0,1,0,0,1
20191225,0,1,0,0,1
20229440,0,1,0,0,1
19387616,0,0,0,1,1
20255622,0,1,0,0,1
20262126,0,1,0,0,1
20275550,0,1,0,0,1
20293015,0,1,0,0,1
20301087,0,1,0,0,1
20311009,0,1,0,0,1
20320394,0,1,0,0,1
20381242,0,1,0,0,1
20514074,0,1,0,0,1
20527037,0,1,0,0,1
19523962,0,1,0,0,1
19371411,0,1,0,0,1
20659155,1,0,0,0,1
18825344,0,1,0,0,1
18298094,0,1,0,0,1
18335844,0,1,0,0,1
18398582,0,1,0,0,1
18407812,0,1,0,0,1
18484282,0,1,0,0,1
18656865,0,1,0,0,1
18701256,0,1,0,0,1
18703385,1,0,0,0,1
18767182,0,1,0,0,1
18790337,0,1,0,0,1
18845869,0,1,0,0,1
19352501,0,1,0,0,1
18849062,0,1,0,0,1
18849779,0,1,0,0,1
19064135,0,1,0,0,1
19079767,1,0,0,0,1
19088288,0,1,0,0,1
19127403,0,1,0,0,1
19162842,0,1,0,0,1
19247992,0,1,0,0,1
19279308,1,0,0,0,1
19324299,0,1,0,0,1
20592886,0,1,0,0,1
20687912,1,0,0,0,1
18274201,0,1,0,0,1
22873354,1,0,0,0,1
22648912,0,1,0,0,1
22672330,0,1,0,0,1
22707454,0,1,0,0,1
22718922,0,1,0,0,1
22778472,0,1,0,0,1
22804865,0,1,0,0,1
22827784,0,1,0,0,1
22829520,0,1,0,0,1
22839036,1,0,0,0,1
22846618,0,1,0,0,1
22949837,0,1,0,0,1
22532954,0,1,0,0,1
23123835,0,1,0,0,1
23137762,0,1,0,0,1
23143973,0,1,0,0,1
23151898,0,1,0,0,1
23191482,0,1,0,0,1
23245225,0,1,0,0,1
23247502,0,1,0,0,1
23292410,0,0,1,0,1
23560232,0,1,0,0,1
23603940,0,1,0,0,1
22607317,0,1,0,0,1
22360236,1,0,0,0,1
20778778,0,1,0,0,1
21458110,0,1,0,0,1
20796457,0,1,0,0,1
20904061,0,1,0,0,1
21078349,0,1,0,0,1
21199970,0,1,0,0,1
21273166,1,0,0,0,1
21332359,0,1,0,0,1
21383314,0,1,0,0,1
21385160,1,0,0,0,1
21427485,0,1,0,0,1
21431729,0,1,0,0,1
21460496,0,1,0,0,1
22273608,0,1,0,0,1
21561223,0,1,0,0,1
21583864,0,1,0,0,1
21663432,0,1,0,0,1
21767358,0,1,0,0,1
21772402,0,1,0,0,1
21869820,0,1,0,0,1
21993294,0,1,0,0,1
22013738,0,1,0,0,1
22189154,0,1,0,0,1
22196150,0,1,0,0,1
18274746,1,0,0,0,1
18250847,0,1,0,0,1
23662500,0,1,0,0,1
15394224,0,1,0,0,1
14799078,0,1,0,0,1
14808213,0,1,0,0,1
14830798,0,1,0,0,1
15053754,0,1,0,0,1
15096041,0,1,0,0,1
15112576,0,1,0,0,1
15115280,1,0,0,0,1
15241602,1,0,0,0,1
15265442,0,1,0,0,1
15293062,0,1,0,0,1
15417091,0,1,0,0,1
14552545,0,1,0,0,1
15458765,0,1,0,0,1
15480737,1,0,0,0,1
15552861,1,0,0,0,1
15627090,1,0,0,0,1
15647482,1,0,0,0,1
15651835,0,1,0,0,1
15658840,1,0,0,0,1
15803316,0,1,0,0,1
15876659,0,1,0,0,1
15891995,0,1,0,0,1
14745059,1,0,0,0,1
14456422,0,1,0,0,1
15988179,0,1,0,0,1
5663832,0,1,0,0,1
654203,1,0,0,0,1
817652,1,0,0,0,1
2052911,0,1,0,0,1
3395761,1,0,0,0,1
3479311,1,0,0,0,1
3510591,0,1,0,0,1
4073591,0,1,0,0,1
4305181,0,1,0,0,1
4390331,0,1,0,0,1
5654932,1,0,0,0,1
7228352,1,0,0,0,1
14350588,1,0,0,0,1
7370332,1,0,0,0,1
7829912,0,1,0,0,1
9105802,1,0,0,0,1
11200472,0,1,0,0,1
13708922,0,1,0,0,1
14046928,1,0,0,0,1
14111373,0,1,0,0,1
14177336,0,1,0,0,1
14187686,0,1,0,0,1
14268323,0,1,0,0,1
15978297,0,1,0,0,1
16107380,0,1,0,0,1
18198566,0,1,0,0,1
17713693,0,1,0,0,1
17222332,0,1,0,0,1
17280041,0,1,0,0,1
17298782,0,1,0,0,1
17372783,0,1,0,0,1
17434245,1,0,0,0,1
17444647,0,1,0,0,1
17464780,1,0,0,0,1
17537020,0,1,0,0,1
17582504,1,0,0,0,1
17701397,0,1,0,0,1
17716267,0,1,0,0,1
17181087,0,1,0,0,1
17731966,0,1,0,0,1
17741346,0,1,0,0,1
17822006,0,1,0,0,1
17846426,0,1,0,0,1
17903946,1,0,0,0,1
17911441,1,0,0,0,1
17918537,0,1,0,0,1
18006752,0,1,0,0,1
18025295,0,1,0,0,1
18179554,1,0,0,0,1
17184930,0,1,0,0,1
17072387,0,1,0,0,1
16148602,0,1,0,0,1
16549200,0,1,0,0,1
16169151,0,1,0,0,1
16176454,0,1,0,0,1
16187539,0,1,0,0,1
16190307,0,1,0,0,1
16209935,0,1,0,0,1
16229706,0,1,0,0,1
16315143,1,0,0,0,1
16390848,0,1,0,0,1
16463257,0,1,0,0,1
16503453,0,1,0,0,1
16670543,0,0,0,1,1
17014037,0,1,0,0,1
16700786,0,1,0,0,1
16705896,0,1,0,0,1
16745288,0,1,0,0,1
16752677,0,1,0,0,1
16804541,0,1,0,0,1
16808153,0,1,0,0,1
16874030,0,1,0,0,1
16882774,0,1,0,0,1
16905853,0,1,0,0,1
17007531,0,1,0,0,1
23608092,0,1,0,0,1
23667009,0,1,0,0,1
44486117,1,0,0,0,1
35618406,0,1,0,0,1
34493217,0,1,0,0,1
34623654,0,1,0,0,1
34860936,0,1,0,0,1
34878201,0,1,0,0,1
34908698,1,0,0,0,1
35255340,0,1,0,0,1
35337927,0,1,0,0,1
35533492,0,1,0,0,1
35585695,1,0,0,0,1
35609823,0,1,0,0,1
35680171,0,1,0,0,1
34230904,1,0,0,0,1
35706932,0,1,0,0,1
35945852,0,1,0,0,1
36196568,0,1,0,0,1
36629111,0,1,0,0,1
36640869,0,1,0,0,1
36664223,0,1,0,0,1
36842122,0,1,0,0,1
37021555,0,1,0,0,1
37118128,1,0,0,0,1
37415869,0,1,0,0,1
34447580,1,0,0,0,1
34196593,0,1,0,0,1
37484152,0,1,0,0,1
32898319,0,1,0,0,1
32337985,0,1,0,0,1
32352565,1,0,0,0,1
32366249,0,1,0,0,1
32425810,0,1,0,0,1
32518396,0,1,0,0,1
32565157,0,1,0,0,1
32587634,0,1,0,0,1
32596982,0,1,0,0,1
32655519,0,1,0,0,1
32687550,0,1,0,0,1
32929694,0,1,0,0,1
33958290,0,1,0,0,1
32951490,0,1,0,0,1
33174468,1,0,0,0,1
33189500,0,1,0,0,1
33285950,0,1,0,0,1
33408559,1,0,0,0,1
33531486,0,1,0,0,1
33577554,0,0,1,0,1
33684165,0,1,0,0,1
33765178,0,1,0,0,1
33880001,0,1,0,0,1
37429421,0,1,0,0,1
37593036,0,1,0,0,1
32047533,0,1,0,0,1
42358442,0,1,0,0,1
41224216,0,1,0,0,1
41342969,0,1,0,0,1
41369863,1,0,0,0,1
41390185,0,1,0,0,1
41550515,0,1,0,0,1
41581597,0,1,0,0,1
42074175,0,1,0,0,1
42212987,0,1,0,0,1
42217478,0,1,0,0,1
42284908,0,1,0,0,1
42371716,0,1,0,0,1
41159844,0,1,0,0,1
42404881,0,1,0,0,1
42413878,0,1,0,0,1
42693483,0,1,0,0,1
43235064,0,1,0,0,1
43442691,0,1,0,0,1
43472550,0,1,0,0,1
43591054,1,0,0,0,1
43601834,1,0,0,0,1
44303297,0,1,0,0,1
44346105,0,1,0,0,1
41172223,0,1,0,0,1
40872499,0,1,0,0,1
38049495,0,1,0,0,1
39292745,0,1,0,0,1
38133178,0,1,0,0,1
38206451,1,0,0,0,1
38330635,0,1,0,0,1
38444226,0,1,0,0,1
38548200,0,1,0,0,1
38749036,0,1,0,0,1
38830654,0,0,1,0,1
38859818,0,1,0,0,1
39055409,1,0,0,0,1
39057708,0,1,0,0,1
39294154,0,1,0,0,1
40869447,0,1,0,0,1
39296425,0,1,0,0,1
39351893,0,0,0,1,1
39407620,1,0,0,0,1
39659802,0,1,0,0,1
39785652,0,1,0,0,1
40249753,0,1,0,0,1
40572712,0,1,0,0,1
40591108,0,1,0,0,1
40591485,0,1,0,0,1
40654708,0,1,0,0,1
32147863,0,1,0,0,1
31771149,0,1,0,0,1
23761307,0,1,0,0,1
25645203,0,1,0,0,1
24828656,0,1,0,0,1
24912288,0,1,0,0,1
24932455,0,1,0,0,1
24970656,0,1,0,0,1
25232175,0,1,0,0,1
25297519,0,1,0,0,1
25369843,0,1,0,0,1
25393191,1,0,0,0,1
25423529,0,1,0,0,1
25462639,0,1,0,0,1
25774450,0,1,0,0,1
24796805,0,1,0,0,1
25868285,0,1,0,0,1
25877022,0,1,0,0,1
25900452,1,0,0,0,1
25909814,0,1,0,0,1
25926296,0,1,0,0,1
25984649,1,0,0,0,1
25990741,0,1,0,0,1
26134591,0,1,0,0,1
26166112,0,1,0,0,1
26535130,0,1,0,0,1
24817432,0,1,0,0,1
24737871,0,1,0,0,1
26966663,0,1,0,0,1
24198047,0,1,0,0,1
23762893,0,1,0,0,1
23784880,0,1,0,0,1
23834557,0,1,0,0,1
23860507,0,1,0,0,1
23983382,0,1,0,0,1
24055705,0,1,0,0,1
24069742,0,1,0,0,1
24130485,0,1,0,0,1
24186792,0,1,0,0,1
24196746,0,1,0,0,1
24203766,0,1,0,0,1
24660607,0,1,0,0,1
24204144,0,1,0,0,1
24238030,0,1,0,0,1
24273406,0,1,0,0,1
24287541,0,1,0,0,1
24329569,0,1,0,0,1
24382901,0,1,0,0,1
24438551,1,0,0,0,1
24508524,1,0,0,0,1
24544802,0,1,0,0,1
24610988,0,1,0,0,1
26824556,0,1,0,0,1
26994187,0,1,0,0,1
31537662,1,0,0,0,1
30691616,0,1,0,0,1
29877533,0,1,0,0,1
29972407,0,1,0,0,1
30130714,0,1,0,0,1
30232355,0,1,0,0,1
30268206,0,1,0,0,1
30387315,1,0,0,0,1
30429504,0,1,0,0,1
30494717,0,1,0,0,1
30507236,0,1,0,0,1
30555751,0,1,0,0,1
30735938,0,1,0,0,1
29194420,0,1,0,0,1
30751859,0,1,0,0,1
30974235,0,1,0,0,1
31000144,0,1,0,0,1
31122373,0,1,0,0,1
31155713,0,1,0,0,1
31253690,0,1,0,0,1
31333030,0,1,0,0,1
31342932,0,1,0,0,1
31422921,1,0,0,0,1
31480713,0,1,0,0,1
29233595,0,1,0,0,1
28976373,0,0,0,1,1
27301793,0,1,0,0,1
28080704,0,1,0,0,1
27338675,0,1,0,0,1
27385508,0,1,0,0,1
27612306,0,1,0,0,1
27621642,0,1,0,0,1
27768662,0,1,0,0,1
27818124,0,1,0,0,1
27842406,0,1,0,0,1
27843443,0,1,0,0,1
27890789,0,1,0,0,1
27971780,0,1,0,0,1
28083870,0,1,0,0,1
28870289,0,1,0,0,1
28092030,0,1,0,0,1
28401178,0,1,0,0,1
28499318,0,1,0,0,1
28574892,0,1,0,0,1
28580504,0,1,0,0,1
28586287,0,1,0,0,1
28614412,0,1,0,0,1
28677186,0,1,0,0,1
28695649,0,1,0,0,1
28721981,0,1,0,0,1
114873175,0,1,0,0,1
115212572,0,1,0,0,1
115613591,0,1,0,0,1
265535152,0,1,0,0,1
262715330,0,1,0,0,1
262804060,0,1,0,0,1
263083163,0,1,0,0,1
263091350,0,1,0,0,1
263394348,1,0,0,0,1
263515257,0,1,0,0,1
263683356,1,0,0,0,1
264177524,0,1,0,0,1
264535319,0,1,0,0,1
265099469,0,1,0,0,1
265557006,0,1,0,0,1
262415495,0,1,0,0,1
265710881,0,1,0,0,1
265719264,0,0,1,0,1
266102331,0,1,0,0,1
266469616,1,0,0,0,1
266685178,0,1,0,0,1
266891800,1,0,0,0,1
267045979,0,1,0,0,1
267325705,0,1,0,0,1
268166768,0,1,0,0,1
268990033,0,1,0,0,1
262491669,1,0,0,0,1
262337822,0,1,0,0,1
269486246,0,1,0,0,1
258564911,0,1,0,0,1
256525048,0,1,0,0,1
256856593,0,1,0,0,1
257088949,1,0,0,0,1
257677319,1,0,0,0,1
258009431,0,0,1,0,1
258040822,1,0,0,0,1
258279518,0,1,0,0,1
258290848,0,1,0,0,1
258361691,0,1,0,0,1
258478622,0,1,0,0,1
258741909,0,1,0,0,1
262292206,0,1,0,0,1
259028190,0,1,0,0,1
259118891,0,1,0,0,1
259765165,0,1,0,0,1
260447783,0,1,0,0,1
260475024,0,1,0,0,1
260936473,0,1,0,0,1
260957853,0,1,0,0,1
261725827,0,1,0,0,1
261736294,0,1,0,0,1
261863668,0,1,0,0,1
269155828,1,0,0,0,1
269683939,0,1,0,0,1
255989017,0,1,0,0,1
277600246,1,0,0,0,1
275754256,0,1,0,0,1
275871572,0,1,0,0,1
275907720,0,1,0,0,1
276106961,0,1,0,0,1
276176449,0,1,0,0,1
276373394,0,1,0,0,1
276395753,0,1,0,0,1
276624310,0,1,0,0,1
277020584,0,1,0,0,1
277507760,0,1,0,0,1
277796372,0,1,0,0,1
275345905,0,1,0,0,1
278030515,0,1,0,0,1
278037129,0,1,0,0,1
278579541,0,1,0,0,1
278893199,0,1,0,0,1
278918605,1,0,0,0,1
279046390,0,1,0,0,1
279135559,0,1,0,0,1
279176310,0,1,0,0,1
279200935,0,1,0,0,1
279337502,0,1,0,0,1
275454299,0,1,0,0,1
274803809,0,1,0,0,1
269793965,0,1,0,0,1
272626019,0,1,0,0,1
269885887,0,1,0,0,1
270348227,0,1,0,0,1
270976215,0,1,0,0,1
270977950,0,1,0,0,1
271376020,0,1,0,0,1
271465574,1,0,0,0,1
271581873,0,1,0,0,1
271707766,1,0,0,0,1
272196949,0,1,0,0,1
272578794,0,1,0,0,1
272837528,0,1,0,0,1
274612077,0,1,0,0,1
273016700,0,1,0,0,1
273028890,0,1,0,0,1
273036018,0,1,0,0,1
273072754,0,1,0,0,1
273139000,0,1,0,0,1
273774213,0,0,0,1,1
273846748,0,1,0,0,1
274260142,0,1,0,0,1
274275764,0,1,0,0,1
274347607,0,1,0,0,1
256495314,0,0,0,1,1
255979988,0,1,0,0,1
279503430,0,1,0,0,1
240697075,0,1,0,0,1
237669302,0,1,0,0,1
237719164,0,1,0,0,1
237903360,0,1,0,0,1
238448916,0,1,0,0,1
238540828,1,0,0,0,1
238711743,0,1,0,0,1
238862918,1,0,0,0,1
239016895,0,1,0,0,1
239375557,0,1,0,0,1
239781958,0,1,0,0,1
240706575,0,1,0,0,1
236629733,0,1,0,0,1
240870634,0,1,0,0,1
240873409,0,1,0,0,1
241911612,0,1,0,0,1
242133106,0,1,0,0,1
243049378,0,1,0,0,1
243115725,0,1,0,0,1
243228289,0,1,0,0,1
243318861,0,1,0,0,1
243355636,0,1,0,0,1
243797050,0,1,0,0,1
237409759,1,0,0,0,1
236506960,0,1,0,0,1
244034863,0,1,0,0,1
233830889,0,1,0,0,1
231597324,0,1,0,0,1
232049614,0,1,0,0,1
232377398,0,1,0,0,1
232384617,0,1,0,0,1
232638078,0,1,0,0,1
232788325,0,1,0,0,1
233086404,1,0,0,0,1
233428900,0,1,0,0,1
233558377,0,1,0,0,1
233674823,0,0,1,0,1
233939592,0,1,0,0,1
236273154,0,1,0,0,1
234239455,1,0,0,0,1
234466998,0,1,0,0,1
234705799,0,1,0,0,1
235117110,0,1,0,0,1
235173460,0,1,0,0,1
235290475,1,0,0,0,1
235487202,0,1,0,0,1
235592742,0,1,0,0,1
236153319,0,1,0,0,1
236167025,0,1,0,0,1
243820194,0,1,0,0,1
244204448,0,1,0,0,1
255674310,0,1,0,0,1
253061264,0,1,0,0,1
250600291,1,0,0,0,1
250832574,0,1,0,0,1
250837333,1,0,0,0,1
251074010,0,1,0,0,1
251448803,0,1,0,0,1
251497683,0,1,0,0,1
251663248,0,1,0,0,1
251789050,1,0,0,0,1
252067101,0,1,0,0,1
252943280,0,1,0,0,1
253174214,0,1,0,0,1
250264750,0,1,0,0,1
253616369,0,1,0,0,1
253618818,0,1,0,0,1
253840687,0,1,0,0,1
253872847,0,1,0,0,1
254082767,1,0,0,0,1
254350827,0,1,0,0,1
254527430,0,1,0,0,1
254901443,0,0,0,1,1
255581407,0,1,0,0,1
255584407,0,1,0,0,1
250393425,0,1,0,0,1
249972742,0,1,0,0,1
244340497,0,1,0,0,1
247167413,0,1,0,0,1
244375392,0,1,0,0,1
244418087,0,1,0,0,1
244476296,0,1,0,0,1
244527424,0,1,0,0,1
244813279,0,1,0,0,1
245701852,1,0,0,0,1
245950595,0,1,0,0,1
246456745,0,1,0,0,1
246694980,1,0,0,0,1
246853997,0,1,0,0,1
247210459,0,1,0,0,1
249799890,0,1,0,0,1
247300882,0,1,0,0,1
247803955,1,0,0,0,1
248646521,0,1,0,0,1
248676615,0,1,0,0,1
248688460,0,1,0,0,1
248972464,0,1,0,0,1
249075947,0,1,0,0,1
249514089,0,1,0,0,1
249532641,1,0,0,0,1
249758109,0,1,0,0,1
279368627,0,1,0,0,1
279775332,0,1,0,0,1
230547464,0,1,0,0,1
322986132,0,1,0,0,1
317103965,0,1,0,0,1
317609731,0,1,0,0,1
317995721,0,1,0,0,1
318674470,0,1,0,0,1
319127558,0,1,0,0,1
321427672,1,0,0,0,1
321470677,0,1,0,0,1
322032346,0,1,0,0,1
322806936,0,1,0,0,1
322881819,0,1,0,0,1
323301287,1,0,0,0,1
316836701,0,1,0,0,1
323965227,0,1,0,0,1
324054785,0,1,0,0,1
324293502,0,1,0,0,1
324825566,0,1,0,0,1
324867642,0,1,0,0,1
324976012,0,1,0,0,1
325092227,0,1,0,0,1
325409117,0,1,0,0,1
325576184,0,1,0,0,1
326096215,1,0,0,0,1
316898957,0,1,0,0,1
316619065,0,1,0,0,1
326563804,0,1,0,0,1
311175928,0,0,1,0,1
309563727,0,1,0,0,1
309564483,0,1,0,0,1
309726207,1,0,0,0,1
309734835,0,1,0,0,1
309870468,0,1,0,0,1
309908788,0,1,0,0,1
310370858,0,1,0,0,1
310788689,0,1,0,0,1
310823490,0,1,0,0,1
310897418,0,1,0,0,1
311834734,0,1,0,0,1
316578266,0,1,0,0,1
312170583,1,0,0,0,1
312517982,1,0,0,0,1
312651085,0,1,0,0,1
313202226,0,1,0,0,1
313527734,0,1,0,0,1
313741596,0,1,0,0,1
314262117,0,1,0,0,1
314839986,0,1,0,0,1
315163546,0,1,0,0,1
316200788,0,1,0,0,1
326285414,0,1,0,0,1
327338844,0,1,0,0,1
308920561,0,1,0,0,1
336968754,0,1,0,0,1
334882778,0,1,0,0,1
335143897,0,1,0,0,1
335190690,0,1,0,0,1
335393795,0,1,0,0,1
335742935,0,0,0,1,1
335840716,0,1,0,0,1
336002320,0,1,0,0,1
336370847,0,1,0,0,1
336475606,0,0,1,0,1
336558514,0,1,0,0,1
337059672,0,1,0,0,1
333797162,0,1,0,0,1
337533802,0,1,0,0,1
338360908,0,1,0,0,1
338422544,0,1,0,0,1
339017657,0,1,0,0,1
339521811,0,1,0,0,1
340266109,0,1,0,0,1
340757907,0,1,0,0,1
340875095,0,1,0,0,1
341454994,0,1,0,0,1
341632958,1,0,0,0,1
334118897,0,1,0,0,1
332872124,0,1,0,0,1
327344765,0,1,0,0,1
329674178,0,1,0,0,1
327571866,0,1,0,0,1
328317873,0,1,0,0,1
328472663,0,1,0,0,1
328515345,0,1,0,0,1
328627804,0,1,0,0,1
329117482,0,1,0,0,1
329245246,0,1,0,0,1
329601769,0,1,0,0,1
329644307,0,1,0,0,1
329673850,0,1,0,0,1
330245848,0,1,0,0,1
332782071,0,1,0,0,1
330324341,0,1,0,0,1
330454295,0,1,0,0,1
330920504,0,1,0,0,1
331646137,0,1,0,0,1
331997732,0,1,0,0,1
332155757,0,0,0,1,1
332472292,0,1,0,0,1
332756194,0,1,0,0,1
332756755,0,1,0,0,1
332767351,0,1,0,0,1
308929601,0,1,0,0,1
308486581,0,1,0,0,1
279927136,0,1,0,0,1
291511365,0,1,0,0,1
287214469,1,0,0,0,1
287451820,0,0,1,0,1
287503006,0,1,0,0,1
288485066,0,1,0,0,1
289185362,1,0,0,0,1
289352133,0,1,0,0,1
290195004,0,0,0,1,1
290417198,0,1,0,0,1
290539614,0,1,0,0,1
290863164,0,1,0,0,1
292549300,0,1,0,0,1
286676920,0,1,0,0,1
292550395,0,1,0,0,1
292797058,0,1,0,0,1
293711508,0,1,0,0,1
293935063,0,1,0,0,1
293968006,1,0,0,0,1
293981380,0,1,0,0,1
294002127,0,1,0,0,1
294165180,0,1,0,0,1
294448945,0,1,0,0,1
294584037,0,1,0,0,1
286978379,0,1,0,0,1
286496548,0,1,0,0,1
295067637,1,0,0,0,1
282733140,1,0,0,0,1
280396049,0,1,0,0,1
280572263,0,1,0,0,1
280600818,0,1,0,0,1
280718813,0,1,0,0,1
280938169,0,1,0,0,1
281336583,0,1,0,0,1
281826197,0,1,0,0,1
282414499,0,1,0,0,1
282551172,0,1,0,0,1
282588931,0,1,0,0,1
282834254,0,1,0,0,1
286279879,0,1,0,0,1
283041807,0,1,0,0,1
283127082,0,1,0,0,1
283305767,1,0,0,0,1
283427229,0,1,0,0,1
284024255,0,1,0,0,1
285089608,0,1,0,0,1
285391200,1,0,0,0,1
285646656,0,1,0,0,1
285907293,0,1,0,0,1
286042966,1,0,0,0,1
295011426,1,0,0,0,1
295119772,0,1,0,0,1
308348466,0,1,0,0,1
304441212,0,1,0,0,1
302429852,0,1,0,0,1
302557364,0,1,0,0,1
302665348,0,1,0,0,1
302709760,0,1,0,0,1
302730365,0,1,0,0,1
302871501,0,1,0,0,1
303121083,0,1,0,0,1
303433851,0,1,0,0,1
303649088,0,1,0,0,1
304166142,0,1,0,0,1
304454068,0,1,0,0,1
302189775,1,0,0,0,1
304490823,0,1,0,0,1
304766078,0,1,0,0,1
304859885,0,1,0,0,1
305435798,0,1,0,0,1
305661348,0,1,0,0,1
306358243,0,1,0,0,1
306436630,0,1,0,0,1
306512683,0,0,1,0,1
306808057,0,1,0,0,1
308012947,0,1,0,0,1
302209027,0,1,0,0,1
301907940,0,1,0,0,1
295139647,0,1,0,0,1
298123661,0,1,0,0,1
295180859,0,1,0,0,1
295283950,0,1,0,0,1
295339096,0,1,0,0,1
295946505,0,1,0,0,1
295997589,0,1,0,0,1
296367154,0,1,0,0,1
296482531,0,1,0,0,1
296991343,0,1,0,0,1
297039548,0,1,0,0,1
297452606,0,1,0,0,1
298588462,0,1,0,0,1
301854953,0,0,0,1,1
298785293,0,1,0,0,1
299062149,0,1,0,0,1
299220494,0,1,0,0,1
299575731,0,1,0,0,1
300282250,0,1,0,0,1
300522087,1,0,0,0,1
300604660,0,1,0,0,1
300810543,0,1,0,0,1
301123203,0,1,0,0,1
301415785,0,1,0,0,1
231539351,0,1,0,0,1
230505030,0,1,0,0,1
116460976,0,1,0,0,1
146207677,0,1,0,0,1
144390623,0,1,0,0,1
144478444,0,1,0,0,1
144805703,0,1,0,0,1
144864922,0,1,0,0,1
145313756,0,0,0,1,1
145424365,0,1,0,0,1
145741739,0,1,0,0,1
145752172,0,1,0,0,1
145959663,1,0,0,0,1
146030638,0,1,0,0,1
146614673,0,1,0,0,1
144094376,1,0,0,0,1
146727723,0,1,0,0,1
147161487,0,1,0,0,1
147401660,0,1,0,0,1
147414021,0,1,0,0,1
147521505,0,1,0,0,1
147622701,0,1,0,0,1
147867506,0,1,0,0,1
148212128,0,1,0,0,1
148280313,0,1,0,0,1
148457607,0,1,0,0,1
144124114,0,1,0,0,1
143965245,0,1,0,0,1
148713483,0,1,0,0,1
142669873,0,1,0,0,1
140169121,0,1,0,0,1
140323220,0,1,0,0,1
140529056,0,1,0,0,1
141712368,0,1,0,0,1
141807836,0,1,0,0,1
142054876,0,1,0,0,1
142067363,0,1,0,0,1
142108877,0,1,0,0,1
142375886,0,1,0,0,1
142538540,0,1,0,0,1
142883006,0,1,0,0,1
143934960,0,1,0,0,1
142946303,0,1,0,0,1
143005275,0,1,0,0,1
143054504,0,1,0,0,1
143144612,0,1,0,0,1
143179399,0,1,0,0,1
143225212,0,1,0,0,1
143301377,0,1,0,0,1
143404925,0,1,0,0,1
143525847,0,1,0,0,1
143550411,0,0,1,0,1
148584206,1,0,0,0,1
148850031,0,1,0,0,1
139608465,0,1,0,0,1
159328686,0,1,0,0,1
157383853,0,1,0,0,1
157810313,0,1,0,0,1
157940392,0,1,0,0,1
157972164,0,1,0,0,1
158123632,0,1,0,0,1
158512614,0,1,0,0,1
158948341,0,1,0,0,1
159001530,0,1,0,0,1
159095242,0,1,0,0,1
159297427,0,1,0,0,1
159717195,0,1,0,0,1
157088111,0,1,0,0,1
160128581,0,1,0,0,1
160167961,0,1,0,0,1
160245390,1,0,0,0,1
160622841,1,0,0,0,1
161063168,0,1,0,0,1
161197918,0,1,0,0,1
161273063,0,1,0,0,1
161611350,0,1,0,0,1
162386311,0,1,0,0,1
162452290,0,1,0,0,1
157276783,0,1,0,0,1
156922548,0,1,0,0,1
149004973,0,1,0,0,1
153456842,0,1,0,0,1
149438050,0,1,0,0,1
149799081,0,1,0,0,1
150036637,0,1,0,0,1
150248705,1,0,0,0,1
150394932,0,1,0,0,1
150413331,0,1,0,0,1
150449842,0,1,0,0,1
150618812,0,1,0,0,1
152239742,0,1,0,0,1
152252818,0,1,0,0,1
154861565,0,1,0,0,1
156749135,0,1,0,0,1
154941779,0,1,0,0,1
154972344,0,1,0,0,1
155009118,0,1,0,0,1
155192471,0,1,0,0,1
155222541,0,1,0,0,1
155432442,1,0,0,0,1
155603315,0,0,0,1,1
156011654,1,0,0,0,1
156041107,0,1,0,0,1
156296719,0,1,0,0,1
139840488,0,1,0,0,1
139262366,0,1,0,0,1
162800009,0,1,0,0,1
123994254,0,1,0,0,1
121299590,0,1,0,0,1
121517711,0,1,0,0,1
121903639,0,1,0,0,1
122301168,0,1,0,0,1
122387014,0,1,0,0,1
122431150,0,1,0,0,1
122877046,0,0,1,0,1
123689686,0,1,0,0,1
123872758,0,1,0,0,1
123893675,0,1,0,0,1
124407527,0,1,0,0,1
121159806,0,1,0,0,1
124407681,0,1,0,0,1
124624889,1,0,0,0,1
124770803,1,0,0,0,1
124903177,0,1,0,0,1
125070671,0,1,0,0,1
125071751,0,1,0,0,1
125111880,0,1,0,0,1
125317641,0,1,0,0,1
125612663,0,1,0,0,1
126021687,0,1,0,0,1
121250769,0,1,0,0,1
120910931,0,1,0,0,1
126556399,0,1,0,0,1
118301306,0,1,0,0,1
116533188,0,1,0,0,1
116689958,0,1,0,0,1
116698020,1,0,0,0,1
116756436,0,0,0,1,1
117025394,0,1,0,0,1
117084776,0,1,0,0,1
117443924,1,0,0,0,1
117589552,0,1,0,0,1
117748506,1,0,0,0,1
117977808,1,0,0,0,1
118523403,0,1,0,0,1
120835472,1,0,0,0,1
118847838,0,1,0,0,1
119072054,0,1,0,0,1
119075977,0,1,0,0,1
119087979,0,1,0,0,1
119109416,0,1,0,0,1
119356687,0,1,0,0,1
119374127,0,1,0,0,1
119540631,0,1,0,0,1
119576067,0,1,0,0,1
120813741,0,1,0,0,1
126278129,0,1,0,0,1
126686763,0,1,0,0,1
138835948,0,1,0,0,1
134869346,0,1,0,0,1
132418948,0,1,0,0,1
132614362,0,1,0,0,1
132808558,0,1,0,0,1
133187049,0,1,0,0,1
133574482,0,1,0,0,1
133873176,1,0,0,0,1
133945668,0,1,0,0,1
134222334,0,1,0,0,1
134341348,0,1,0,0,1
134777422,0,1,0,0,1
134921712,0,1,0,0,1
132016606,0,1,0,0,1
135024196,0,1,0,0,1
135487599,0,1,0,0,1
135508425,0,1,0,0,1
136669557,0,1,0,0,1
136880760,0,1,0,0,1
136979516,0,1,0,0,1
137594055,0,1,0,0,1
138490162,0,1,0,0,1
138497432,0,1,0,0,1
138658081,0,1,0,0,1
132218770,1,0,0,0,1
132002348,0,1,0,0,1
126702875,0,1,0,0,1
128925204,0,1,0,0,1
127030296,0,1,0,0,1
127187232,0,1,0,0,1
127280796,0,1,0,0,1
127612960,1,0,0,0,1
127613900,0,1,0,0,1
127991636,0,1,0,0,1
128224504,0,1,0,0,1
128494616,0,1,0,0,1
128517224,0,1,0,0,1
128586397,0,1,0,0,1
129414888,0,1,0,0,1
131128020,0,1,0,0,1
129609863,0,0,0,1,1
129725010,0,1,0,0,1
129771435,0,1,0,0,1
129839690,0,0,0,1,1
129849644,0,1,0,0,1
130607739,1,0,0,0,1
130707313,0,0,1,0,1
130748481,0,1,0,0,1
130809034,0,1,0,0,1
131014582,0,1,0,0,1
162794286,0,1,0,0,1
163186979,0,1,0,0,1
230060103,0,1,0,0,1
211568474,0,1,0,0,1
209261403,0,1,0,0,1
209420818,0,1,0,0,1
209700946,0,1,0,0,1
209713788,1,0,0,0,1
210026535,0,1,0,0,1
210507149,0,1,0,0,1
210532832,0,1,0,0,1
210701630,0,1,0,0,1
210712596,0,1,0,0,1
211235151,0,1,0,0,1
212245514,0,1,0,0,1
207879183,0,1,0,0,1
212276091,0,1,0,0,1
212787760,1,0,0,0,1
213187214,0,1,0,0,1
213275801,1,0,0,0,1
213296458,0,1,0,0,1
213494487,1,0,0,0,1
213922717,1,0,0,0,1
213953293,0,1,0,0,1
214236270,0,1,0,0,1
214462770,1,0,0,0,1
207920369,1,0,0,0,1
207378625,0,1,0,0,1
214760518,0,0,0,1,1
200932736,0,1,0,0,1
196214661,0,1,0,0,1
196215861,0,1,0,0,1
196676305,0,1,0,0,1
196802928,0,0,0,1,1
197138645,0,1,0,0,1
197279172,1,0,0,0,1
197482361,0,1,0,0,1
197900164,0,1,0,0,1
198327794,0,1,0,0,1
200270165,1,0,0,0,1
201270123,0,1,0,0,1
206890002,0,1,0,0,1
201811911,0,1,0,0,1
202552776,0,1,0,0,1
203652187,0,1,0,0,1
204271181,0,1,0,0,1
204647319,0,1,0,0,1
205371115,0,1,0,0,1
205397578,0,1,0,0,1
205587392,0,1,0,0,1
206104425,0,1,0,0,1
206145910,0,1,0,0,1
214561149,0,1,0,0,1
216445711,0,0,1,0,1
195291926,0,1,0,0,1
227187978,0,1,0,0,1
225332010,0,1,0,0,1
225980270,0,1,0,0,1
226198180,0,1,0,0,1
226217403,1,0,0,0,1
226233180,0,1,0,0,1
226448422,0,1,0,0,1
226529073,1,0,0,0,1
226675191,0,1,0,0,1
226896723,0,1,0,0,1
226944217,0,1,0,0,1
227716526,0,1,0,0,1
224122224,0,1,0,0,1
228010353,1,0,0,0,1
229075545,0,1,0,0,1
229356705,0,1,0,0,1
229518601,0,1,0,0,1
229535170,0,1,0,0,1
229598421,0,1,0,0,1
229695209,0,1,0,0,1
229820962,0,1,0,0,1
229844203,0,1,0,0,1
229852951,0,1,0,0,1
225279862,0,1,0,0,1
223947784,0,1,0,0,1
216579598,0,1,0,0,1
220380200,1,0,0,0,1
216681262,0,1,0,0,1
217415964,0,1,0,0,1
217716880,0,1,0,0,1
217861269,0,1,0,0,1
218897943,0,1,0,0,1
219042977,0,1,0,0,1
219209519,0,1,0,0,1
219399438,0,1,0,0,1
220082244,0,1,0,0,1
220225357,0,1,0,0,1
220578511,0,1,0,0,1
223901973,0,1,0,0,1
220648195,0,1,0,0,1
220723107,1,0,0,0,1
221327410,1,0,0,0,1
221385621,0,1,0,0,1
221546344,0,1,0,0,1
221662789,0,1,0,0,1
222020937,0,1,0,0,1
222023216,0,1,0,0,1
222199746,0,1,0,0,1
223145087,0,1,0,0,1
195855213,0,1,0,0,1
195245230,0,1,0,0,1
163381770,0,1,0,0,1
173273484,0,1,0,0,1
171109355,0,1,0,0,1
171590685,0,0,0,1,1
171683512,0,1,0,0,1
171888400,0,1,0,0,1
172181276,0,1,0,0,1
172270481,0,1,0,0,1
172410858,0,1,0,0,1
172449031,0,1,0,0,1
172958901,0,1,0,0,1
173229237,0,1,0,0,1
173443785,0,1,0,0,1
170763654,0,1,0,0,1
174059721,0,1,0,0,1
174098656,0,1,0,0,1
175745753,0,1,0,0,1
175781159,0,1,0,0,1
175974238,0,1,0,0,1
176619668,1,0,0,0,1
177490350,0,1,0,0,1
177616551,0,1,0,0,1
177766603,0,1,0,0,1
178768521,0,0,0,1,1
170787007,0,1,0,0,1
170518308,0,1,0,0,1
179527642,1,0,0,0,1
167023314,0,1,0,0,1
164096172,0,1,0,0,1
164702268,0,1,0,0,1
165136131,0,1,0,0,1
165468632,0,1,0,0,1
165682513,0,1,0,0,1
165793361,0,1,0,0,1
166230862,0,1,0,0,1
166597081,0,1,0,0,1
166837712,0,1,0,0,1
166853893,0,1,0,0,1
167474190,0,1,0,0,1
170440777,0,1,0,0,1
167638662,0,1,0,0,1
167800385,0,1,0,0,1
168195850,1,0,0,0,1
168253175,0,1,0,0,1
168343559,1,0,0,0,1
168590782,0,0,0,1,1
168637157,0,1,0,0,1
169592236,0,1,0,0,1
169908688,0,1,0,0,1
170230658,1,0,0,0,1
179430946,1,0,0,0,1
180057743,1,0,0,0,1
195045036,0,1,0,0,1
191325966,0,1,0,0,1
188067977,0,1,0,0,1
188215032,0,1,0,0,1
188710604,0,1,0,0,1
189359275,0,1,0,0,1
189526414,0,1,0,0,1
189699584,1,0,0,0,1
190513949,0,0,0,1,1
190623762,0,1,0,0,1
190685193,1,0,0,0,1
190928223,0,1,0,0,1
191427045,0,1,0,0,1
187456856,0,1,0,0,1
191934632,0,1,0,0,1
192021416,0,1,0,0,1
192221864,0,1,0,0,1
192923366,0,1,0,0,1
193520135,0,1,0,0,1
193900025,0,1,0,0,1
194011870,0,1,0,0,1
194196463,0,1,0,0,1
194376363,0,0,1,0,1
194490076,0,0,0,1,1
187570151,0,1,0,0,1
186949186,0,1,0,0,1
180237277,0,1,0,0,1
184629530,0,0,0,1,1
180308386,0,1,0,0,1
181227373,0,1,0,0,1
181312769,0,1,0,0,1
181316931,0,1,0,0,1
181638022,0,1,0,0,1
182156484,0,1,0,0,1
182569676,0,1,0,0,1
183270424,0,1,0,0,1
183628462,0,1,0,0,1
184050726,0,1,0,0,1
184685461,1,0,0,0,1
186824014,0,1,0,0,1
184738202,0,1,0,0,1
184739178,0,1,0,0,1
184752939,0,1,0,0,1
185165839,0,1,0,0,1
185606986,1,0,0,0,1
185699563,1,0,0,0,1
185741133,1,0,0,0,1
185991524,0,1,0,0,1
186293728,0,1,0,0,1
186730028,0,1,0,0,1
2190507720,0,1,0,0,1
2191477736,0,1,0,0,1
2192134717,0,1,0,0,1
4835772058,0,1,0,0,1
801974572866097152,0,1,0,0,1
48903,0,1,0,0,1
802552657890177024,1,0,0,0,1
802785705428598784,0,1,0,0,1
803266555190607872,0,0,0,1,1
803567505650384896,0,1,0,0,1
803636604682305536,0,1,0,0,1
803810059490709504,1,0,0,0,1
803824854139080704,1,0,0,0,1
803900899676426240,0,1,0,0,1
803964977254203392,0,1,0,0,1
804047193707606016,0,1,0,0,1
804153286475530240,0,1,0,0,1
804200527290630144,0,1,0,0,1
804437934573137920,0,1,0,0,1
804550497386401792,0,1,0,0,1
804636200799707136,0,1,0,0,1
804636337718575104,0,1,0,0,1
804642472395763712,0,1,0,0,1
804680042135560192,0,1,0,0,1
804786980915650560,0,1,0,0,1
804947812144140288,0,1,0,0,1
804956206179766272,1,0,0,0,1
801866753093537792,0,1,0,0,1
801824112251465728,0,1,0,0,1
801693873651281920,0,1,0,0,1
800701414506795008,0,1,0,0,1
799351563714236416,0,1,0,0,1
799375064466485248,0,1,0,0,1
799414122488201216,1,0,0,0,1
799636412408729600,0,1,0,0,1
799718923541291008,1,0,0,0,1
799859255184527360,1,0,0,0,1
799972115453714432,0,1,0,0,1
799991013037211648,1,0,0,0,1
800234427943006208,0,1,0,0,1
800463336630403072,0,1,0,0,1
800783792428302336,0,1,0,0,1
801491364496056320,1,0,0,0,1
801002165623996416,1,0,0,0,1
801016001345130496,0,1,0,0,1
801063381583167488,0,1,0,0,1
801072031718514688,0,1,0,0,1
801103657638866944,0,1,0,0,1
801118168190062592,1,0,0,0,1
801127134802706432,0,1,0,0,1
801354014487093248,0,1,0,0,1
801393345809547264,0,1,0,0,1
801480027414163456,0,1,0,0,1
805248112264626176,0,1,0,0,1
805478922993311744,0,1,0,0,1
805508504605904896,0,1,0,0,1
810336436813590528,0,1,0,0,1
809439673193885696,0,1,0,0,1
809653827750297600,1,0,0,0,1
809658114458824704,0,1,0,0,1
809723802468745216,0,1,0,0,1
809798639023509504,0,1,0,0,1
809827604341604352,0,1,0,0,1
809922769051852800,0,1,0,0,1
809970499853828096,0,1,0,0,1
810018503281537024,0,1,0,0,1
810129719567990784,0,1,0,0,1
810769909219258368,0,1,0,0,1
809256115607375872,0,1,0,0,1
811246799465938944,1,0,0,0,1
811425744609869824,0,1,0,0,1
811481100576923648,0,1,0,0,1
811593640233402368,1,0,0,0,1
811601610606514176,0,1,0,0,1
811713997737168896,0,1,0,0,1
812154239657054208,0,1,0,0,1
812494675022123008,0,1,0,0,1
812852991640281088,0,1,0,0,1
813277292206166016,0,1,0,0,1
809362000698556416,0,1,0,0,1
809200067408076800,0,1,0,0,1
805516112456581120,0,1,0,0,1
807150682411106304,0,1,0,0,1
805750822558691328,0,1,0,0,1
805764041868247040,0,1,0,0,1
805791467423879168,0,1,0,0,1
805816841272598528,0,1,0,0,1
806029153145233408,0,1,0,0,1
806135385055236096,0,1,0,0,1
806350430141906944,0,1,0,0,1
806525046667771904,0,1,0,0,1
806798097896513536,0,1,0,0,1
807029571195469824,0,1,0,0,1
807402110723575808,0,1,0,0,1
809075425892667392,0,1,0,0,1
807537956881887232,0,1,0,0,1
807936005487595520,0,1,0,0,1
808201508542103552,0,1,0,0,1
808395743639797760,0,1,0,0,1
808435931749449728,1,0,0,0,1
808608344764256256,0,1,0,0,1
808668064992481280,1,0,0,0,1
808878257424703488,0,1,0,0,1
808882953644163072,1,0,0,0,1
809019979207151616,0,1,0,0,1
799289977255432192,0,1,0,0,1
799196371190284288,0,1,0,0,1
798964170054057984,0,1,0,0,1
787444033064951808,0,1,0,0,1
785739852448829440,0,1,0,0,1
785805412113219584,0,1,0,0,1
786198604792946688,0,1,0,0,1
786220869613854720,0,1,0,0,1
786516154361651200,0,1,0,0,1
786811991394430976,0,1,0,0,1
786963810829512704,0,1,0,0,1
787116920004747264,0,1,0,0,1
787197022751174656,0,1,0,0,1
787357161592614912,0,1,0,0,1
787537105119506432,0,1,0,0,1
785577526101803008,0,1,0,0,1
787635329603960832,0,1,0,0,1
787722343154061312,0,1,0,0,1
787835103934226432,1,0,0,0,1
788075355856773120,0,1,0,0,1
788408667972341760,0,1,0,0,1
788465078928629760,0,1,0,0,1
788479052504002560,0,1,0,0,1
788661474717827072,0,1,0,0,1
788783634228576256,0,1,0,0,1
788974380931883008,0,1,0,0,1
785690572551966720,0,1,0,0,1
785563682126331904,0,1,0,0,1
789141609141022720,0,1,0,0,1
783481429631967232,0,1,0,0,1
781699938879168512,0,1,0,0,1
781751067621023744,1,0,0,0,1
781897362201387008,0,1,0,0,1
782166293092921344,0,1,0,0,1
782246416437706752,0,1,0,0,1
782436419235094528,0,1,0,0,1
782957256434409472,0,1,0,0,1
783183905876762624,0,1,0,0,1
783243383468797952,0,0,0,1,1
783292189933760512,0,1,0,0,1
783682914303082496,0,1,0,0,1
785509659302035456,0,1,0,0,1
783833718100074496,0,1,0,0,1
783892775121063936,0,1,0,0,1
784017869893808128,1,0,0,0,1
784027426502348800,0,1,0,0,1
784232078040629248,0,1,0,0,1
784295680063991808,1,0,0,0,1
784839986646507520,0,1,0,0,1
784944769784963072,1,0,0,0,1
785174374978457600,0,1,0,0,1
785404380606455808,0,1,0,0,1
788978736204918784,1,0,0,0,1
789259319334363136,0,1,0,0,1
798704978860777472,1,0,0,0,1
797442530438692864,0,1,0,0,1
796065671440371712,0,1,0,0,1
796166318231875584,1,0,0,0,1
796271735687512064,0,1,0,0,1
796282862836346880,1,0,0,0,1
796545680806449152,0,1,0,0,1
796754413037748224,0,1,0,0,1
796882084040241152,0,1,0,0,1
796985802114891776,0,1,0,0,1
797250788825382912,0,1,0,0,1
797435774186745856,0,1,0,0,1
797613374960009216,0,1,0,0,1
795928258420285440,1,0,0,0,1
797625058151821312,0,1,0,0,1
797634389081522176,1,0,0,0,1
797734955535204352,0,1,0,0,1
797761076595068928,0,1,0,0,1
797932204168876032,0,1,0,0,1
797970505621901312,0,1,0,0,1
798248575448793088,0,1,0,0,1
798400674522341376,0,1,0,0,1
798435784621637632,0,1,0,0,1
798503833764626432,0,1,0,0,1
796022783377571840,0,1,0,0,1
795429282298245120,0,1,0,0,1
789260849353338880,0,1,0,0,1
792003323998109696,0,1,0,0,1
789851957947146240,0,1,0,0,1
789874706287513600,0,1,0,0,1
789882477028474880,0,1,0,0,1
790168227066281984,0,1,0,0,1
790279207704145920,1,0,0,0,1
790376162346332160,1,0,0,0,1
790518022641377280,1,0,0,0,1
791331750249017344,0,1,0,0,1
791676920794669056,1,0,0,0,1
791712550110973952,0,0,1,0,1
792032646461132800,1,0,0,0,1
795403662382219264,0,1,0,0,1
792064076754980864,0,1,0,0,1
792627828583899136,0,1,0,0,1
792949206243651584,1,0,0,0,1
792997143170670592,0,1,0,0,1
793020405493760000,0,1,0,0,1
793124892652830720,1,0,0,0,1
793187418585214976,0,1,0,0,1
793715982774706176,0,1,0,0,1
794281298223398912,0,1,0,0,1
794509685214814208,0,1,0,0,1
813347338878009344,0,1,0,0,1
813517116477411328,0,1,0,0,1
813673445745491968,0,1,0,0,1
837766451767410688,0,1,0,0,1
835021619349315584,0,1,0,0,1
835268468693843968,0,1,0,0,1
835547775144165376,0,1,0,0,1
835947332852056064,0,1,0,0,1
836260260771991552,1,0,0,0,1
836467701002473472,0,1,0,0,1
836809909421363200,0,1,0,0,1
836851462516899840,0,1,0,0,1
836864078530371584,1,0,0,0,1
837267702297284608,1,0,0,0,1
837932045296930816,0,1,0,0,1
834792823551557632,0,1,0,0,1
838721530624368640,1,0,0,0,1
838727706783191040,0,1,0,0,1
838756996681588736,0,1,0,0,1
838935519094460416,0,1,0,0,1
839323933774065664,0,1,0,0,1
839646137837568000,0,1,0,0,1
839729534803066880,1,0,0,0,1
840019284277501952,0,1,0,0,1
840052389327462400,0,1,0,0,1
840627813363331072,0,1,0,0,1
834867750191370240,0,1,0,0,1
834649368816803840,0,1,0,0,1
840827187792117760,0,1,0,0,1
832340281051717632,1,0,0,0,1
831540817344999424,0,1,0,0,1
831622337434906624,0,1,0,0,1
831828677742718976,0,1,0,0,1
831966547656720384,0,1,0,0,1
832001313756037120,0,1,0,0,1
832111188586688512,1,0,0,0,1
832113514277789696,1,0,0,0,1
832209347979649024,0,1,0,0,1
832285764998176768,0,1,0,0,1
832306794483609600,0,1,0,0,1
832919780294291456,0,1,0,0,1
834398829705310208,0,1,0,0,1
833013451249197056,0,1,0,0,1
833054862350905344,0,1,0,0,1
833150701211623424,0,1,0,0,1
833341968419737600,1,0,0,0,1
833552205810638848,0,1,0,0,1
833624458296492032,0,1,0,0,1
833643214397722624,0,1,0,0,1
833884948436238336,0,1,0,0,1
833948277766762496,0,0,1,0,1
833952365497745408,0,1,0,0,1
840637531494469632,0,1,0,0,1
840923483169271808,0,1,0,0,1
831351123764199424,1,0,0,0,1
846183679630049280,0,1,0,0,1
845579722805465088,1,0,0,0,1
845588259988230144,1,0,0,0,1
845593192061845504,0,1,0,0,1
845648414415245312,1,0,0,0,1
845695778127593472,1,0,0,0,1
845793138321113088,0,1,0,0,1
845880059965640704,0,1,0,0,1
845907093601234944,0,1,0,0,1
846061858066841600,0,1,0,0,1
846127897706446848,0,1,0,0,1
846224467097534464,0,1,0,0,1
845381215532339200,0,1,0,0,1
846410393698238464,0,1,0,0,1
846610971028324352,0,1,0,0,1
846665437534289920,1,0,0,0,1
847052620082679808,0,1,0,0,1
847097292394024960,0,1,0,0,1
847390642544050176,0,1,0,0,1
847419130772770816,0,1,0,0,1
847974145543606272,0,1,0,0,1
848374983596294144,1,0,0,0,1
848414434024464384,0,1,0,0,1
845465022046232576,0,1,0,0,1
845257509380206592,1,0,0,0,1
840992098404974592,1,0,0,0,1
843398002219929600,0,1,0,0,1
841013102237872128,0,1,0,0,1
841254445295927296,1,0,0,0,1
841518800705015808,0,1,0,0,1
841688299848753152,0,1,0,0,1
841691667602255872,0,1,0,0,1
842244256974663680,0,1,0,0,1
842537763295674368,0,1,0,0,1
842776728514826240,0,1,0,0,1
842798615349420032,0,1,0,0,1
843376961628000256,1,0,0,0,1
843445390242471936,0,1,0,0,1
845218206750949376,0,1,0,0,1
843885193060536320,0,1,0,0,1
843933092289175552,0,1,0,0,1
844101708427018240,0,1,0,0,1
844323985110261760,1,0,0,0,1
844494610093260800,0,1,0,0,1
844825419220074496,0,1,0,0,1
844898149818880000,0,1,0,0,1
845001958557732864,0,1,0,0,1
845009192284934144,0,1,0,0,1
845214395173126144,0,1,0,0,1
831503211697696768,0,1,0,0,1
831127089025781760,0,1,0,0,1
813739955528798208,0,1,0,0,1
820548349069770752,1,0,0,0,1
817874603846565888,0,1,0,0,1
818510627878514688,0,1,0,0,1
818997815514959872,1,0,0,0,1
819213495954706432,0,1,0,0,1
819535545827201024,0,1,0,0,1
819554149197107200,0,1,0,0,1
819640020646723584,0,1,0,0,1
819678298540220416,0,1,0,0,1
819865851994120192,0,1,0,0,1
820070489619976192,0,1,0,0,1
820567753081765888,0,1,0,0,1
817779655679811584,1,0,0,0,1
820605647448178688,0,1,0,0,1
820722380599332864,0,1,0,0,1
820781677240877056,0,1,0,0,1
820896265827323904,0,1,0,0,1
821062012977508352,0,1,0,0,1
821164592281722880,0,1,0,0,1
821388002899292160,1,0,0,0,1
821578662549950464,0,1,0,0,1
821764654070460416,0,1,0,0,1
821873849176358912,0,1,0,0,1
817822675288502272,0,1,0,0,1
817775946983993344,0,1,0,0,1
821916207288877056,0,1,0,0,1
815569309560926208,0,1,0,0,1
814049530735972352,0,1,0,0,1
814159009699790848,0,1,0,0,1
814364921538301952,0,1,0,0,1
814463942277951488,0,1,0,0,1
814654909723262976,0,1,0,0,1
814735259514339328,1,0,0,0,1
814750953098264576,0,1,0,0,1
814817543206699008,1,0,0,0,1
815074418141630464,0,1,0,0,1
815178965195378688,0,1,0,0,1
815645250559483904,0,1,0,0,1
817654614778609664,1,0,0,0,1
815693052379537408,0,0,0,1,1
815754838398992384,0,1,0,0,1
815968436799078400,0,1,0,0,1
816007196802772992,0,1,0,0,1
816427489589415936,0,1,0,0,1
816803808298803200,0,1,0,0,1
816818681258868736,0,1,0,0,1
817014828887744512,0,1,0,0,1
817465730044018688,0,1,0,0,1
817482165130821632,0,1,0,0,1
821890196216180736,0,1,0,0,1
821939292532604928,0,1,0,0,1
830777722855108608,0,1,0,0,1
829171470068748288,0,1,0,0,1
826814150227722240,0,1,0,0,1
826869573207076864,0,1,0,0,1
826950561174081536,0,1,0,0,1
827046914285830144,0,1,0,0,1
827143126364078080,1,0,0,0,1
828038191974346752,0,1,0,0,1
828192817939890176,0,1,0,0,1
828231213768806400,0,1,0,0,1
828293492115906560,0,1,0,0,1
828915057362870272,0,1,0,0,1
829391066021392384,0,1,0,0,1
826332877457481728,0,1,0,0,1
829395312330555392,1,0,0,0,1
829462211177353216,0,1,0,0,1
829506669453463552,0,1,0,0,1
829709855892062208,0,1,0,0,1
829787503641010176,0,1,0,0,1
829884452314689536,0,1,0,0,1
830359539828539392,0,1,0,0,1
830411895488249856,0,1,0,0,1
830446915867332608,0,1,0,0,1
830692991660482560,0,1,0,0,1
826695086998167552,0,1,0,0,1
826297816796581888,0,1,0,0,1
822816634180108288,0,1,0,0,1
824328513515884544,0,1,0,0,1
822926139693953024,0,1,0,0,1
822987116254756864,0,1,0,0,1
823012910247055360,0,1,0,0,1
823158943677444096,0,1,0,0,1
823209498256896000,0,1,0,0,1
823339381175906304,1,0,0,0,1
823528676373463040,1,0,0,0,1
823950275253780480,0,1,0,0,1
824107343738572800,0,1,0,0,1
824229271073918976,0,1,0,0,1
824344483575853056,0,1,0,0,1
826226047146299392,0,1,0,0,1
824348360026959872,0,1,0,0,1
824545986353754112,0,0,1,0,1
824683329400102912,1,0,0,0,1
824835519448285184,0,1,0,0,1
825019113948983296,0,1,0,0,1
825127941507944448,0,1,0,0,1
825302640644984832,0,1,0,0,1
825593425680437248,0,1,0,0,1
825696408980307968,1,0,0,0,1
826220482810744832,0,1,0,0,1
781578192654069760,0,1,0,0,1
781194806890344448,1,0,0,0,1
781070026233315328,0,1,0,0,1
722118304337436672,1,0,0,0,1
719829201147269120,0,1,0,0,1
719992427726184448,0,1,0,0,1
720017205354737664,1,0,0,0,1
720426478932992000,0,1,0,0,1
720432251956248576,0,1,0,0,1
720869355278340096,0,1,0,0,1
721457020365336576,0,1,0,0,1
721509603738009600,0,1,0,0,1
721915424833556480,0,1,0,0,1
722070786274672640,0,1,0,0,1
722121281315934208,0,1,0,0,1
719713154146676736,0,1,0,0,1
722281464721608704,0,1,0,0,1
722337107537195008,0,1,0,0,1
722476110567587840,0,1,0,0,1
722684299426799616,1,0,0,0,1
723297452787261440,0,1,0,0,1
723587850898432000,0,1,0,0,1
723623281077702656,0,1,0,0,1
724327951370579968,0,1,0,0,1
724546859205820416,0,1,0,0,1
724990372246593536,0,1,0,0,1
719782226196467712,1,0,0,0,1
719534361226436608,0,1,0,0,1
725409350580359168,0,1,0,0,1
717519041003294720,0,1,0,0,1
715387805849886720,1,0,0,0,1
715664922634547200,0,1,0,0,1
715884094983376896,0,1,0,0,1
715889915427422208,0,1,0,0,1
716669082355916800,0,1,0,0,1
716765126959955968,0,1,0,0,1
717117713987072000,0,1,0,0,1
717287294017736704,0,1,0,0,1
717297164519653376,0,1,0,0,1
717468384015859712,0,1,0,0,1
717633182338785280,0,1,0,0,1
719089994581831680,1,0,0,0,1
717903871545180160,0,1,0,0,1
718057504043900928,0,1,0,0,1
718127155566276608,0,1,0,0,1
718190806394355712,0,1,0,0,1
718434919467200512,0,1,0,0,1
718448731906039808,0,1,0,0,1
718564180094283776,0,1,0,0,1
718676635692576768,1,0,0,0,1
718682210069417984,0,1,0,0,1
718758334178967552,0,0,0,1,1
725067235681832960,0,1,0,0,1
726009378688651264,0,1,0,0,1
714729231046066176,0,1,0,0,1
735783232726147072,1,0,0,0,1
733782382654939136,0,1,0,0,1
733964059544952832,1,0,0,0,1
734105656962121728,0,1,0,0,1
734444561548873728,0,1,0,0,1
734487989741576192,0,1,0,0,1
734678260542476288,0,1,0,0,1
734740109539442688,0,1,0,0,1
734805107829792768,0,1,0,0,1
735358500000411648,0,1,0,0,1
735434924426039296,0,1,0,0,1
736233689185685504,0,1,0,0,1
732861867673169920,0,1,0,0,1
736629391904673792,1,0,0,0,1
736974957775851520,1,0,0,0,1
737171067148591104,0,1,0,0,1
737283798279294976,0,1,0,0,1
737355119780499456,0,1,0,0,1
737417748272189440,0,1,0,0,1
737631282897768448,0,1,0,0,1
737706428056502272,0,1,0,0,1
738330005101367296,0,1,0,0,1
738338875383386112,0,1,0,0,1
733133120698994688,0,1,0,0,1
732612059976753152,1,0,0,0,1
726588856523325440,0,1,0,0,1
729162599233884160,0,1,0,0,1
727229365554049024,0,1,0,0,1
727358727767089152,0,1,0,0,1
727574810222419968,0,1,0,0,1
727764147170115584,0,1,0,0,1
727851673180356608,0,1,0,0,1
727900757614329856,0,1,0,0,1
728151573155586048,0,1,0,0,1
728581257777586176,0,0,0,1,1
728821872092188672,0,1,0,0,1
729086825172766720,1,0,0,0,1
729702675386785792,0,1,0,0,1
731760110184321024,0,1,0,0,1
730030224784515072,0,0,0,1,1
730739055302860800,0,1,0,0,1
730988278615138304,1,0,0,0,1
731270465344417792,0,1,0,0,1
731453235857264640,0,1,0,0,1
731455272670134272,0,1,0,0,1
731457887445323776,0,1,0,0,1
731608385645318144,0,1,0,0,1
731662323824361472,0,1,0,0,1
731753429782036480,0,1,0,0,1
715367992918298624,1,0,0,0,1
714538042229305344,0,1,0,0,1
738792132220223488,1,0,0,0,1
4909522369,1,0,0,0,1
4884432045,0,1,0,0,1
4889264403,1,0,0,0,1
4889723584,1,0,0,0,1
4890312893,0,1,0,0,1
4891488483,0,1,0,0,1
4891705746,0,1,0,0,1
4892699568,1,0,0,0,1
4892888575,0,1,0,0,1
4893262045,0,1,0,0,1
4898849445,0,1,0,0,1
4911528523,0,0,0,1,1
4881970084,0,1,0,0,1
4915522883,0,1,0,0,1
4915674285,0,1,0,0,1
4921730335,0,1,0,0,1
4922461913,1,0,0,0,1
4922553093,0,1,0,0,1
4925926183,1,0,0,0,1
4926290294,1,0,0,0,1
699606619211046912,0,1,0,0,1
700542488222642176,1,0,0,0,1
701944711221813248,0,1,0,0,1
4882171539,0,1,0,0,1
4881647332,0,1,0,0,1
702157579326136320,0,1,0,0,1
4855815293,0,1,0,0,1
4841851760,0,1,0,0,1
4843828283,0,1,0,0,1
4843930009,0,1,0,0,1
4843959012,0,1,0,0,1
4847603783,0,1,0,0,1
4850032211,0,1,0,0,1
4853446485,0,1,0,0,1
4854610433,1,0,0,0,1
4854694213,1,0,0,0,1
4854699473,1,0,0,0,1
4860779540,0,1,0,0,1
4873949577,0,1,0,0,1
4861249686,0,1,0,0,1
4864537920,0,1,0,0,1
4865193790,0,1,0,0,1
4865877334,0,1,0,0,1
4866093940,0,1,0,0,1
4866743890,0,1,0,0,1
4870478255,0,1,0,0,1
4871145023,0,1,0,0,1
4872276735,0,1,0,0,1
4873921391,0,1,0,0,1
702061230643662848,1,0,0,0,1
703080334196277248,0,1,0,0,1
714471685269774336,0,1,0,0,1
711851612243791872,0,1,0,0,1
709396066249080832,0,1,0,0,1
709564705304498176,0,1,0,0,1
709604045036478464,0,1,0,0,1
710105141651722240,0,1,0,0,1
710612345819508736,0,1,0,0,1
711091516966481920,0,1,0,0,1
711329783272046592,0,1,0,0,1
711577449084141568,0,1,0,0,1
711720939822551040,0,1,0,0,1
711794951793856512,0,1,0,0,1
712280289171472384,0,1,0,0,1
708761957013307392,1,0,0,0,1
713109457392144384,0,1,0,0,1
713180918178058240,0,1,0,0,1
713261243918737408,1,0,0,0,1
713327104528494592,0,1,0,0,1
713392710346866688,0,1,0,0,1
713410737323044864,0,1,0,0,1
713438307192082432,0,1,0,0,1
713606175732985856,0,1,0,0,1
714007860334583808,1,0,0,0,1
714454059659476992,0,1,0,0,1
709230392382001152,0,1,0,0,1
708433143729008640,0,1,0,0,1
703251865991905280,1,0,0,0,1
705333253226369024,1,0,0,0,1
703998994322567168,1,0,0,0,1
704342738012078080,0,1,0,0,1
704524912656973824,0,1,0,0,1
704583568316633088,0,1,0,0,1
704660097935343616,0,1,0,0,1
704863841092505600,0,1,0,0,1
704960481748983808,0,1,0,0,1
705106811611963392,0,1,0,0,1
705140392287580160,0,1,0,0,1
705295879129858048,0,1,0,0,1
705555281371987968,0,1,0,0,1
708318936513777664,0,1,0,0,1
705867977766219776,0,1,0,0,1
706155797445672960,0,1,0,0,1
706501066548973568,0,1,0,0,1
706780971119550464,1,0,0,0,1
706812526365790208,0,1,0,0,1
707394717844025344,0,1,0,0,1
707514019414933504,0,1,0,0,1
707605012117979136,0,1,0,0,1
707641459990728704,0,1,0,0,1
708318523408437248,1,0,0,0,1
738759178139770880,0,1,0,0,1
739001857155211264,0,1,0,0,1
780853370198237184,0,1,0,0,1
769359486217773056,1,0,0,0,1
768079458121113600,0,1,0,0,1
768113660820529152,0,1,0,0,1
768140596112351232,0,1,0,0,1
768172656923258880,0,1,0,0,1
768233740942258176,0,1,0,0,1
768775233113235456,0,0,0,1,1
768967818381492224,0,1,0,0,1
769094767368110080,0,1,0,0,1
769142164681060352,0,1,0,0,1
769201099647614976,0,1,0,0,1
769543909882097664,0,1,0,0,1
767952289814474752,0,1,0,0,1
769611592761827328,1,0,0,0,1
769652343382151168,0,1,0,0,1
769831551303430144,0,1,0,0,1
769901923231227904,0,1,0,0,1
769928455307886592,0,1,0,0,1
770046663926902784,0,1,0,0,1
770303933243809792,1,0,0,0,1
770583838061948928,0,1,0,0,1
770619645921550336,0,1,0,0,1
770642242977529856,0,1,0,0,1
768076679143120896,1,0,0,0,1
767515935238344704,0,1,0,0,1
770683725331955712,0,1,0,0,1
763946979521011712,1,0,0,0,1
761753904090537984,1,0,0,0,1
761902597829558272,0,1,0,0,1
762857708483522560,0,1,0,0,1
762946889956425728,1,0,0,0,1
762961411068657664,0,1,0,0,1
763107632110510080,0,1,0,0,1
763237809436168192,0,0,0,1,1
763260388750176256,0,1,0,0,1
763555610700820480,0,1,0,0,1
763672356191547392,0,1,0,0,1
764390537621147648,0,1,0,0,1
766916875817218048,0,1,0,0,1
764511795574738944,0,1,0,0,1
764825121248993280,0,1,0,0,1
764971702656827392,0,1,0,0,1
765250431140392960,0,1,0,0,1
765296237331357696,0,1,0,0,1
765493682783092736,0,1,0,0,1
765638699900145664,0,1,0,0,1
765673136180330496,0,1,0,0,1
765778014332387328,0,1,0,0,1
766626586988716032,1,0,0,0,1
770643664733364224,0,1,0,0,1
770944775037947904,0,1,0,0,1
761536257738629120,1,0,0,0,1
777872832810328064,0,1,0,0,1
776401742724562944,0,1,0,0,1
776455321699160064,0,1,0,0,1
776750775947198464,0,1,0,0,1
777113349242822656,0,1,0,0,1
777121189634256896,1,0,0,0,1
777245322494050304,0,0,1,0,1
777315775585529856,1,0,0,0,1
777367587168645120,1,0,0,0,1
777526532851892224,0,1,0,0,1
777845429652316160,0,1,0,0,1
778090085791260672,1,0,0,0,1
776266149587595264,0,1,0,0,1
778943272295157760,0,1,0,0,1
779337837804158976,0,1,0,0,1
779423841089183744,0,1,0,0,1
779659598378696704,0,1,0,0,1
779708553733009408,0,1,0,0,1
779914322289958912,1,0,0,0,1
780131099162705920,0,1,0,0,1
780454812450230272,0,1,0,0,1
780475888303480832,0,1,0,0,1
780775501006647296,0,1,0,0,1
776282875863773184,0,1,0,0,1
776080579989278720,0,1,0,0,1
771183866228805632,0,1,0,0,1
773922169701228544,0,1,0,0,1
771425646270554112,0,0,0,1,1
771810098025037824,0,1,0,0,1
772679233713872896,0,1,0,0,1
772727852450115584,0,1,0,0,1
772758627992100864,0,1,0,0,1
773284111435829248,1,0,0,0,1
773511533867433984,0,1,0,0,1
773667327577579520,0,1,0,0,1
773742660276412416,1,0,0,0,1
773812850892664832,0,1,0,0,1
774023998380310528,0,1,0,0,1
775792747177312256,0,1,0,0,1
774167934151163904,0,1,0,0,1
774260875549143040,0,1,0,0,1
774302264534106112,1,0,0,0,1
774628898491527168,0,1,0,0,1
774727701198311424,0,1,0,0,1
775045381000425472,1,0,0,0,1
775045497258020864,0,1,0,0,1
775091788860325888,0,1,0,0,1
775325788946042880,1,0,0,0,1
775595032925573120,1,0,0,0,1
761658226656022528,0,1,0,0,1
761511752181899264,0,1,0,0,1
739844197935644672,0,1,0,0,1
748373063151063040,0,1,0,0,1
746689772391927808,0,1,0,0,1
746757181148659712,0,1,0,0,1
746784982048378880,0,1,0,0,1
746883123779108864,0,1,0,0,1
747007229308641280,0,1,0,0,1
747011861380489216,1,0,0,0,1
747117665282629632,1,0,0,0,1
747502586765279232,0,1,0,0,1
747745989482647552,0,1,0,0,1
748104963251789824,1,0,0,0,1
748446211238031360,0,1,0,0,1
746286918388809728,1,0,0,0,1
748665102304436224,0,1,0,0,1
748830053840982016,0,1,0,0,1
748940974152355840,0,1,0,0,1
749396672585748480,0,1,0,0,1
749631319110549504,0,1,0,0,1
750131636671479808,0,1,0,0,1
750354109534969856,0,1,0,0,1
750642724999536640,1,0,0,0,1
750674726759071744,0,1,0,0,1
750799225995296768,0,1,0,0,1
746292755589009408,1,0,0,0,1
745845348774592512,0,1,0,0,1
750972968159838208,0,1,0,0,1
742770870817415168,0,1,0,0,1
740059279772647424,0,1,0,0,1
740067382354415616,0,1,0,0,1
740104533334970368,0,1,0,0,1
740934574256099328,0,1,0,0,1
741046554459525120,0,1,0,0,1
741410799395045376,0,1,0,0,1
741701333774958592,0,1,0,0,1
742252206099816448,0,1,0,0,1
742649261272276992,1,0,0,0,1
742724476605960192,1,0,0,0,1
742968397357580288,0,1,0,0,1
745695411512324096,0,1,0,0,1
743327592258756608,0,1,0,0,1
743438926388428800,0,1,0,0,1
744240959450394624,0,1,0,0,1
744571677946818560,1,0,0,0,1
744683962568683520,0,1,0,0,1
744742368398610432,1,0,0,0,1
744890661078433792,0,1,0,0,1
745086663664205824,0,1,0,0,1
745289999084457984,0,1,0,0,1
745611362626330624,0,1,0,0,1
750877022528897024,0,1,0,0,1
751336488604954624,0,1,0,0,1
761389247182036992,0,1,0,0,1
759514362432331776,1,0,0,0,1
758123917806534656,0,1,0,0,1
758297734801522688,0,1,0,0,1
758393427138674688,1,0,0,0,1
758575846638530560,0,1,0,0,1
758592337652158464,1,0,0,0,1
758708308354162688,0,1,0,0,1
758928681288863744,1,0,0,0,1
758995773459603456,0,1,0,0,1
759155531332390912,0,1,0,0,1
759199880434819072,0,1,0,0,1
759839343208910848,0,1,0,0,1
757643241034358784,0,1,0,0,1
759946989765132288,0,1,0,0,1
760048705433112576,0,1,0,0,1
760098534595055616,0,1,0,0,1
760102550418911232,0,1,0,0,1
760478434095226880,0,1,0,0,1
760504427463708672,0,1,0,0,1
760525203835199488,0,1,0,0,1
760637554244874240,0,1,0,0,1
760915232390873088,0,1,0,0,1
761170701093142528,0,1,0,0,1
757816281248641024,1,0,0,0,1
757594515851112448,0,1,0,0,1
751337247597666304,0,1,0,0,1
754202906744815616,1,0,0,0,1
751846063825252352,0,1,0,0,1
752325460361637888,0,1,0,0,1
752559084881211392,0,1,0,0,1
752561763489636352,0,1,0,0,1
752854639423422464,0,1,0,0,1
752990004142411776,0,1,0,0,1
753275224053780480,1,0,0,0,1
753383923275694080,0,1,0,0,1
753885984400506880,0,1,0,0,1
753946098092285952,1,0,0,0,1
754626969812078592,0,1,0,0,1
757358178044678144,0,1,0,0,1
754675862792962048,0,1,0,0,1
754708941611859968,0,1,0,0,1
754745393234243584,0,1,0,0,1
754928301781635072,1,0,0,0,1
755004795979563008,0,1,0,0,1
755006291932749824,0,1,0,0,1
755034090668171264,0,1,0,0,1
756550126978629632,0,1,0,0,1
756564931676209152,0,1,0,0,1
756737840130756608,0,1,0,0,1
848440530472058880,1,0,0,0,1
849411796171620352,0,1,0,0,1
849685715323506688,0,1,0,0,1
958825122613399552,0,1,0,0,1
956875285802217472,0,1,0,0,1
956927837356920832,1,0,0,0,1
956940279038332928,0,1,0,0,1
956988172399009792,0,1,0,0,1
957289787504787456,0,1,0,0,1
957538266416283648,0,1,0,0,1
958013361001828352,0,1,0,0,1
958250887939612672,0,1,0,0,1
958408897886212096,0,1,0,0,1
958587088135512064,0,1,0,0,1
958940231939473408,0,1,0,0,1
956304828845690880,0,1,0,0,1
959277204797403136,0,1,0,0,1
960342304820285440,0,1,0,0,1
961113478718246912,0,1,0,0,1
961169730710188032,0,1,0,0,1
961234698193137664,1,0,0,0,1
961259625717944320,0,1,0,0,1
961295881982033920,0,1,0,0,1
961495547357089792,0,1,0,0,1
961553940209860608,0,1,0,0,1
961586537015234560,0,1,0,0,1
956814655380475904,0,1,0,0,1
956081285465767936,0,1,0,0,1
962255536287895552,1,0,0,0,1
954089878287011840,0,1,0,0,1
951712508309536768,0,1,0,0,1
951883796319784960,0,1,0,0,1
951938730805399552,1,0,0,0,1
952088803098943488,0,1,0,0,1
952595922281676800,0,1,0,0,1
952756506751066112,1,0,0,0,1
953449248732848128,1,0,0,0,1
953693899792543744,0,1,0,0,1
953761646832271360,0,1,0,0,1
953969344211496960,0,1,0,0,1
954198774691303424,0,1,0,0,1
955949916148428800,0,1,0,0,1
954680337665150976,0,1,0,0,1
954786183044911104,0,1,0,0,1
954832889350443008,0,1,0,0,1
955109562612441088,0,1,0,0,1
955187061811765248,0,1,0,0,1
955338922518896640,0,1,0,0,1
955501237746655232,0,1,0,0,1
955802254308790272,0,1,0,0,1
955883817058885632,0,1,0,0,1
955910644720635904,0,1,0,0,1
962211528773484544,0,1,0,0,1
962347650438774784,0,1,0,0,1
951330458972893184,1,0,0,0,1
967183736910442496,1,0,0,0,1
965064844855693312,0,1,0,0,1
965140071287410688,0,0,0,1,1
965301079092219904,0,1,0,0,1
965578209734557696,0,1,0,0,1
966361524909457408,0,1,0,0,1
966370598279569408,0,1,0,0,1
966416492739821568,0,1,0,0,1
966794424863862784,0,1,0,0,1
966979437521702912,0,1,0,0,1
967133261917954048,0,1,0,0,1
967224956043055104,0,1,0,0,1
964922046412140544,1,0,0,0,1
967315556129914880,0,1,0,0,1
967498061269348352,0,1,0,0,1
967549119484088320,0,1,0,0,1
967577840475451392,0,1,0,0,1
967694426574348288,0,1,0,0,1
967697314704801792,0,1,0,0,1
967783226600177664,1,0,0,0,1
967783355369615360,0,1,0,0,1
967955020351090688,0,0,0,1,1
968016204718903296,1,0,0,0,1
965044995559477248,0,1,0,0,1
964914610565472256,0,1,0,0,1
962446794872455168,0,1,0,0,1
963549742398627840,0,1,0,0,1
962520683875045376,0,1,0,0,1
962561748342538240,0,1,0,0,1
962600198844354560,0,1,0,0,1
962749615966736384,0,1,0,0,1
962960297970380800,0,1,0,0,1
962978559580082176,0,1,0,0,1
962989341973860352,0,0,0,1,1
963205694819328000,0,1,0,0,1
963364228357816320,0,1,0,0,1
963471526811942912,0,1,0,0,1
963717604387926016,0,1,0,0,1
964914259158355968,0,1,0,0,1
964082935975546880,1,0,0,0,1
964140058990096384,0,1,0,0,1
964190420556279808,1,0,0,0,1
964234439558664192,0,1,0,0,1
964359531978354688,0,1,0,0,1
964407340941242368,1,0,0,0,1
964498431245864960,0,1,0,0,1
964611137168789504,0,1,0,0,1
964669849057333248,1,0,0,0,1
964875116327915520,0,1,0,0,1
951556429361512448,0,1,0,0,1
951125075293589504,0,1,0,0,1
968047670718689280,0,1,0,0,1
939014415260696576,0,1,0,0,1
938008991543779328,0,1,0,0,1
938148322988130304,0,1,0,0,1
938330968099819520,0,1,0,0,1
938343343993511936,1,0,0,0,1
938345288426803200,0,1,0,0,1
938346970644697088,0,1,0,0,1
938574887802802176,0,1,0,0,1
938614197994250240,0,1,0,0,1
938619434402377728,0,1,0,0,1
938825901642354688,0,1,0,0,1
939166655703404544,1,0,0,0,1
937817215700783104,0,1,0,0,1
939242098422943744,0,1,0,0,1
939816511987789824,0,1,0,0,1
940101318143651840,0,1,0,0,1
940134012021964800,1,0,0,0,1
940167450481459200,1,0,0,0,1
940237652581793792,1,0,0,0,1
940714168835104768,0,1,0,0,1
941134943131971584,0,1,0,0,1
941177326573838336,0,1,0,0,1
941614869194960896,0,1,0,0,1
937902444348039168,1,0,0,0,1
937625617809338368,0,1,0,0,1
941694974256484352,1,0,0,0,1
934702629061570560,0,1,0,0,1
932502778806751232,0,1,0,0,1
932766229651103744,0,1,0,0,1
933026212905066496,1,0,0,0,1
933167603740217344,0,1,0,0,1
933227406843772928,0,1,0,0,1
933357903486046208,0,1,0,0,1
933703443390386176,1,0,0,0,1
933885056531206144,0,1,0,0,1
934254348464398336,1,0,0,0,1
934531630101876736,0,1,0,0,1
934954838852386816,0,1,0,0,1
937266259619655680,0,1,0,0,1
935121440302497792,0,1,0,0,1
935124306006302720,0,1,0,0,1
935147383285010432,1,0,0,0,1
935403267072372736,0,1,0,0,1
935438129212690432,0,1,0,0,1
936598283102838784,1,0,0,0,1
936743236521136128,0,1,0,0,1
936828296800690176,0,0,0,1,1
937140123228979200,1,0,0,0,1
937222384133664768,1,0,0,0,1
941689937044410368,0,1,0,0,1
941739686619484160,0,1,0,0,1
951051508321345536,0,1,0,0,1
949693308036681728,0,0,0,1,1
947896964879876096,0,1,0,0,1
948012715670355968,1,0,0,0,1
948025288356642816,0,1,0,0,1
948347017868214272,0,1,0,0,1
948779822917955584,1,0,0,0,1
948878796354023424,0,1,0,0,1
948977800693866496,0,1,0,0,1
949033461867859968,0,0,0,1,1
949118017874653184,1,0,0,0,1
949434683028398080,1,0,0,0,1
949711084453277696,0,1,0,0,1
947728490014523392,1,0,0,0,1
949747386389168128,0,1,0,0,1
949771863382724608,0,1,0,0,1
950087871892938752,0,1,0,0,1
950196207682404352,0,1,0,0,1
950201608159232000,0,0,0,1,1
950305595227336704,0,1,0,0,1
950361609439887360,1,0,0,0,1
950629707199930368,0,1,0,0,1
950657843274936320,0,1,0,0,1
951019013777211392,0,1,0,0,1
947803638776205312,0,1,0,0,1
947551974207000576,0,1,0,0,1
941906937851011072,0,1,0,0,1
945521733896826880,0,1,0,0,1
942107577793384448,0,1,0,0,1
942219461649580032,0,1,0,0,1
942344206927896576,0,1,0,0,1
942722725776257024,0,1,0,0,1
943173783975636992,0,1,0,0,1
943733036084072448,1,0,0,0,1
943754921588924416,0,1,0,0,1
944228181908901888,1,0,0,0,1
944857493309497344,1,0,0,0,1
944965975765635072,0,1,0,0,1
945528360410660864,0,1,0,0,1
947532800500023296,0,1,0,0,1
945706076607000576,0,1,0,0,1
945800022150574080,0,1,0,0,1
945880713743790080,0,0,0,1,1
945969317673254912,0,1,0,0,1
946238250078949376,0,1,0,0,1
946241634127134720,0,1,0,0,1
946382999192506368,0,1,0,0,1
946394906695626752,0,1,0,0,1
946620098286104576,0,1,0,0,1
947210950691528704,0,1,0,0,1
968018341016170496,0,1,0,0,1
969063320849395712,0,1,0,0,1
932223172664889344,0,1,0,0,1
998332081657794560,0,1,0,0,1
995965067043618816,1,0,0,0,1
996085885358637056,0,1,0,0,1
996511970806452224,0,1,0,0,1
996590696311279616,1,0,0,0,1
996969382910754816,0,1,0,0,1
997049933147582464,0,1,0,0,1
997395326922354688,0,1,0,0,1
997920298463776768,0,1,0,0,1
997924072380973056,0,1,0,0,1
997927919551905792,0,1,0,0,1
998463666294087680,1,0,0,0,1
995365881491410944,0,1,0,0,1
998480902614220800,0,1,0,0,1
999100972348706816,0,1,0,0,1
999331382143913984,0,1,0,0,1
999450676777308160,0,1,0,0,1
999677836410703872,0,1,0,0,1
1000005268225183744,0,1,0,0,1
1000076281608749056,0,1,0,0,1
1000177043529646080,1,0,0,0,1
1000313229590122496,0,1,0,0,1
1000569458123915264,0,1,0,0,1
995584777334947840,0,1,0,0,1
994647661532794880,0,1,0,0,1
1001120670586232832,0,1,0,0,1
991674814661365760,0,1,0,0,1
989363598022524928,0,1,0,0,1
989442787123789824,0,1,0,0,1
989461888760139776,0,1,0,0,1
989579486889885696,0,1,0,0,1
990119995911716864,0,1,0,0,1
990161370791403520,0,1,0,0,1
990338766442119168,1,0,0,0,1
990364156497924096,1,0,0,0,1
991392995412008960,0,0,0,1,1
991644426991800320,0,1,0,0,1
991680235044331520,0,1,0,0,1
993938300577632256,0,1,0,0,1
991846962025480192,0,0,1,0,1
991883450880741376,0,1,0,0,1
992954467724201984,1,0,0,0,1
993134676180127744,0,1,0,0,1
993217742932234240,0,1,0,0,1
993444985105154048,0,0,0,1,1
993499349278773248,0,1,0,0,1
993540165237800960,0,1,0,0,1
993668235626082304,0,1,0,0,1
993797037576482816,1,0,0,0,1
1000660132332822528,0,1,0,0,1
1001773494663704576,1,0,0,0,1
989078279620579328,0,1,0,0,1
1010694648845754368,0,1,0,0,1
1007560450748354560,0,1,0,0,1
1007830643399634944,0,1,0,0,1
1007931222163640320,0,1,0,0,1
1007957979860295680,0,1,0,0,1
1008319710050439168,0,1,0,0,1
1008868556002545664,0,1,0,0,1
1009273718760202240,0,1,0,0,1
1009526028828540928,0,1,0,0,1
1009838722907590656,1,0,0,0,1
1010673175124996096,0,1,0,0,1
1010731868763770880,0,0,0,1,1
1007243628622897152,0,1,0,0,1
1010854410350678016,0,1,0,0,1
1011273546595643392,0,1,0,0,1
1011345798045622272,0,1,0,0,1
1011531121232891904,1,0,0,0,1
1011817655957893120,0,1,0,0,1
1012008634975440896,0,1,0,0,1
1012749562690273280,0,1,0,0,1
1012902898336854016,0,1,0,0,1
1012957322912526336,1,0,0,0,1
1013378008722432000,0,1,0,0,1
1007518859979579392,0,1,0,0,1
1006648588791943168,0,1,0,0,1
1001893496528293888,0,1,0,0,1
1003905947062841344,1,0,0,0,1
1002130997541031936,0,1,0,0,1
1002268142306054144,0,1,0,0,1
1002738888127832064,0,1,0,0,1
1002790256419090432,0,1,0,0,1
1002896580611997696,0,1,0,0,1
1002981635862736896,0,1,0,0,1
1002988457868845056,0,1,0,0,1
1003344372136415232,1,0,0,0,1
1003660439283068928,0,1,0,0,1
1003704886003994624,0,1,0,0,1
1004111918443966464,0,1,0,0,1
1006602241782865920,0,1,0,0,1
1004269461002706944,0,1,0,0,1
1004293802159497216,1,0,0,0,1
1004422403521298432,1,0,0,0,1
1004525901080678400,0,1,0,0,1
1004664937015332864,0,1,0,0,1
1004766856434110464,0,1,0,0,1
1004880221261189120,0,1,0,0,1
1005328901336264704,0,1,0,0,1
1005335198928601088,0,1,0,0,1
1005658713837973504,0,1,0,0,1
989330734287486976,1,0,0,0,1
988456874549723136,0,1,0,0,1
969328969697955840,0,1,0,0,1
976475740370739200,0,1,0,0,1
975506377065058304,0,1,0,0,1
975559533409046528,0,1,0,0,1
975579200512905216,0,1,0,0,1
975833098939138048,0,1,0,0,1
975885864524906496,0,1,0,0,1
975914217978003456,0,1,0,0,1
975948728396865536,0,1,0,0,1
976085176248930304,0,1,0,0,1
976175696971161600,0,1,0,0,1
976426834857549824,0,1,0,0,1
976490560180531200,0,1,0,0,1
973881095900028928,1,0,0,0,1
976727379128344576,0,1,0,0,1
976911859373805568,0,1,0,0,1
977546842673156096,0,1,0,0,1
977897335530418176,0,1,0,0,1
977910392767877120,1,0,0,0,1
977912922084012032,0,1,0,0,1
977960755919228928,0,1,0,0,1
978025632247549952,0,1,0,0,1
978259384747855872,0,1,0,0,1
978305197620506624,0,1,0,0,1
975126413459296256,0,1,0,0,1
973627051071672320,0,1,0,0,1
978522323870453760,0,1,0,0,1
971383663819743232,0,1,0,0,1
969353913244807168,0,1,0,0,1
969357693348540416,1,0,0,0,1
969437911664988160,1,0,0,0,1
969518593728794624,0,1,0,0,1
969630770909384704,0,1,0,0,1
969646565039239168,0,1,0,0,1
970058089427763200,0,1,0,0,1
970117914731757568,0,1,0,0,1
970379661535514624,0,1,0,0,1
971264135416700928,0,1,0,0,1
971598312599007232,1,0,0,0,1
973413634801065984,0,1,0,0,1
971628780543332352,0,1,0,0,1
972044748415492096,0,1,0,0,1
972114564111364096,0,1,0,0,1
972386654630662144,0,1,0,0,1
972433603752755200,0,1,0,0,1
972558014275301376,1,0,0,0,1
972700359058636800,1,0,0,0,1
973217550615105536,1,0,0,0,1
973247240822280192,0,1,0,0,1
973379693834653696,1,0,0,0,1
978346816172445696,0,1,0,0,1
978860122956095488,1,0,0,0,1
988062589803487232,0,1,0,0,1
986340242431950848,0,1,0,0,1
983615202208858112,0,1,0,0,1
983895893819740160,0,1,0,0,1
984182548791164928,0,1,0,0,1
984383039538106368,0,1,0,0,1
984459638945890304,1,0,0,0,1
985022531609513984,0,1,0,0,1
985367757599399936,0,1,0,0,1
985725604065566720,0,1,0,0,1
985757195588415488,0,1,0,0,1
985827127227486208,0,1,0,0,1
986529756089741312,0,1,0,0,1
983361664501170176,0,1,0,0,1
986544655180488704,0,1,0,0,1
986551002382983168,1,0,0,0,1
986614304857182208,0,1,0,0,1
986627700604325888,0,1,0,0,1
986846611945893888,0,1,0,0,1
986935574048145408,0,1,0,0,1
987112918637572096,0,1,0,0,1
987132740570173440,1,0,0,0,1
987469019488931840,0,1,0,0,1
987666065974071296,1,0,0,0,1
983597609137815552,0,1,0,0,1
982915233365798912,0,1,0,0,1
978901377811443712,0,1,0,0,1
980711341521448960,0,1,0,0,1
978916359143809024,0,1,0,0,1
979119143512309760,0,1,0,0,1
979165011925925888,0,1,0,0,1
979212105533440000,1,0,0,0,1
979407010293743616,0,1,0,0,1
979456159789690880,0,1,0,0,1
979575144548126720,1,0,0,0,1
980357308961062912,1,0,0,0,1
980407239943979008,0,1,0,0,1
980431802660737024,1,0,0,0,1
980718004181716992,0,1,0,0,1
982882642860347392,0,1,0,0,1
981037520270929920,1,0,0,0,1
981062620261355520,0,1,0,0,1
981068624726188032,0,1,0,0,1
981161081036070912,0,1,0,0,1
981221719493890048,0,1,0,0,1
981275931678560256,0,1,0,0,1
981404701731295232,0,1,0,0,1
981909443205050368,0,1,0,0,1
982316463632592896,0,1,0,0,1
982510007085355008,0,1,0,0,1
932266547451744256,0,1,0,0,1
932216273340997632,0,0,0,1,1
849815510355243008,1,0,0,0,1
879901565989130240,0,1,0,0,1
877878207609020416,0,1,0,0,1
877995866069577728,0,1,0,0,1
878997609309929472,0,1,0,0,1
879005787674222592,0,1,0,0,1
879041943585656832,0,1,0,0,1
879229057786933248,0,1,0,0,1
879276276199997440,0,1,0,0,1
879300633777590272,0,1,0,0,1
879358414555561984,0,1,0,0,1
879487116224364544,1,0,0,0,1
880071559125323776,0,1,0,0,1
877858431067201536,0,1,0,0,1
880226143353401344,0,1,0,0,1
880358566829236224,1,0,0,0,1
880370622160875520,0,1,0,0,1
880441656088113152,0,1,0,0,1
880631440370786304,0,1,0,0,1
880701508911845376,0,1,0,0,1
880722093385670656,0,1,0,0,1
880868432664817664,0,1,0,0,1
881038131104956416,0,1,0,0,1
881078372205572096,1,0,0,0,1
877864689111367680,0,1,0,0,1
877545372255526912,1,0,0,0,1
881185403180654592,0,1,0,0,1
874401900254306304,0,0,1,0,1
871429799431913472,0,1,0,0,1
871580975574200320,0,1,0,0,1
871611057386774528,0,1,0,0,1
871787588239208448,0,1,0,0,1
872177510968119296,0,1,0,0,1
872494578309492736,0,1,0,0,1
872655616073793536,1,0,0,0,1
873637773940359168,0,1,0,0,1
874004596506546176,1,0,0,0,1
874219074334724096,0,1,0,0,1
874786087176110080,0,1,0,0,1
877493316803276800,0,1,0,0,1
875398567036375040,1,0,0,0,1
875596606476738560,0,1,0,0,1
876459390437662720,0,1,0,0,1
876708212401029120,0,1,0,0,1
876749472553996288,0,1,0,0,1
877093472150466560,0,1,0,0,1
877163392263479296,0,1,0,0,1
877352838829154304,0,1,0,0,1
877358994905542656,0,1,0,0,1
877440143564697600,0,1,0,0,1
881120553783840768,0,1,0,0,1
881486070851960832,0,1,0,0,1
871326001342623744,0,1,0,0,1
889091365505650688,1,0,0,0,1
887841046717136896,0,1,0,0,1
887933658966900736,0,0,0,1,1
887961140424298496,0,1,0,0,1
888029012898979840,0,1,0,0,1
888087887199260672,0,1,0,0,1
888287120627859456,0,1,0,0,1
888356847618588672,0,1,0,0,1
888446168790736896,1,0,0,0,1
888638690100076544,0,1,0,0,1
888827889587802112,0,1,0,0,1
889472467156164608,0,1,0,0,1
887366926724472832,0,1,0,0,1
889483082318962688,1,0,0,0,1
889489424802865152,0,1,0,0,1
889558865464918016,0,1,0,0,1
890004406380281856,0,1,0,0,1
890091088966541312,0,1,0,0,1
890130860380499968,0,1,0,0,1
890217183770533888,0,1,0,0,1
891067071970164736,0,1,0,0,1
891093412262359040,0,1,0,0,1
891095583376715776,0,1,0,0,1
887645332204642304,0,1,0,0,1
887056828928053248,0,1,0,0,1
881648104797339648,0,1,0,0,1
884207218215854080,0,1,0,0,1
881682521565544448,1,0,0,0,1
882009881162780672,0,1,0,0,1
882144957448024064,0,1,0,0,1
882482172422111232,0,1,0,0,1
882643164594552832,0,1,0,0,1
882865998096986112,1,0,0,0,1
883316851421458432,1,0,0,0,1
883534167446880256,0,1,0,0,1
884026348515115008,0,1,0,0,1
884107008491651072,0,1,0,0,1
884516110686724096,0,1,0,0,1
886994389355999232,1,0,0,0,1
884548017092780032,0,1,0,0,1
884586863423442944,0,1,0,0,1
884887114021826560,0,1,0,0,1
885109600034402304,0,1,0,0,1
885174037097455616,0,1,0,0,1
885843411835670528,0,1,0,0,1
885871842367606784,0,1,0,0,1
886438270225207296,0,1,0,0,1
886472039933984768,1,0,0,0,1
886562247694102528,1,0,0,0,1
871353501867266048,0,1,0,0,1
871306655983652864,0,1,0,0,1
891299897625980928,0,1,0,0,1
856164259612340224,1,0,0,0,1
854653102389170176,1,0,0,0,1
854991167137751040,0,1,0,0,1
855186636577144832,0,1,0,0,1
855344898723020800,0,1,0,0,1
855356208965746688,0,1,0,0,1
855688314023809024,0,1,0,0,1
855815781111787520,1,0,0,0,1
855885128995930112,0,1,0,0,1
855928914513887232,0,1,0,0,1
856113724318294016,0,1,0,0,1
856202964192702464,0,1,0,0,1
854313612915097600,1,0,0,0,1
856738266799890432,1,0,0,0,1
856792972582637568,0,1,0,0,1
856884497261920256,0,1,0,0,1
856984530816614400,0,1,0,0,1
857050373219078144,0,1,0,0,1
857604167371640832,0,1,0,0,1
857806922174550016,1,0,0,0,1
857875033649106944,0,1,0,0,1
857925749520650240,1,0,0,0,1
857929207015510016,1,0,0,0,1
854549160242040832,0,1,0,0,1
854224318867353600,1,0,0,0,1
858384773097631744,0,0,1,0,1
850867471150047232,0,1,0,0,1
849911824086519808,0,1,0,0,1
849971884221444096,0,1,0,0,1
849976839867179008,1,0,0,0,1
850065573761343488,0,1,0,0,1
850087650857844736,0,1,0,0,1
850088451781349376,0,1,0,0,1
850319085527326720,0,1,0,0,1
850463401243533312,0,1,0,0,1
850698823445790720,0,1,0,0,1
850737957271085056,0,1,0,0,1
850923235411623936,0,1,0,0,1
854003431123677184,0,1,0,0,1
851418788436336640,1,0,0,0,1
852168956903395328,0,1,0,0,1
852169330339053568,0,1,0,0,1
852287009544523776,1,0,0,0,1
852930896294490112,0,1,0,0,1
852961755877830656,0,1,0,0,1
853190786095210496,0,1,0,0,1
853306469667786752,0,1,0,0,1
853462154376343552,0,1,0,0,1
853601859424182272,0,1,0,0,1
857961766743150592,0,1,0,0,1
858509735607361536,0,1,0,0,1
871187681899724800,0,1,0,0,1
867359390877265920,0,1,0,0,1
864635915070844928,0,1,0,0,1
865345181809352704,0,1,0,0,1
865542924221652992,0,1,0,0,1
865596179177906176,0,1,0,0,1
865783015615504384,1,0,0,0,1
866277358071824384,0,1,0,0,1
866292373717995520,0,1,0,0,1
866571426504990720,1,0,0,0,1
866930688632778752,1,0,0,0,1
866941929816285184,0,1,0,0,1
867686881940709376,0,1,0,0,1
864490832983994368,0,1,0,0,1
867816228844437504,1,0,0,0,1
868107088144334848,0,1,0,0,1
868527756690305024,0,1,0,0,1
868719508328001536,0,1,0,0,1
868800278019153920,0,1,0,0,1
868886601195077632,0,1,0,0,1
869417417327480832,0,1,0,0,1
869513533725188096,0,1,0,0,1
869973266080911360,0,1,0,0,1
870288180561555456,0,1,0,0,1
864509482218528768,0,1,0,0,1
864259481324204032,0,1,0,0,1
858720118502813696,1,0,0,0,1
861172168603848704,0,1,0,0,1
859061213526929408,0,1,0,0,1
859078673118490624,0,1,0,0,1
859738809260425216,0,1,0,0,1
860350567130034176,0,1,0,0,1
860393825545670656,0,1,0,0,1
860620797999808512,0,1,0,0,1
860638149134962688,0,1,0,0,1
861055200588640256,0,1,0,0,1
861139319477723136,1,0,0,0,1
861171261107523584,0,1,0,0,1
861865249577869312,0,1,0,0,1
864190044113969152,0,1,0,0,1
861929229520449536,0,1,0,0,1
862005735495835648,0,1,0,0,1
862106769862078464,0,1,0,0,1
862315258916085760,0,1,0,0,1
862386913470287872,0,1,0,0,1
863235865618808832,0,1,0,0,1
863239548087656448,0,1,0,0,1
863852250304663552,0,1,0,0,1
863986348373364736,0,1,0,0,1
864015997123964928,0,1,0,0,1
891119774327091200,0,1,0,0,1
891565171281244160,0,1,0,0,1
932157833969307648,0,1,0,0,1
917940762259496960,0,1,0,0,1
916597182622343168,0,1,0,0,1
916659987073634304,1,0,0,0,1
916709777065037824,1,0,0,0,1
916832046797877248,0,1,0,0,1
917084764149911552,0,1,0,0,1
917438513704030208,0,1,0,0,1
917444639463964672,0,1,0,0,1
917618944592064512,0,1,0,0,1
917687552051761152,0,1,0,0,1
917699990805397504,1,0,0,0,1
917948804715991040,1,0,0,0,1
916364191476404224,0,1,0,0,1
917956717429870592,0,1,0,0,1
918154344364740608,0,1,0,0,1
918376871892459520,0,1,0,0,1
918768746264535040,0,1,0,0,1
919032732398772224,0,1,0,0,1
919062289046650880,0,0,0,1,1
919333439857405952,0,1,0,0,1
919542122482561024,1,0,0,0,1
919590727423856640,0,1,0,0,1
919623473034489856,0,1,0,0,1
916559534428172288,1,0,0,0,1
916083407838433280,0,1,0,0,1
920125513670172672,0,1,0,0,1
913405184297988096,1,0,0,0,1
911154732651171840,0,1,0,0,1
911614243778244608,0,1,0,0,1
911662594078863360,0,1,0,0,1
912180649527775232,0,1,0,0,1
912198203084300288,1,0,0,0,1
912247592918114304,0,1,0,0,1
912579628757389312,1,0,0,0,1
912646293339721728,0,1,0,0,1
913211769593634816,0,1,0,0,1
913371465608654848,0,1,0,0,1
913761000297500672,0,1,0,0,1
915622304985616384,0,1,0,0,1
913795551560388608,0,1,0,0,1
913808495480360960,0,1,0,0,1
913835896092418048,0,1,0,0,1
914009111662120960,0,1,0,0,1
914352835982106624,0,1,0,0,1
914682025474437120,0,1,0,0,1
914807350325682176,0,1,0,0,1
914860452622020608,1,0,0,0,1
915248290693869568,0,1,0,0,1
915469606160015360,1,0,0,0,1
919866426831208448,0,1,0,0,1
920296798106935296,0,1,0,0,1
910987787964440576,0,1,0,0,1
929643998012157952,0,1,0,0,1
927161023613816832,0,1,0,0,1
927251154291085312,0,1,0,0,1
927376376029519872,1,0,0,0,1
927828802532552704,1,0,0,0,1
928020477876023296,0,1,0,0,1
928294761064144896,0,1,0,0,1
928449073337831424,0,1,0,0,1
928477922339332096,0,1,0,0,1
928542634595045376,1,0,0,0,1
928981059982696448,0,1,0,0,1
929714154927280128,0,1,0,0,1
926129649414848512,0,1,0,0,1
929758172855672832,0,1,0,0,1
929777583817928704,0,1,0,0,1
930047221227286528,0,1,0,0,1
930197852319600640,0,1,0,0,1
930259946834292736,1,0,0,0,1
930855288546123776,0,1,0,0,1
931320942927548416,0,1,0,0,1
931746138486489088,1,0,0,0,1
932014289518546944,0,1,0,0,1
932131256204107776,0,1,0,0,1
926859582302928896,0,1,0,0,1
925983010775691264,1,0,0,0,1
920668459716841472,0,1,0,0,1
922790757148196864,0,1,0,0,1
921232601817350144,0,1,0,0,1
921680972365684736,0,1,0,0,1
921701390929580032,1,0,0,0,1
921774812271390720,0,1,0,0,1
921781235332116480,0,1,0,0,1
922142231674449920,0,1,0,0,1
922458620155121664,0,1,0,0,1
922487584684630016,0,1,0,0,1
922559157521342464,0,1,0,0,1
922667790884130816,0,1,0,0,1
923242090661740544,0,1,0,0,1
925840750805479424,0,1,0,0,1
923547827883606016,0,1,0,0,1
924455819348865024,0,1,0,0,1
924459368480935936,1,0,0,0,1
924871166988238848,1,0,0,0,1
925342485949374464,0,1,0,0,1
925408498761940992,0,1,0,0,1
925624701380067328,0,1,0,0,1
925663808210817024,0,1,0,0,1
925683142312235008,0,1,0,0,1
925786558724296704,0,1,0,0,1
911029456948445184,0,1,0,0,1
910916112937713664,0,1,0,0,1
891702056511184896,1,0,0,0,1
898631862553198592,0,1,0,0,1
896692359466852352,0,1,0,0,1
896896702971621376,0,1,0,0,1
897279603819126784,0,1,0,0,1
897333409562996736,0,1,0,0,1
897700562531213312,1,0,0,0,1
897867179852431360,0,1,0,0,1
898113384197099520,0,1,0,0,1
898154642089009152,1,0,0,0,1
898231845925646336,0,1,0,0,1
898559267829055488,1,0,0,0,1
898844032977305600,0,1,0,0,1
896496644656685056,0,1,0,0,1
898910608439074816,0,1,0,0,1
899019949372526592,1,0,0,0,1
899085537243516928,0,1,0,0,1
899144939552026624,0,1,0,0,1
899190534627102720,0,1,0,0,1
899421936379408384,0,1,0,0,1
899505004028993536,0,1,0,0,1
899516785304641536,0,1,0,0,1
899660493920518144,1,0,0,0,1
900043369224691712,0,1,0,0,1
896591210273423360,0,1,0,0,1
896438967016476672,1,0,0,0,1
900244552765681664,0,1,0,0,1
894351380235735040,0,1,0,0,1
892128385492697088,1,0,0,0,1
892152140118077440,0,1,0,0,1
892382335781490688,0,1,0,0,1
892583428666740736,0,1,0,0,1
892922176122302464,0,1,0,0,1
893120937461252096,0,1,0,0,1
893143836620464128,0,1,0,0,1
893405045508763648,0,1,0,0,1
894166719278841856,0,1,0,0,1
894312561671360512,0,1,0,0,1
894680600103223296,0,1,0,0,1
896317636988076032,0,1,0,0,1
894964899893391360,0,1,0,0,1
894993264075579392,0,1,0,0,1
895008345345724416,0,1,0,0,1
895153407773859840,0,1,0,0,1
895191979780440064,0,1,0,0,1
895193499246751744,0,1,0,0,1
895209679248277504,0,1,0,0,1
895294858851516416,0,1,0,0,1
895586354347880448,0,1,0,0,1
896040616005586944,1,0,0,0,1
900087634747379712,0,1,0,0,1
900677829804818432,0,1,0,0,1
910909490815311872,0,1,0,0,1
908060654879203328,0,1,0,0,1
906745538535497728,0,1,0,0,1
906823206908186624,0,1,0,0,1
906936041696665600,1,0,0,0,1
907100315912040448,0,1,0,0,1
907120744836059136,0,1,0,0,1
907254395687002112,0,1,0,0,1
907281562533855232,1,0,0,0,1
907328301626249216,0,1,0,0,1
907594726097879040,0,1,0,0,1
907615230473244672,0,1,0,0,1
908231228339474432,0,1,0,0,1
906085435524317184,0,1,0,0,1
908550923533697024,0,1,0,0,1
908607733380685824,0,1,0,0,1
908674027157200896,0,1,0,0,1
909018313333731328,1,0,0,0,1
909322715110170624,1,0,0,0,1
909388722080116736,0,1,0,0,1
909401280673484800,0,1,0,0,1
909460410905927680,0,1,0,0,1
910004101240446976,0,1,0,0,1
910823182428291072,0,1,0,0,1
906431871210291200,0,1,0,0,1
906058351057944576,1,0,0,0,1
900699295552335872,0,1,0,0,1
902883631177244672,1,0,0,0,1
900982274472136704,0,1,0,0,1
901108721924878336,0,1,0,0,1
901545370400038912,0,1,0,0,1
902239348569071616,0,1,0,0,1
902329869190569984,0,1,0,0,1
902452640860303360,0,1,0,0,1
902480786892443648,1,0,0,0,1
902502004106383360,0,1,0,0,1
902689690704367616,0,1,0,0,1
902810201899888640,0,1,0,0,1
903000663038320640,0,1,0,0,1
905655108767068160,1,0,0,0,1
903628614578483200,0,1,0,0,1
903663227526987776,0,1,0,0,1
903711865678684160,0,1,0,0,1
903871660180201472,0,1,0,0,1
904276119976857600,0,1,0,0,1
904568058856914944,1,0,0,0,1
904600538666426368,0,1,0,0,1
904662179705745408,0,1,0,0,1
904950292113969152,0,1,0,0,1
905386000905633792,0,1,0,0,1
4841697589,0,1,0,0,1
4835280659,0,1,0,0,1
2193936185,0,1,0,0,1
4832527270,1,0,0,0,1
2714422100,0,1,0,0,1
2714607003,0,1,0,0,1
2714720192,0,1,0,0,1
2716439338,0,0,0,1,1
2717201014,0,0,0,1,1
2717307492,0,1,0,0,1
2720051267,0,1,0,0,1
2720881970,1,0,0,0,1
2721849256,0,0,0,1,1
2723439348,0,1,0,0,1
2724235426,0,1,0,0,1
2724591468,0,1,0,0,1
2725914834,0,1,0,0,1
2727022773,0,1,0,0,1
2727101837,0,1,0,0,1
2730035464,0,1,0,0,1
2730448037,1,0,0,0,1
2730567387,1,0,0,0,1
2730850091,0,1,0,0,1
2730961647,1,0,0,0,1
2731598831,0,1,0,0,1
2732175387,0,1,0,0,1
2733558241,0,1,0,0,1
2713479871,0,1,0,0,1
2712875472,0,1,0,0,1
2708670817,0,1,0,0,1
2691780625,0,1,0,0,1
2675180559,0,1,0,0,1
2675201388,0,1,0,0,1
2676231584,1,0,0,0,1
2679788407,1,0,0,0,1
2686540202,1,0,0,0,1
2687524718,0,1,0,0,1
2687849290,0,1,0,0,1
2688156810,0,1,0,0,1
2690612599,0,1,0,0,1
2690728826,0,1,0,0,1
2694873543,0,1,0,0,1
2708496769,0,1,0,0,1
2695017948,0,1,0,0,1
2698413066,0,1,0,0,1
2698642382,0,1,0,0,1
2701958452,0,1,0,0,1
2702816064,0,1,0,0,1
2703555055,0,1,0,0,1
2704817130,0,1,0,0,1
2706639805,0,1,0,0,1
2707104481,0,1,0,0,1
2708112612,1,0,0,0,1
2734081605,0,0,0,1,1
2734086734,0,1,0,0,1
2735404548,0,1,0,0,1
2767897979,0,1,0,0,1
2761586466,0,1,0,0,1
2761864770,0,1,0,0,1
2761997377,0,1,0,0,1
2764052433,0,1,0,0,1
2765434932,0,1,0,0,1
2765867636,0,1,0,0,1
2766087346,0,1,0,0,1
2766249896,0,1,0,0,1
2767023425,0,0,0,1,1
2767408248,0,1,0,0,1
2771077116,0,1,0,0,1
2759566762,0,1,0,0,1
2771961436,0,1,0,0,1
2772145132,0,1,0,0,1
2773448044,0,1,0,0,1
2774966905,0,1,0,0,1
2775883356,1,0,0,0,1
2776091042,0,1,0,0,1
2777579626,0,1,0,0,1
2778604968,0,1,0,0,1
2779979072,0,1,0,0,1
2780053435,0,1,0,0,1
2759928466,0,1,0,0,1
2759267087,0,1,0,0,1
2735576523,0,1,0,0,1
2744919340,0,1,0,0,1
2737123126,0,1,0,0,1
2737203670,0,1,0,0,1
2737972626,0,1,0,0,1
2739712336,0,1,0,0,1
2740189101,0,1,0,0,1
2740330022,0,1,0,0,1
2741597919,1,0,0,0,1
2742109196,1,0,0,0,1
2743312755,0,1,0,0,1
2743611484,0,1,0,0,1
2748605343,0,1,0,0,1
2758393521,0,1,0,0,1
2749134911,1,0,0,0,1
2750738998,0,1,0,0,1
2751624233,1,0,0,0,1
2753262537,0,1,0,0,1
2753835684,0,1,0,0,1
2754433723,0,1,0,0,1
2754445004,0,1,0,0,1
2754734218,0,1,0,0,1
2755631844,0,1,0,0,1
2756534978,0,1,0,0,1
2673507133,1,0,0,0,1
2673185698,0,1,0,0,1
2666623830,0,1,0,0,1
2577463315,0,1,0,0,1
2568063048,1,0,0,0,1
2569418047,0,1,0,0,1
2569776548,0,1,0,0,1
2570480899,1,0,0,0,1
2570650778,0,1,0,0,1
2570727893,0,1,0,0,1
2570791232,0,1,0,0,1
2575006644,1,0,0,0,1
2575919562,0,1,0,0,1
2577053858,0,0,1,0,1
2578457550,0,0,0,1,1
2567232804,0,1,0,0,1
2580127429,0,1,0,0,1
2580812306,0,1,0,0,1
2587393361,0,1,0,0,1
2587915249,0,1,0,0,1
2588540720,0,1,0,0,1
2589246434,1,0,0,0,1
2593707738,0,1,0,0,1
2595167442,0,1,0,0,1
2595200168,0,1,0,0,1
2595305888,0,1,0,0,1
2567545710,0,1,0,0,1
2566684690,0,1,0,0,1
2595973524,1,0,0,0,1
2541762506,0,1,0,0,1
2530596320,0,1,0,0,1
2532706662,1,0,0,0,1
2533109552,0,1,0,0,1
2533511951,0,1,0,0,1
2535654342,0,1,0,0,1
2535751839,0,1,0,0,1
2536010292,0,1,0,0,1
2536027175,0,1,0,0,1
2536846767,0,1,0,0,1
2537764291,0,1,0,0,1
2542779508,0,1,0,0,1
2564430042,1,0,0,0,1
2544525761,0,1,0,0,1
2545187754,1,0,0,0,1
2547027481,0,1,0,0,1
2547798406,0,1,0,0,1
2551979329,0,1,0,0,1
2552502524,0,1,0,0,1
2553106650,0,1,0,0,1
2560871361,1,0,0,0,1
2562268036,0,1,0,0,1
2563212194,0,1,0,0,1
2595431574,0,1,0,0,1
2596467289,0,0,1,0,1
2666543848,0,1,0,0,1
2653387519,1,0,0,0,1
2632048449,1,0,0,0,1
2633179534,0,1,0,0,1
2634639947,0,1,0,0,1
2637666777,0,1,0,0,1
2639963430,0,1,0,0,1
2643762987,0,1,0,0,1
2645611694,1,0,0,0,1
2648638897,0,1,0,0,1
2649669674,0,1,0,0,1
2650617666,0,1,0,0,1
2654704009,0,1,0,0,1
2627650517,1,0,0,0,1
2657972227,1,0,0,0,1
2658640056,0,1,0,0,1
2658919874,0,1,0,0,1
2658926385,1,0,0,0,1
2659215845,0,1,0,0,1
2661448969,0,1,0,0,1
2661559494,0,1,0,0,1
2662046317,0,1,0,0,1
2663672707,0,1,0,0,1
2666165597,0,1,0,0,1
2628196252,0,1,0,0,1
2617377350,0,1,0,0,1
2598000222,1,0,0,0,1
2608253269,1,0,0,0,1
2598508508,1,0,0,0,1
2599517731,0,1,0,0,1
2600818932,0,1,0,0,1
2601350231,0,1,0,0,1
2601700769,1,0,0,0,1
2604748297,1,0,0,0,1
2604955507,0,1,0,0,1
2605190720,0,1,0,0,1
2606768528,0,1,0,0,1
2607399944,0,1,0,0,1
2609670517,0,0,0,1,1
2617266732,0,1,0,0,1
2610398283,0,1,0,0,1
2610909177,0,1,0,0,1
2612112102,0,1,0,0,1
2612411324,0,1,0,0,1
2612807220,0,1,0,0,1
2613946590,1,0,0,0,1
2614745246,0,1,0,0,1
2615044988,0,1,0,0,1
2615112505,0,0,0,1,1
2617153778,0,1,0,0,1
2780427601,1,0,0,0,1
2780466917,1,0,0,0,1
2780931428,0,1,0,0,1
2893810663,1,0,0,0,1
2887175724,0,1,0,0,1
2888304032,0,1,0,0,1
2888402509,0,1,0,0,1
2889199220,0,1,0,0,1
2889251771,0,1,0,0,1
2889557138,1,0,0,0,1
2890629965,0,1,0,0,1
2890900471,0,1,0,0,1
2891855044,0,1,0,0,1
2893471570,0,0,0,1,1
2894786789,0,1,0,0,1
2886212078,0,1,0,0,1
2895281598,1,0,0,0,1
2895744179,0,1,0,0,1
2896021283,0,1,0,0,1
2896795704,1,0,0,0,1
2897537845,0,1,0,0,1
2898621396,1,0,0,0,1
2898918799,1,0,0,0,1
2899797278,0,1,0,0,1
2900473490,0,1,0,0,1
2900683412,0,1,0,0,1
2887070351,0,1,0,0,1
2885756132,0,1,0,0,1
2901743035,0,1,0,0,1
2878141707,0,1,0,0,1
2870028477,0,1,0,0,1
2870956757,0,1,0,0,1
2871068361,0,0,0,1,1
2871291667,0,1,0,0,1
2872284965,1,0,0,0,1
2872719378,0,1,0,0,1
2872899253,0,1,0,0,1
2874782163,0,0,1,0,1
2874877371,0,1,0,0,1
2875005131,0,1,0,0,1
2878261390,0,1,0,0,1
2884918560,0,1,0,0,1
2878352604,0,1,0,0,1
2878497576,0,1,0,0,1
2878657856,0,1,0,0,1
2879414803,1,0,0,0,1
2879805485,0,1,0,0,1
2879920362,0,1,0,0,1
2880886713,0,1,0,0,1
2881197235,0,1,0,0,1
2881856141,0,1,0,0,1
2884834600,0,1,0,0,1
2900870822,0,1,0,0,1
2902190254,0,1,0,0,1
2869181350,0,1,0,0,1
2927357723,0,1,0,0,1
2918893137,0,1,0,0,1
2920343018,0,1,0,0,1
2920356349,0,1,0,0,1
2920669003,0,1,0,0,1
2921238568,0,1,0,0,1
2922524818,1,0,0,0,1
2922525462,0,1,0,0,1
2922534255,1,0,0,0,1
2926293427,0,1,0,0,1
2926351647,0,1,0,0,1
2927416883,1,0,0,0,1
2915828272,0,1,0,0,1
2927740740,0,1,0,0,1
2929376288,0,1,0,0,1
2929413680,0,1,0,0,1
2930177514,0,1,0,0,1
2931175130,1,0,0,0,1
2931254123,1,0,0,0,1
2931427874,0,1,0,0,1
2931438266,0,1,0,0,1
2931855164,0,1,0,0,1
2931943553,0,1,0,0,1
2916052816,0,1,0,0,1
2914950325,0,1,0,0,1
2902742284,1,0,0,0,1
2909561979,0,1,0,0,1
2904700968,0,1,0,0,1
2904715406,1,0,0,0,1
2905735542,0,1,0,0,1
2905884350,0,1,0,0,1
2906412698,0,1,0,0,1
2906738107,0,1,0,0,1
2906881485,0,1,0,0,1
2908413596,1,0,0,0,1
2909105518,0,1,0,0,1
2909288114,0,1,0,0,1
2909970794,0,1,0,0,1
2914637736,0,1,0,0,1
2911018041,0,1,0,0,1
2911676784,0,1,0,0,1
2912685199,1,0,0,0,1
2912700614,0,1,0,0,1
2912733831,0,1,0,0,1
2912865831,0,1,0,0,1
2913343554,0,1,0,0,1
2913563439,0,1,0,0,1
2913849482,0,1,0,0,1
2914622131,0,1,0,0,1
2869891286,0,1,0,0,1
2868860048,0,1,0,0,1
2781080976,0,1,0,0,1
2807428571,0,1,0,0,1
2795839899,0,1,0,0,1
2797095307,1,0,0,0,1
2797594555,0,1,0,0,1
2799277666,0,1,0,0,1
2800517861,0,1,0,0,1
2801853174,0,1,0,0,1
2803475497,0,1,0,0,1
2803480094,0,1,0,0,1
2803580676,1,0,0,0,1
2805275295,0,1,0,0,1
2809088685,0,1,0,0,1
2794620122,0,1,0,0,1
2809133224,0,1,0,0,1
2810825457,0,1,0,0,1
2811422314,0,1,0,0,1
2814630924,0,1,0,0,1
2816234438,0,1,0,0,1
2817201331,0,1,0,0,1
2817371322,0,1,0,0,1
2817389862,0,1,0,0,1
2819120790,0,1,0,0,1
2819417829,1,0,0,0,1
2794827385,0,1,0,0,1
2794584335,0,1,0,0,1
2820794202,0,1,0,0,1
2788398650,1,0,0,0,1
2781587661,0,1,0,0,1
2782311588,0,1,0,0,1
2782552223,0,1,0,0,1
2782626229,0,1,0,0,1
2782626359,0,1,0,0,1
2783670680,0,1,0,0,1
2784391122,0,1,0,0,1
2784468732,0,1,0,0,1
2785714583,0,1,0,0,1
2786972397,0,1,0,0,1
2788701906,0,1,0,0,1
2793854050,0,1,0,0,1
2789270629,0,0,1,0,1
2790686519,0,1,0,0,1
2791209257,1,0,0,0,1
2792582272,0,1,0,0,1
2792615047,0,1,0,0,1
2792747364,0,1,0,0,1
2793042114,0,1,0,0,1
2793124600,1,0,0,0,1
2793155680,0,1,0,0,1
2793314393,0,1,0,0,1
2819793068,0,1,0,0,1
2820914025,0,1,0,0,1
2868690868,0,1,0,0,1
2853629978,0,1,0,0,1
2844218086,0,1,0,0,1
2844988335,1,0,0,0,1
2845767412,0,1,0,0,1
2847140499,0,1,0,0,1
2848017345,0,1,0,0,1
2848105953,0,1,0,0,1
2848697050,0,0,0,1,1
2849064914,0,1,0,0,1
2849398098,1,0,0,0,1
2850828237,0,1,0,0,1
2855137220,0,1,0,0,1
2843568791,0,1,0,0,1
2855181243,0,1,0,0,1
2855207483,0,1,0,0,1
2855440393,1,0,0,0,1
2856043121,0,1,0,0,1
2857187378,0,1,0,0,1
2857972450,0,1,0,0,1
2860169068,0,1,0,0,1
2864508014,1,0,0,0,1
2865929091,0,1,0,0,1
2867635397,0,1,0,0,1
2844092667,0,1,0,0,1
2843197672,0,1,0,0,1
2821965207,0,1,0,0,1
2830600891,0,1,0,0,1
2822191199,0,1,0,0,1
2822213032,0,1,0,0,1
2822501959,0,1,0,0,1
2823517820,1,0,0,0,1
2824953549,0,1,0,0,1
2825790968,0,1,0,0,1
2827075293,0,1,0,0,1
2827855827,0,1,0,0,1
2829235404,1,0,0,0,1
2829735517,0,1,0,0,1
2831588546,0,1,0,0,1
2842804346,0,1,0,0,1
2832732061,1,0,0,0,1
2834037116,0,1,0,0,1
2834050354,1,0,0,0,1
2834061381,0,1,0,0,1
2835708726,0,1,0,0,1
2839932121,0,0,0,1,1
2840614863,1,0,0,0,1
2841453548,0,1,0,0,1
2841508159,0,1,0,0,1
2842671219,0,0,1,0,1
2530360730,0,1,0,0,1
2529823099,1,0,0,0,1
2529776011,0,1,0,0,1
2311930328,0,1,0,0,1
2303587664,0,1,0,0,1
2303949999,0,1,0,0,1
2304105108,0,1,0,0,1
2305269516,0,1,0,0,1
2307961058,0,1,0,0,1
2308321327,0,1,0,0,1
2309521459,0,1,0,0,1
2310278886,0,1,0,0,1
2310329963,0,1,0,0,1
2311450311,0,1,0,0,1
2312475354,0,1,0,0,1
2301687886,0,1,0,0,1
2312614634,0,1,0,0,1
2312698814,0,1,0,0,1
2314841621,0,1,0,0,1
2316056401,0,1,0,0,1
2316065196,0,1,0,0,1
2316341832,0,1,0,0,1
2316963485,0,1,0,0,1
2317003029,0,1,0,0,1
2317626046,0,1,0,0,1
2318065756,0,1,0,0,1
2302554284,0,1,0,0,1
2301628435,0,1,0,0,1
2318514655,1,0,0,0,1
2289639253,0,1,0,0,1
2277864330,0,1,0,0,1
2280860358,1,0,0,0,1
2281304642,1,0,0,0,1
2282202266,0,1,0,0,1
2284755698,0,1,0,0,1
2285835360,1,0,0,0,1
2286153404,1,0,0,0,1
2286371038,0,1,0,0,1
2288791987,0,1,0,0,1
2289473889,0,1,0,0,1
2290157515,0,1,0,0,1
2301505879,0,1,0,0,1
2290263476,0,1,0,0,1
2290639691,0,1,0,0,1
2292419694,0,1,0,0,1
2292463507,0,1,0,0,1
2294040718,0,1,0,0,1
2294412564,0,1,0,0,1
2294834298,1,0,0,0,1
2297871647,0,1,0,0,1
2298079995,0,1,0,0,1
2298184387,0,1,0,0,1
2318305657,0,1,0,0,1
2319109226,0,1,0,0,1
2277486757,0,1,0,0,1
2347516376,0,1,0,0,1
2340595915,1,0,0,0,1
2340774583,0,1,0,0,1
2341560667,0,1,0,0,1
2341663735,1,0,0,0,1
2343577562,0,1,0,0,1
2344005566,0,1,0,0,1
2344686282,0,1,0,0,1
2344897573,0,1,0,0,1
2346278074,0,1,0,0,1
2346674910,1,0,0,0,1
2347940717,0,1,0,0,1
2339744844,0,1,0,0,1
2348819034,0,1,0,0,1
2349018425,0,1,0,0,1
2349550855,0,1,0,0,1
2351701746,0,1,0,0,1
2352103436,0,1,0,0,1
2352103497,0,1,0,0,1
2353148465,0,1,0,0,1
2353956404,0,1,0,0,1
2355730940,0,1,0,0,1
2355754945,0,1,0,0,1
2340204522,0,1,0,0,1
2338355248,0,1,0,0,1
2319410766,0,1,0,0,1
2327229611,0,1,0,0,1
2320660100,0,1,0,0,1
2322771403,0,1,0,0,1
2323208959,0,1,0,0,1
2323786920,0,1,0,0,1
2323971608,0,1,0,0,1
2324046799,0,1,0,0,1
2324379750,0,1,0,0,1
2324388034,0,1,0,0,1
2324446151,0,1,0,0,1
2326992684,0,1,0,0,1
2327401314,1,0,0,0,1
2336743454,0,1,0,0,1
2327829774,0,1,0,0,1
2328143234,0,1,0,0,1
2328829518,0,1,0,0,1
2329217720,1,0,0,0,1
2329524740,0,1,0,0,1
2330863686,0,0,0,1,1
2330892786,0,1,0,0,1
2333929287,0,1,0,0,1
2336193997,1,0,0,0,1
2336430332,0,1,0,0,1
2277763627,0,1,0,0,1
2277262537,0,1,0,0,1
2357062980,0,1,0,0,1
2221549729,0,1,0,0,1
2213380028,0,1,0,0,1
2214242310,0,1,0,0,1
2215276092,0,1,0,0,1
2215680066,0,1,0,0,1
2215781736,0,1,0,0,1
2217063241,0,1,0,0,1
2219803080,0,1,0,0,1
2219835033,0,1,0,0,1
2220606116,1,0,0,0,1
2220894078,0,1,0,0,1
2223214314,1,0,0,0,1
2210064396,0,1,0,0,1
2225191873,0,1,0,0,1
2225478246,0,1,0,0,1
2227369292,0,1,0,0,1
2227519351,0,1,0,0,1
2227827621,0,1,0,0,1
2228881712,0,1,0,0,1
2229803966,0,0,1,0,1
2229933834,0,1,0,0,1
2230964700,0,1,0,0,1
2231121815,0,1,0,0,1
2211547243,0,1,0,0,1
2209203481,1,0,0,0,1
2232117081,0,1,0,0,1
2201248822,0,1,0,0,1
2194204362,1,0,0,0,1
2195171466,0,1,0,0,1
2196166289,0,1,0,0,1
2197450469,0,1,0,0,1
2197709268,0,1,0,0,1
2197804539,0,1,0,0,1
2197863605,0,1,0,0,1
2198489003,0,1,0,0,1
2199678761,0,1,0,0,1
2200502176,0,1,0,0,1
2202085476,0,1,0,0,1
2207830737,0,1,0,0,1
2202404829,0,1,0,0,1
2203101945,0,1,0,0,1
2203219748,1,0,0,0,1
2203426855,0,1,0,0,1
2204216838,1,0,0,0,1
2204374646,0,1,0,0,1
2206123385,0,1,0,0,1
2206690694,1,0,0,0,1
2206722907,0,1,0,0,1
2206777986,0,1,0,0,1
2231709188,0,1,0,0,1
2233559107,1,0,0,0,1
2277217211,0,1,0,0,1
2268514934,0,1,0,0,1
2260872499,0,1,0,0,1
2261090502,0,1,0,0,1
2262087378,0,1,0,0,1
2263370412,0,1,0,0,1
2265317162,0,1,0,0,1
2265397625,0,1,0,0,1
2266556515,0,1,0,0,1
2266874337,0,1,0,0,1
2266967466,0,1,0,0,1
2267637702,0,1,0,0,1
2269789341,0,1,0,0,1
2259766448,0,1,0,0,1
2269997340,0,1,0,0,1
2270357774,0,1,0,0,1
2270992435,0,1,0,0,1
2271328974,0,1,0,0,1
2271438265,1,0,0,0,1
2273040445,0,1,0,0,1
2273195304,0,1,0,0,1
2274338543,0,1,0,0,1
2275361181,1,0,0,0,1
2275591945,0,1,0,0,1
2260402009,0,1,0,0,1
2259487251,0,1,0,0,1
2233606956,0,1,0,0,1
2242497128,0,1,0,0,1
2233963072,0,1,0,0,1
2235849330,1,0,0,0,1
2236209313,0,1,0,0,1
2237692376,0,1,0,0,1
2238402254,0,1,0,0,1
2239231165,0,1,0,0,1
2239454690,0,1,0,0,1
2240551668,0,1,0,0,1
2240857110,0,1,0,0,1
2241205392,0,1,0,0,1
2243450863,0,1,0,0,1
2256725467,0,1,0,0,1
2243508517,0,1,0,0,1
2246013237,0,1,0,0,1
2246920915,0,1,0,0,1
2246925222,0,1,0,0,1
2248974029,0,1,0,0,1
2250275878,1,0,0,0,1
2250436508,0,1,0,0,1
2250579974,0,1,0,0,1
2250864506,0,1,0,0,1
2252217270,0,1,0,0,1
2356048602,1,0,0,0,1
2358437905,0,1,0,0,1
2528800858,0,1,0,0,1
2469660242,0,1,0,0,1
2460857545,0,1,0,0,1
2462009840,0,1,0,0,1
2462103809,0,1,0,0,1
2463717281,0,1,0,0,1
2463752532,0,1,0,0,1
2463779581,0,1,0,0,1
2464326284,0,1,0,0,1
2464763188,0,1,0,0,1
2465063916,0,1,0,0,1
2465554105,0,1,0,0,1
2470167278,0,1,0,0,1
2460352694,0,1,0,0,1
2470638328,0,1,0,0,1
2470713434,0,1,0,0,1
2471150767,0,1,0,0,1
2471878450,0,1,0,0,1
2472191347,0,1,0,0,1
2472440202,0,1,0,0,1
2473648700,1,0,0,0,1
2474383129,0,1,0,0,1
2475219840,0,1,0,0,1
2475893282,0,1,0,0,1
2460624548,0,1,0,0,1
2459782002,1,0,0,0,1
2479339436,0,1,0,0,1
2447366624,0,1,0,0,1
2439873644,0,1,0,0,1
2440623760,0,1,0,0,1
2440944379,0,1,0,0,1
2441025506,0,1,0,0,1
2441705954,0,1,0,0,1
2444926385,0,1,0,0,1
2445353088,1,0,0,0,1
2445370958,1,0,0,0,1
2445539769,0,1,0,0,1
2447030716,0,1,0,0,1
2447912052,0,1,0,0,1
2458045731,0,1,0,0,1
2449212476,0,1,0,0,1
2449529990,0,1,0,0,1
2452853334,0,1,0,0,1
2453487542,0,1,0,0,1
2454792535,0,1,0,0,1
2454909739,1,0,0,0,1
2455327860,1,0,0,0,1
2456188900,0,1,0,0,1
2456953441,0,1,0,0,1
2457831082,0,0,0,1,1
2476168771,0,1,0,0,1
2479647151,0,1,0,0,1
2438130194,1,0,0,0,1
2514465151,0,1,0,0,1
2509162152,0,1,0,0,1
2509604209,0,0,0,1,1
2510548399,1,0,0,0,1
2510892986,0,1,0,0,1
2511422952,0,1,0,0,1
2511775112,0,1,0,0,1
2511775418,0,1,0,0,1
2512869634,0,1,0,0,1
2514005034,0,1,0,0,1
2514286146,0,1,0,0,1
2516405673,0,1,0,0,1
2505277147,0,1,0,0,1
2516828927,0,1,0,0,1
2519467770,0,1,0,0,1
2520368563,0,1,0,0,1
2521927722,0,1,0,0,1
2523497204,0,1,0,0,1
2523944166,0,1,0,0,1
2524077089,0,1,0,0,1
2525368010,0,1,0,0,1
2525654528,0,1,0,0,1
2528101704,0,1,0,0,1
2508168652,0,1,0,0,1
2504393804,0,1,0,0,1
2480083422,0,1,0,0,1
2492019237,0,1,0,0,1
2482237620,1,0,0,0,1
2482417234,0,1,0,0,1
2483845033,0,1,0,0,1
2483955892,0,1,0,0,1
2484687435,0,1,0,0,1
2485448881,0,1,0,0,1
2485563985,0,1,0,0,1
2485649725,1,0,0,0,1
2485738604,0,1,0,0,1
2486973816,0,1,0,0,1
2492411154,0,1,0,0,1
2502992592,0,1,0,0,1
2493215114,0,1,0,0,1
2493222307,0,1,0,0,1
2493453869,0,1,0,0,1
2494534850,0,1,0,0,1
2494825934,0,1,0,0,1
2496018341,0,1,0,0,1
2496617294,0,1,0,0,1
2496761904,0,1,0,0,1
2498303167,0,1,0,0,1
2499579890,0,1,0,0,1
2439700397,0,1,0,0,1
2435864338,0,1,0,0,1
2359421557,0,1,0,0,1
2387392712,0,1,0,0,1
2379784621,0,1,0,0,1
2380901426,0,1,0,0,1
2381913646,0,1,0,0,1
2382573770,0,1,0,0,1
2383413742,0,1,0,0,1
2383532828,1,0,0,0,1
2385141056,0,1,0,0,1
2385512329,0,1,0,0,1
2385799301,0,1,0,0,1
2386229700,0,1,0,0,1
2387441671,0,0,0,1,1
2379635420,0,1,0,0,1
2387779440,0,1,0,0,1
2388229788,0,1,0,0,1
2388832279,1,0,0,0,1
2390066072,0,1,0,0,1
2390676985,0,1,0,0,1
2391614580,0,1,0,0,1
2391981690,1,0,0,0,1
2392009662,0,1,0,0,1
2394221167,0,1,0,0,1
2394498527,0,1,0,0,1
2379780438,1,0,0,0,1
2378462474,0,1,0,0,1
2395374864,0,1,0,0,1
2368695974,0,1,0,0,1
2360210096,0,1,0,0,1
2360810063,0,1,0,0,1
2360846821,0,1,0,0,1
2361351328,0,1,0,0,1
2362558264,0,1,0,0,1
2362745268,0,1,0,0,1
2364206394,1,0,0,0,1
2365066716,0,1,0,0,1
2367641796,0,1,0,0,1
2368558318,0,1,0,0,1
2370152191,0,1,0,0,1
2378324935,0,1,0,0,1
2371055244,0,1,0,0,1
2371069376,0,1,0,0,1
2371463850,0,1,0,0,1
2371782936,0,1,0,0,1
2372316552,0,1,0,0,1
2372969028,1,0,0,0,1
2373850152,0,1,0,0,1
2375147314,0,1,0,0,1
2375308038,0,1,0,0,1
2376142685,1,0,0,0,1
2395081501,0,1,0,0,1
2396642793,0,1,0,0,1
2435558040,1,0,0,0,1
2423648153,0,1,0,0,1
2415094355,0,1,0,0,1
2415176101,0,1,0,0,1
2416864110,1,0,0,0,1
2418454729,0,1,0,0,1
2419341534,0,1,0,0,1
2420270246,0,1,0,0,1
2420680411,1,0,0,0,1
2421047521,0,1,0,0,1
2423391796,0,1,0,0,1
2423444586,0,1,0,0,1
2428248196,1,0,0,0,1
2412026433,0,1,0,0,1
2428634731,0,1,0,0,1
2429101304,0,1,0,0,1
2429328178,0,1,0,0,1
2430808297,0,1,0,0,1
2430808498,0,1,0,0,1
2430826616,1,0,0,0,1
2432417366,0,1,0,0,1
2433542039,0,1,0,0,1
2434592319,0,1,0,0,1
2435212585,0,1,0,0,1
2414627815,0,0,1,0,1
2411574215,0,1,0,0,1
2396828862,0,1,0,0,1
2405890546,0,1,0,0,1
2397584508,0,0,0,1,1
2397757194,0,1,0,0,1
2397973519,0,1,0,0,1
2398312101,0,1,0,0,1
2401013484,0,1,0,0,1
2401718935,0,1,0,0,1
2402046427,1,0,0,0,1
2403749410,0,1,0,0,1
2404979006,1,0,0,0,1
2405332228,0,1,0,0,1
2406721976,0,1,0,0,1
2411569314,0,1,0,0,1
2407368942,0,1,0,0,1
2409230066,0,1,0,0,1
2409414559,0,1,0,0,1
2409451987,0,1,0,0,1
2409666443,0,1,0,0,1
2410379587,1,0,0,0,1
2411024755,0,1,0,0,1
2411136444,0,1,0,0,1
2411362892,0,1,0,0,1
2411402404,1,0,0,0,1
2933048376,0,1,0,0,1
2933818796,1,0,0,0,1
2937387990,0,1,0,0,1
3462238936,0,1,0,0,1
3428622190,0,1,0,0,1
3430979573,0,1,0,0,1
3431236737,0,1,0,0,1
3433054378,0,1,0,0,1
3434305366,0,1,0,0,1
3437037673,1,0,0,0,1
3437600242,0,1,0,0,1
3449281936,1,0,0,0,1
3458027476,0,1,0,0,1
3459447015,0,1,0,0,1
3464362874,0,1,0,0,1
3427547931,1,0,0,0,1
3469160492,0,1,0,0,1
3472832174,0,1,0,0,1
3481914496,0,1,0,0,1
3489424759,0,1,0,0,1
3491602877,0,1,0,0,1
3504049575,0,1,0,0,1
3504189561,0,1,0,0,1
3507274336,0,1,0,0,1
3515042789,0,1,0,0,1
3524887157,1,0,0,0,1
3427953909,0,1,0,0,1
3426723071,0,1,0,0,1
3527304028,0,1,0,0,1
3412412433,0,1,0,0,1
3394100653,1,0,0,0,1
3395993163,0,1,0,0,1
3397079415,0,1,0,0,1
3397585109,0,1,0,0,1
3404706688,0,1,0,0,1
3406769292,0,1,0,0,1
3407210764,0,1,0,0,1
3408885449,0,1,0,0,1
3409070541,0,1,0,0,1
3411232874,0,1,0,0,1
3413058801,1,0,0,0,1
3425838676,0,1,0,0,1
3415337770,0,1,0,0,1
3415871265,0,1,0,0,1
3416173552,0,1,0,0,1
3420375767,0,1,0,0,1
3420511259,0,1,0,0,1
3420940469,0,1,0,0,1
3421678660,1,0,0,0,1
3422754592,1,0,0,0,1
3423200533,0,1,0,0,1
3423554232,0,1,0,0,1
3526516272,0,1,0,0,1
3542136737,0,1,0,0,1
3391198715,0,1,0,0,1
3822178574,0,1,0,0,1
3742608922,0,1,0,0,1
3745579934,0,1,0,0,1
3747134895,0,1,0,0,1
3768539004,0,1,0,0,1
3785029754,0,1,0,0,1
3795043660,1,0,0,0,1
3812505440,0,1,0,0,1
3816878483,0,1,0,0,1
3821343917,0,1,0,0,1
3822060074,0,1,0,0,1
3835582274,0,1,0,0,1
3740697861,0,1,0,0,1
3838724001,0,1,0,0,1
3841519648,0,0,1,0,1
3844783220,0,1,0,0,1
3845512759,0,1,0,0,1
3853276012,0,1,0,0,1
3866431401,0,1,0,0,1
3872573308,1,0,0,0,1
3873923855,1,0,0,0,1
3884988738,0,1,0,0,1
3891194560,0,1,0,0,1
3741798133,1,0,0,0,1
3740201843,0,1,0,0,1
3543303917,0,1,0,0,1
3647185212,0,1,0,0,1
3554939899,0,1,0,0,1
3560379048,0,1,0,0,1
3570350113,1,0,0,0,1
3572912359,0,1,0,0,1
3598083615,0,1,0,0,1
3599810656,0,1,0,0,1
3621070587,0,1,0,0,1
3625825466,0,1,0,0,1
3637615754,0,1,0,0,1
3645967102,0,1,0,0,1
3647608752,0,1,0,0,1
3738981673,1,0,0,0,1
3664575561,0,1,0,0,1
3668122753,0,1,0,0,1
3673337894,0,1,0,0,1
3676295055,0,1,0,0,1
3684481933,0,1,0,0,1
3687558497,0,1,0,0,1
3689308343,0,1,0,0,1
3691168338,0,1,0,0,1
3721621514,0,1,0,0,1
3734163107,0,1,0,0,1
3393013192,0,1,0,0,1
3388793098,1,0,0,0,1
3903318556,0,1,0,0,1
3326127893,0,1,0,0,1
3318861756,1,0,0,0,1
3318939722,0,1,0,0,1
3319010620,0,1,0,0,1
3319541943,0,1,0,0,1
3319650444,0,1,0,0,1
3319694382,0,1,0,0,1
3322336511,0,1,0,0,1
3324018952,0,1,0,0,1
3324429346,0,1,0,0,1
3324605487,0,1,0,0,1
3326600907,1,0,0,0,1
3317268426,0,1,0,0,1
3329125568,0,1,0,0,1
3329298914,0,1,0,0,1
3331359575,0,1,0,0,1
3332360991,0,1,0,0,1
3333251188,0,1,0,0,1
3334587148,0,1,0,0,1
3335550792,0,1,0,0,1
3337295067,0,1,0,0,1
3337595532,0,1,0,0,1
3338041468,0,1,0,0,1
3318053130,0,1,0,0,1
3317040702,0,1,0,0,1
3340065373,0,1,0,0,1
3307397045,0,1,0,0,1
3302171550,1,0,0,0,1
3302256527,0,1,0,0,1
3302775858,0,1,0,0,1
3302993621,0,1,0,0,1
3304810526,0,0,0,1,1
3304820383,1,0,0,0,1
3305756332,0,1,0,0,1
3306588509,0,1,0,0,1
3306650467,0,1,0,0,1
3307342716,1,0,0,0,1
3308587846,0,1,0,0,1
3314852629,1,0,0,0,1
3309077409,0,1,0,0,1
3309831378,0,1,0,0,1
3311627289,1,0,0,0,1
3312283324,0,1,0,0,1
3312352446,0,1,0,0,1
3312408301,1,0,0,0,1
3312474896,0,1,0,0,1
3313946418,0,1,0,0,1
3314303766,0,1,0,0,1
3314564018,0,1,0,0,1
3339804972,0,1,0,0,1
3341106220,0,1,0,0,1
3387499252,0,1,0,0,1
3375861225,0,1,0,0,1
3364648001,0,1,0,0,1
3365340173,0,1,0,0,1
3366086818,0,1,0,0,1
3366493624,0,1,0,0,1
3369674594,0,1,0,0,1
3369923260,1,0,0,0,1
3371678117,0,1,0,0,1
3371829033,0,1,0,0,1
3373882852,0,1,0,0,1
3374207817,0,1,0,0,1
3377048410,0,1,0,0,1
3362792968,0,1,0,0,1
3377645751,1,0,0,0,1
3378430071,0,1,0,0,1
3378915562,0,1,0,0,1
3380684063,0,1,0,0,1
3380761420,0,1,0,0,1
3381545284,0,1,0,0,1
3383915847,0,1,0,0,1
3385199859,0,1,0,0,1
3386732044,0,1,0,0,1
3387275555,0,1,0,0,1
3364402835,0,1,0,0,1
3360929733,0,1,0,0,1
3341219591,0,1,0,0,1
3346883554,0,1,0,0,1
3341446180,0,1,0,0,1
3341868261,0,1,0,0,1
3342096706,0,1,0,0,1
3342536589,1,0,0,0,1
3342807545,0,1,0,0,1
3344521174,1,0,0,0,1
3345121312,0,1,0,0,1
3345808217,0,1,0,0,1
3346316813,0,1,0,0,1
3346642084,0,1,0,0,1
3347488523,0,1,0,0,1
3360174258,1,0,0,0,1
3347674024,0,1,0,0,1
3347752821,0,1,0,0,1
3348182956,0,1,0,0,1
3348472557,0,1,0,0,1
3349130025,0,1,0,0,1
3350465793,0,1,0,0,1
3351001203,0,1,0,0,1
3351223889,0,1,0,0,1
3357427702,0,1,0,0,1
3358576882,0,0,0,1,1
3900822552,0,1,0,0,1
3907397675,1,0,0,0,1
3300874760,0,1,0,0,1
4618938195,1,0,0,0,1
4588201636,0,1,0,0,1
4591420994,1,0,0,0,1
4596931393,0,1,0,0,1
4599238213,1,0,0,0,1
4600705881,0,1,0,0,1
4601817074,0,1,0,0,1
4604814018,1,0,0,0,1
4605077532,0,1,0,0,1
4611148117,0,1,0,0,1
4613115101,1,0,0,0,1
4622363735,0,1,0,0,1
4581789627,0,1,0,0,1
4630642954,0,1,0,0,1
4636978957,0,1,0,0,1
4638363019,0,1,0,0,1
4639016236,0,1,0,0,1
4640585592,0,1,0,0,1
4650824990,0,1,0,0,1
4650996737,0,1,0,0,1
4654673535,0,0,0,1,1
4656235272,1,0,0,0,1
4658543538,0,1,0,0,1
4582475775,0,1,0,0,1
4580641873,1,0,0,0,1
4674240235,0,1,0,0,1
4510644922,0,1,0,0,1
4456802175,0,1,0,0,1
4459642286,0,1,0,0,1
4465690760,0,1,0,0,1
4481861534,0,1,0,0,1
4482289152,0,1,0,0,1
4487948292,0,1,0,0,1
4488303807,0,1,0,0,1
4495775355,0,1,0,0,1
4500079041,0,1,0,0,1
4505879056,0,1,0,0,1
4518345435,0,1,0,0,1
4568936352,0,1,0,0,1
4533876557,0,1,0,0,1
4542850109,1,0,0,0,1
4548360677,0,1,0,0,1
4548980176,0,1,0,0,1
4556198174,0,1,0,0,1
4558358858,0,1,0,0,1
4559044094,0,1,0,0,1
4563283152,0,1,0,0,1
4566647534,0,1,0,0,1
4567407868,0,1,0,0,1
4666007353,0,1,0,0,1
4676332416,0,1,0,0,1
4452108857,0,1,0,0,1
4813347089,0,0,1,0,1
4755563591,0,1,0,0,1
4762405404,0,1,0,0,1
4764363381,0,1,0,0,1
4766450011,0,1,0,0,1
4768235113,1,0,0,0,1
4773224352,1,0,0,0,1
4777366585,0,1,0,0,1
4782672988,0,1,0,0,1
4784313320,1,0,0,0,1
4794534938,0,1,0,0,1
4813624657,0,1,0,0,1
4742691435,0,1,0,0,1
4818208875,0,1,0,0,1
4818239073,0,1,0,0,1
4820930547,0,1,0,0,1
4824567798,0,1,0,0,1
4825218632,1,0,0,0,1
4825907840,0,1,0,0,1
4826677880,0,1,0,0,1
4830519058,0,1,0,0,1
4831483937,0,1,0,0,1
4832003951,0,1,0,0,1
4753492694,0,1,0,0,1
4742073428,0,1,0,0,1
4676368926,0,1,0,0,1
4711615766,0,1,0,0,1
4678134630,0,1,0,0,1
4679187912,0,0,0,1,1
4681805893,1,0,0,0,1
4683468349,0,1,0,0,1
4690107504,0,1,0,0,1
4691850570,1,0,0,0,1
4700707349,0,1,0,0,1
4702015165,1,0,0,0,1
4707735756,1,0,0,0,1
4708082121,0,1,0,0,1
4713179477,0,1,0,0,1
4741832473,0,1,0,0,1
4715862924,0,1,0,0,1
4718373017,1,0,0,0,1
4719870764,1,0,0,0,1
4720620588,1,0,0,0,1
4724829374,1,0,0,0,1
4730403444,0,1,0,0,1
4731354265,0,1,0,0,1
4731989292,0,1,0,0,1
4737000802,0,0,0,1,1
4737557984,0,1,0,0,1
4454116337,0,1,0,0,1
4445079513,0,1,0,0,1
3918521847,0,1,0,0,1
4113753072,1,0,0,0,1
4050620657,0,1,0,0,1
4060332794,0,1,0,0,1
4069686312,0,1,0,0,1
4074866050,1,0,0,0,1
4076494032,0,1,0,0,1
4080681012,0,1,0,0,1
4080795859,1,0,0,0,1
4097692823,0,1,0,0,1
4106708728,1,0,0,0,1
4109342178,0,1,0,0,1
4123321274,0,1,0,0,1
4044677778,0,1,0,0,1
4123529058,0,1,0,0,1
4135706307,0,1,0,0,1
4146538821,0,1,0,0,1
4149689798,0,1,0,0,1
4150044789,0,1,0,0,1
4151398643,0,1,0,0,1
4160197102,0,1,0,0,1
4160203479,0,1,0,0,1
4161428843,0,1,0,0,1
4161673277,0,1,0,0,1
4046262879,0,1,0,0,1
4042237812,0,1,0,0,1
4173270129,0,1,0,0,1
4004609957,0,1,0,0,1
3919901952,0,1,0,0,1
3931268660,0,1,0,0,1
3949875262,0,1,0,0,1
3950843788,0,1,0,0,1
3953329695,0,1,0,0,1
3970567395,0,1,0,0,1
3985969828,0,1,0,0,1
3997432706,0,1,0,0,1
3997870336,0,1,0,0,1
4003846553,0,1,0,0,1
4008543555,0,1,0,0,1
4042134378,1,0,0,0,1
4009632850,0,1,0,0,1
4010130735,0,1,0,0,1
4010173955,0,1,0,0,1
4012051701,0,1,0,0,1
4012940717,0,1,0,0,1
4027552414,0,1,0,0,1
4031900412,0,1,0,0,1
4036066393,0,1,0,0,1
4039275028,0,1,0,0,1
4039758442,0,1,0,0,1
4166270807,0,1,0,0,1
4179045199,0,1,0,0,1
4444279573,0,1,0,0,1
4385027728,0,1,0,0,1
4325647755,0,1,0,0,1
4340793021,0,1,0,0,1
4346110885,0,1,0,0,1
4352392037,0,1,0,0,1
4363670657,0,1,0,0,1
4364520516,0,1,0,0,1
4364923707,0,1,0,0,1
4368536056,0,1,0,0,1
4375564935,0,1,0,0,1
4382443697,0,1,0,0,1
4385491453,0,1,0,0,1
4312898958,0,1,0,0,1
4385654592,0,1,0,0,1
4386476547,1,0,0,0,1
4390421355,0,1,0,0,1
4406980456,0,0,0,1,1
4407789622,0,1,0,0,1
4415851994,1,0,0,0,1
4416101902,0,1,0,0,1
4423827676,1,0,0,0,1
4424388879,0,1,0,0,1
4442937736,1,0,0,0,1
4321371256,1,0,0,0,1
4302752122,0,1,0,0,1
4180744041,0,1,0,0,1
4218861628,0,1,0,0,1
4181482152,0,1,0,0,1
4184966477,0,1,0,0,1
4185742553,0,1,0,0,1
4186465095,0,1,0,0,1
4195123455,0,1,0,0,1
4195481594,0,1,0,0,1
4199717032,0,1,0,0,1
4204395133,0,1,0,0,1
4208945423,1,0,0,0,1
4215287735,0,1,0,0,1
4229242453,0,1,0,0,1
4294243872,0,1,0,0,1
4235752297,0,1,0,0,1
4236870801,0,1,0,0,1
4243494432,1,0,0,0,1
4244636745,0,1,0,0,1
4257636190,0,1,0,0,1
4261792354,0,1,0,0,1
4263792359,0,1,0,0,1
4264011983,1,0,0,0,1
4265862020,0,0,0,1,1
4292601132,0,1,0,0,1
3301520817,0,1,0,0,1
3300735027,0,1,0,0,1
2937667860,0,1,0,0,1
3032830519,0,1,0,0,1
3020917566,0,1,0,0,1
3021938713,1,0,0,0,1
3022406810,0,0,1,0,1
3022409396,0,1,0,0,1
3022508149,0,1,0,0,1
3023466846,0,1,0,0,1
3024504029,0,1,0,0,1
3028286472,0,1,0,0,1
3029718660,0,1,0,0,1
3032745635,0,1,0,0,1
3036521414,0,1,0,0,1
3020418097,0,1,0,0,1
3038308638,0,1,0,0,1
3038633291,0,1,0,0,1
3039675660,1,0,0,0,1
3040013870,0,1,0,0,1
3040685096,0,1,0,0,1
3040691818,0,1,0,0,1
3041219154,0,1,0,0,1
3041520391,0,1,0,0,1
3042081751,0,1,0,0,1
3042436850,0,1,0,0,1
3020612242,0,0,0,1,1
3020280786,0,1,0,0,1
3044554164,0,1,0,0,1
3011138821,0,1,0,0,1
3005463477,0,0,0,1,1
3005712151,0,0,0,1,1
3006610437,0,1,0,0,1
3006779197,0,1,0,0,1
3007815702,0,1,0,0,1
3008029160,0,1,0,0,1
3009728522,0,1,0,0,1
3010267538,1,0,0,0,1
3010943936,0,1,0,0,1
3011054520,0,1,0,0,1
3011546546,0,1,0,0,1
3020005514,0,1,0,0,1
3011633000,0,1,0,0,1
3011850654,0,1,0,0,1
3013190934,0,1,0,0,1
3014619519,0,1,0,0,1
3016309178,0,1,0,0,1
3016722291,1,0,0,0,1
3017400805,0,1,0,0,1
3017796337,1,0,0,0,1
3017819603,0,1,0,0,1
3018703854,0,1,0,0,1
3042749234,1,0,0,0,1
3044658093,0,1,0,0,1
3004782984,0,1,0,0,1
3082546368,0,1,0,0,1
3068362154,0,1,0,0,1
3069203935,1,0,0,0,1
3072157503,0,1,0,0,1
3072967957,0,1,0,0,1
3076052198,0,1,0,0,1
3077186182,0,1,0,0,1
3077272879,0,1,0,0,1
3077629085,0,1,0,0,1
3077842258,0,1,0,0,1
3081725823,1,0,0,0,1
3084588675,0,1,0,0,1
3067361486,0,1,0,0,1
3086287570,1,0,0,0,1
3087416718,0,1,0,0,1
3087520533,0,1,0,0,1
3088152166,0,1,0,0,1
3089966123,0,1,0,0,1
3090603569,0,1,0,0,1
3091257648,0,1,0,0,1
3091715073,0,1,0,0,1
3092296437,0,1,0,0,1
3092438314,0,1,0,0,1
3067618586,0,1,0,0,1
3066089486,0,1,0,0,1
3045052811,0,0,1,0,1
3058790964,0,0,0,1,1
3045181324,0,1,0,0,1
3049027139,0,1,0,0,1
3050616480,0,1,0,0,1
3050910743,0,1,0,0,1
3051378893,0,1,0,0,1
3052958004,0,1,0,0,1
3053065057,0,1,0,0,1
3054080576,0,1,0,0,1
3055563480,0,1,0,0,1
3058112163,0,1,0,0,1
3058861982,0,1,0,0,1
3066038962,0,1,0,0,1
3059858687,1,0,0,0,1
3060075937,0,1,0,0,1
3061600800,0,1,0,0,1
3061755709,1,0,0,0,1
3061985803,1,0,0,0,1
3064247597,0,1,0,0,1
3064535448,0,1,0,0,1
3064850970,0,1,0,0,1
3065695658,0,1,0,0,1
3065732783,1,0,0,0,1
3004813892,0,1,0,0,1
3004650411,0,1,0,0,1
3095385861,0,1,0,0,1
2963025150,0,1,0,0,1
2955643646,1,0,0,0,1
2955658671,0,1,0,0,1
2956714162,0,1,0,0,1
2957345767,0,1,0,0,1
2957885904,1,0,0,0,1
2958381770,0,1,0,0,1
2958622098,0,1,0,0,1
2958906245,0,1,0,0,1
2959498134,0,1,0,0,1
2959769138,1,0,0,0,1
2963758719,0,1,0,0,1
2953702838,0,1,0,0,1
2963948477,0,1,0,0,1
2964383954,0,1,0,0,1
2964461514,1,0,0,0,1
2964720673,0,1,0,0,1
2965796110,0,1,0,0,1
2966041852,0,1,0,0,1
2966167102,0,1,0,0,1
2967943317,0,1,0,0,1
2968464106,0,1,0,0,1
2970265474,0,1,0,0,1
2955226946,0,1,0,0,1
2953667150,0,1,0,0,1
2970602812,0,1,0,0,1
2945087081,0,1,0,0,1
2938796697,0,1,0,0,1
2939120786,0,1,0,0,1
2939339627,0,1,0,0,1
2941760268,0,1,0,0,1
2942221865,0,1,0,0,1
2943059415,1,0,0,0,1
2943643384,0,1,0,0,1
2943972530,0,1,0,0,1
2944138989,0,0,0,1,1
2945062417,0,0,0,1,1
2945171645,0,1,0,0,1
2953048040,0,1,0,0,1
2945585378,0,1,0,0,1
2947538772,0,1,0,0,1
2949411432,0,1,0,0,1
2950089219,0,1,0,0,1
2951256342,0,1,0,0,1
2951476593,0,1,0,0,1
2951691286,0,1,0,0,1
2951694113,1,0,0,0,1
2951991563,0,1,0,0,1
2952056157,0,1,0,0,1
2970316480,0,0,0,1,1
2971176376,0,1,0,0,1
3004370115,1,0,0,0,1
2999643032,0,1,0,0,1
2993687259,0,1,0,0,1
2995699426,0,1,0,0,1
2996130955,0,1,0,0,1
2996979797,0,1,0,0,1
2997223328,0,1,0,0,1
2997659079,0,1,0,0,1
2998025239,0,1,0,0,1
2998044877,0,1,0,0,1
2998943772,0,1,0,0,1
2999297760,0,1,0,0,1
2999727293,0,1,0,0,1
2989698046,0,1,0,0,1
2999888577,0,1,0,0,1
2999996563,0,1,0,0,1
3000215721,0,1,0,0,1
3000325435,0,1,0,0,1
3000889809,0,1,0,0,1
3001573091,0,0,1,0,1
3001824743,0,1,0,0,1
3003002316,0,1,0,0,1
3003457797,0,1,0,0,1
3004363940,0,1,0,0,1
2989821190,0,1,0,0,1
2989114437,0,1,0,0,1
2971430315,0,1,0,0,1
2979194375,0,1,0,0,1
2972030884,1,0,0,0,1
2972774791,0,1,0,0,1
2973592155,0,1,0,0,1
2974785586,0,1,0,0,1
2975842359,0,1,0,0,1
2975882358,0,1,0,0,1
2976235671,1,0,0,0,1
2977993431,0,1,0,0,1
2977999337,0,1,0,0,1
2978320633,0,1,0,0,1
2980508496,1,0,0,0,1
2989010268,0,1,0,0,1
2983945431,0,1,0,0,1
2984192029,0,1,0,0,1
2984501511,0,1,0,0,1
2986007101,0,0,0,1,1
2986605719,0,1,0,0,1
2986817549,0,1,0,0,1
2986922754,1,0,0,0,1
2986999155,0,1,0,0,1
2987140454,0,1,0,0,1
2987764394,0,1,0,0,1
3095148560,0,1,0,0,1
3095974769,0,1,0,0,1
3300075122,0,1,0,0,1
3249013926,0,1,0,0,1
3238991996,0,1,0,0,1
3241704612,0,1,0,0,1
3244074287,0,1,0,0,1
3244921135,0,1,0,0,1
3244948896,0,1,0,0,1
3245242609,0,1,0,0,1
3245300220,0,1,0,0,1
3246417142,0,1,0,0,1
3248420218,0,1,0,0,1
3248453770,0,1,0,0,1
3250105759,0,1,0,0,1
3238028250,0,1,0,0,1
3251573024,0,1,0,0,1
3252247290,1,0,0,0,1
3253974125,1,0,0,0,1
3254439900,0,1,0,0,1
3255415159,0,1,0,0,1
3256007342,1,0,0,0,1
3256320342,0,1,0,0,1
3256358540,0,1,0,0,1
3258141985,0,1,0,0,1
3258472557,0,1,0,0,1
3238741314,0,1,0,0,1
3236721175,0,1,0,0,1
3259845080,1,0,0,0,1
3224697389,0,1,0,0,1
3207871133,0,1,0,0,1
3208137371,0,1,0,0,1
3214501217,0,1,0,0,1
3215549691,0,0,0,1,1
3218945983,0,1,0,0,1
3220936962,0,1,0,0,1
3221431946,0,1,0,0,1
3223967599,0,1,0,0,1
3224206316,0,1,0,0,1
3224385975,0,1,0,0,1
3227359728,0,1,0,0,1
3236459370,0,1,0,0,1
3227582048,0,1,0,0,1
3228386331,0,1,0,0,1
3229521818,1,0,0,0,1
3229870591,0,1,0,0,1
3230035206,1,0,0,0,1
3230106062,0,1,0,0,1
3233176297,0,1,0,0,1
3233621988,1,0,0,0,1
3235141260,0,1,0,0,1
3236153226,0,1,0,0,1
3258865773,0,1,0,0,1
3265658655,1,0,0,0,1
3206775953,0,1,0,0,1
3293897116,0,1,0,0,1
3288601627,0,1,0,0,1
3288652618,0,1,0,0,1
3288685697,0,1,0,0,1
3288887328,0,1,0,0,1
3289157339,0,1,0,0,1
3290577872,0,1,0,0,1
3291063469,0,1,0,0,1
3291108131,0,1,0,0,1
3291458404,1,0,0,0,1
3291518664,1,0,0,0,1
3294233099,0,1,0,0,1
3288507545,0,1,0,0,1
3294856065,0,1,0,0,1
3295413585,0,1,0,0,1
3295875473,0,1,0,0,1
3296453011,0,1,0,0,1
3296535056,0,1,0,0,1
3297264123,0,1,0,0,1
3297920308,0,1,0,0,1
3298657571,0,1,0,0,1
3299042377,0,1,0,0,1
3299637050,0,1,0,0,1
3288567212,0,1,0,0,1
3288475207,0,0,0,1,1
3265710066,0,1,0,0,1
3278545782,0,1,0,0,1
3267033240,0,1,0,0,1
3267790334,0,1,0,0,1
3268666621,0,1,0,0,1
3269777071,0,1,0,0,1
3270505015,0,1,0,0,1
3271212810,0,1,0,0,1
3271716044,0,1,0,0,1
3271899109,0,1,0,0,1
3272105508,0,0,0,1,1
3274004778,0,1,0,0,1
3279487404,1,0,0,0,1
3288300120,0,1,0,0,1
3281172959,1,0,0,0,1
3282332568,0,1,0,0,1
3282439550,0,1,0,0,1
3282536012,1,0,0,0,1
3282914310,0,1,0,0,1
3284343157,0,1,0,0,1
3284577349,0,1,0,0,1
3286490240,0,1,0,0,1
3287004092,0,1,0,0,1
3288147861,0,1,0,0,1
3207527194,0,1,0,0,1
3201157798,0,1,0,0,1
3096002059,0,1,0,0,1
3131156139,0,1,0,0,1
3118990858,0,1,0,0,1
3119294922,0,1,0,0,1
3122796956,0,1,0,0,1
3123916546,0,1,0,0,1
3123941134,0,1,0,0,1
3124655846,0,1,0,0,1
3127343241,0,1,0,0,1
3129281193,0,1,0,0,1
3129415847,0,1,0,0,1
3129986735,0,1,0,0,1
3134763672,0,1,0,0,1
3118828252,0,1,0,0,1
3135482320,0,1,0,0,1
3137494822,0,1,0,0,1
3137519426,0,1,0,0,1
3137560986,0,1,0,0,1
3137579504,0,1,0,0,1
3137868648,1,0,0,0,1
3138090979,0,1,0,0,1
3138553615,0,1,0,0,1
3138896941,0,1,0,0,1
3140139857,0,1,0,0,1
3118869943,0,1,0,0,1
3118431034,0,1,0,0,1
3143287132,0,1,0,0,1
3102552156,1,0,0,0,1
3096079038,0,1,0,0,1
3096646701,0,1,0,0,1
3097377387,1,0,0,0,1
3098335375,1,0,0,0,1
3098929960,0,1,0,0,1
3099386659,1,0,0,0,1
3099737665,0,1,0,0,1
3101034189,1,0,0,0,1
3101327082,0,1,0,0,1
3102489823,1,0,0,0,1
3103716602,0,1,0,0,1
3117943361,0,1,0,0,1
3104724533,0,1,0,0,1
3104797553,0,1,0,0,1
3105481797,1,0,0,0,1
3106326488,0,1,0,0,1
3106884745,0,1,0,0,1
3108119281,0,1,0,0,1
3110238626,1,0,0,0,1
3111624335,0,1,0,0,1
3113725004,0,1,0,0,1
3116779857,0,1,0,0,1
3140953202,0,1,0,0,1
3143535596,0,1,0,0,1
3199787987,0,1,0,0,1
3186919122,0,1,0,0,1
3179743520,0,1,0,0,1
3183688605,1,0,0,0,1
3183808218,0,1,0,0,1
3183868232,0,0,0,1,1
3183946032,0,1,0,0,1
3185466956,0,1,0,0,1
3185516904,0,1,0,0,1
3185529091,0,1,0,0,1
3185588736,0,1,0,0,1
3186814954,0,1,0,0,1
3187306332,0,1,0,0,1
3177200475,0,1,0,0,1
3187519130,0,1,0,0,1
3187941074,0,1,0,0,1
3188676656,0,1,0,0,1
3190439118,1,0,0,0,1
3190580726,0,1,0,0,1
3191478638,0,1,0,0,1
3191665920,0,1,0,0,1
3191699060,0,1,0,0,1
3192965018,0,1,0,0,1
3194671848,1,0,0,0,1
3178954463,0,1,0,0,1
3176362787,0,1,0,0,1
3144942663,0,1,0,0,1
3160974427,0,1,0,0,1
3145387487,0,1,0,0,1
3147232288,0,1,0,0,1
3150365913,0,1,0,0,1
3150524468,1,0,0,0,1
3150795277,0,1,0,0,1
3150800516,0,1,0,0,1
3152029795,1,0,0,0,1
3156794327,0,1,0,0,1
3157798849,1,0,0,0,1
3159472316,0,1,0,0,1
3161851189,1,0,0,0,1
3175104029,0,1,0,0,1
3162027599,0,1,0,0,1
3162628130,0,1,0,0,1
3163491621,0,1,0,0,1
3163773349,0,1,0,0,1
3164779651,0,1,0,0,1
3165058344,0,0,0,1,1
3165775179,0,1,0,0,1
3168811295,0,1,0,0,1
3171211230,0,1,0,0,1
3172430939,0,1,0,0,1
1552958238248902656,0,1,0,0,1
