author_id,norigins,nretweets,nquotes,nreplies,ntotal
1474002567793455104,0,34,0,2488,2522
2565866570,119,1130,25,97,1371
1307865457903448064,90,76,201,690,1057
2652298388,5,8,90,433,536
1112361822,435,0,0,0,435
832107584467275776,68,295,14,15,392
303469628,0,0,190,190,380
1568514918,0,0,181,183,364
14126697,114,1,199,22,336
381717202,26,0,117,188,331
366928053,0,311,0,0,311
1208456828213846016,40,264,0,0,304
1196554258688225280,42,0,249,10,301
314588400,34,83,62,80,259
539035503,32,2,103,88,225
2849550196,48,0,112,64,224
163372983,3,66,2,150,221
1234811749087444992,0,216,0,0,216
1488399859,176,0,2,30,208
873233558680326144,3,11,44,136,194
1286963814269726720,0,188,0,0,188
1242106993386479616,9,150,2,24,185
1303701463386828800,0,180,0,0,180
53665207,22,96,57,0,175
120815015,24,1,119,23,167
852112455660695552,43,53,67,3,166
2230018860,25,16,50,71,162
3223223454,2,154,0,5,161
906491200655544320,49,56,0,48,153
1736606712,27,114,11,0,152
1496174892345180160,22,71,12,38,143
167747869,1,142,0,0,143
1405112104416333824,30,0,51,59,140
1497347359977914368,10,87,0,42,139
995365138436972544,28,33,56,21,138
3226661780,0,0,0,137,137
415919459,95,0,40,0,135
1117022026638565376,4,105,9,15,133
923461744294379520,29,17,17,69,132
1072438256359288832,0,72,0,60,132
1296482569211371520,17,115,0,0,132
1297300767682883584,0,131,0,0,131
1356619851125637120,1,128,0,0,129
1471861813469929472,12,10,67,38,127
3365826074,0,127,0,0,127
787648918737809408,0,127,0,0,127
3395130700,5,108,8,0,121
1471902251207823360,58,41,16,1,116
302318073,16,14,26,60,116
102639230,5,22,78,9,114
891963858193178624,18,64,11,19,112
1242168397959438336,59,3,18,31,111
3209659246,49,0,37,22,108
1047367439762292736,1,45,4,57,107
923106269761851392,13,0,3,89,105
4651829368,1,101,0,1,103
1405762844923031552,0,99,0,2,101
1157930231270793216,83,0,0,18,101
1256405934190071808,1,8,0,90,99
278103259,0,94,0,0,94
1455911398865707008,1,93,0,0,94
911996595104870400,1,48,14,29,92
1241762937364033536,1,10,5,76,92
1495302850032943104,80,0,11,0,91
985561897016545280,0,91,0,0,91
2920189469,11,2,11,66,90
273941968,4,3,2,81,90
537012548,1,0,0,88,89
1527667292900839424,3,12,0,74,89
506536593,0,2,41,45,88
201405774,15,67,6,0,88
337581838,64,3,13,7,87
1234055849770876928,62,14,2,9,87
1080777644541526016,0,87,0,0,87
1489315067602432000,86,0,0,0,86
2161179552,2,83,0,0,85
1208349296774406144,0,85,0,0,85
1958979349,14,70,0,0,84
804409198293331968,63,11,3,6,83
10333162,11,0,64,7,82
257133240,0,77,3,0,80
1283798035,14,66,0,0,80
1292355121045635072,1,76,0,2,79
1496847829435928576,2,77,0,0,79
1376256898261942272,1,78,0,0,79
258191730,1,77,0,0,78
3026739151,5,16,55,1,77
273026048,1,75,0,0,76
158811187,3,73,0,0,76
3042896986,2,74,0,0,76
2957025127,0,76,0,0,76
1267494431952973824,2,72,1,1,76
921766811963658240,10,21,30,15,76
1509091822865293312,1,58,0,16,75
1346778193307561984,10,1,1,63,75
1175706264938123264,21,0,9,45,75
826522214191210496,21,0,0,53,74
737697122057785344,49,17,1,6,73
130189793,9,61,3,0,73
1953307206,0,73,0,0,73
1447685553713934336,0,73,0,0,73
2910751804,3,57,11,0,71
1254403937676996608,36,18,12,5,71
1165571798618038272,14,2,54,1,71
130905752,0,71,0,0,71
93918083,1,10,0,60,71
1021223962376884224,30,9,30,1,70
387186799,51,15,1,3,70
1423192956861915136,0,64,2,2,68
1494631208348622848,13,28,15,12,68
700619605,26,19,18,5,68
3303748522,0,68,0,0,68
719772317220544512,0,64,0,3,67
3597451816,20,15,32,0,67
1391998574246825984,0,66,0,0,66
1174263649,3,62,0,0,65
55387418,0,65,0,0,65
1209110887031697408,0,65,0,0,65
1202591764869079040,0,64,0,0,64
1071125272739659776,5,5,26,28,64
2910043371,3,1,0,59,63
1339420400,1,60,0,2,63
1110515312875765760,1,62,0,0,63
1438269440710389760,0,62,0,0,62
1203316693533175808,2,1,0,59,62
1206869464823816192,14,48,0,0,62
538562689,0,62,0,0,62
1121752949305294848,0,62,0,0,62
1259506674714509312,55,5,0,1,61
1208173173319045120,7,45,5,4,61
136210074,0,61,0,0,61
201793489,0,60,0,0,60
1149666034032549888,7,12,0,41,60
1314924972473753600,33,12,9,6,60
984782291720286208,4,27,25,3,59
950727069461336064,0,0,0,59,59
556244876,3,56,0,0,59
1255647533671440384,59,0,0,0,59
754783621,3,44,3,7,57
762366474,0,57,0,0,57
1067460354765139968,2,0,10,45,57
81355941,1,54,0,2,57
1367422671248625664,0,57,0,0,57
1302611031508672512,0,57,0,0,57
1325785515493261312,2,53,2,0,57
1080353163243331584,9,0,18,29,56
1236433599844331520,0,56,0,0,56
1046958384082169856,41,0,14,1,56
510024647,43,4,1,7,55
412899549,11,3,25,16,55
1137365461140508672,39,11,2,2,54
1694025397,0,53,0,1,54
1118105335695151104,0,13,0,41,54
2989854433,0,0,0,54,54
1860145130,33,1,1,18,53
1263855413121949696,32,1,11,9,53
1032915104252276736,5,30,0,18,53
3047133276,25,24,1,3,53
251090475,2,51,0,0,53
1253105303870042112,6,45,2,0,53
455065584,5,47,0,1,53
1322744504575819776,13,1,39,0,53
325107525,9,30,13,0,52
787881938941902848,32,1,2,17,52
1361764416568647680,1,0,1,50,52
1966156230,2,50,0,0,52
1512079760,0,51,1,0,52
2971320860,0,52,0,0,52
1425493098696626176,13,3,36,0,52
989841337,0,0,26,26,52
190228590,34,15,1,1,51
454408786,0,51,0,0,51
288772169,34,2,15,0,51
1912181796,8,1,26,16,51
1868163668,12,38,0,1,51
1219421486,16,4,27,4,51
921006828,0,50,0,0,50
1065667906929942528,0,50,0,0,50
927474456246833152,0,50,0,0,50
1653471637,0,50,0,0,50
1034384008828862464,0,50,0,0,50
404045656,0,47,2,0,49
1455546890510950400,40,9,0,0,49
475145379,27,5,11,6,49
886883720585760768,4,36,0,9,49
3893729838,12,37,0,0,49
757593167050973184,2,1,16,30,49
3073674679,0,49,0,0,49
3010277369,10,3,11,24,48
1412893496399302656,0,48,0,0,48
135557534,3,0,0,45,48
385268627,8,36,4,0,48
121510377,13,6,8,21,48
1185873445,1,0,0,47,48
1469989244,1,27,15,5,48
2513468750,0,41,3,3,47
927813756809367552,0,47,0,0,47
1263044053324771328,0,47,0,0,47
1490467644272791552,41,4,1,1,47
987079155543142400,0,46,0,0,46
1149920097357717504,7,13,23,3,46
1105392961121062912,0,46,0,0,46
1220945107,0,46,0,0,46
333400942,1,0,1,43,45
494621796,0,44,0,1,45
1504015640629325824,3,2,3,37,45
1247438667661971456,0,45,0,0,45
1488507543622148096,0,22,0,23,45
1423342330325749760,3,1,1,40,45
2802264119,7,1,9,28,45
1304816700,0,44,0,0,44
1494886617278201856,14,0,30,0,44
765913587890196480,11,13,17,3,44
2526106870,0,44,0,0,44
182811283,2,0,20,22,44
121103638,8,1,33,1,43
1243498938495373312,9,21,12,1,43
1482319536468676608,0,34,0,9,43
1494817010852642816,4,22,3,14,43
1230235427015217152,0,2,10,31,43
1197966978750676992,8,0,35,0,43
367140216,0,42,0,0,42
310594770,0,42,0,0,42
1065326882235785216,7,28,1,6,42
2262653591,14,7,9,12,42
1395974507677028352,9,25,3,5,42
2516858301,11,6,24,1,42
3413364226,4,21,8,9,42
1064264836643614720,23,5,12,2,42
1497543095474593792,0,41,1,0,42
791836313167106048,3,4,12,23,42
1484270366927298560,3,38,0,1,42
555505307,14,25,0,3,42
1496888467716022272,8,29,1,3,41
3414886005,1,0,0,40,41
2959897413,30,6,0,5,41
128514656,0,41,0,0,41
1408386505307918336,0,41,0,0,41
1040994514280886272,31,7,0,3,41
399847300,0,41,0,0,41
1386264177145262080,1,39,0,1,41
1086603623189090304,0,40,0,0,40
3449359774,0,40,0,0,40
240638933,3,35,0,2,40
1016558617846337536,0,40,0,0,40
1113399259850846208,0,40,0,0,40
211635931,0,40,0,0,40
1385599112133832704,0,40,0,0,40
1246042555122409472,2,12,25,1,40
1494246997830041600,5,12,19,4,40
308661117,21,0,13,6,40
1420694485,0,12,2,26,40
3394355711,0,35,0,5,40
1118777288764608512,1,39,0,0,40
1304387332846518272,0,40,0,0,40
794297274411184128,0,40,0,0,40
3135535360,2,0,9,29,40
1172394663170363392,0,40,0,0,40
1275787750642462720,2,37,0,0,39
800721312041738240,0,39,0,0,39
3223557747,2,37,0,0,39
55787870,0,39,0,0,39
1249105143276007424,39,0,0,0,39
1463810250935517184,6,28,5,0,39
162823643,1,4,0,34,39
1379021132,0,39,0,0,39
3066578262,0,31,4,4,39
3140350122,9,8,14,7,38
368452285,5,0,2,31,38
758494724583981056,5,27,2,4,38
1498752036933824512,2,26,3,7,38
356560894,0,38,0,0,38
1186282148401205248,1,15,1,21,38
1242020136,6,0,32,0,38
727041743984668672,0,38,0,0,38
1091194666169491456,1,0,0,37,38
1224004379604217856,0,38,0,0,38
224081294,11,0,21,6,38
889113834312654848,0,33,4,1,38
1478736397641019392,2,36,0,0,38
949446566116433920,2,36,0,0,38
2754660997,2,35,0,1,38
1427179678129864704,0,38,0,0,38
1213135459439628288,7,4,9,18,38
802867984054255616,0,38,0,0,38
2606185866,17,16,2,2,37
1265917986000392192,1,12,0,24,37
1076872929898573824,2,12,5,18,37
286204440,1,32,4,0,37
2179811783,4,30,2,1,37
807508085883490304,0,37,0,0,37
2787800906,1,36,0,0,37
966389354,1,32,1,2,36
106417193,5,1,23,7,36
763304998914691072,0,36,0,0,36
1214968166692085760,9,7,20,0,36
1345429050941030400,7,25,4,0,36
1483373399640584192,0,36,0,0,36
2308539251,2,1,1,32,36
782034728388005888,2,2,2,30,36
1481841577,5,19,12,0,36
2838255289,0,36,0,0,36
1593245287,4,4,3,25,36
992693234,1,35,0,0,36
1384626162,4,30,2,0,36
341055710,0,36,0,0,36
4152206032,23,0,12,0,35
823775623,35,0,0,0,35
496851361,16,0,9,10,35
1484898126184218624,0,33,0,2,35
1093592682352570368,1,34,0,0,35
4868519128,0,35,0,0,35
1091294678,24,7,1,3,35
398706584,15,0,17,3,35
1150337874702680064,13,1,19,2,35
205654180,8,22,1,3,34
1488501003259629568,4,30,0,0,34
1135238519973076992,0,34,0,0,34
1175752864414797824,3,0,0,31,34
74666350,21,1,1,11,34
599427190,1,33,0,0,34
1278614477961785344,2,3,2,27,34
227960503,0,34,0,0,34
1171744151542648832,2,3,7,22,34
1478725630074269696,7,25,0,1,33
933772683657007104,0,33,0,0,33
929786374668128256,0,33,0,0,33
1405921440155668480,0,33,0,0,33
1002578564049321984,0,33,0,0,33
195681313,0,33,0,0,33
2560118975,14,12,0,7,33
880016768403738624,0,0,1,32,33
4240432823,0,33,0,0,33
1052861531736674304,2,0,5,26,33
749260140,0,33,0,0,33
794679487535333376,0,33,0,0,33
900353796504772608,0,33,0,0,33
1276928220806262784,0,33,0,0,33
882557444047740928,0,31,1,1,33
27405039,25,8,0,0,33
263338731,0,33,0,0,33
2455366572,0,33,0,0,33
2563929115,0,33,0,0,33
2845061361,0,31,0,1,32
2208520322,28,1,3,0,32
549235496,2,30,0,0,32
279491277,0,32,0,0,32
1524557713,2,25,5,0,32
2841092226,0,32,0,0,32
1483851489156399104,4,28,0,0,32
1618772023,1,31,0,0,32
1376452734963101696,1,0,2,29,32
1966369100,4,19,3,6,32
139008816,15,14,3,0,32
1156441583480266752,23,0,6,2,31
312081749,1,30,0,0,31
227279563,1,30,0,0,31
1406917833477459968,0,31,0,0,31
439234131,0,31,0,0,31
15170258,17,5,9,0,31
438213306,8,3,16,4,31
1211208774217650176,29,0,0,2,31
1001440798527950848,0,31,0,0,31
1223209698968711168,0,31,0,0,31
893065284315217920,31,0,0,0,31
3232768628,6,5,12,8,31
725951516926865408,8,17,1,5,31
167333792,1,30,0,0,31
924214168194048000,1,30,0,0,31
1255362608129101824,0,31,0,0,31
249900812,1,30,0,0,31
963098230392311808,2,15,0,14,31
1246820602935197696,26,2,2,1,31
3122219981,5,0,2,24,31
921862233960927232,2,24,1,4,31
1014557948738260992,3,1,27,0,31
476620797,0,12,0,18,30
272114850,0,29,0,1,30
1240227710737059840,0,30,0,0,30
2386041601,2,27,0,1,30
1277197596,19,0,0,11,30
1204002979973681152,3,24,1,2,30
1165776877203664896,0,0,1,29,30
2457635065,0,29,1,0,30
420065832,1,29,0,0,30
359906551,5,7,0,18,30
122804381,0,30,0,0,30
1276416257655541760,0,0,0,30,30
912602857588666368,0,0,0,30,30
1432617439,0,30,0,0,30
1455173991627378688,10,19,0,1,30
194456472,9,3,8,10,30
872439868777000960,1,29,0,0,30
1493001480,18,7,3,2,30
584279348,0,28,1,1,30
553528452,0,30,0,0,30
337554845,1,29,0,0,30
1420343515,0,30,0,0,30
1371765388825010176,7,2,9,11,29
3606547215,4,1,24,0,29
1005976738889752576,0,29,0,0,29
1686852254,8,15,4,2,29
4695144900,0,28,0,1,29
1066110346497269760,5,15,0,9,29
98851188,0,0,0,29,29
1022232738,3,10,8,8,29
1170205573901537280,0,29,0,0,29
243554968,0,29,0,0,29
1302453244820467712,2,21,1,5,29
766631222231588864,21,1,0,7,29
1476937165678559232,16,12,1,0,29
3022862503,13,0,9,7,29
562672745,1,28,0,0,29
1954667564,18,9,0,2,29
4731588974,0,24,1,4,29
2423449500,1,23,3,2,29
220539424,1,28,0,0,29
1480295601355042816,6,18,3,2,29
1497763907263508480,25,2,0,1,28
1364609228158173184,2,26,0,0,28
2296212614,0,28,0,0,28
502456780,21,6,1,0,28
1263015626467147776,0,20,8,0,28
1255890128448425984,0,28,0,0,28
1044163286307151872,0,16,0,12,28
1288880705678827520,4,23,0,1,28
558457642,0,28,0,0,28
96729063,0,28,0,0,28
948239426974507008,0,25,0,3,28
3889410567,0,28,0,0,28
1040633071291097088,8,2,8,10,28
1046446224843444224,0,12,9,7,28
257097577,0,28,0,0,28
1246446547300040704,19,0,1,8,28
124987668,1,0,1,26,28
2176889224,14,7,0,7,28
271293064,2,23,0,3,28
2231478266,0,28,0,0,28
2734253816,2,6,3,17,28
57598941,21,5,1,1,28
447646601,22,3,1,2,28
1109200201611440128,0,28,0,0,28
803567193875169280,0,0,1,27,28
1123274347773190144,4,8,15,1,28
915862853113987072,0,27,0,0,27
4243878676,3,24,0,0,27
4268670137,0,26,0,1,27
1153584302531260416,9,18,0,0,27
23972869,0,27,0,0,27
2555443614,0,27,0,0,27
1427281272162996224,17,0,4,6,27
96404863,3,23,0,1,27
1281521262636998656,0,27,0,0,27
1264256508725997568,0,27,0,0,27
706250496,2,8,14,3,27
1430418359883993088,0,27,0,0,27
1492349423824687104,1,24,0,2,27
1213732271368204288,0,27,0,0,27
562239354,25,2,0,0,27
23303781,6,5,0,16,27
73088007,0,22,0,5,27
798060265501814784,0,27,0,0,27
166957354,5,16,6,0,27
1065228929026289664,0,27,0,0,27
1261706535622733824,0,27,0,0,27
1750833829,0,27,0,0,27
866160515092856832,0,27,0,0,27
1450693089119535104,0,26,1,0,27
414610510,0,27,0,0,27
1331811693106610176,0,0,0,27,27
1202860063,1,0,5,21,27
758773076,0,27,0,0,27
4080787793,1,23,1,2,27
1289825748539195392,0,27,0,0,27
2910730143,0,27,0,0,27
137395022,2,25,0,0,27
250334693,4,6,5,12,27
1276975703247015936,2,14,2,9,27
873641322,2,23,1,0,26
269256017,5,11,0,10,26
821084302704250880,0,26,0,0,26
2711184571,0,26,0,0,26
1277541944357314560,0,26,0,0,26
1405704236009066496,3,13,10,0,26
2786758031,0,26,0,0,26
711531474739208192,0,26,0,0,26
3010719216,0,26,0,0,26
211203106,25,0,0,1,26
1452928167157460992,0,26,0,0,26
851079681256427520,4,19,3,0,26
1233522668508344320,0,26,0,0,26
3406551359,2,0,20,4,26
1353326232398520320,4,0,5,17,26
1460501929180553216,0,26,0,0,26
372677521,0,26,0,0,26
1449644910,0,26,0,0,26
1228589360,0,26,0,0,26
1053144811,0,26,0,0,26
820066301053988864,4,2,3,17,26
1088011336540475392,2,6,3,15,26
858955611643551744,3,17,2,4,26
75826197,4,11,0,11,26
1398967243,0,15,0,11,26
1206532216232132608,0,26,0,0,26
1139393161568985088,0,26,0,0,26
1131029979104468992,26,0,0,0,26
972960558868709376,18,0,0,8,26
931497257073102848,0,26,0,0,26
914497091040350208,0,26,0,0,26
492643486,1,19,0,6,26
1397215070350823424,14,0,10,1,25
2873433012,0,24,1,0,25
1367199432677146624,1,21,0,3,25
1026898462917386240,2,20,3,0,25
710536295538429952,1,24,0,0,25
52434833,5,0,9,11,25
1289760234869645312,0,25,0,0,25
1246089893077323776,0,24,0,1,25
1428030416926121984,0,21,0,4,25
1055975316,0,25,0,0,25
854484116078829568,0,25,0,0,25
786898871003865088,0,25,0,0,25
48672667,1,18,2,4,25
901891617530929152,4,21,0,0,25
2366175355,10,5,4,6,25
708912985230553088,0,25,0,0,25
1241542340835229696,12,0,9,4,25
761007001824403456,2,23,0,0,25
1497758612709863424,1,23,0,1,25
760466597458931712,0,25,0,0,25
1202520696301195264,12,4,7,2,25
143125394,1,24,0,0,25
828118931823009792,1,9,1,14,25
2694992321,17,0,2,6,25
1904106060,17,8,0,0,25
1359773297379061760,0,25,0,0,25
591614968,0,25,0,0,25
1225015880406323200,1,18,5,1,25
1478774442855653376,0,25,0,0,25
1039158334891417600,0,21,4,0,25
1398348888550092800,4,1,20,0,25
278094847,10,1,7,6,24
984089455,0,0,0,24,24
737169402215464960,6,14,0,4,24
2929465251,5,11,2,6,24
1393061967686815744,0,24,0,0,24
422507988,0,24,0,0,24
388506808,0,24,0,0,24
460459795,0,24,0,0,24
2321916710,0,24,0,0,24
1451287289015975936,0,23,0,1,24
1196934348,1,3,0,20,24
11282612,5,19,0,0,24
1286344768734167040,1,19,1,3,24
2271600139,7,3,6,8,24
1464683120637186048,0,24,0,0,24
1256936665911824384,0,24,0,0,24
1405800125470027776,3,21,0,0,24
1154072419080048640,0,24,0,0,24
341101836,5,5,14,0,24
2466118694,0,22,0,2,24
1189818911090511872,0,24,0,0,24
52379885,0,21,2,1,24
2677293150,17,2,3,2,24
1017039544540172288,4,1,5,14,24
71490932,1,21,1,1,24
699686062164148224,0,24,0,0,24
2329885877,0,24,0,0,24
951572917,2,20,0,2,24
902613078466076672,21,0,1,2,24
1194597142272368640,0,24,0,0,24
979633801973436416,0,24,0,0,24
2275642720,5,1,5,13,24
3290314871,0,13,0,11,24
1113830354358423552,6,16,0,2,24
1477729976803901440,1,23,0,0,24
470909953,12,10,1,1,24
1215321872,2,22,0,0,24
3860196976,7,9,3,5,24
1627566026,0,22,1,0,23
153718807,0,23,0,0,23
1450379082412216320,7,11,2,3,23
1256219921530396672,3,19,0,1,23
3222952025,0,23,0,0,23
915194220,0,23,0,0,23
1132211485290237952,0,22,1,0,23
96127056,4,0,0,19,23
1879086318,21,0,0,2,23
1260338610529804288,0,23,0,0,23
1257940576139276288,3,20,0,0,23
1382233022280343552,0,23,0,0,23
788840750431731712,21,0,0,2,23
624977655,0,9,14,0,23
947990340,0,23,0,0,23
1497875940659056640,0,4,0,19,23
232478240,2,20,1,0,23
2972742135,0,0,0,23,23
1315916428843847680,1,19,1,2,23
2197043696,21,0,1,1,23
1378343063504838656,4,19,0,0,23
1726150146,14,9,0,0,23
1244224579360473088,0,23,0,0,23
1231844778850959360,0,23,0,0,23
1175786827153846272,14,1,1,7,23
2715145142,2,0,1,20,23
1314404554792824832,9,0,11,3,23
1552087633,0,6,2,15,23
1491865929063579648,2,15,5,1,23
382802501,0,21,0,2,23
886520595600617472,0,23,0,0,23
1481701813925687296,0,23,0,0,23
1958152405,0,22,0,0,22
1130367132221546496,0,21,0,1,22
1487719394885382144,2,12,0,8,22
1136874141183807488,1,15,0,6,22
1245077173112696832,0,22,0,0,22
1500544118774132736,1,0,3,18,22
183188816,1,21,0,0,22
931924050,2,20,0,0,22
987382679870951424,0,22,0,0,22
784309194576896000,0,22,0,0,22
618811816,4,14,0,4,22
3214382156,0,22,0,0,22
258917819,0,22,0,0,22
112495128,4,1,5,12,22
1714935486,2,19,1,0,22
1872185280,0,22,0,0,22
2764633630,0,22,0,0,22
1273303278013624320,1,0,19,2,22
1141869972,0,22,0,0,22
1010655357994233856,2,20,0,0,22
1141841701,0,22,0,0,22
1106620340082343936,0,22,0,0,22
186512756,9,0,1,12,22
1275424431318487040,0,21,0,1,22
1076492047,0,22,0,0,22
106404745,0,22,0,0,22
16407750,3,19,0,0,22
1195209298155950080,3,19,0,0,22
1315904071681761280,2,13,4,3,22
121520058,6,10,6,0,22
134601124,0,0,0,22,22
1351839787481591808,11,0,11,0,22
1386646732134502400,0,22,0,0,22
114145266,1,0,3,17,21
1154079914737446912,0,21,0,0,21
464512469,0,21,0,0,21
84654250,0,0,0,21,21
164301202,17,4,0,0,21
4019178741,0,21,0,0,21
174835771,1,17,1,2,21
755256975303200768,0,21,0,0,21
1485760704065851392,0,0,12,9,21
1287711531220729856,0,21,0,0,21
1094995810893336576,0,21,0,0,21
1494350812100837376,9,0,3,9,21
147215905,0,21,0,0,21
4275743723,0,21,0,0,21
4913370821,7,6,3,5,21
904799581199851520,0,20,1,0,21
3447483852,1,19,1,0,21
2460028799,7,8,0,6,21
1389651402046148608,0,21,0,0,21
474046462,0,2,11,8,21
1000776381842706432,0,21,0,0,21
314949802,3,3,0,15,21
1274242404518895616,0,21,0,0,21
1238334394164633600,0,0,0,21,21
54473457,21,0,0,0,21
1258842824147005440,0,21,0,0,21
892665285588770816,0,2,2,17,21
834200269,1,20,0,0,21
18362993,7,11,3,0,21
1230184628549554176,0,21,0,0,21
960049040,3,1,17,0,21
1182755376883736576,0,21,0,0,21
822071046,2,19,0,0,21
1404451046,0,21,0,0,21
1272757731024306176,1,19,0,1,21
3085556335,8,4,5,4,21
893552762851651584,0,21,0,0,21
1875827437,3,5,4,9,21
1321795892,1,19,0,1,21
948366256154992640,0,21,0,0,21
1367639538609385472,0,21,0,0,21
706680336,0,20,0,0,20
248812036,0,20,0,0,20
353148692,0,20,0,0,20
1468337205588684800,18,0,1,1,20
2930948224,1,19,0,0,20
1209567979,1,1,18,0,20
802526495235342336,8,3,1,8,20
911588684889239552,2,6,3,9,20
757754864084606976,0,20,0,0,20
2287351036,1,19,0,0,20
1064053347164930048,2,18,0,0,20
1312861773226106880,5,0,7,8,20
828520700,0,3,0,17,20
726727728,0,20,0,0,20
74449914,0,18,1,1,20
965091170194948096,0,20,0,0,20
2496738176,0,20,0,0,20
1357188181368705024,11,4,2,3,20
1455991424470634496,0,20,0,0,20
2921798457,0,20,0,0,20
71286765,0,20,0,0,20
310320081,0,20,0,0,20
3178138770,1,19,0,0,20
1493678906389725184,9,10,1,0,20
1569866095,1,17,0,2,20
2265409832,0,20,0,0,20
388361890,19,0,1,0,20
335959915,0,20,0,0,20
1429494182314393600,0,20,0,0,20
3039666477,0,0,0,20,20
268445810,3,11,6,0,20
624625452,9,8,3,0,20
365365344,3,0,17,0,20
987587398455439360,3,10,0,7,20
3356985854,1,19,0,0,20
970580920301387776,2,16,2,0,20
1269883033366167552,0,20,0,0,20
1082471857541001216,1,1,7,11,20
886150348209049600,0,20,0,0,20
2432466866,0,8,0,12,20
2811003200,4,5,11,0,20
3224008242,5,1,2,12,20
1494690280142163968,0,19,0,0,19
1463067330338975744,4,15,0,0,19
4915572028,0,19,0,0,19
1306581632053202944,19,0,0,0,19
1268542933776596992,0,0,0,19,19
345924880,14,0,2,3,19
1286232816389255168,0,19,0,0,19
1545436339,0,7,1,11,19
1493015378,15,0,4,0,19
756228057644539904,0,14,4,1,19
735866515719913472,1,13,5,0,19
1003043816121733120,0,0,1,18,19
1145708220,0,19,0,0,19
356394685,0,19,0,0,19
2422053479,0,19,0,0,19
3074997268,4,1,14,0,19
150050144,0,19,0,0,19
4702149811,19,0,0,0,19
969021885211140096,0,19,0,0,19
1544258301688512512,16,1,0,2,19
272863677,0,14,3,2,19
1496865843250040832,0,19,0,0,19
1097000634904166400,3,7,4,5,19
887715168,0,19,0,0,19
1496964676600705024,0,19,0,0,19
27600935,0,19,0,0,19
984203824196931584,0,18,0,1,19
2874274583,1,18,0,0,19
1428002217907347456,2,11,0,6,19
171240917,1,3,2,13,19
388179182,8,0,7,4,19
1261555570315874304,0,19,0,0,19
1318292684998463488,14,0,5,0,19
1006161793910177792,11,0,4,4,19
1329103416904224768,0,19,0,0,19
1471484811965440000,4,0,0,15,19
1467048183675060224,1,8,4,6,19
431377087,0,19,0,0,19
175622392,2,1,0,16,19
1078789831583514624,0,19,0,0,19
34453976,0,10,1,7,18
1331950266,0,18,0,0,18
156579343,2,11,4,1,18
871018895284596736,14,1,1,2,18
907299464087347200,0,18,0,0,18
265049085,18,0,0,0,18
1498021343136124928,10,0,1,7,18
1210847984952365056,0,18,0,0,18
1691338699,4,3,3,8,18
266827893,0,18,0,0,18
29940278,3,3,0,12,18
275443180,0,18,0,0,18
1343143470362460160,0,18,0,0,18
1298548637715374080,0,5,0,13,18
256090050,7,7,3,1,18
1496690258091679744,18,0,0,0,18
1417876134,7,0,1,10,18
1026470977742495744,3,0,0,15,18
842764884173504512,0,18,0,0,18
966418443233669120,3,1,4,10,18
1112226474,0,18,0,0,18
1181625762132172800,0,18,0,0,18
501690086,2,14,0,2,18
1036699802,0,18,0,0,18
1008838789,1,0,0,17,18
1186673859354857472,0,18,0,0,18
1491564355015491584,2,0,1,15,18
1978349402,0,18,0,0,18
133001062,1,0,6,11,18
709304670,0,18,0,0,18
1332022905979342848,0,18,0,0,18
1194298651918495744,0,18,0,0,18
1724195040,13,3,1,1,18
722069998215102464,6,7,5,0,18
932320676,1,1,6,10,18
1497221421130465280,3,8,7,0,18
3019909388,18,0,0,0,18
146056673,1,15,2,0,18
1014821568826896384,0,18,0,0,18
1216302049249370112,3,15,0,0,18
1238236890614071296,0,0,0,18,18
3287251921,0,16,0,2,18
1058519731148333056,2,15,1,0,18
3027978136,1,16,0,1,18
873648774526185472,5,9,3,1,18
1232606515179204608,5,0,4,9,18
1169170209716002816,0,18,0,0,18
918785384871493632,2,11,5,0,18
1341049693753626624,1,0,0,17,18
974435384271630336,2,1,0,15,18
765958031297380352,0,18,0,0,18
1003935589459251200,0,18,0,0,18
1322938638045388800,0,18,0,0,18
445944943,0,18,0,0,18
836620927408418816,2,16,0,0,18
1362302494076923904,0,18,0,0,18
706194719492206592,3,0,15,0,18
157767580,0,18,0,0,18
85657389,11,6,0,1,18
4867254005,0,18,0,0,18
1261594024751833088,0,18,0,0,18
1184930296065593344,1,17,0,0,18
1405815062221131776,1,11,0,6,18
1053864021156196352,7,4,3,3,17
913418634017382400,0,17,0,0,17
3189954992,2,0,1,14,17
1432899689846738944,0,17,0,0,17
1165159393006170112,15,0,0,2,17
1070041658539077632,1,0,16,0,17
845244444,0,17,0,0,17
2859405689,2,3,9,3,17
1091713666607665152,0,17,0,0,17
1723349827,16,0,0,1,17
844906272604475392,0,17,0,0,17
2887988230,5,1,9,2,17
2198274359,4,13,0,0,17
246664619,0,17,0,0,17
1263868310904606720,0,17,0,0,17
2375238376,0,17,0,0,17
953641129,1,4,1,11,17
3287879827,4,13,0,0,17
258440198,1,15,1,0,17
316016845,2,15,0,0,17
2256287230,0,17,0,0,17
1247101810495668224,0,17,0,0,17
518496913,2,15,0,0,17
1468043257959510016,0,17,0,0,17
1192327820636241920,0,17,0,0,17
3436419192,1,15,0,1,17
1094375787426402304,0,17,0,0,17
107813400,12,0,0,5,17
172488648,0,17,0,0,17
1200516672357949440,3,14,0,0,17
104766333,1,16,0,0,17
2857954350,0,17,0,0,17
758344449608986624,0,17,0,0,17
3243783855,15,1,0,1,17
2753564511,0,17,0,0,17
2409423895,0,17,0,0,17
1456973367383265280,1,14,0,2,17
843079076030177280,0,17,0,0,17
93862279,0,17,0,0,17
825257304702455808,2,14,0,1,17
1396712597454565376,0,17,0,0,17
1314937331837816832,2,1,0,14,17
1492429274,0,17,0,0,17
1239837436701814784,0,17,0,0,17
259802714,0,11,0,6,17
310841365,0,17,0,0,17
1204266219659878400,0,17,0,0,17
522848268,1,16,0,0,17
1320575795925000192,0,17,0,0,17
856681321,1,4,4,8,17
3857652914,1,16,0,0,17
787987748925935616,4,5,5,3,17
1315174796447997952,9,0,6,2,17
1460811076388352000,5,12,0,0,17
3034423840,0,17,0,0,17
1903240711,0,17,0,0,17
2873692062,4,12,1,0,17
73599308,1,6,3,7,17
824212118,0,17,0,0,17
221497233,16,1,0,0,17
1337749527797719040,0,17,0,0,17
1422814399539068928,8,9,0,0,17
1673580054,0,17,0,0,17
1220958398948134912,1,8,0,8,17
3426641835,0,14,0,3,17
308728026,17,0,0,0,17
360626978,0,17,0,0,17
1265883976427884544,0,1,0,16,17
64556398,9,1,7,0,17
18042814,1,15,1,0,17
846342955686395904,0,17,0,0,17
1472508893192327168,10,2,1,4,17
1210590469748658176,0,17,0,0,17
735800135159042048,0,17,0,0,17
1223387406146998272,0,17,0,0,17
1300378599086678016,1,16,0,0,17
999488665,8,0,8,1,17
1588253204,16,0,0,1,17
1049633567926603776,1,16,0,0,17
995079043174227968,6,0,11,0,17
890057351218298880,0,17,0,0,17
3502575852,0,16,0,1,17
828161403873804288,8,8,0,1,17
1202178256864194560,15,0,2,0,17
1496475440952659968,1,14,0,2,17
140624884,0,17,0,0,17
1392489761810624512,0,17,0,0,17
1593180294,0,17,0,0,17
865848432958820352,0,3,1,13,17
484765612,0,4,0,13,17
26820035,8,0,5,4,17
1214335647193993216,0,17,0,0,17
2203054075,0,17,0,0,17
1296745330835365888,0,17,0,0,17
1907216702,0,17,0,0,17
361280419,6,9,2,0,17
295430103,1,15,1,0,17
1380557500190126080,0,17,0,0,17
3656504301,0,16,0,0,16
2864776750,4,12,0,0,16
1420538663339888640,2,7,0,7,16
1309440669509988352,1,13,0,2,16
1642593638,0,16,0,0,16
1444070473,4,12,0,0,16
450082749,0,0,0,16,16
1354699208046108672,10,3,0,3,16
1433411258057957376,0,4,10,2,16
1004069947352469504,1,15,0,0,16
740151349619396608,0,16,0,0,16
1963583071,0,16,0,0,16
1458135245291618304,0,16,0,0,16
1501994422640078848,0,16,0,0,16
3642353549,0,16,0,0,16
839212839411806208,0,16,0,0,16
1359258449637494784,0,0,4,12,16
1426939202923548672,5,0,3,8,16
2382677628,0,4,2,10,16
376938145,8,6,1,1,16
1177872821562875904,0,16,0,0,16
2874957840,3,12,0,1,16
1208819873792634880,0,14,0,2,16
539042790,0,16,0,0,16
1330768907414679552,0,16,0,0,16
111368100,2,14,0,0,16
1155296268265984000,0,0,0,16,16
950164372017463296,0,15,0,1,16
1479580375584280576,0,1,10,5,16
1292047625647095808,3,0,10,3,16
971932910856081408,0,16,0,0,16
1266749859337363456,1,15,0,0,16
333718320,0,16,0,0,16
1106517928575266816,7,4,3,2,16
973115146619858944,0,16,0,0,16
2453033169,8,6,1,1,16
876365818598219776,0,16,0,0,16
609309428,7,3,0,6,16
1428539137,2,10,4,0,16
3008273118,1,15,0,0,16
187510799,3,12,0,1,16
403310571,1,5,0,10,16
47993321,0,16,0,0,16
706138485,0,16,0,0,16
1480231364037337088,4,12,0,0,16
3002585144,0,16,0,0,16
1435489901970079744,2,12,0,2,16
966319342987108352,1,15,0,0,16
1459057448665300992,0,16,0,0,16
114295783,4,8,2,2,16
1159102135474282496,1,0,0,15,16
1286813780786249728,2,1,8,5,16
787582429871665152,1,15,0,0,16
27906709,16,0,0,0,16
454046565,0,0,0,16,16
1160791888049397760,0,16,0,0,16
922380415641546752,0,16,0,0,16
1492353503578423296,0,16,0,0,16
1202687467159207936,1,14,1,0,16
1494004251395121152,4,2,0,10,16
1401478338426900480,0,1,0,15,16
3075013403,0,14,2,0,16
58111368,0,16,0,0,16
1633431512,2,14,0,0,16
841999318856921088,3,13,0,0,16
1089996813262835712,6,4,2,4,16
2215892270,1,15,0,0,16
1214868013641617408,7,3,4,2,16
131222694,8,0,2,6,16
1243821644,0,16,0,0,16
568376960,11,3,0,2,16
1933393075,0,16,0,0,16
720191184,0,0,0,16,16
1128941265318436864,5,10,0,1,16
1093725105350295552,2,8,0,6,16
1400914470344396800,0,16,0,0,16
1499735870122905600,16,0,0,0,16
3072879716,10,6,0,0,16
847306147,0,16,0,0,16
717766428363870208,7,3,2,4,16
2916570813,0,16,0,0,16
925989297852858368,12,0,0,4,16
467382324,1,15,0,0,16
1361888960,1,15,0,0,16
943499326289883136,1,12,3,0,16
1222886615816667136,0,16,0,0,16
997868661309194240,1,15,0,0,16
988418402,4,10,2,0,16
1498142015829147648,0,16,0,0,16
4220125455,7,7,0,2,16
1499087419362009088,6,1,5,4,16
831658008,0,15,0,0,15
1055380681,0,15,0,0,15
1290614502455681024,2,0,10,3,15
1237028294928859136,0,15,0,0,15
496333433,4,0,11,0,15
1156254976085073920,0,15,0,0,15
1891648074,0,15,0,0,15
1142337897556668416,11,2,2,0,15
994899439088119808,10,5,0,0,15
1307446843,0,12,0,3,15
165103719,0,15,0,0,15
101045551,0,15,0,0,15
412075706,1,14,0,0,15
1095599919375765504,2,13,0,0,15
353289006,0,14,0,1,15
1243591229633331200,1,8,0,6,15
785442728,0,15,0,0,15
1245831270388699136,0,5,8,2,15
3755983639,0,5,0,10,15
980655648,14,1,0,0,15
226459769,9,1,2,3,15
1002433951,0,15,0,0,15
17928387,0,0,15,0,15
910829572417081344,0,8,0,7,15
1615522807,0,14,0,1,15
1504439826,1,14,0,0,15
401974112,0,15,0,0,15
1465580445576273920,5,8,0,2,15
1254525794,4,8,3,0,15
290019914,0,15,0,0,15
243829132,3,11,0,1,15
15275804,0,15,0,0,15
850180281508265984,0,15,0,0,15
1211383796,0,15,0,0,15
1229297910380019712,0,0,0,15,15
1387341030844821504,0,15,0,0,15
1086112999,0,12,1,2,15
806011442,0,15,0,0,15
1357230441506304000,1,2,1,11,15
1934310319,1,1,0,13,15
935565505624137728,0,14,1,0,15
1206295789221208064,0,14,0,1,15
1493408981972185088,5,9,0,1,15
324273472,1,13,0,1,15
887307590803361792,0,15,0,0,15
1291460162952331264,0,15,0,0,15
19507697,0,3,3,9,15
1397440359433707520,0,15,0,0,15
3017620351,1,3,7,4,15
16569996,11,0,2,2,15
436869979,6,0,3,6,15
702951340717293568,0,14,1,0,15
4732587377,1,0,0,14,15
1105741591086424064,0,15,0,0,15
4543390574,0,15,0,0,15
1058214270633050112,1,10,2,2,15
952377328553766912,0,15,0,0,15
148705704,3,12,0,0,15
731264390,0,15,0,0,15
1331963477011750912,0,15,0,0,15
1344125857829277696,0,15,0,0,15
952453605835132928,0,1,0,14,15
781914761567035392,0,15,0,0,15
1442584328966266880,0,15,0,0,15
4133719033,1,14,0,0,15
1333442307794870272,8,6,0,1,15
1442670540188160000,11,2,0,2,15
2264701860,0,15,0,0,15
545498522,0,0,1,14,15
1067171283165736960,0,15,0,0,15
1142014903,0,15,0,0,15
1673493151,0,15,0,0,15
1333843387389259776,0,15,0,0,15
115442450,0,15,0,0,15
985506340448751616,0,15,0,0,15
1344331989625794560,0,15,0,0,15
1227053762751029248,10,4,1,0,15
1320665356189396992,0,15,0,0,15
924943818973175808,5,10,0,0,15
623024796,0,15,0,0,15
1461941005,4,4,3,3,14
206043877,14,0,0,0,14
1044498676989775872,6,8,0,0,14
1286070505125089280,0,14,0,0,14
2710484416,0,13,0,1,14
1459442060,2,11,0,1,14
1344009007858671616,5,2,1,6,14
1391699160240381952,0,14,0,0,14
865327702877908992,0,14,0,0,14
416480953,1,13,0,0,14
4822594816,0,14,0,0,14
2161454077,2,12,0,0,14
1431312266,0,14,0,0,14
778205047,1,13,0,0,14
23608973,2,11,1,0,14
2439782677,0,14,0,0,14
1400324279317635072,0,0,0,14,14
50743019,0,9,0,5,14
1232648406633349120,0,14,0,0,14
2282932901,4,1,1,8,14
2232319147,0,14,0,0,14
1324003829365485568,0,0,3,11,14
1332232015358418944,0,14,0,0,14
323156161,0,14,0,0,14
1198097887877484544,1,0,6,7,14
2862608596,1,5,8,0,14
1376412151988953088,0,14,0,0,14
1143912774440902656,0,12,2,0,14
2614421196,9,5,0,0,14
1197915061102239744,7,7,0,0,14
1475593441744666624,9,3,1,1,14
1084763220244496384,0,14,0,0,14
1549766052,1,0,4,9,14
1497247938082656256,0,14,0,0,14
1494674487949680640,1,13,0,0,14
1413086356625104896,2,2,0,10,14
1478737097099931648,0,13,0,1,14
1287318931175342080,0,14,0,0,14
39958003,0,14,0,0,14
465701827,0,14,0,0,14
320365961,0,14,0,0,14
4814516163,0,14,0,0,14
26774617,0,0,0,14,14
1230773246963798016,0,14,0,0,14
130928523,0,14,0,0,14
73579523,1,1,10,2,14
2241903781,0,14,0,0,14
968481139244462080,0,14,0,0,14
1381587271137296384,0,1,0,13,14
962678540314570752,1,11,2,0,14
1331908116,7,1,0,6,14
1407991924594728960,0,14,0,0,14
441345268,0,14,0,0,14
3963961401,2,12,0,0,14
1893227472,0,14,0,0,14
704803358062809088,3,0,7,4,14
1369633452103004160,0,14,0,0,14
2570080614,1,13,0,0,14
1514355192,0,14,0,0,14
1382607823679463424,1,11,0,2,14
821287746937290752,0,14,0,0,14
273507256,4,3,3,4,14
1289474148964564992,0,14,0,0,14
1065778437560840192,12,0,0,2,14
1557165212,7,3,4,0,14
1450800879980978176,0,7,0,7,14
1244109542943625216,5,0,0,9,14
822710718948605952,0,0,0,14,14
4871065486,0,14,0,0,14
1202649521186103296,2,12,0,0,14
846000664849338368,0,10,0,4,14
348417729,0,14,0,0,14
964978087057379328,10,0,0,4,14
246741143,0,14,0,0,14
1238499335442034688,0,14,0,0,14
54470780,0,14,0,0,14
724107994951233536,1,4,7,2,14
1363772862516006912,0,14,0,0,14
939968303619067904,0,14,0,0,14
2576889048,6,5,1,2,14
2238755929,0,14,0,0,14
986176646980882432,0,9,5,0,14
615253131,1,9,0,4,14
434318114,2,12,0,0,14
2417838617,0,14,0,0,14
1432240171739582464,0,14,0,0,14
289961042,1,13,0,0,14
3157793017,0,14,0,0,14
1119163686717779968,6,0,1,7,14
1143677174,0,1,2,11,14
3204068134,1,12,0,1,14
193848958,0,14,0,0,14
1527023406,0,14,0,0,14
1865185232,0,14,0,0,14
745162964,1,13,0,0,14
1051877366631297024,6,7,1,0,14
1306184373411086336,0,3,0,11,14
88414196,4,8,2,0,14
1325731023724769280,0,14,0,0,14
1040847129193918464,0,14,0,0,14
1455235847528357888,8,0,3,3,14
3022406601,0,14,0,0,14
479358515,0,14,0,0,14
3189972248,0,14,0,0,14
418803058,1,12,0,1,14
1151939549880176640,2,12,0,0,14
1458667993085489152,0,14,0,0,14
780011963199946752,2,3,9,0,14
3006865346,0,14,0,0,14
3283283438,1,11,0,2,14
4673975173,0,14,0,0,14
154477093,13,1,0,0,14
262302919,0,13,1,0,14
844603194479128576,0,14,0,0,14
900432409,4,6,3,1,14
128142100,0,14,0,0,14
1435738816913027072,0,14,0,0,14
770895450,0,14,0,0,14
1420105006422712320,0,12,0,2,14
194261615,0,13,0,1,14
1472640378,0,14,0,0,14
1282209871861956608,9,2,1,2,14
2205279974,0,0,0,14,14
1457180192217067520,3,4,0,7,14
1356476245844897792,0,14,0,0,14
359454215,0,13,0,1,14
1395093031406104576,0,14,0,0,14
1353958920465903616,2,12,0,0,14
1574628661,2,0,12,0,14
3197223744,0,14,0,0,14
1075257793022779392,2,1,11,0,14
965876141088231424,0,14,0,0,14
20240214,0,1,8,5,14
519236267,2,0,0,12,14
971005086724972544,0,13,0,0,13
371398125,5,0,0,8,13
1090625266840469504,0,13,0,0,13
777932903338696704,0,13,0,0,13
3515153602,4,1,0,8,13
336920631,0,13,0,0,13
241227516,0,13,0,0,13
127274211,0,13,0,0,13
4003654395,0,12,0,1,13
1065642878850916352,5,5,3,0,13
15296486,0,13,0,0,13
2923107932,1,12,0,0,13
997832030736924672,2,4,4,3,13
885510466788671488,0,13,0,0,13
740671895822045184,1,12,0,0,13
2204595255,6,1,6,0,13
2754087252,2,0,4,7,13
2276525006,0,13,0,0,13
2335608937,2,6,0,5,13
2454215166,0,13,0,0,13
2608839742,3,0,0,10,13
947309135745507328,0,13,0,0,13
132444816,0,13,0,0,13
912337980890796032,0,13,0,0,13
1122513252204699648,2,4,2,5,13
626605891,2,11,0,0,13
284116442,2,2,0,9,13
1238034619724779520,11,0,1,1,13
753756280834166784,0,12,0,1,13
2273486728,1,10,1,1,13
3234819072,0,11,2,0,13
385257551,1,11,1,0,13
629398669,3,6,0,4,13
2557077511,0,13,0,0,13
1250004196130279424,0,13,0,0,13
14377199,11,1,0,1,13
1289792234653544448,0,13,0,0,13
39852792,0,13,0,0,13
3380145143,0,13,0,0,13
215945807,1,12,0,0,13
1264677174239350784,1,12,0,0,13
801813201188843520,1,12,0,0,13
968445195363766272,0,13,0,0,13
1186983337149091840,1,12,0,0,13
1481567471215783936,2,11,0,0,13
1320831901469270016,0,13,0,0,13
1006569845419372544,1,12,0,0,13
1505811181856256000,0,13,0,0,13
345323199,2,10,0,1,13
37078637,4,3,2,4,13
101712359,0,13,0,0,13
2174908151,0,13,0,0,13
890455642896568320,9,4,0,0,13
1297848322246561792,1,0,0,12,13
2372170789,3,10,0,0,13
1363925967861817344,0,13,0,0,13
236413441,3,10,0,0,13
1414391392088956928,0,13,0,0,13
1472755431206383616,3,1,1,8,13
2690092086,0,13,0,0,13
298994191,0,13,0,0,13
1449397732012138496,0,12,1,0,13
1338116131400396800,0,13,0,0,13
1314584526362865664,0,13,0,0,13
1199329421628301312,1,0,0,12,13
315180337,0,13,0,0,13
1291267355742367744,0,13,0,0,13
145513790,0,13,0,0,13
954444603503075328,0,13,0,0,13
1132152836538609664,0,13,0,0,13
1289133994743754752,2,11,0,0,13
1043062461056868352,7,4,1,1,13
767312743128969216,0,13,0,0,13
1297777156244692992,0,13,0,0,13
1188032926874787840,0,6,0,7,13
988855537,7,2,3,1,13
2685934308,4,8,0,1,13
708048141791039488,0,13,0,0,13
1678813897,0,13,0,0,13
1475778008992534528,0,13,0,0,13
521234035,0,13,0,0,13
76515790,4,3,6,0,13
921910895852294144,0,13,0,0,13
1337479517305114624,11,0,0,2,13
1327417496794697728,0,13,0,0,13
2636962101,0,13,0,0,13
603958101,0,11,0,2,13
2575115489,0,13,0,0,13
936583899823656960,11,1,1,0,13
1258498248253243392,2,7,0,4,13
1058134876371718144,12,1,0,0,13
1176074650486366208,0,13,0,0,13
2334431051,0,13,0,0,13
781535175293403136,0,13,0,0,13
1486659234729275392,0,13,0,0,13
270308528,0,13,0,0,13
1039383397720834048,0,13,0,0,13
281448362,1,0,0,12,13
1251235536276201472,0,10,0,3,13
280843648,0,13,0,0,13
907245568350711808,4,9,0,0,13
307078538,0,13,0,0,13
1023938285595443200,0,13,0,0,13
623232056,2,11,0,0,13
1099902613712195584,0,13,0,0,13
76046620,0,13,0,0,13
945637713193050112,0,13,0,0,13
868422336546045952,0,13,0,0,13
308481441,0,13,0,0,13
1044705977587716096,0,13,0,0,13
3072996907,4,5,3,1,13
867244138286039040,0,13,0,0,13
1454304202864435200,0,13,0,0,13
2440454732,2,11,0,0,13
867299030245801984,4,8,0,1,13
4185034305,4,1,6,2,13
4805997737,0,13,0,0,13
827953546213482496,2,11,0,0,13
46344695,1,12,0,0,13
938280604516446208,1,9,3,0,13
1548964013026967552,0,2,0,11,13
3316431380,2,6,5,0,13
887553404477644800,1,12,0,0,13
990432623225782272,0,13,0,0,13
1462510990579232768,0,13,0,0,13
1358698758955966464,13,0,0,0,13
3034042323,0,13,0,0,13
2594577728,0,12,1,0,13
3246364294,2,9,0,2,13
2177309949,0,13,0,0,13
267106449,5,7,1,0,13
1349697321576099840,1,5,1,6,13
1238764718694727680,0,0,13,0,13
103243483,9,0,1,3,13
1011308689133797376,0,13,0,0,13
401463573,5,5,2,1,13
904011187,1,12,0,0,13
964261219,2,7,0,4,13
77372040,3,0,4,6,13
75875510,0,13,0,0,13
1240011990048944128,0,12,1,0,13
424341117,0,6,0,7,13
88377399,2,0,0,11,13
2219705391,0,9,1,3,13
2605537297,0,13,0,0,13
425053266,0,13,0,0,13
924951206979670016,0,12,0,0,12
241822365,0,12,0,0,12
1027955964,2,2,8,0,12
1087308270635761664,0,12,0,0,12
2294582959,2,10,0,0,12
2283891306,5,6,1,0,12
2718747911,0,12,0,0,12
2364198450,0,12,0,0,12
314722869,1,8,0,3,12
2224322184,0,12,0,0,12
904195854935916544,0,10,0,2,12
1307147316369879040,0,12,0,0,12
1339286002242826240,2,10,0,0,12
1421932763352117248,1,11,0,0,12
1253582807420424192,2,1,6,3,12
2952446035,0,12,0,0,12
165721147,2,10,0,0,12
32913859,0,12,0,0,12
3560192654,2,10,0,0,12
2718368211,2,6,0,4,12
2833765237,0,12,0,0,12
115632047,1,11,0,0,12
398551982,0,12,0,0,12
972021252,5,0,7,0,12
716890432584683520,0,12,0,0,12
378061694,3,7,2,0,12
541914020,1,8,1,2,12
2290014582,4,0,8,0,12
232964813,0,12,0,0,12
814779482,0,12,0,0,12
520928612,4,4,4,0,12
1273389125757009920,1,3,1,7,12
624557599,4,8,0,0,12
1834452541,0,12,0,0,12
1210420650550190080,3,0,1,8,12
419762691,0,12,0,0,12
54777994,3,2,3,4,12
1296567329556398080,0,12,0,0,12
171453533,0,10,2,0,12
249088074,6,1,0,5,12
456892745,1,11,0,0,12
1241749848921124864,4,1,6,1,12
1420278259946827776,0,12,0,0,12
789906731220492288,0,12,0,0,12
368142045,0,12,0,0,12
4860543475,0,12,0,0,12
1112135803,0,12,0,0,12
1474151037296689152,4,8,0,0,12
1497175367467118592,0,12,0,0,12
870327004494790656,0,12,0,0,12
41825607,0,11,1,0,12
1850877294,7,2,0,3,12
2457620318,3,3,6,0,12
132955602,0,11,0,1,12
2214025440,0,12,0,0,12
1073586787514286080,0,12,0,0,12
1477315786104401920,3,9,0,0,12
231345145,0,0,0,12,12
148414847,3,8,1,0,12
386714052,5,0,7,0,12
484423957,0,12,0,0,12
349694925,2,0,5,5,12
1267714049011302400,0,12,0,0,12
1687569872,0,12,0,0,12
1165270758752497664,0,12,0,0,12
1320024130494758912,6,3,0,3,12
1479881125854023680,0,12,0,0,12
1503102724078018560,0,5,1,6,12
2376305063,0,12,0,0,12
1870883772,11,0,0,1,12
1491839186449616896,1,9,0,2,12
762955853146226688,0,12,0,0,12
317602365,0,12,0,0,12
1407787591,5,2,1,4,12
3190724466,2,10,0,0,12
399239807,1,10,0,1,12
233640686,0,12,0,0,12
1307745683911438336,0,12,0,0,12
2408181550,0,12,0,0,12
239353393,0,0,0,12,12
1357347177144619008,1,11,0,0,12
187021634,0,12,0,0,12
2281779998,1,7,0,4,12
1309486434420547584,0,12,0,0,12
937527678931951616,0,12,0,0,12
823503499,0,12,0,0,12
1671055268,1,10,1,0,12
805119690,0,8,0,4,12
1209625034,6,2,1,3,12
1425572108202135552,0,12,0,0,12
609307205,0,5,0,7,12
995220278581121024,0,12,0,0,12
306247363,0,12,0,0,12
1498615155856400384,11,1,0,0,12
2826499106,0,12,0,0,12
1213285120876015616,1,11,0,0,12
778240004908867584,0,12,0,0,12
3954416829,0,12,0,0,12
3927303699,0,12,0,0,12
114136109,0,12,0,0,12
1102585259491774464,11,0,1,0,12
572394074,0,11,0,1,12
2893878174,6,6,0,0,12
1508729614243225600,8,0,4,0,12
818495546784645120,0,12,0,0,12
3308013021,0,12,0,0,12
1665293768,4,2,4,2,12
1404741838502699008,2,7,0,3,12
903045102,0,12,0,0,12
1288063759957684224,6,3,0,3,12
185187643,0,12,0,0,12
1213367302348951552,5,7,0,0,12
4447366174,1,7,0,4,12
343669088,0,11,0,1,12
1136718811,0,4,1,7,12
824341236,2,10,0,0,12
936232142,0,12,0,0,12
1284686897143578624,0,0,12,0,12
2932618992,0,12,0,0,12
3425959257,2,10,0,0,12
65722183,7,0,3,2,12
1486660537161330688,0,12,0,0,12
4633882273,1,11,0,0,12
1258262014683742208,10,1,1,0,12
156346969,0,12,0,0,12
778902350,2,9,1,0,12
1064116543,0,12,0,0,12
1163804959126589440,2,7,3,0,12
527620483,0,12,0,0,12
324816472,0,11,0,1,12
951343968,1,11,0,0,12
870417313618677760,0,12,0,0,12
1398000828,0,12,0,0,12
2422128218,0,12,0,0,12
459819976,0,11,0,1,12
1701134648,0,4,5,3,12
963680245,2,10,0,0,12
817227933173608448,0,12,0,0,12
1682838728,3,4,0,5,12
1084199934398816256,0,10,2,0,12
1224007918401572864,0,12,0,0,12
362300597,7,0,0,5,12
158406682,0,12,0,0,12
2751673859,9,0,3,0,12
799541496,12,0,0,0,12
206348851,0,1,4,7,12
942843427955380224,0,12,0,0,12
765279755943997440,0,11,0,1,12
1235987715432177664,11,0,0,1,12
1495991863089762304,0,12,0,0,12
47725854,6,0,1,5,12
120458275,7,0,2,3,12
358894323,0,12,0,0,12
1116852637423431680,2,0,1,9,12
839157722,0,12,0,0,12
1195367972132536320,0,12,0,0,12
70165280,2,10,0,0,12
3795543680,0,12,0,0,12
814474074302935040,8,0,3,1,12
3142115899,6,0,6,0,12
1175141954583257088,1,0,9,2,12
1267234259347165184,1,10,1,0,12
2201013471,0,12,0,0,12
1316620612744425472,0,12,0,0,12
1191231033800364032,0,12,0,0,12
869200022922985472,2,8,2,0,12
52380802,1,0,5,6,12
201398385,0,12,0,0,12
395924111,0,12,0,0,12
1202997235060899840,0,12,0,0,12
1041368468,0,12,0,0,12
1169056086126747648,0,12,0,0,12
3295900088,1,11,0,0,12
1268194336191152128,0,12,0,0,12
1236560846547009536,0,12,0,0,12
2364045054,0,9,0,3,12
452662223,0,9,0,3,12
2582038681,0,12,0,0,12
2801745922,0,12,0,0,12
876514612685848576,0,12,0,0,12
1315696786044973056,4,7,1,0,12
222719539,12,0,0,0,12
22474997,2,4,2,4,12
1159003758661001216,0,11,0,0,11
3545127615,11,0,0,0,11
372394815,0,11,0,0,11
701749446137221120,8,1,2,0,11
2883955247,0,11,0,0,11
255463185,0,9,0,2,11
2274500544,2,4,4,1,11
1443574214326325248,4,4,1,2,11
240602945,0,11,0,0,11
3272681774,2,1,0,8,11
24955296,7,0,4,0,11
279505617,0,11,0,0,11
1454849418864201728,1,10,0,0,11
269414839,5,5,0,1,11
2792286873,5,0,4,2,11
1285856385436188672,1,9,0,1,11
64026636,0,11,0,0,11
1447699218022473728,0,11,0,0,11
75502929,0,11,0,0,11
174980795,0,10,0,1,11
2174428695,0,10,0,1,11
913111231522684928,8,3,0,0,11
1394192527541026816,0,11,0,0,11
191793637,0,4,2,5,11
232993358,0,11,0,0,11
1272398854558711808,1,10,0,0,11
3394543715,0,11,0,0,11
1165454921812107264,0,11,0,0,11
4639845448,4,3,0,4,11
201005567,2,9,0,0,11
1958976074,8,0,0,3,11
1734664291,0,11,0,0,11
1382691497871605760,0,0,0,11,11
1144557974,0,11,0,0,11
2263106237,0,11,0,0,11
1269275078853718016,0,11,0,0,11
1089650700,3,2,0,6,11
2518469380,0,11,0,0,11
1964314159,2,9,0,0,11
1025436125584707584,10,0,0,1,11
3395279679,0,11,0,0,11
190412579,0,9,2,0,11
823897758,0,11,0,0,11
1454840482123689984,1,7,3,0,11
432637066,0,11,0,0,11
401689736,0,11,0,0,11
1389944341473411072,0,11,0,0,11
186709124,0,11,0,0,11
921690248,0,11,0,0,11
229722639,8,0,2,1,11
1249330231648886784,2,6,3,0,11
2889688511,8,0,0,3,11
1096804266415742976,1,5,0,5,11
1574568637,0,11,0,0,11
4702957434,1,10,0,0,11
64324273,8,2,0,1,11
1265343528961478656,7,2,1,1,11
2787089568,0,11,0,0,11
3301940051,2,3,2,4,11
1190739541298237440,1,10,0,0,11
864973480307118080,0,11,0,0,11
2553366901,0,11,0,0,11
262173081,0,11,0,0,11
278051814,11,0,0,0,11
1112274275413774336,7,0,2,2,11
1423323050,1,10,0,0,11
1096917190018850816,0,11,0,0,11
1101569824701014016,0,11,0,0,11
1031224937196003328,0,11,0,0,11
1435904761493168128,0,11,0,0,11
226105774,1,0,0,10,11
827892050951417856,0,10,0,1,11
3301546743,3,7,1,0,11
995031827298611200,9,1,0,1,11
1049706187854360576,5,2,1,3,11
182139160,0,9,1,1,11
1246423650758209536,0,11,0,0,11
750607897109889024,8,0,2,1,11
987984393716273152,0,11,0,0,11
891498360,0,11,0,0,11
2308643070,4,7,0,0,11
1365116677,2,1,2,6,11
3290980671,0,11,0,0,11
2900243270,5,2,0,4,11
2566715489,0,1,0,10,11
1286433985355276288,0,11,0,0,11
990988655442395136,0,11,0,0,11
566829309,3,0,4,4,11
1108779920971333632,0,11,0,0,11
271267478,0,11,0,0,11
750884153177112576,0,11,0,0,11
401491066,0,11,0,0,11
409090886,3,4,2,2,11
213727739,0,11,0,0,11
403420503,0,11,0,0,11
928321324111495168,1,10,0,0,11
913644295,0,11,0,0,11
1192407720286019584,5,5,1,0,11
2298147547,0,11,0,0,11
1052748992482869248,0,11,0,0,11
986400975089958912,0,11,0,0,11
890456413,0,11,0,0,11
782384633279381504,1,0,8,2,11
824562579200581632,3,1,5,2,11
857990961879801856,0,11,0,0,11
3096921527,0,11,0,0,11
2243579609,6,1,3,1,11
855478711,0,11,0,0,11
2731344113,0,11,0,0,11
84224921,0,11,0,0,11
1977616915,1,10,0,0,11
1300132465701392384,0,11,0,0,11
1231822583630323712,0,11,0,0,11
802157428896894976,10,1,0,0,11
1492917925535453184,0,11,0,0,11
703952134622982144,8,0,2,1,11
1205969377641848832,3,8,0,0,11
1028283176,0,11,0,0,11
1193308034,0,11,0,0,11
853366645322076160,0,11,0,0,11
1205898967256420352,9,0,2,0,11
345808917,0,11,0,0,11
1364844326497513472,6,5,0,0,11
2733940365,0,11,0,0,11
1329249740358238208,0,0,2,9,11
1488383807744925696,0,11,0,0,11
22343978,1,1,9,0,11
1311902599520514048,9,0,2,0,11
1313421534460084224,8,0,0,3,11
1019173254,0,11,0,0,11
1213465602905391104,0,11,0,0,11
317204627,7,4,0,0,11
791240691816988672,8,0,0,3,11
1655573935,0,11,0,0,11
1237472273013055488,0,11,0,0,11
3754075578,0,11,0,0,11
2978649432,0,11,0,0,11
2624898472,4,7,0,0,11
1133418026139676672,1,8,0,2,11
159133559,0,11,0,0,11
135027441,0,11,0,0,11
3055168695,0,11,0,0,11
1484185323672600576,2,9,0,0,11
77989590,0,4,7,0,11
346237327,0,11,0,0,11
2753522979,0,0,0,11,11
97970653,3,8,0,0,11
1302099397799366656,0,11,0,0,11
3772367837,3,0,1,7,11
1303074600067174400,11,0,0,0,11
1328693020615651328,0,11,0,0,11
143381214,0,10,0,1,11
1041923736625209344,0,11,0,0,11
2221442917,0,11,0,0,11
1492202026859921408,0,11,0,0,11
1334432920354705408,9,0,0,2,11
1300433175483543552,0,11,0,0,11
1449825235,0,11,0,0,11
1267306098,0,11,0,0,11
893987761627295744,0,11,0,0,11
1364474143526240256,0,1,0,10,11
165842572,0,11,0,0,11
1368402907817680896,11,0,0,0,11
1011054427,0,11,0,0,11
718720864934567936,0,11,0,0,11
1136318786628284416,0,11,0,0,11
495187946,5,0,5,1,11
358030276,9,2,0,0,11
3107578662,0,11,0,0,11
918172816566079488,0,10,0,1,11
301326879,2,0,1,8,11
1356017784413712384,1,0,0,10,11
1489772770619576320,1,10,0,0,11
314157334,0,2,0,9,11
3681315799,0,10,0,1,11
801124253974351872,0,11,0,0,11
4149041896,0,11,0,0,11
1517745577,1,4,0,6,11
1324732534467391488,6,1,0,4,11
1268724236,2,0,9,0,11
971632964315488256,0,11,0,0,11
136959569,0,11,0,0,11
453786251,0,11,0,0,11
710157995263565824,10,0,0,1,11
1200763498441138176,0,11,0,0,11
1128720410189680640,0,11,0,0,11
703417965803220992,0,11,0,0,11
89627832,4,7,0,0,11
1522929610522038272,1,2,0,8,11
873231439,1,2,1,7,11
989098693,2,9,0,0,11
524371072,0,11,0,0,11
1334189157460094976,0,11,0,0,11
1016207204985266176,0,11,0,0,11
1530101424356347904,5,0,0,6,11
3016741856,1,10,0,0,11
106479222,0,11,0,0,11
623925978,0,11,0,0,11
361763987,0,11,0,0,11
1073381570533343232,0,11,0,0,11
976428700349751296,0,11,0,0,11
629882601,0,11,0,0,11
3043389878,0,11,0,0,11
994379262,0,10,0,0,10
634755275,0,10,0,0,10
2442116255,0,10,0,0,10
1219240754494574592,9,0,0,1,10
613371976,0,10,0,0,10
1076440592308150272,0,10,0,0,10
743737204577447936,0,8,0,2,10
66915181,1,8,1,0,10
1318428254705864704,1,9,0,0,10
55162753,0,10,0,0,10
1389929675120594944,2,8,0,0,10
1346151557830742016,1,0,0,9,10
888580648990117888,0,10,0,0,10
24604191,0,0,0,10,10
293894853,0,10,0,0,10
2238004037,0,10,0,0,10
410000354,6,4,0,0,10
131775499,8,0,1,1,10
2943087397,0,10,0,0,10
2407204614,0,3,6,1,10
1288320368726274048,10,0,0,0,10
1272050390712807424,1,7,2,0,10
990944812059721728,0,10,0,0,10
1483015778601701376,2,2,5,1,10
1161430069,1,9,0,0,10
976399449361588224,0,9,1,0,10
1031214370561425408,0,3,2,5,10
570746151,1,9,0,0,10
2328163816,0,10,0,0,10
1215250795672809472,6,4,0,0,10
272885781,5,0,3,2,10
1121669701,0,10,0,0,10
347250495,0,9,0,1,10
1489682517582036992,7,3,0,0,10
1196441402,0,10,0,0,10
1021386025,6,3,0,1,10
291583941,0,10,0,0,10
977617436307525632,0,10,0,0,10
213782054,1,8,0,1,10
775812037079334912,0,5,2,3,10
1319305622244913152,8,1,0,1,10
821988474664472576,0,10,0,0,10
4856241507,0,10,0,0,10
1169992693579177984,0,10,0,0,10
1255570084648628224,0,10,0,0,10
836932779996819456,1,9,0,0,10
1067324592837005312,0,10,0,0,10
879201070047789056,0,10,0,0,10
843075938095190016,0,10,0,0,10
1143385554161004544,1,4,3,2,10
856051799626788864,6,3,0,1,10
1244685999885541376,0,10,0,0,10
1216584763898765312,0,10,0,0,10
83861035,0,10,0,0,10
809048575564881920,1,7,2,0,10
2231698057,0,10,0,0,10
906226676283133952,0,10,0,0,10
2813627012,0,10,0,0,10
200561892,2,8,0,0,10
1222911104,0,10,0,0,10
2229704648,0,10,0,0,10
1014834446,0,10,0,0,10
1305865621880569856,2,1,6,1,10
1398755821564182528,7,0,0,3,10
2732434978,0,10,0,0,10
1461777355131793408,0,10,0,0,10
96147619,5,5,0,0,10
3003503333,0,10,0,0,10
862293912492310528,1,9,0,0,10
1305586497827926016,0,8,0,2,10
840282722354503680,0,0,0,10,10
297527126,0,10,0,0,10
1201533318702845952,0,3,3,4,10
2221576258,0,0,0,10,10
2731112105,0,10,0,0,10
783735764118966272,0,10,0,0,10
1487715137834291200,5,3,2,0,10
4651282168,0,10,0,0,10
1597740841,0,10,0,0,10
314925981,0,10,0,0,10
456986148,0,10,0,0,10
891169327579361280,1,9,0,0,10
32044030,2,7,0,1,10
3009982584,6,0,4,0,10
1459007626855997440,0,10,0,0,10
1356400486405070848,1,0,1,8,10
301428998,0,10,0,0,10
90498284,0,10,0,0,10
197798161,0,9,0,1,10
709299866430668800,10,0,0,0,10
149655065,9,1,0,0,10
944118489828200448,5,5,0,0,10
709365030232432640,0,10,0,0,10
31139150,1,0,8,1,10
1248867704246657024,0,10,0,0,10
1457543680101863424,0,10,0,0,10
1664972126,2,1,1,6,10
1489065161168388096,2,2,0,6,10
795211327727730688,3,0,0,7,10
2738012448,0,3,1,6,10
1033248219495579648,0,10,0,0,10
143364316,0,9,1,0,10
4304571749,0,10,0,0,10
34852703,1,2,0,7,10
987236502085296128,10,0,0,0,10
1364001910261481472,0,10,0,0,10
36222859,0,10,0,0,10
1274624930219466752,0,10,0,0,10
4418949432,5,2,0,3,10
1033350519706791936,0,10,0,0,10
2831487228,8,2,0,0,10
797926079629557760,0,10,0,0,10
449971974,1,9,0,0,10
100798317,6,0,1,3,10
1089900963681382400,3,7,0,0,10
312843710,0,10,0,0,10
635573357,1,9,0,0,10
952138100007870464,2,7,0,1,10
449579934,0,10,0,0,10
1003177010112421888,0,10,0,0,10
190198691,4,6,0,0,10
2833016007,5,5,0,0,10
3221233284,1,9,0,0,10
1202726289381187584,0,10,0,0,10
17363599,0,10,0,0,10
733396976817995776,0,0,4,6,10
1721054496,6,4,0,0,10
945102892956086272,0,4,1,5,10
1251243315976122368,0,7,0,3,10
3392511597,4,2,1,3,10
2349222982,0,10,0,0,10
154903397,0,10,0,0,10
712182176301842432,0,10,0,0,10
309118220,0,10,0,0,10
376075084,2,8,0,0,10
141953293,2,8,0,0,10
311314150,2,0,7,1,10
35532210,2,0,0,8,10
1402213269725712384,6,2,2,0,10
1231484029,0,8,2,0,10
1126241349227954176,1,9,0,0,10
310729105,0,10,0,0,10
1275619154565885952,5,5,0,0,10
1230888802161328128,6,2,2,0,10
929878193271689216,10,0,0,0,10
774261484641746944,4,6,0,0,10
1602590018,0,0,0,10,10
3009583445,0,9,0,1,10
180810321,9,1,0,0,10
804306444531236864,0,5,0,5,10
3350724094,0,10,0,0,10
171824239,0,10,0,0,10
771051393209597952,3,4,3,0,10
1497373634,0,10,0,0,10
771214517183270912,0,10,0,0,10
396099751,5,3,2,0,10
725914220894679040,1,0,1,8,10
1139548696025059328,2,8,0,0,10
3499225696,1,9,0,0,10
1293082946937556992,0,10,0,0,10
3315732978,0,10,0,0,10
1422242847474950144,0,10,0,0,10
225749093,4,4,2,0,10
1132919516051021824,0,10,0,0,10
1374788020084174848,0,10,0,0,10
2283827468,0,10,0,0,10
1210422659462389760,0,10,0,0,10
1324431101843132416,3,6,1,0,10
115895674,0,9,0,1,10
1697805672,0,10,0,0,10
325694164,0,10,0,0,10
983145092,0,10,0,0,10
629382298,0,10,0,0,10
1259138407000932352,4,4,2,0,10
1450955802,1,8,0,1,10
760516135,0,10,0,0,10
4761058634,0,5,3,2,10
1500334111377879040,7,3,0,0,10
75253821,1,9,0,0,10
543414756,1,7,2,0,10
1450750033,0,10,0,0,10
224113863,0,10,0,0,10
878362130814308352,6,1,1,2,10
3126299247,0,0,0,10,10
73257286,0,10,0,0,10
1159398616366223360,0,10,0,0,10
3085785656,1,7,0,2,10
1327276017988276224,2,8,0,0,10
394515350,1,8,0,1,10
704450324833169408,0,10,0,0,10
1061631724520685568,7,0,1,2,10
1434548902095728640,4,1,5,0,10
1296362290569269248,4,4,1,1,10
333771664,2,0,0,8,10
1137430360743141376,0,10,0,0,10
113829347,0,10,0,0,10
122141973,0,10,0,0,10
823841182643933184,3,0,5,2,10
1157628774537715712,0,10,0,0,10
845851179586342912,0,10,0,0,10
1265905893167824896,4,2,4,0,10
1039624646130364416,0,10,0,0,10
440662321,0,10,0,0,10
2511854943,1,9,0,0,10
1945543310,0,0,0,10,10
1135081782230028288,2,8,0,0,10
1260535514437836800,1,9,0,0,10
948614762983763968,0,10,0,0,10
236416175,0,10,0,0,10
1472481988921618432,1,7,2,0,10
995559244505075712,1,9,0,0,10
3506553857,0,9,0,1,10
1917500130,0,10,0,0,10
1432235454414393344,0,10,0,0,10
1327183924670316544,0,10,0,0,10
2893340806,2,1,4,3,10
625332005,1,9,0,0,10
3623602216,2,5,1,2,10
278458196,1,8,1,0,10
1175107482710138880,0,10,0,0,10
1893408366,0,10,0,0,10
1015589453140844544,0,10,0,0,10
2573565041,0,10,0,0,10
281433928,0,8,0,2,10
1573213267,0,10,0,0,10
1365554266090270720,0,10,0,0,10
1114211460341592064,3,0,3,4,10
337669983,0,10,0,0,10
1394632928,0,10,0,0,10
963967544150257664,2,8,0,0,10
1365233887669010432,7,0,1,2,10
391933746,0,10,0,0,10
129751283,0,10,0,0,10
1100408021925023744,2,4,0,4,10
220925739,0,10,0,0,10
1065190636913979392,0,9,0,1,10
430547699,0,10,0,0,10
1469337818807750656,0,10,0,0,10
1377906408482430976,0,10,0,0,10
128490728,1,9,0,0,10
738373753,0,10,0,0,10
1438791869127823360,0,10,0,0,10
2574485324,0,10,0,0,10
1044234090,1,9,0,0,10
1239821728630571008,0,10,0,0,10
935550606466473984,5,3,1,1,10
899649703939260416,0,5,5,0,10
3244836552,2,1,3,4,10
4581192694,0,10,0,0,10
615870017,0,9,0,1,10
1206087459806699520,0,10,0,0,10
3540252020,2,7,0,1,10
1379996377,0,10,0,0,10
1195304540830076928,2,8,0,0,10
162237349,1,2,6,1,10
1193461089683595264,0,10,0,0,10
1300721245739245568,1,9,0,0,10
173510084,0,10,0,0,10
1254874442,1,8,1,0,10
1176394757020561408,3,7,0,0,10
740215111,3,2,4,1,10
774143949933916160,1,9,0,0,10
962307936767930368,4,5,1,0,10
1083046504611233792,7,0,2,1,10
1131989223068786688,4,6,0,0,10
1351506612645724160,0,9,0,0,9
912419588,0,9,0,0,9
1490325296352235520,0,9,0,0,9
2291082134,0,9,0,0,9
722152152760762368,0,9,0,0,9
262615794,0,9,0,0,9
2432223560,4,5,0,0,9
121501210,1,8,0,0,9
1201896930625896448,0,7,0,2,9
1265263570465558528,0,9,0,0,9
3329328741,0,9,0,0,9
1015780318593216512,0,8,0,1,9
487543967,0,0,0,9,9
995092033537740800,2,0,3,4,9
1104013914361221120,0,9,0,0,9
18128714,0,9,0,0,9
1493255100521152512,4,4,1,0,9
910088768404803584,0,0,0,9,9
1335160601308499968,8,1,0,0,9
1265303092561657856,0,0,0,9,9
416562503,0,9,0,0,9
1265220810773540864,3,6,0,0,9
805315690022387712,0,9,0,0,9
1281846732100382720,0,5,0,4,9
3333390461,1,8,0,0,9
1103595022652305408,0,9,0,0,9
1036329502727708672,0,9,0,0,9
1334583593218306048,0,9,0,0,9
796017529332305920,0,8,1,0,9
760249850562740224,2,4,2,1,9
3019699915,0,9,0,0,9
966365196028665856,1,8,0,0,9
796427955346014208,1,3,4,1,9
1308673881452867584,0,9,0,0,9
604624914,0,8,0,1,9
1334223919964971008,3,3,0,3,9
1272918295,0,9,0,0,9
259197281,0,9,0,0,9
3323121036,0,9,0,0,9
2430048728,0,9,0,0,9
1175189498730123264,0,3,0,6,9
1227171998356443136,0,9,0,0,9
1009658561834565632,8,1,0,0,9
1060046316934516736,2,6,1,0,9
1491645886904303616,0,9,0,0,9
763603555,0,8,0,1,9
521400875,0,9,0,0,9
804700304914714624,0,9,0,0,9
1427406754967605248,0,9,0,0,9
4348296314,0,9,0,0,9
867910567150989312,0,9,0,0,9
1006268960,2,6,0,1,9
882297386424553472,0,9,0,0,9
1149795571034677248,1,6,0,2,9
819119703645913088,0,9,0,0,9
867705353579802624,1,8,0,0,9
3104063786,3,1,5,0,9
4693503157,0,9,0,0,9
93207347,5,0,3,1,9
230184932,8,1,0,0,9
1455293734111772672,0,9,0,0,9
95763863,5,1,3,0,9
2549830465,0,9,0,0,9
489742345,0,9,0,0,9
1685878934,0,9,0,0,9
95535815,0,9,0,0,9
758660768,0,9,0,0,9
1308279870473015296,0,9,0,0,9
1071805163726344192,0,9,0,0,9
1087118354266054656,2,0,0,7,9
2317083769,1,8,0,0,9
1099277958,0,9,0,0,9
1907705029,0,9,0,0,9
303869819,0,9,0,0,9
1131362986910769152,0,9,0,0,9
1251211002701438976,2,5,1,1,9
346495555,0,2,3,4,9
849645682340265984,0,9,0,0,9
1320700281726840832,1,2,2,4,9
1272537774420365312,0,9,0,0,9
822974256996679680,1,4,3,1,9
1488164605,0,9,0,0,9
1093613491586510848,0,9,0,0,9
405007521,6,0,1,2,9
3981213676,1,0,0,8,9
821583356,0,9,0,0,9
3980223020,4,5,0,0,9
4214805185,1,7,0,1,9
854968806,0,9,0,0,9
469428603,0,9,0,0,9
404908322,0,9,0,0,9
936951131317702656,0,9,0,0,9
2306307694,0,9,0,0,9
135809180,0,9,0,0,9
1497100206520692736,0,9,0,0,9
222896037,2,7,0,0,9
568507116,0,9,0,0,9
1409107420442288128,1,8,0,0,9
16480319,5,0,2,2,9
1419588531584966656,0,8,1,0,9
574518292,4,2,3,0,9
3301733532,0,0,1,8,9
2899812564,0,9,0,0,9
766557970708639744,8,0,1,0,9
1500619780847460352,0,0,0,9,9
920774256,0,9,0,0,9
1269888583038652416,9,0,0,0,9
1323009410793431040,5,1,3,0,9
911987601091039232,4,5,0,0,9
904517431,0,9,0,0,9
1215093254636441600,0,9,0,0,9
1170350622358614016,3,5,0,1,9
997458606005071872,4,0,5,0,9
2845312427,0,9,0,0,9
1341913874925142016,1,8,0,0,9
3066157985,2,4,3,0,9
1404530228,1,0,4,4,9
850041247133835264,5,2,2,0,9
1119042595,3,5,1,0,9
4019565496,1,8,0,0,9
1438986587606601728,3,3,3,0,9
866624168158269440,0,9,0,0,9
1323957701341306880,5,1,3,0,9
3367957425,0,9,0,0,9
3063756442,0,9,0,0,9
2535280969,0,8,1,0,9
1066872128060964864,2,0,1,6,9
3304969389,3,1,0,5,9
3369254519,0,9,0,0,9
1374077400,0,9,0,0,9
222323499,2,0,2,5,9
1408642524902838272,2,5,0,2,9
127262164,0,9,0,0,9
3032554639,9,0,0,0,9
3383939151,0,9,0,0,9
2907261095,0,9,0,0,9
311553500,1,7,0,1,9
1039473442050007040,4,3,1,1,9
1102324721629253632,0,9,0,0,9
2908303014,2,7,0,0,9
1070274336,0,8,0,1,9
1221471125969850368,0,9,0,0,9
1102445327720697856,0,9,0,0,9
512382661,1,0,8,0,9
99141869,0,9,0,0,9
1126415691937087488,0,9,0,0,9
141571248,4,4,0,1,9
486971738,0,0,2,7,9
760841664076386304,5,0,2,2,9
1260830264437211136,1,3,0,5,9
810104784661467136,2,7,0,0,9
1494238222800470016,1,8,0,0,9
752786816,1,8,0,0,9
599485993,1,7,0,1,9
343956175,2,4,3,0,9
3915658875,3,0,6,0,9
2880852710,0,9,0,0,9
2522582112,0,9,0,0,9
2202558326,1,8,0,0,9
901621302,5,1,2,1,9
479762287,1,3,4,1,9
1337685502808428544,9,0,0,0,9
3377454442,0,9,0,0,9
725826932835782656,0,9,0,0,9
1064003511233335296,6,0,0,3,9
1408240301085544448,0,9,0,0,9
1259392847867834368,0,9,0,0,9
16639219,0,9,0,0,9
2717251910,0,9,0,0,9
14553524,5,1,1,2,9
42045444,0,9,0,0,9
1496770039344738304,0,9,0,0,9
2366191117,9,0,0,0,9
3159728553,3,1,2,3,9
1436029505953488896,0,9,0,0,9
478753351,0,9,0,0,9
921647399071768576,0,9,0,0,9
1259741952553242624,0,9,0,0,9
937919955860942848,0,9,0,0,9
1317305524912758784,0,9,0,0,9
1213526643773296640,1,8,0,0,9
1347526919135354880,6,2,1,0,9
1448599799394185216,0,9,0,0,9
1040719016858406912,0,9,0,0,9
1183244052596219904,1,4,4,0,9
720520380,0,9,0,0,9
2860125457,1,8,0,0,9
1220970306988195840,2,7,0,0,9
1239486956,3,1,5,0,9
1221468571047346176,3,1,2,3,9
767338632,0,9,0,0,9
159895531,0,9,0,0,9
2785137772,1,8,0,0,9
1054317568083689472,0,9,0,0,9
1208251916,4,3,2,0,9
1357974250502586368,0,9,0,0,9
1034051421459468288,0,9,0,0,9
746433955965067264,3,4,0,2,9
1481794139251433472,0,7,0,2,9
610626706,0,9,0,0,9
1462481069140230144,3,6,0,0,9
1165339370,1,8,0,0,9
1034112230336413696,0,9,0,0,9
1733109812,2,7,0,0,9
878623376788598784,0,9,0,0,9
616988310,1,8,0,0,9
753124794703503360,1,0,8,0,9
1482065288858329088,0,9,0,0,9
1358304707366719488,2,4,3,0,9
3445042576,0,9,0,0,9
1329942547,1,8,0,0,9
1236924064108892160,0,9,0,0,9
832357855,0,5,0,4,9
177800579,0,9,0,0,9
609159244,0,9,0,0,9
298971048,0,9,0,0,9
2249643799,0,9,0,0,9
1488445425812078592,0,9,0,0,9
787241009348345856,0,0,9,0,9
1296778156817317888,0,9,0,0,9
2766150091,9,0,0,0,9
440651784,0,9,0,0,9
1297610193631617024,0,9,0,0,9
79525202,0,9,0,0,9
1480775408781967360,0,9,0,0,9
4484187199,0,4,1,4,9
276844070,0,9,0,0,9
782641310,1,6,0,2,9
627426399,5,4,0,0,9
2781633192,0,9,0,0,9
2331136110,2,7,0,0,9
1462045945483468800,7,2,0,0,9
1045196973991743488,0,9,0,0,9
87820601,5,1,2,1,9
616210670,0,9,0,0,9
273029889,0,8,0,1,9
1302530039368441856,0,9,0,0,9
792700794789359616,0,9,0,0,9
1466669824931598336,8,1,0,0,9
1361900083969748992,0,9,0,0,9
2993009886,2,7,0,0,9
829889929,0,9,0,0,9
294424366,2,0,7,0,9
743293743843803136,5,4,0,0,9
362663219,0,9,0,0,9
188358524,0,0,0,9,9
1284891660573265920,1,1,0,7,9
879489409724370944,0,9,0,0,9
67498656,1,3,4,1,9
1197227545596350464,4,3,2,0,9
28447324,0,0,0,9,9
1108571999465398272,0,9,0,0,9
1465136212021329920,0,2,0,7,9
1047631272,0,9,0,0,9
2751631222,0,9,0,0,9
295028415,0,9,0,0,9
86727989,2,0,2,5,9
1198161669517664256,0,9,0,0,9
86734388,0,9,0,0,9
1190724679356444672,5,4,0,0,9
1243790173663526912,3,5,0,1,9
855390500177752064,0,8,1,0,9
1285073743346200576,1,0,0,8,9
1243817630735056896,0,9,0,0,9
3427635243,2,6,1,0,9
1486748575723765760,1,5,3,0,9
1234528657298903040,0,9,0,0,9
69509347,2,7,0,0,9
2445586759,0,9,0,0,9
2990383549,2,3,2,2,9
987197966275538944,0,8,1,0,9
160812512,0,9,0,0,9
1387876421238935552,8,0,1,0,9
1154238421,1,8,0,0,9
160421104,0,9,0,0,9
902677453637914624,0,9,0,0,9
3006720900,1,5,0,3,9
287277083,0,9,0,0,9
1442805842,2,2,5,0,9
1074247581897768960,0,9,0,0,9
359014842,1,0,0,8,9
927556990842351616,4,5,0,0,9
171562326,0,9,0,0,9
948312991342133248,1,2,0,6,9
1239240073738158080,3,6,0,0,9
368397238,0,5,0,4,9
1199659716286255104,0,9,0,0,9
2595801283,0,9,0,0,9
300220304,1,5,3,0,9
2801972787,0,9,0,0,9
862700631026544640,0,9,0,0,9
263639237,1,8,0,0,9
196335985,0,9,0,0,9
4498811839,0,9,0,0,9
1675662186,9,0,0,0,9
540912559,3,0,0,6,9
890189460922486784,0,9,0,0,9
2318590526,0,9,0,0,9
1247465323156078592,0,9,0,0,9
788473808692928512,1,7,1,0,9
1377898014136619008,0,9,0,0,9
175604092,0,9,0,0,9
1606512530,1,8,0,0,9
369273333,0,3,0,6,9
196829634,0,9,0,0,9
1193419197314785280,0,9,0,0,9
74744979,0,4,1,4,9
1244621594217132032,1,8,0,0,9
1004523887143669760,0,0,0,9,9
789629224483221504,0,9,0,0,9
433468258,0,8,0,0,8
583264304,1,3,0,4,8
1294678066174636032,0,8,0,0,8
1205504677443461120,4,3,0,1,8
1477585570994036736,0,8,0,0,8
3143876783,0,8,0,0,8
938856092,0,8,0,0,8
626195264,0,7,0,1,8
1322247500410085376,5,0,0,3,8
2869581820,2,0,4,2,8
237159447,0,8,0,0,8
52600134,1,7,0,0,8
2701771811,1,7,0,0,8
1483101596766838784,0,4,0,4,8
175679933,0,8,0,0,8
1292289247,0,8,0,0,8
615037505,0,8,0,0,8
1483384223742500864,1,5,0,2,8
246484784,0,6,2,0,8
1442475670399975424,0,0,8,0,8
4853638372,0,8,0,0,8
1629774822,0,8,0,0,8
1343830330181095424,0,5,0,3,8
3436005783,0,8,0,0,8
2705170764,0,8,0,0,8
1143053135931424768,0,8,0,0,8
53192353,0,8,0,0,8
46542925,0,1,2,5,8
2333414155,3,0,5,0,8
1498188952120934400,0,8,0,0,8
169559027,6,0,0,2,8
2577008346,1,0,0,7,8
1265654105567121408,1,7,0,0,8
984690887497338880,1,6,0,1,8
1034390050786738176,0,8,0,0,8
162650716,0,8,0,0,8
399777531,1,6,1,0,8
1482592272881524736,0,8,0,0,8
866586289877004288,0,6,1,1,8
1134424160023785472,7,1,0,0,8
1647989604,0,6,1,1,8
2447054798,0,8,0,0,8
1364110809018736640,0,8,0,0,8
1363929237598597120,0,8,0,0,8
4844172383,5,2,1,0,8
727779534188220416,1,7,0,0,8
474551847,1,4,3,0,8
1161453186416201728,0,8,0,0,8
2246945390,0,8,0,0,8
1896098720,3,0,0,5,8
1208704231517147136,0,8,0,0,8
801076238836056064,1,7,0,0,8
1170636962656448512,4,2,0,2,8
52016801,0,8,0,0,8
4811924371,2,0,0,6,8
116140201,0,6,1,1,8
1065694616807182336,0,8,0,0,8
1322819661356920832,8,0,0,0,8
1322553926869110784,1,7,0,0,8
807897719658479616,0,8,0,0,8
1109410048227373056,1,7,0,0,8
722879561415962624,0,8,0,0,8
28037130,0,8,0,0,8
2469878145,0,8,0,0,8
350207877,0,8,0,0,8
387838634,0,8,0,0,8
28375866,0,8,0,0,8
1078660374,0,8,0,0,8
436130571,2,3,2,1,8
1296567292218740736,0,8,0,0,8
350319959,0,8,0,0,8
1218820245533519872,7,1,0,0,8
1393037869,4,3,1,0,8
135905787,0,8,0,0,8
293402344,0,8,0,0,8
469110697,0,8,0,0,8
3243776577,0,2,6,0,8
46113957,0,8,0,0,8
1497031299261169664,6,2,0,0,8
3158309251,2,0,6,0,8
997861995062980608,0,8,0,0,8
67176627,2,6,0,0,8
1218898485736427520,2,6,0,0,8
233320217,1,6,1,0,8
973382561756950528,4,0,0,4,8
11054742,0,8,0,0,8
884595963804778496,4,4,0,0,8
916379891200942080,3,4,1,0,8
2565300801,0,8,0,0,8
1670158410,1,7,0,0,8
189510651,4,3,0,1,8
398971412,0,8,0,0,8
1175438978,0,8,0,0,8
1330440597149106176,0,8,0,0,8
2195898541,0,8,0,0,8
3119736591,0,8,0,0,8
116732074,0,8,0,0,8
68450351,0,8,0,0,8
105155257,2,6,0,0,8
3262966940,2,6,0,0,8
1373804534,0,8,0,0,8
1204554214812372992,7,0,0,1,8
3320649642,0,7,0,1,8
933238823936442368,0,8,0,0,8
2409216255,0,8,0,0,8
531089853,1,4,0,3,8
486280347,0,7,1,0,8
1199965700451794944,2,6,0,0,8
2712365461,0,1,0,7,8
1239887274134900736,6,0,0,2,8
542594787,1,7,0,0,8
271858720,2,2,0,4,8
2236395397,0,8,0,0,8
2236175442,5,3,0,0,8
1091375783673823232,0,8,0,0,8
339108951,5,2,1,0,8
2305006730,0,8,0,0,8
969243949696192512,4,0,1,3,8
2780140669,0,8,0,0,8
1198364389,1,5,2,0,8
2212503120,0,8,0,0,8
2665214480,3,5,0,0,8
40433343,0,5,0,3,8
1156115451807748096,1,4,0,3,8
1434596010702032896,0,0,0,8,8
772368400035278848,1,0,3,4,8
394040684,1,3,1,3,8
4535619314,0,1,0,7,8
1283784692,0,8,0,0,8
1368874029508141056,8,0,0,0,8
1261083472812113920,3,2,2,1,8
286106548,0,7,0,1,8
4062646451,0,8,0,0,8
4478949077,0,8,0,0,8
1504163463815380992,0,0,0,8,8
1262445117610352640,0,8,0,0,8
1213712931646361600,0,4,0,4,8
72508338,0,8,0,0,8
956188938821042176,8,0,0,0,8
2398401380,0,8,0,0,8
899971747436298240,0,8,0,0,8
2204658868,0,8,0,0,8
1436219317662670848,0,8,0,0,8
771938953658306560,3,5,0,0,8
975747794215501824,0,8,0,0,8
1063912692833026048,0,8,0,0,8
1335912356711436288,3,0,4,1,8
1436550962982932480,0,8,0,0,8
2572679345,0,8,0,0,8
628411751,0,8,0,0,8
2506735674,1,0,1,6,8
1242693473834237952,0,8,0,0,8
3313826326,7,0,1,0,8
543974291,0,8,0,0,8
2333182068,0,8,0,0,8
924362880799199232,0,7,0,1,8
869989102325833728,0,8,0,0,8
1336559626527985664,0,8,0,0,8
768115642574569472,0,8,0,0,8
1327314330648539136,0,8,0,0,8
48344342,6,1,1,0,8
974981406668410880,0,8,0,0,8
992952994202308608,0,8,0,0,8
3341808855,1,1,1,5,8
394800541,0,8,0,0,8
1079373629563891712,0,8,0,0,8
1673438708,0,8,0,0,8
2882251877,0,8,0,0,8
3123760535,0,8,0,0,8
480184041,0,8,0,0,8
283209389,0,8,0,0,8
537407663,0,8,0,0,8
239383423,1,7,0,0,8
955928183278329856,0,8,0,0,8
3341556935,0,8,0,0,8
285388966,0,8,0,0,8
14109618,6,0,1,1,8
1326254363313119232,0,8,0,0,8
1336414508168962048,0,8,0,0,8
586722283,3,5,0,0,8
1374166629722984448,0,8,0,0,8
1369489224232284160,0,8,0,0,8
900441226348027904,0,8,0,0,8
1480452818523725824,1,5,0,2,8
230992968,0,8,0,0,8
880307486,0,8,0,0,8
1529815183,0,8,0,0,8
1972365230,3,1,0,4,8
3452957836,0,8,0,0,8
1427253643783278592,0,8,0,0,8
237771070,1,7,0,0,8
1300000951340683264,1,7,0,0,8
1300049635847929856,1,7,0,0,8
1088858492,0,8,0,0,8
1470084448548900864,0,8,0,0,8
405197195,0,8,0,0,8
1438465980930277376,0,3,0,5,8
1324019535415050240,0,2,2,4,8
243279187,0,8,0,0,8
2850344184,0,4,2,2,8
1330084680360718336,0,8,0,0,8
434453451,5,3,0,0,8
1333983823109865472,0,8,0,0,8
405667557,0,8,0,0,8
1082960520825716736,4,2,2,0,8
4838618332,0,4,0,4,8
4165787172,1,7,0,0,8
282328282,0,8,0,0,8
1097049391523917824,0,8,0,0,8
108223024,0,0,1,7,8
572864375,0,8,0,0,8
1023511095745630208,0,8,0,0,8
1235419376112762880,4,4,0,0,8
864372570,0,8,0,0,8
2282106114,1,7,0,0,8
274138369,0,1,0,7,8
3135578474,0,8,0,0,8
48295777,2,6,0,0,8
365424087,0,7,1,0,8
888352014958198784,0,8,0,0,8
2151138495,1,7,0,0,8
47096258,3,0,0,5,8
287463848,0,8,0,0,8
443565257,4,0,0,4,8
1014815646431903744,0,8,0,0,8
964577143,0,8,0,0,8
962364349900759040,1,7,0,0,8
818815776,1,7,0,0,8
1261175677857873920,1,7,0,0,8
801754844671410176,0,8,0,0,8
14806609,1,6,1,0,8
1172518608162844672,1,7,0,0,8
1499416296676540416,3,3,2,0,8
274539581,0,8,0,0,8
1214181314078732288,4,4,0,0,8
836624444,7,0,1,0,8
818906672,0,8,0,0,8
1437760988103643136,3,5,0,0,8
1117331741381779456,0,8,0,0,8
969856326,0,8,0,0,8
1470691671746785280,1,0,0,7,8
626364066,0,8,0,0,8
1158304846543491072,8,0,0,0,8
1042310622,0,8,0,0,8
3255520339,0,8,0,0,8
1210715854113034240,0,8,0,0,8
1478963504040140800,0,8,0,0,8
1359123385,6,2,0,0,8
1454759565862453248,4,2,0,2,8
302799461,0,8,0,0,8
1357205287451697152,4,4,0,0,8
1251910839185158144,0,8,0,0,8
901590696917913600,5,0,2,1,8
2999332065,0,4,1,3,8
2827034089,0,8,0,0,8
3297610027,0,8,0,0,8
794227735652691968,1,7,0,0,8
2932317550,0,0,3,5,8
3190766338,0,8,0,0,8
4700876422,0,7,1,0,8
452924674,1,7,0,0,8
1202311401236131840,0,8,0,0,8
1152215012368424960,1,7,0,0,8
254281388,0,8,0,0,8
1284537123652042752,8,0,0,0,8
380927791,3,3,0,2,8
1353197629031604224,1,7,0,0,8
258693840,0,8,0,0,8
192309665,6,2,0,0,8
1025796872743645184,2,6,0,0,8
304976261,6,0,0,2,8
716614135,0,8,0,0,8
3391619512,1,1,1,5,8
610728372,0,8,0,0,8
756643373847572480,1,2,4,1,8
1304669215987658752,8,0,0,0,8
1102999303767830528,2,6,0,0,8
1418005410,0,0,0,8,8
1494707065612234752,6,0,2,0,8
888919400144699392,0,4,0,4,8
1304165868075724800,1,7,0,0,8
1360365403,0,6,0,2,8
796273368022532096,1,3,1,3,8
1315638550730244096,0,8,0,0,8
1449964460693725184,1,0,6,1,8
1168985901210451968,0,8,0,0,8
881945748681748480,0,8,0,0,8
1163296858678054912,1,0,6,1,8
919023246497869824,0,8,0,0,8
253058012,0,8,0,0,8
777957970827177984,0,8,0,0,8
944805578915926016,4,0,4,0,8
65635732,0,8,0,0,8
1126684201049133056,7,0,0,1,8
945212307063259136,1,7,0,0,8
2736852409,6,2,0,0,8
1310248752398118912,6,0,2,0,8
152163725,0,8,0,0,8
798910302,0,8,0,0,8
90020596,0,8,0,0,8
1280012999307128832,1,7,0,0,8
841253721371639808,1,6,1,0,8
1233328088,6,1,0,1,8
1220971868,0,8,0,0,8
2725063516,0,7,0,1,8
3017456388,4,1,2,1,8
1667113850,4,4,0,0,8
65201638,0,0,0,8,8
716439055,0,8,0,0,8
4872746068,0,8,0,0,8
853260765444415488,0,8,0,0,8
735761079721066496,8,0,0,0,8
95412194,4,3,0,1,8
1003447759,3,5,0,0,8
18445561,1,0,0,7,8
1565618484,0,8,0,0,8
143776620,3,1,3,1,8
1312712538241544192,0,8,0,0,8
1422529579,0,8,0,0,8
1312716910161793024,0,8,0,0,8
2270534858,0,8,0,0,8
1462085478841307136,3,2,1,2,8
1607208902,0,7,0,1,8
2816355846,0,8,0,0,8
2260421546,0,8,0,0,8
298595790,0,8,0,0,8
64665513,1,4,1,2,8
898699984740208640,0,8,0,0,8
203872551,0,8,0,0,8
736837678780551168,0,8,0,0,8
1104362645778399232,0,7,1,0,8
3881228474,0,6,2,0,8
1352143532501442560,1,7,0,0,8
417259412,0,8,0,0,8
903918980947173376,0,8,0,0,8
459727375,0,8,0,0,8
1198853860741255168,0,8,0,0,8
1230340363283419136,0,8,0,0,8
296985881,0,8,0,0,8
737580477880487936,1,7,0,0,8
1420853856,0,8,0,0,8
98229707,0,8,0,0,8
255039093,0,8,0,0,8
461760037,0,8,0,0,8
4397096354,1,7,0,0,8
741311462010966016,0,7,0,1,8
1166537293991174144,7,0,0,1,8
354949437,0,8,0,0,8
1070398243236802560,1,6,0,1,8
1478873143,0,8,0,0,8
97802862,0,8,0,0,8
943018760717393920,1,7,0,0,8
4319919980,0,8,0,0,8
64088983,3,0,3,2,8
1163868257238913024,8,0,0,0,8
1313693494607843328,0,8,0,0,8
1977459373,7,0,1,0,8
979425491416440832,0,8,0,0,8
1313674404010754048,1,0,6,1,8
258001488,0,8,0,0,8
3873391996,0,8,0,0,8
1087761168305979392,0,8,0,0,8
1000286991878045696,0,8,0,0,8
426158446,0,8,0,0,8
1305921966780678144,2,6,0,0,8
2592597974,1,7,0,0,8
1311999419907276800,8,0,0,0,8
1221333041244786688,0,8,0,0,8
2817182953,0,8,0,0,8
261249799,0,7,0,1,8
1406680098527334400,0,8,0,0,8
851427529319698432,0,5,0,3,8
1489187274600419328,0,8,0,0,8
386465192,1,7,0,0,8
1187329267396419584,0,8,0,0,8
1129529580,0,8,0,0,8
1148495311,0,8,0,0,8
2214821131,2,6,0,0,8
1618081424,0,8,0,0,8
1020228960,0,4,2,2,8
2721700336,0,8,0,0,8
881585401810571264,0,8,0,0,8
3013642453,8,0,0,0,8
881522773583179776,0,8,0,0,8
508529046,3,0,0,5,8
841664220496314368,1,6,0,1,8
2191888290,0,8,0,0,8
412825727,6,2,0,0,8
2228210945,0,8,0,0,8
1485534200501612544,2,1,0,5,8
1308280047669780480,0,8,0,0,8
138107750,3,2,1,2,8
3289682613,0,5,0,3,8
1490180997664874496,8,0,0,0,8
358830823,6,0,0,2,8
952168777881456640,0,8,0,0,8
863297134816366592,0,8,0,0,8
32534416,1,6,1,0,8
612419858,0,8,0,0,8
1241025936,0,8,0,0,8
1485628257617776640,0,8,0,0,8
811605000690475008,0,8,0,0,8
958282436810452992,5,3,0,0,8
923109764,4,1,0,3,8
1496521700976046080,2,1,2,3,8
1691877313,0,8,0,0,8
854327091218620416,4,3,0,1,8
2792585317,0,8,0,0,8
2414969825,1,7,0,0,8
4885418535,0,8,0,0,8
1489287266594082816,0,8,0,0,8
3955078392,0,8,0,0,8
1074243863030755328,0,8,0,0,8
1464215071551549440,0,4,0,4,8
1347074742273011712,0,8,0,0,8
32948422,0,8,0,0,8
312137055,0,8,0,0,8
1084218288794673152,3,5,0,0,8
148037431,0,8,0,0,8
1459057915499667456,0,8,0,0,8
1359463184227213312,6,1,0,1,8
210770407,0,8,0,0,8
4885717600,0,8,0,0,8
151075016,0,8,0,0,8
263894928,0,8,0,0,8
1307445058623254528,4,0,0,4,8
1390961752272220160,0,8,0,0,8
781003422,0,8,0,0,8
959886088298024960,0,8,0,0,8
1183457498478632960,4,1,3,0,8
3221285458,0,7,1,0,8
1101685767099858944,0,0,0,8,8
796089938211205120,0,8,0,0,8
1495842345278869504,8,0,0,0,8
713152786851094528,0,8,0,0,8
1394654089582022656,1,7,0,0,8
1108150240966860800,0,8,0,0,8
1165120757636222976,0,2,0,5,7
1291334039111110656,0,7,0,0,7
1394940649263222784,0,7,0,0,7
576369892,0,7,0,0,7
493458359,0,0,1,6,7
95006181,0,7,0,0,7
1427933469980647424,3,1,1,2,7
1356168915282497536,0,7,0,0,7
1136663878002253824,0,7,0,0,7
1227579487,1,5,1,0,7
3107728341,0,7,0,0,7
3283845474,0,7,0,0,7
225940966,2,3,0,2,7
708040043550679040,0,7,0,0,7
1138043625101778944,1,6,0,0,7
174944657,0,7,0,0,7
965847972125790208,0,7,0,0,7
197100509,1,6,0,0,7
868426369138659328,0,7,0,0,7
195133810,1,6,0,0,7
1134107894314496000,4,3,0,0,7
1356287922065076224,3,0,3,1,7
1394922566188511232,0,7,0,0,7
481458073,2,0,4,1,7
194606563,1,3,1,2,7
862953390585729024,0,7,0,0,7
2930147509,1,0,1,5,7
1606655252,4,3,0,0,7
1317441667,0,7,0,0,7
89303748,6,1,0,0,7
1105902642985881600,0,7,0,0,7
95419833,3,3,1,0,7
174537146,5,2,0,0,7
722613459268038656,0,7,0,0,7
710736443736498176,0,7,0,0,7
1297063718950440960,0,7,0,0,7
2331391464,0,7,0,0,7
1281926718329171968,0,7,0,0,7
3236318550,4,1,2,0,7
117670989,0,7,0,0,7
897292026,4,0,0,3,7
1356505354306162688,5,1,1,0,7
232727377,0,7,0,0,7
150964541,1,6,0,0,7
1039531876849995776,0,7,0,0,7
3294455634,0,7,0,0,7
1639032523,6,0,1,0,7
1167054392782217216,2,3,2,0,7
173740536,1,6,0,0,7
1398646714634948608,6,1,0,0,7
147755710,4,0,3,0,7
178355865,2,5,0,0,7
2926866081,0,7,0,0,7
1292443605747916800,0,7,0,0,7
1264875236316467200,0,7,0,0,7
749255766977110016,3,2,2,0,7
3096461769,0,7,0,0,7
560941976,0,7,0,0,7
121471010,1,6,0,0,7
1296152319118065664,0,7,0,0,7
838661590530441216,0,7,0,0,7
400067960,0,7,0,0,7
1166287522521133056,0,7,0,0,7
1292125093347430400,0,7,0,0,7
4803320716,0,7,0,0,7
400053687,0,7,0,0,7
488814217,0,3,1,3,7
769290281896280064,6,0,1,0,7
1282325817440313344,0,7,0,0,7
1310156987863310336,0,7,0,0,7
196549903,0,7,0,0,7
1296033847969226752,0,6,1,0,7
1378922588542410752,0,2,1,4,7
1354052860804272128,1,5,1,0,7
1329627175297961984,0,7,0,0,7
438261962,6,0,1,0,7
2876809224,0,7,0,0,7
1310101715278950400,0,1,1,5,7
1426767290876370944,2,0,0,5,7
1426531995232792576,0,6,0,1,7
3117211039,0,7,0,0,7
176322051,2,5,0,0,7
172482647,5,2,0,0,7
1970917675,0,7,0,0,7
114829695,1,5,1,0,7
1334295628059381760,0,1,1,5,7
854729390902693888,0,7,0,0,7
1425630429068075008,0,7,0,0,7
1164825832319266816,0,7,0,0,7
1098040021297156096,0,7,0,0,7
2955656653,1,5,0,1,7
557013331,0,5,2,0,7
2390798966,0,6,0,1,7
2433741363,0,7,0,0,7
985466484578308096,0,7,0,0,7
491640057,0,7,0,0,7
1164885597950844928,0,7,0,0,7
2925299916,0,7,0,0,7
3101735613,0,7,0,0,7
558034355,1,0,6,0,7
3092690019,0,7,0,0,7
122585079,0,6,0,1,7
1098531457759244288,3,4,0,0,7
75399604,1,6,0,0,7
3021273576,1,3,1,2,7
2337057608,0,7,0,0,7
1137685042631729152,1,4,0,2,7
835167858699087872,0,7,0,0,7
708410166828470272,0,7,0,0,7
769346654541537280,0,7,0,0,7
456083283,7,0,0,0,7
1328622877181054976,0,7,0,0,7
909975518,0,7,0,0,7
1605694716,0,3,0,4,7
195449009,0,7,0,0,7
2381830674,0,7,0,0,7
839700376584605696,0,0,0,7,7
1355149764409647104,4,3,0,0,7
1357307953343299584,0,4,3,0,7
1311209533788876800,0,7,0,0,7
845528738,2,5,0,0,7
455536726,0,7,0,0,7
1165259804341886976,0,0,1,6,7
1340966826,0,7,0,0,7
579007490,0,7,0,0,7
468303442,0,7,0,0,7
1290909187698909184,5,0,1,1,7
105446698,0,7,0,0,7
1391030459576979456,1,6,0,0,7
733130023100502016,2,5,0,0,7
413038728,0,7,0,0,7
1288028927009710080,0,0,0,7,7
1142826342527803392,1,6,0,0,7
1101053376660422656,0,7,0,0,7
4853806841,0,7,0,0,7
969612733908791296,3,4,0,0,7
1348034828663463936,0,3,4,0,7
139964256,0,7,0,0,7
1362678290947788800,3,1,0,3,7
55849745,1,5,0,1,7
976745084174700544,0,7,0,0,7
190321607,0,7,0,0,7
4854666707,0,1,0,6,7
211119118,0,7,0,0,7
3219262662,1,5,0,1,7
1347395247349714944,1,4,2,0,7
832166576765988864,0,7,0,0,7
899308266748080128,0,7,0,0,7
55910443,4,0,2,1,7
1406587537179688960,7,0,0,0,7
52993494,0,7,0,0,7
2327400901,6,0,0,1,7
961899907190870016,2,5,0,0,7
570318719,0,7,0,0,7
1131159347575214080,4,3,0,0,7
3259798694,2,3,1,1,7
1271514572843819008,0,7,0,0,7
856309243145748480,0,7,0,0,7
566258581,0,7,0,0,7
761471564470710272,0,7,0,0,7
850259759454343168,0,5,1,1,7
107003050,0,6,0,1,7
210048374,0,7,0,0,7
185092960,0,7,0,0,7
570584158,4,1,0,2,7
855407564141584384,0,7,0,0,7
1304033883822804992,5,2,0,0,7
1126875023392813056,5,0,1,1,7
728362999464005632,0,7,0,0,7
2405720943,1,6,0,0,7
1363235824058392576,3,4,0,0,7
450006075,0,5,0,2,7
4908312593,0,7,0,0,7
1348435561,0,7,0,0,7
843541543155892224,0,6,1,0,7
1370300701,0,7,0,0,7
104431676,0,5,2,0,7
2159042199,1,6,0,0,7
3158715249,0,7,0,0,7
190175146,1,5,0,1,7
1169483949384654848,3,4,0,0,7
2903924148,1,5,1,0,7
102368436,0,7,0,0,7
4863208452,0,7,0,0,7
1154286866830520320,6,1,0,0,7
3272067373,1,1,5,0,7
2413271164,0,4,0,3,7
85637771,0,6,1,0,7
136108591,0,7,0,0,7
1285874116294107136,0,0,7,0,7
977066517681487872,0,7,0,0,7
2173116562,0,7,0,0,7
743560512504397824,0,7,0,0,7
3301472115,0,7,0,0,7
1145306652381339648,2,5,0,0,7
213018335,1,4,1,1,7
1127216148,2,2,2,1,7
1318267608601260032,0,7,0,0,7
55049447,0,7,0,0,7
1154414189802217472,0,7,0,0,7
1360552434041561088,6,1,0,0,7
137353459,0,0,2,5,7
1242637992,1,6,0,0,7
715451531546468352,0,6,1,0,7
842275027454201856,0,1,0,6,7
4856026445,0,7,0,0,7
957765551903924224,0,7,0,0,7
101516293,0,7,0,0,7
187439825,0,7,0,0,7
730095946646884352,0,7,0,0,7
86424043,0,7,0,0,7
2900232985,0,7,0,0,7
1129709662918438912,3,4,0,0,7
3155519850,0,7,0,0,7
1286953280023728128,0,7,0,0,7
821914502,0,7,0,0,7
1242015182,0,7,0,0,7
469450484,3,4,0,0,7
982695289910939648,0,7,0,0,7
1119505175079739392,1,5,1,0,7
1317678143034085376,0,7,0,0,7
1372211844,3,4,0,0,7
54283925,0,7,0,0,7
1272986355837087744,5,2,0,0,7
135792355,0,7,0,0,7
1954948364,0,7,0,0,7
705663405642780672,0,7,0,0,7
707511952269053952,0,7,0,0,7
2331154075,0,7,0,0,7
1313660940785790976,0,7,0,0,7
1420464304457863168,1,0,0,6,7
403944171,2,5,0,0,7
1111019626727641088,0,7,0,0,7
960572873067855872,0,7,0,0,7
1160546601083068416,0,7,0,0,7
2449850334,0,7,0,0,7
962726490319261696,0,7,0,0,7
97212023,0,7,0,0,7
1383710423464042496,0,7,0,0,7
2341691036,6,0,1,0,7
1110765595669127168,1,6,0,0,7
1284032281452195840,0,7,0,0,7
1276988821448450048,0,7,0,0,7
574413969,0,7,0,0,7
164623615,1,6,0,0,7
127451772,0,7,0,0,7
3313458757,0,7,0,0,7
461088350,0,7,0,0,7
1418914896494858240,0,1,6,0,7
1418814893642461184,0,7,0,0,7
555400199,0,7,0,0,7
1117135297907703808,0,0,1,6,7
3314082051,0,7,0,0,7
1257091862,0,7,0,0,7
1111091866194325504,1,6,0,0,7
1257397484,0,7,0,0,7
1283424272434814976,0,7,0,0,7
725833153613553664,1,1,2,3,7
547547234,0,7,0,0,7
983985974299545600,0,7,0,0,7
525712266,0,7,0,0,7
1167305272404008960,0,7,0,0,7
962955480078454784,0,7,0,0,7
203462199,0,6,0,1,7
2913490879,1,6,0,0,7
1678299445,5,1,1,0,7
1688265614,0,7,0,0,7
1035765632447524864,1,6,0,0,7
442231995,0,7,0,0,7
1582778792,0,7,0,0,7
1267427694003646464,0,7,0,0,7
547909374,0,7,0,0,7
88729438,0,7,0,0,7
981763458839523328,0,7,0,0,7
1283655156756738048,0,7,0,0,7
1285273932,0,7,0,0,7
2449884064,0,7,0,0,7
97906910,1,6,0,0,7
880215426,0,7,0,0,7
3228147853,0,7,0,0,7
474682316,1,6,0,0,7
141537126,7,0,0,0,7
1117703003140526080,7,0,0,0,7
1323314342427680768,0,7,0,0,7
986009409447964672,2,3,0,2,7
1100443687555874816,3,0,0,4,7
1205643764,3,4,0,0,7
162496549,0,7,0,0,7
99193821,0,3,4,0,7
1269896889299845120,1,6,0,0,7
827102964301053952,0,7,0,0,7
161665339,0,7,0,0,7
461531603,0,7,0,0,7
2362445466,6,1,0,0,7
1270409346111995904,0,7,0,0,7
1100704368159006720,1,6,0,0,7
565401924,1,6,0,0,7
1134335348,0,7,0,0,7
424495696,0,7,0,0,7
988994881627611136,0,7,0,0,7
1694988168,1,6,0,0,7
1955540833,0,7,0,0,7
51858939,1,6,0,0,7
1120734739344822272,0,7,0,0,7
913964311189479424,0,7,0,0,7
1107904701432057856,1,6,0,0,7
82303843,0,7,0,0,7
205148837,1,3,3,0,7
1268707975381700608,7,0,0,0,7
164051295,0,7,0,0,7
461879076,0,7,0,0,7
3312460018,0,7,0,0,7
1125625682946449408,0,4,2,1,7
847654820,0,7,0,0,7
221851016,1,6,0,0,7
1107829235027247104,1,6,0,0,7
3256507136,2,3,0,2,7
108935962,1,2,0,4,7
82120357,5,0,1,1,7
526497034,0,7,0,0,7
1603392944,1,4,2,0,7
1417177058833281024,0,7,0,0,7
1341096118957039616,2,2,0,3,7
183113684,0,7,0,0,7
1141193921055211520,1,6,0,0,7
98667396,1,6,0,0,7
1401808434249486336,4,0,1,2,7
897214164430729216,1,6,0,0,7
3182001024,0,0,3,4,7
227010617,0,7,0,0,7
2727051659,0,7,0,0,7
1465285255141625856,0,7,0,0,7
322977301,0,7,0,0,7
1009145933882421248,0,7,0,0,7
704555553,2,5,0,0,7
1053650124109438976,2,0,5,0,7
271079458,0,7,0,0,7
19909305,0,7,0,0,7
614053154,0,7,0,0,7
373815598,0,7,0,0,7
1229014084982575104,0,7,0,0,7
1023541736579231744,0,7,0,0,7
1214861367863390208,0,2,0,5,7
952886337274867712,0,7,0,0,7
244208108,1,6,0,0,7
1466785992845651968,0,6,1,0,7
949616899687624704,0,7,0,0,7
4385438174,0,3,1,3,7
907199024276627456,2,4,1,0,7
1214640696327626752,0,7,0,0,7
14965080,0,7,0,0,7
2206773013,0,7,0,0,7
2206385660,0,7,0,0,7
1206080019132338176,0,7,0,0,7
296725789,0,7,0,0,7
704746224,1,0,1,5,7
28607023,1,1,4,1,7
2209729313,0,7,0,0,7
390340887,0,7,0,0,7
4010774579,0,7,0,0,7
1256238250441793536,0,7,0,0,7
2189283941,0,7,0,0,7
376048315,0,7,0,0,7
1471399724,6,1,0,0,7
39545984,2,4,0,1,7
3426504598,0,7,0,0,7
29269648,0,7,0,0,7
389479119,0,7,0,0,7
3428156232,3,0,1,3,7
735283098,0,7,0,0,7
706513224,0,7,0,0,7
706495820,1,5,1,0,7
2740453302,0,7,0,0,7
909961755639418880,5,0,2,0,7
1489886614004592640,5,0,1,1,7
3817142714,3,4,0,0,7
1181089147156680704,1,6,0,0,7
4017326793,0,7,0,0,7
28779345,0,7,0,0,7
1405755542,0,7,0,0,7
591539117,1,6,0,0,7
902843321785106432,0,7,0,0,7
1230803051478429696,0,4,0,3,7
2188561658,1,4,1,1,7
2629174403,0,7,0,0,7
1019060826,0,0,7,0,7
1507251662825877504,1,6,0,0,7
294042333,0,7,0,0,7
2250666204,0,7,0,0,7
816429474589843456,1,6,0,0,7
870254570286481408,0,7,0,0,7
3349683432,2,5,0,0,7
1828327680,4,0,3,0,7
1197200153565786112,1,6,0,0,7
1178379211624476672,0,7,0,0,7
2782429566,0,7,0,0,7
2587656166,0,7,0,0,7
1213150709643792384,0,7,0,0,7
1004356122806013952,1,0,6,0,7
1917663036,0,7,0,0,7
329450505,7,0,0,0,7
1050268210497560576,0,3,3,1,7
26263379,1,6,0,0,7
619279048,0,7,0,0,7
587708711,1,6,0,0,7
292467865,0,7,0,0,7
1055642854045990912,7,0,0,0,7
1233909803707228160,0,7,0,0,7
888126000500011008,0,5,1,1,7
1242678455956799488,0,7,0,0,7
1436528841275498496,0,7,0,0,7
2783548251,0,7,0,0,7
1470038521784115200,0,7,0,0,7
812901974337318912,0,7,0,0,7
392300504,7,0,0,0,7
4757784142,4,3,0,0,7
295563938,2,5,0,0,7
745264832,0,7,0,0,7
1019287244,0,7,0,0,7
1497127765,0,7,0,0,7
909643588807675904,0,7,0,0,7
361560873,6,0,0,1,7
4759001086,6,0,1,0,7
294844504,1,3,3,0,7
1574808145,0,7,0,0,7
4060441720,0,7,0,0,7
1093782150325903360,3,4,0,0,7
617255838,1,6,0,0,7
1082703910450515968,0,7,0,0,7
876593417119297536,0,7,0,0,7
635121650,0,7,0,0,7
1259171463430639616,1,1,0,5,7
1242801386489647104,0,7,0,0,7
1020698772064497664,0,7,0,0,7
1545409868,0,7,0,0,7
796187508,2,5,0,0,7
4349594964,0,7,0,0,7
772368000259424256,0,7,0,0,7
902090930152280064,0,7,0,0,7
4299393136,0,7,0,0,7
1252849776212598784,0,7,0,0,7
315250214,0,7,0,0,7
1068398828754214912,0,7,0,0,7
17820351,2,1,1,3,7
1185921421425500160,0,7,0,0,7
33389090,3,4,0,0,7
4304560222,0,7,0,0,7
251984741,0,7,0,0,7
385824783,0,7,0,0,7
1907172127,0,7,0,0,7
3399826924,2,0,5,0,7
1183223873598300160,1,0,3,3,7
1448353077451378688,0,7,0,0,7
1219127374014488576,0,7,0,0,7
1496952237394116608,3,4,0,0,7
3400255754,3,4,0,0,7
1253205850002341888,5,1,1,0,7
1497079594519654400,0,7,0,0,7
2811094400,7,0,0,0,7
2613651126,0,7,0,0,7
1533390254,0,7,0,0,7
1223326050723291136,1,6,0,0,7
4707337280,1,3,2,1,7
16712223,3,3,1,0,7
1200439962338037760,0,7,0,0,7
803254692,1,6,0,0,7
4697888132,0,7,0,0,7
778564355780739072,0,7,0,0,7
17138386,0,7,0,0,7
2823515842,0,7,0,0,7
1453046009643212800,0,7,0,0,7
1251184157465567232,0,7,0,0,7
352019229,1,6,0,0,7
253623730,0,0,0,7,7
883983414310952960,0,7,0,0,7
1535142612,0,7,0,0,7
351686967,0,7,0,0,7
1450759740854779904,0,7,0,0,7
906479321086341120,0,7,0,0,7
4703955076,0,7,0,0,7
1496680602027769856,0,7,0,0,7
353861956,0,7,0,0,7
1202515657671266304,0,7,0,0,7
252993233,0,7,0,0,7
1564529707,0,0,0,7,7
4295580335,0,7,0,0,7
1455587498260844544,0,5,1,1,7
385310818,0,6,1,0,7
797419771885133824,0,7,0,0,7
797147511634952192,0,7,0,0,7
18100552,6,0,1,0,7
1497175319710683136,7,0,0,0,7
906636446605484032,0,7,0,0,7
318956205,2,5,0,0,7
955101288,2,4,1,0,7
2801940764,0,7,0,0,7
2277422089,0,0,0,7,7
1188327086722674688,0,7,0,0,7
1026865168087764992,0,7,0,0,7
796420190850449408,1,5,1,0,7
247417815,1,3,1,2,7
1491752544800239616,6,1,0,0,7
936502773222436864,4,0,3,0,7
775560886471786496,0,7,0,0,7
376673430,4,3,0,0,7
1472529175,0,7,0,0,7
1013502080076664832,1,6,0,0,7
1246383157907050496,0,7,0,0,7
30199785,3,4,0,0,7
1200588008619044864,1,0,1,5,7
2598945876,0,3,0,4,7
934643472,0,7,0,0,7
2561547748,2,1,0,4,7
800297416415006720,0,7,0,0,7
1246001669072203776,0,7,0,0,7
774075182,1,6,0,0,7
305139426,2,5,0,0,7
730334606,0,7,0,0,7
3872082494,1,5,0,1,7
249620286,2,5,0,0,7
3403772061,0,7,0,0,7
260787380,0,0,0,7,7
16332341,2,3,2,0,7
821444995060113408,0,7,0,0,7
796900634834378752,0,7,0,0,7
2732267625,0,7,0,0,7
1254053938485174272,0,7,0,0,7
2712981391,0,7,0,0,7
712389082,0,7,0,0,7
604777507,4,1,1,1,7
249589999,3,4,0,0,7
1187099422687150080,0,7,0,0,7
3880122874,0,7,0,0,7
1254465229909422080,0,6,0,1,7
810812325582303232,0,7,0,0,7
1497426638463987712,1,0,0,6,7
1492555218743091200,0,7,0,0,7
356217307,2,4,1,0,7
1247959065235296256,0,7,0,0,7
3878263835,0,7,0,0,7
248893278,0,7,0,0,7
871846145680715776,0,7,0,0,7
292253404,0,7,0,0,7
1418779790,2,0,2,3,7
1239074248972476416,0,7,0,0,7
1913401238,0,7,0,0,7
1457472006,2,5,0,0,7
394680267,0,7,0,0,7
770288369783992320,0,7,0,0,7
887174838334484480,1,6,0,0,7
912913728223531008,3,0,0,4,7
1552426447,1,6,0,0,7
994581299179466752,0,0,4,3,7
1705150118,6,1,0,0,7
1212743588028678144,0,7,0,0,7
2673033783,0,7,0,0,7
237104507,0,7,0,0,7
1473216501171712000,0,7,0,0,7
2764151075,0,7,0,0,7
4792771463,1,6,0,0,7
1481902009561542656,6,1,0,0,7
1940158046,1,6,0,0,7
970865156,0,7,0,0,7
1479504156624752640,0,7,0,0,7
1023555853,0,7,0,0,7
278226949,0,7,0,0,7
2575666549,1,6,0,0,7
4501984941,5,2,0,0,7
878746085522644992,0,7,0,0,7
946326196609892352,0,7,0,0,7
1858938163,1,0,0,6,7
621869620,0,7,0,0,7
804942477291651072,2,4,1,0,7
331643450,0,7,0,0,7
2764701471,2,5,0,0,7
1517132916,0,7,0,0,7
626622939,0,6,1,0,7
368198105,0,7,0,0,7
2780396725,7,0,0,0,7
1005670399676436480,0,3,3,1,7
1516881583,0,7,0,0,7
1432650895154688000,6,1,0,0,7
868794554652270592,0,7,0,0,7
948527738356404224,1,0,3,3,7
814602750,0,7,0,0,7
2288639644,0,7,0,0,7
1026800628,0,7,0,0,7
2196001025,0,7,0,0,7
887593307785895936,0,7,0,0,7
340828179,0,7,0,0,7
1472723582824460288,0,3,0,4,7
1194125776813248512,0,7,0,0,7
1849859960,0,7,0,0,7
586383566,6,1,0,0,7
3608611767,0,7,0,0,7
1262307905258356736,0,6,1,0,7
947529531555962880,1,6,0,0,7
1240999949254324224,0,7,0,0,7
279216410,2,4,0,1,7
1102839853,0,7,0,0,7
815051493774532608,0,7,0,0,7
365977278,0,7,0,0,7
288722358,2,2,1,2,7
2194713914,7,0,0,0,7
332090722,0,7,0,0,7
1212835150490263552,0,4,3,0,7
1459591067255324672,0,5,0,1,6
926034185432780800,3,3,0,0,6
196588585,0,6,0,0,6
287138096,1,0,0,5,6
873864849830289408,0,6,0,0,6
1005733374,0,6,0,0,6
261227299,0,0,0,6,6
458150744,0,6,0,0,6
1595708304,0,6,0,0,6
1311388657371303936,2,0,2,2,6
3408474833,0,6,0,0,6
1116348741445775360,5,0,1,0,6
459275571,0,5,0,1,6
858238860198895616,0,6,0,0,6
173203962,0,6,0,0,6
420904037,0,4,0,2,6
749499734784561152,0,6,0,0,6
1224062389,0,6,0,0,6
459124038,3,2,0,1,6
2772787632,0,6,0,0,6
628266716,0,6,0,0,6
2478704820,0,6,0,0,6
1298610127193473024,0,2,0,4,6
442680931,1,3,0,2,6
1072563247369334784,2,4,0,0,6
1248152402219458560,0,6,0,0,6
305252085,0,6,0,0,6
261736693,1,5,0,0,6
197010637,0,6,0,0,6
1458782778871406592,0,6,0,0,6
1114323025858576384,0,6,0,0,6
943395100717146112,3,1,1,1,6
917751312904630272,0,6,0,0,6
95621704,4,1,1,0,6
1312389084225171456,0,6,0,0,6
18474270,0,6,0,0,6
780449040,0,3,0,3,6
4667588904,0,6,0,0,6
436991292,0,0,0,6,6
1483549367961518080,1,5,0,0,6
1353319469158977536,3,3,0,0,6
1225046507612557312,0,6,0,0,6
1009913148,2,3,1,0,6
195344282,0,6,0,0,6
1188411580137951232,0,6,0,0,6
303648789,0,6,0,0,6
1225812455722369024,0,6,0,0,6
2928533178,3,0,1,2,6
1353943512392159232,0,2,1,3,6
1491483657151737856,0,6,0,0,6
1106960907702165504,0,6,0,0,6
1477190610826235904,0,6,0,0,6
4340913974,4,2,0,0,6
814638278842388480,0,6,0,0,6
1356727543,0,6,0,0,6
890033832816025600,0,6,0,0,6
1164249622908264448,0,6,0,0,6
1246762293246996480,1,4,1,0,6
1309825568465129472,0,1,0,5,6
1331780875,1,5,0,0,6
1035822504,0,6,0,0,6
80881313,0,6,0,0,6
165089403,2,0,2,2,6
4517428577,0,6,0,0,6
2474930520,1,4,1,0,6
1240165096590106624,2,4,0,0,6
1293812054072205312,0,6,0,0,6
193078128,0,5,1,0,6
1245968037745917952,6,0,0,0,6
1227195137681346560,4,2,0,0,6
3422927013,0,6,0,0,6
303889542,0,6,0,0,6
2773908893,3,0,0,3,6
839727987280982016,1,0,0,5,6
1019856380486963200,2,4,0,0,6
457866683,0,6,0,0,6
1006320163,3,0,3,0,6
1729388340,0,6,0,0,6
933995404579835904,0,6,0,0,6
796651196182364160,0,6,0,0,6
857355297916149760,2,3,0,1,6
2773384862,2,4,0,0,6
835781132,0,6,0,0,6
877577741226430464,0,6,0,0,6
1368789201039151104,0,4,1,1,6
356552814,1,5,0,0,6
757441886592331776,4,0,1,1,6
757433672794595328,0,1,5,0,6
862593089705320448,0,6,0,0,6
2166570694,0,5,0,1,6
63655598,0,6,0,0,6
377243975,0,5,1,0,6
2427656550,0,6,0,0,6
1150157290496045056,0,6,0,0,6
3190714782,2,4,0,0,6
1222108621,0,6,0,0,6
3017990102,1,5,0,0,6
2982013384,4,0,1,1,6
963871360459124736,0,6,0,0,6
966657279742287872,5,1,0,0,6
24381630,3,1,0,2,6
4894687510,0,6,0,0,6
30719252,0,6,0,0,6
559466018,5,1,0,0,6
1492968076694142976,3,2,0,1,6
95850465,0,6,0,0,6
979069272889741312,0,6,0,0,6
1495315071739781120,0,6,0,0,6
733674260024201216,2,0,3,1,6
256703118,0,6,0,0,6
140973553,0,6,0,0,6
1126479263899836416,0,6,0,0,6
4288103419,0,6,0,0,6
3926686229,1,5,0,0,6
170436968,1,5,0,0,6
601732343,0,6,0,0,6
99134614,0,6,0,0,6
1238545402871181312,1,5,0,0,6
3035652604,0,6,0,0,6
2420184890,1,4,0,1,6
141529750,0,6,0,0,6
1187482286,0,6,0,0,6
789272750,0,6,0,0,6
1250296889846554624,0,6,0,0,6
1399003317863215104,2,4,0,0,6
2219550947,0,6,0,0,6
462385416,0,6,0,0,6
1185619239564005376,0,6,0,0,6
1296881124187283456,0,6,0,0,6
920894669826883584,0,6,0,0,6
1229869027,0,6,0,0,6
748513240129363968,0,5,0,1,6
2219801933,1,2,2,1,6
1166623175066738688,0,6,0,0,6
1115252512527982592,0,6,0,0,6
34372806,0,6,0,0,6
140738782,1,5,0,0,6
704014448818851840,0,6,0,0,6
1031976924862722048,0,6,0,0,6
3389835484,0,6,0,0,6
100848200,1,3,2,0,6
1347750797543542784,0,6,0,0,6
1069424269682188288,0,6,0,0,6
465544474,1,5,0,0,6
3297131665,1,5,0,0,6
23278492,3,3,0,0,6
1102989024308985856,0,6,0,0,6
1851350888,0,6,0,0,6
1184534335950643200,0,6,0,0,6
884030884390817792,0,6,0,0,6
205325519,1,5,0,0,6
4273919833,4,1,0,1,6
4275419487,0,6,0,0,6
954776763590000640,0,6,0,0,6
1348126047162789888,0,5,0,1,6
1057435261888393216,3,3,0,0,6
713285453970018304,4,0,1,1,6
563809614,4,2,0,0,6
2216510583,0,6,0,0,6
284385789,0,6,0,0,6
790187191024648192,0,6,0,0,6
23486495,3,1,2,0,6
170435325,5,0,1,0,6
779625937017208832,0,6,0,0,6
718695420,3,0,3,0,6
2418382879,0,6,0,0,6
3618841873,1,2,1,2,6
1238863805670543360,0,6,0,0,6
852692183731683328,1,5,0,0,6
1011311544787972096,0,6,0,0,6
1114973839585370112,0,6,0,0,6
2554428824,0,6,0,0,6
366993264,0,6,0,0,6
537178044,2,4,0,0,6
714299473,0,1,2,3,6
2316836618,4,1,1,0,6
307202198,0,6,0,0,6
2731474121,0,6,0,0,6
1424818951,0,6,0,0,6
1223710614859575296,1,5,0,0,6
535677043,0,6,0,0,6
306782805,1,4,1,0,6
1351869063342026752,0,6,0,0,6
2148189352,2,0,0,4,6
420453594,0,6,0,0,6
540164588,1,3,2,0,6
2968120546,0,6,0,0,6
703471534015451136,0,6,0,0,6
198132431,0,6,0,0,6
1227928236,1,0,4,1,6
537083653,1,5,0,0,6
306559952,0,6,0,0,6
23978162,0,6,0,0,6
1312831062045675520,1,2,0,3,6
3024078918,1,3,2,0,6
1145523114,2,1,1,2,6
79998151,0,6,0,0,6
143409707,2,4,0,0,6
2334509351,1,0,2,3,6
1052028504445923328,4,2,0,0,6
2919421988,0,1,0,5,6
142321213,0,6,0,0,6
3234997046,1,5,0,0,6
2978478585,1,2,0,3,6
461252081,0,6,0,0,6
17834249,1,5,0,0,6
142982896,1,4,0,1,6
711863141894901760,0,6,0,0,6
790369826682339328,0,6,0,0,6
789454870923403264,0,6,0,0,6
1249474983761285120,0,6,0,0,6
3902362453,0,6,0,0,6
2917616090,0,6,0,0,6
840486469089275904,0,6,0,0,6
1179727112,0,6,0,0,6
1223084847960190976,3,3,0,0,6
199684459,0,6,0,0,6
758832174359453696,0,3,3,0,6
1493713234779684864,1,5,0,0,6
4484631923,0,6,0,0,6
1055380828748955648,0,6,0,0,6
3628589177,0,6,0,0,6
2479994168,5,1,0,0,6
171487410,1,5,0,0,6
917671046014156800,1,4,0,1,6
1423705543,0,6,0,0,6
1223323675920752640,0,6,0,0,6
61243585,1,4,1,0,6
1551490196,0,6,0,0,6
1366618210603302912,2,4,0,0,6
75757797,0,6,0,0,6
2591170543,0,6,0,0,6
176429726,0,5,1,0,6
4453895315,0,6,0,0,6
935857259841650688,0,6,0,0,6
1386185508863320064,4,1,0,1,6
1023474414468325376,5,0,0,1,6
1020672355993989120,0,6,0,0,6
791261209,0,6,0,0,6
86771588,0,0,3,3,6
2988401575,0,6,0,0,6
1160921737799712768,1,3,0,2,6
1235119414921637888,1,5,0,0,6
859727545821835264,0,6,0,0,6
1474381301314637824,0,6,0,0,6
785109074,0,6,0,0,6
1553767070,0,6,0,0,6
1232288879874650112,0,6,0,0,6
856333314797522944,0,6,0,0,6
1385700683136094208,3,2,0,1,6
1301138096331710464,1,5,0,0,6
792338387470524416,1,0,1,4,6
1243209926152871936,0,6,0,0,6
3729219912,0,6,0,0,6
1120200761017634816,0,6,0,0,6
157246206,0,6,0,0,6
1234534367206223872,0,6,0,0,6
434200408,0,6,0,0,6
4425588617,1,5,0,0,6
294414537,3,3,0,0,6
1301166910009044992,0,6,0,0,6
361203954,0,6,0,0,6
3440615237,0,4,0,2,6
71129463,0,6,0,0,6
615577113,0,6,0,0,6
615093434,0,6,0,0,6
1230355235043831808,2,1,0,3,6
1467696154611621888,1,5,0,0,6
2566483298,0,4,1,1,6
2230542601,5,1,0,0,6
1190637435895463936,2,4,0,0,6
296819591,0,6,0,0,6
1358222351561682944,0,6,0,0,6
1464364742,0,6,0,0,6
926627094188175360,0,6,0,0,6
1464350060,0,6,0,0,6
4924588875,4,1,0,1,6
3438387201,1,5,0,0,6
4404619033,1,5,0,0,6
184931900,0,6,0,0,6
832413594327379968,0,6,0,0,6
1464186295,0,6,0,0,6
2748015381,6,0,0,0,6
2438237062,0,6,0,0,6
87904947,0,5,1,0,6
1288706539205926912,0,6,0,0,6
631834977,0,6,0,0,6
445261401,0,6,0,0,6
69891383,0,6,0,0,6
155706655,1,5,0,0,6
450443384,2,0,3,1,6
637223231,0,6,0,0,6
184023731,0,6,0,0,6
1198394383223185408,0,6,0,0,6
1303625637144322048,6,0,0,0,6
157733574,0,6,0,0,6
357635596,0,6,0,0,6
1241903947045941248,0,6,0,0,6
1362706375718162432,0,6,0,0,6
1472834892601782272,0,6,0,0,6
1112357032714100736,0,6,0,0,6
1974601560,3,1,2,0,6
292093743,1,4,1,0,6
1160413792687144960,6,0,0,0,6
546528730,6,0,0,0,6
1043793616056066048,0,6,0,0,6
1054374688317681664,4,2,0,0,6
927913816922390528,0,6,0,0,6
159444243,1,5,0,0,6
2570885207,0,6,0,0,6
982795231811678208,2,2,1,1,6
84074624,2,4,0,0,6
926906393382223872,3,0,1,2,6
1111562084431642624,0,6,0,0,6
1022245112,1,5,0,0,6
1361928387040788480,0,6,0,0,6
1343438996,0,6,0,0,6
855979902801031168,0,6,0,0,6
1169182405,0,6,0,0,6
1055695344430919680,0,6,0,0,6
1242173526217379840,0,6,0,0,6
2463571945,0,6,0,0,6
1301812908079214592,0,6,0,0,6
1169506849,0,6,0,0,6
1381294482667229184,3,0,1,2,6
1828892059,0,6,0,0,6
2781596592,0,6,0,0,6
292909365,0,6,0,0,6
432532768,1,5,0,0,6
1119874005962334208,0,6,0,0,6
1301519302848180224,0,6,0,0,6
1110588444340678656,0,6,0,0,6
2995460587,0,6,0,0,6
1112598202086100992,1,4,1,0,6
1291684965357359104,0,6,0,0,6
786568717328986112,0,6,0,0,6
1110779003944796160,1,5,0,0,6
1154309125397995520,0,6,0,0,6
160870683,2,0,1,3,6
274996192,0,6,0,0,6
294095970,0,5,1,0,6
431483374,0,6,0,0,6
3483778333,0,6,0,0,6
160856290,0,6,0,0,6
431492640,2,1,3,0,6
545349237,0,6,0,0,6
1290149952912412672,0,6,0,0,6
1290198680322994176,0,6,0,0,6
634651304,0,6,0,0,6
160608167,0,6,0,0,6
2951216662,0,6,0,0,6
876982993977475072,0,6,0,0,6
1361132883805499392,0,6,0,0,6
3688543575,0,5,0,1,6
2951506463,0,6,0,0,6
1860426271,0,6,0,0,6
73852953,3,1,2,0,6
1233067177902624768,0,6,0,0,6
2235714315,0,6,0,0,6
159044690,0,6,0,0,6
526080717,3,1,1,1,6
2184727058,0,5,1,0,6
701115793,0,5,0,1,6
1163256291315240960,4,0,0,2,6
3548047872,0,6,0,0,6
2934519908,2,0,1,3,6
1227981565420015616,0,6,0,0,6
788325464259436544,1,0,5,0,6
981181606042910720,0,6,0,0,6
3431265339,0,6,0,0,6
268927070,4,1,1,0,6
1867093416,0,6,0,0,6
2343110429,2,3,0,1,6
612404647,0,5,1,0,6
1235844032179232768,2,1,1,2,6
1073891621177970688,0,6,0,0,6
1390547231263105024,0,0,0,6,6
784702282315231232,0,6,0,0,6
622109755,0,6,0,0,6
1285821615499104256,3,3,0,0,6
300922559,2,1,1,2,6
750432440095633408,0,6,0,0,6
630937017,0,6,0,0,6
1664452663,0,6,0,0,6
1489555525842964480,0,6,0,0,6
426112917,0,6,0,0,6
90657492,0,6,0,0,6
953766356,0,6,0,0,6
1235660769792061440,1,5,0,0,6
533572036,0,6,0,0,6
613278323,0,3,0,3,6
358640300,3,0,0,3,6
1465556949286588416,0,5,0,1,6
1355848005249859584,0,6,0,0,6
268467483,0,6,0,0,6
1195928051953098752,5,0,0,1,6
1365653687813701632,0,2,0,4,6
861788176850886656,2,4,0,0,6
2449304580,1,5,0,0,6
1227481424795537408,0,6,0,0,6
1490547363349467136,0,6,0,0,6
75756363,0,5,1,0,6
1151417814214991872,0,6,0,0,6
1284541977233686528,6,0,0,0,6
1476277564297592832,1,5,0,0,6
746508870521061376,0,6,0,0,6
1463081632462561280,0,6,0,0,6
960848841099677696,0,6,0,0,6
744169778022092800,0,6,0,0,6
149415433,0,6,0,0,6
1284767501268578304,1,5,0,0,6
1481601062784180224,0,6,0,0,6
149432947,5,0,1,0,6
881762829237231616,2,1,0,3,6
629451012,0,6,0,0,6
1481633816989024256,0,4,1,1,6
1490488167933300736,1,3,0,2,6
65617373,0,6,0,0,6
844031984,0,6,0,0,6
3554473817,0,6,0,0,6
357935844,0,6,0,0,6
191435302,3,2,1,0,6
835927492666011648,0,5,0,1,6
746128084475219968,0,6,0,0,6
918025287127855104,1,1,0,4,6
611585332,1,2,3,0,6
1306906953713672192,0,5,0,1,6
2937175654,0,6,0,0,6
1606287620,0,6,0,0,6
1351282501,0,6,0,0,6
1432901954,0,6,0,0,6
1083483437749714944,2,4,0,0,6
4915682400,0,6,0,0,6
4381171516,0,5,1,0,6
935565033798623232,0,6,0,0,6
2188789383,0,6,0,0,6
953247272,3,0,0,3,6
2254842222,2,2,2,0,6
176123296,1,5,0,0,6
465787460,2,4,0,0,6
1482229784163893248,0,6,0,0,6
2744280377,0,6,0,0,6
1474939426543308800,1,5,0,0,6
934496121514323968,0,0,2,4,6
3785391622,0,6,0,0,6
875307650,4,0,1,1,6
2254441615,0,6,0,0,6
2744446434,0,6,0,0,6
2941402122,0,6,0,0,6
1230157020335988736,6,0,0,0,6
1487749419382763520,3,0,0,3,6
1235209840466644992,5,1,0,0,6
855011105634041856,0,4,0,2,6
919116207785066496,0,6,0,0,6
162737653,0,6,0,0,6
753891640197181440,0,6,0,0,6
154268758,0,6,0,0,6
272410649,0,5,1,0,6
1117869288503726080,2,4,0,0,6
289700070,0,6,0,0,6
2595020491,0,6,0,0,6
3796137980,0,6,0,0,6
2595707907,0,6,0,0,6
22085981,1,5,0,0,6
19747338,0,6,0,0,6
1356646447136055296,1,5,0,0,6
2790378917,0,6,0,0,6
1244422494418763776,0,6,0,0,6
75205283,0,6,0,0,6
1306731388402532352,0,6,0,0,6
1542478633,0,6,0,0,6
1190244038588416000,0,0,2,4,6
188676602,3,0,0,3,6
2351380419,0,6,0,0,6
1157502704,2,4,0,0,6
90124611,3,0,2,1,6
90112060,2,3,0,1,6
453013039,2,3,0,1,6
1121691587992363008,4,2,0,0,6
2325580417,0,6,0,0,6
543450526,2,1,3,0,6
188333163,1,4,0,1,6
2325651231,0,6,0,0,6
2255456954,0,6,0,0,6
152222099,4,2,0,0,6
786764138,0,6,0,0,6
1357019253099155456,0,6,0,0,6
524557578,0,6,0,0,6
279228459,0,6,0,0,6
453020056,0,6,0,0,6
67918795,0,6,0,0,6
298721986,3,3,0,0,6
1054917054178963456,0,6,0,0,6
169442181,1,0,2,3,6
492138135,0,6,0,0,6
1173834727578456064,0,6,0,0,6
239212362,0,6,0,0,6
1215444095444881408,1,0,0,5,6
1138106612038721536,0,6,0,0,6
1215540147657175040,2,4,0,0,6
1374820224,0,6,0,0,6
1094686603547762688,4,1,1,0,6
123017405,2,2,2,0,6
123010230,0,6,0,0,6
800330075602186240,0,6,0,0,6
1518668053453721600,6,0,0,0,6
1412879008182714368,0,6,0,0,6
3367721238,3,1,0,2,6
1137869464698085376,0,6,0,0,6
1498381354001653760,0,6,0,0,6
720116425852108800,0,6,0,0,6
1173935396360638464,0,6,0,0,6
215593710,0,6,0,0,6
570154747,0,6,0,0,6
2209685654,0,6,0,0,6
955830145784229888,0,6,0,0,6
843547252249583616,0,6,0,0,6
348442430,0,6,0,0,6
1336186099819921408,0,2,1,3,6
728551028199702528,0,6,0,0,6
238167377,0,6,0,0,6
330852770,0,6,0,0,6
1497853714648137728,0,6,0,0,6
2534967565,0,4,0,2,6
402209053,0,2,0,4,6
2635642402,0,6,0,0,6
1260003199,0,6,0,0,6
864516265,0,6,0,0,6
123827993,0,6,0,0,6
3087088080,1,4,0,1,6
3068225635,0,6,0,0,6
1267051688529219584,0,6,0,0,6
1498352617722122240,6,0,0,0,6
3068217028,0,0,0,6,6
409224694,0,6,0,0,6
1170502735910883328,0,6,0,0,6
941414715019759616,4,2,0,0,6
908804000,0,6,0,0,6
130444825,0,6,0,0,6
1336768578289188864,0,6,0,0,6
1173525404738473984,0,6,0,0,6
1256546025227124736,0,6,0,0,6
321857037,0,6,0,0,6
48655111,4,1,1,0,6
1256465945398304768,1,0,0,5,6
2861132409,3,3,0,0,6
2861294735,0,6,0,0,6
4826588926,0,6,0,0,6
2208646204,0,6,0,0,6
869894482400993280,0,6,0,0,6
1514875907722334208,0,2,0,4,6
751936362,0,6,0,0,6
42701045,0,6,0,0,6
1384991112,0,6,0,0,6
577359160,5,1,0,0,6
4776648323,0,6,0,0,6
2496735276,2,1,3,0,6
1067013414852136960,0,6,0,0,6
47914900,0,5,0,1,6
1137577798598504448,3,0,2,1,6
1265259073013837824,6,0,0,0,6
3372268931,1,4,0,1,6
105178245,6,0,0,0,6
1216668361041551360,0,6,0,0,6
1497603442566901760,2,3,1,0,6
501225362,0,6,0,0,6
768772888816128000,0,6,0,0,6
1125940261,0,6,0,0,6
1013431379151990784,0,6,0,0,6
4730390828,5,0,0,1,6
471714125,2,3,1,0,6
1321022886715498496,1,5,0,0,6
822004610,0,6,0,0,6
891561071802273792,4,0,2,0,6
3373643771,2,1,0,3,6
1335143061492543488,6,0,0,0,6
586096133,5,0,1,0,6
2840102943,2,4,0,0,6
3999715159,0,6,0,0,6
2709582227,0,6,0,0,6
2839624622,0,6,0,0,6
2644141136,0,6,0,0,6
229425527,1,0,0,5,6
38253728,0,0,0,6,6
1212014253240025088,0,6,0,0,6
1328285912053157888,0,6,0,0,6
2511225162,0,6,0,0,6
728900834495500288,0,6,0,0,6
38658601,0,6,0,0,6
2379664384,0,6,0,0,6
728956750678917120,6,0,0,0,6
1424396711947034624,4,2,0,0,6
53237132,5,0,0,1,6
1248044845,0,6,0,0,6
331201435,0,6,0,0,6
2522380383,0,6,0,0,6
4004330309,0,0,0,6,6
1207286018879164416,0,6,0,0,6
775372111976226816,0,6,0,0,6
922788697577099264,0,6,0,0,6
1017341231339397120,0,6,0,0,6
1335839058816200704,3,0,1,2,6
388858518,1,5,0,0,6
3062369539,6,0,0,0,6
1425006803239112704,0,1,3,2,6
348719002,0,6,0,0,6
2380249240,2,4,0,0,6
2510586728,5,1,0,0,6
2536667015,0,6,0,0,6
593584968,2,4,0,0,6
214917730,0,6,0,0,6
2178214820,4,2,0,0,6
1411303263387926528,0,6,0,0,6
1177560938276278272,0,6,0,0,6
2705770226,6,0,0,0,6
1130385385773621248,2,2,1,1,6
1170611504103616512,1,5,0,0,6
1267120059236876288,0,6,0,0,6
1130145163454476288,1,5,0,0,6
1499234404442546176,1,5,0,0,6
1267821643373527040,0,6,0,0,6
1100263171636514816,0,6,0,0,6
325549588,0,6,0,0,6
906215269,0,3,1,2,6
870368315687829504,0,6,0,0,6
325399052,1,3,1,1,6
826650550276063232,3,0,1,2,6
1324296500462129152,2,4,0,0,6
971037940653678592,0,6,0,0,6
971013990729076736,6,0,0,0,6
3311704922,0,6,0,0,6
1420356270402400256,0,5,1,0,6
896063413599776768,0,6,0,0,6
324895110,1,5,0,0,6
474736412,1,5,0,0,6
109540425,0,6,0,0,6
496834651,0,6,0,0,6
111667628,3,0,1,2,6
1438851470619779072,1,0,3,2,6
346431276,2,4,0,0,6
1038917746216640512,0,6,0,0,6
111968511,1,5,0,0,6
1213404019281973248,5,0,0,1,6
3127772599,0,6,0,0,6
575310473,6,0,0,0,6
405858077,6,0,0,0,6
1340659946413690880,0,6,0,0,6
4839266283,0,0,5,1,6
940924152181067776,0,6,0,0,6
1140689530892292096,1,4,0,1,6
127352883,6,0,0,0,6
2401526498,0,6,0,0,6
1063861845155565568,1,4,0,1,6
125902413,5,1,0,0,6
1063802833689034752,1,1,4,0,6
3131008429,0,6,0,0,6
41468232,0,6,0,0,6
746868170,1,5,0,0,6
1419144075886809088,1,4,0,1,6
1093766542528073728,0,6,0,0,6
773164322495135744,4,0,1,1,6
1325021968907767808,0,6,0,0,6
2889274562,2,3,0,1,6
392557812,1,2,0,3,6
1325000358133784576,0,6,0,0,6
327170565,0,3,0,3,6
2398812783,0,6,0,0,6
574496622,0,6,0,0,6
1338590808602267648,3,3,0,0,6
2887663908,0,6,0,0,6
1325360876371673088,0,6,0,0,6
4062726074,0,6,0,0,6
1436791328193585152,0,6,0,0,6
50223678,0,6,0,0,6
1063677988548632576,0,6,0,0,6
50230155,0,0,1,5,6
345836811,0,6,0,0,6
222597346,0,1,1,4,6
111377136,0,6,0,0,6
727060611650179072,0,6,0,0,6
1030806668140060672,0,0,0,6,6
1213389883529523200,0,6,0,0,6
3084068365,1,5,0,0,6
2893738487,1,5,0,0,6
956180842006560768,1,3,0,2,6
1180168768112205824,0,6,0,0,6
244463294,5,0,0,1,6
475510590,0,6,0,0,6
904947991,0,6,0,0,6
1326181831478276096,0,6,0,0,6
765424457993289728,0,6,0,0,6
4021426103,1,0,0,5,6
390794834,0,6,0,0,6
108056087,0,6,0,0,6
2302280726,2,4,0,0,6
1435631640940879872,6,0,0,0,6
1214910557855371264,0,6,0,0,6
4190894359,0,6,0,0,6
474831736,0,6,0,0,6
129824860,0,6,0,0,6
765133995671752704,0,6,0,0,6
4018063335,1,5,0,0,6
2532721652,1,2,3,0,6
930833102598893568,0,6,0,0,6
2679579486,0,6,0,0,6
4225561634,0,6,0,0,6
1291636866,0,6,0,0,6
107774943,1,1,2,2,6
112835907,1,1,4,0,6
244806635,0,6,0,0,6
129145104,1,5,0,0,6
886151723525459968,0,6,0,0,6
346509799,0,0,0,6,6
475603026,0,6,0,0,6
822787094200217600,0,6,0,0,6
40548465,3,3,0,0,6
4026375327,0,6,0,0,6
1498992718625837056,3,0,3,0,6
108889014,0,0,0,6,6
972006924676984832,0,6,0,0,6
3137282648,0,6,0,0,6
1340890035122409472,0,6,0,0,6
393130866,0,6,0,0,6
497186713,0,6,0,0,6
3309660587,0,6,0,0,6
870586134119809024,0,5,0,1,6
1416286845701300224,0,6,0,0,6
40320649,0,6,0,0,6
1421288134612951040,0,6,0,0,6
849886565920800768,1,5,0,0,6
479462963,4,2,0,0,6
406802024,0,6,0,0,6
51208268,0,6,0,0,6
4220868280,1,0,0,5,6
2395720188,0,6,0,0,6
1498710077083369472,0,6,0,0,6
827372598740795392,1,5,0,0,6
1267378617366929408,2,4,0,0,6
937965587359289344,1,0,1,4,6
919330369,0,6,0,0,6
727281157465866240,4,0,0,2,6
133850657,0,6,0,0,6
395260504,0,6,0,0,6
3994385679,0,6,0,0,6
335907020,0,6,0,0,6
2388970188,2,4,0,0,6
1448256036658237440,0,6,0,0,6
597257235,0,6,0,0,6
721999370808221696,0,6,0,0,6
910436029,0,6,0,0,6
1253201969281331200,0,4,0,2,6
1346168779005427712,0,6,0,0,6
2875972385,0,6,0,0,6
211187941,0,3,0,3,6
3104470654,5,0,0,1,6
315961602,3,3,0,0,6
1263131858025545728,1,5,0,0,6
136234466,0,6,0,0,6
2869653770,0,6,0,0,6
4156738390,2,0,1,3,6
3049783907,2,4,0,0,6
1533710461,0,6,0,0,6
2654686793,1,5,0,0,6
857769014,0,6,0,0,6
1523321051018674176,0,3,3,0,6
820577460886458368,0,5,0,1,6
4155958512,1,5,0,0,6
1513223490,0,6,0,0,6
1060896252211027968,0,6,0,0,6
3379599005,1,5,0,0,6
1069224548560773120,2,4,0,0,6
395846207,0,6,0,0,6
44197817,1,5,0,0,6
44215923,0,6,0,0,6
1329460587529719808,0,6,0,0,6
211951625,1,5,0,0,6
1447605176710438912,0,6,0,0,6
138100606,0,6,0,0,6
3115542694,0,6,0,0,6
1051792906846134272,0,5,1,0,6
925411109707898880,0,6,0,0,6
350227231,0,6,0,0,6
1274175244916277248,0,6,0,0,6
3050394906,0,6,0,0,6
597041967,0,6,0,0,6
1429820158529269760,0,6,0,0,6
2294950086,0,6,0,0,6
799166808020369408,3,2,1,0,6
842487323992477696,0,6,0,0,6
1590899820,1,5,0,0,6
805424011,5,1,0,0,6
4703596645,5,1,0,0,6
958598392971751424,0,6,0,0,6
508452861,1,5,0,0,6
1102211532258041856,0,6,0,0,6
2648819300,0,5,1,0,6
3159925458,0,6,0,0,6
137645638,0,6,0,0,6
1095890952466714624,0,6,0,0,6
924963530,4,0,1,1,6
977954733775314944,0,6,0,0,6
3337488485,0,6,0,0,6
1068760086229778432,2,3,0,1,6
954660517209083904,4,0,1,1,6
1450033478452584448,0,6,0,0,6
3101283571,5,0,0,1,6
1496755878963433472,3,0,2,1,6
1317709928073551872,0,6,0,0,6
2717869425,0,6,0,0,6
809274386792517632,1,5,0,0,6
1175485756036587520,1,5,0,0,6
234662563,2,4,0,0,6
1168929589256757248,0,6,0,0,6
2517157454,0,6,0,0,6
208998826,0,4,1,1,6
1318162598626529280,0,6,0,0,6
2491689563,1,4,0,1,6
723767705191456768,0,6,0,0,6
1104624775,0,6,0,0,6
958761684,0,6,0,0,6
2875016927,0,0,6,0,6
884564341143461888,0,6,0,0,6
340272848,1,2,1,2,6
234984498,4,0,0,2,6
970157504,2,1,2,1,6
860050962,0,6,0,0,6
994693346,0,6,0,0,6
769150668,1,0,4,1,6
210805695,0,6,0,0,6
999013208223637504,0,6,0,0,6
1449147984915021824,2,0,2,2,6
813940057,5,1,0,0,6
3102312404,5,1,0,0,6
1210205836699734016,0,6,0,0,6
16710907,0,6,0,0,6
2831473664,0,6,0,0,6
1096686674321592320,0,6,0,0,6
2294204539,0,6,0,0,6
3053040672,1,4,1,0,6
1425782893746409472,0,6,0,0,6
595295325,0,6,0,0,6
1041332992763781120,0,5,0,1,6
501916189,0,6,0,0,6
1944084086,1,0,0,5,6
3152169341,1,2,0,3,6
1445286816093986816,4,0,1,1,6
1239644196,0,6,0,0,6
914561073319223296,0,4,2,0,6
2910521926,0,6,0,0,6
1127777131,0,6,0,0,6
470925855,0,6,0,0,6
1522391342,0,6,0,0,6
729980463511646208,1,3,1,1,6
9884232,5,0,1,0,6
1344777147542601728,1,1,3,1,6
1497329796610760704,5,1,0,0,6
1041275912296194048,6,0,0,0,6
1265222541641220096,3,1,1,1,6
3988805686,0,2,0,4,6
3297592656,3,1,0,2,6
1097847511602130944,0,6,0,0,6
1209136345433563136,0,6,0,0,6
1038358989434773504,2,1,3,0,6
1168205827578060800,0,6,0,0,6
4097684727,4,0,1,1,6
808662348655460352,0,3,1,2,6
1445788590886166528,0,6,0,0,6
414844974,0,6,0,0,6
1428360067221389312,0,6,0,0,6
134567231,1,5,0,0,6
1101532489124900864,6,0,0,0,6
969488326154706944,0,6,0,0,6
1096611162454667264,0,6,0,0,6
3301435511,0,0,0,6,6
16201287,0,6,0,0,6
776869266582667264,0,6,0,0,6
3301297483,0,6,0,0,6
1944083467,6,0,0,0,6
1403065038693359616,0,6,0,0,6
729847182,0,6,0,0,6
869470375440265216,0,6,0,0,6
713629540854194176,0,6,0,0,6
1102616419,0,6,0,0,6
808754568691675136,0,5,0,1,6
233583904,0,6,0,0,6
914821974320386048,0,6,0,0,6
3097413466,0,6,0,0,6
338352189,2,3,0,1,6
888716985076510720,0,6,0,0,6
1212009325838778368,0,6,0,0,6
338262900,2,4,0,0,6
1652838936,4,1,1,0,6
501751607,0,6,0,0,6
2292530432,0,6,0,0,6
9540112,5,0,1,0,6
398972615,0,6,0,0,6
470954519,0,6,0,0,6
489596897,3,0,3,0,6
1488793392,0,6,0,0,6
1169456182421065728,0,6,0,0,6
1175084578752651264,0,6,0,0,6
723191235490512896,0,5,0,0,5
1115742312397598720,3,0,0,2,5
494943301,0,5,0,0,5
1333414515078172672,0,5,0,0,5
749348659,0,5,0,0,5
1035531742117916672,3,2,0,0,5
21256749,3,0,0,2,5
937963462206074880,2,3,0,0,5
748168281488449536,0,5,0,0,5
3102043024,3,1,1,0,5
487338515,4,0,0,1,5
1645655809,0,2,3,0,5
2767098649,0,5,0,0,5
1499364678,0,5,0,0,5
1210229629966938112,0,5,0,0,5
1325784623184568320,0,5,0,0,5
1232946288309800960,1,4,0,0,5
1525803500,0,5,0,0,5
1232910569440714752,0,5,0,0,5
112382110,4,0,1,0,5
79692544,0,5,0,0,5
3704090834,1,4,0,0,5
20933985,0,5,0,0,5
1550558886142550016,1,0,1,3,5
1139402552523366400,0,5,0,0,5
528214648,0,5,0,0,5
923115015825129472,0,5,0,0,5
1302491914411937792,0,3,2,0,5
158294161,1,4,0,0,5
157799311,0,4,1,0,5
1460349355,0,5,0,0,5
859510632,0,5,0,0,5
4147300092,0,5,0,0,5
1269883022,4,1,0,0,5
790188074839998464,5,0,0,0,5
2975899495,0,1,0,4,5
362179534,0,5,0,0,5
328010360,0,5,0,0,5
125265395,1,0,0,4,5
3222155008,0,5,0,0,5
877309346,0,5,0,0,5
841383498,1,3,1,0,5
367239066,0,5,0,0,5
2234036934,0,5,0,0,5
538197894,0,5,0,0,5
1538237517312696320,0,2,0,3,5
486638855,0,5,0,0,5
478976173,1,0,0,4,5
2451835142,0,5,0,0,5
327973561,0,5,0,0,5
2975736610,0,5,0,0,5
947107515858264064,0,5,0,0,5
1136708912424656896,0,5,0,0,5
1332695232,3,0,0,2,5
158750260,2,3,0,0,5
3236803154,5,0,0,0,5
1237956158263967744,1,4,0,0,5
111255236,0,5,0,0,5
2204494946,0,5,0,0,5
1480060104527388672,2,3,0,0,5
1021158650,0,5,0,0,5
294265834,0,5,0,0,5
494061886,0,5,0,0,5
1237944643733487616,0,4,0,1,5
982491714463006720,1,0,0,4,5
704421925725011968,0,5,0,0,5
768201468,1,0,1,3,5
528563580,0,5,0,0,5
2154022666,0,5,0,0,5
849046970064932864,5,0,0,0,5
1325706307706494976,0,5,0,0,5
1206510736874172416,4,0,1,0,5
1498504838,0,5,0,0,5
2681747029,0,5,0,0,5
2397394266,0,5,0,0,5
2197922888,0,5,0,0,5
2442057562,2,0,0,3,5
2991845963,0,4,0,1,5
805504513130070016,0,5,0,0,5
1480408653551259648,2,3,0,0,5
445436238,0,5,0,0,5
1300828624363294720,0,0,0,5,5
161958738,1,4,0,0,5
745339531566661632,0,5,0,0,5
629303987,0,5,0,0,5
629303751,0,5,0,0,5
287731262,0,5,0,0,5
1234867785605320704,4,0,0,1,5
907982429444562944,0,5,0,0,5
1212576633980219392,2,0,1,2,5
1044122394120474624,0,5,0,0,5
949022852,0,5,0,0,5
1546205708,0,5,0,0,5
2755963869,0,5,0,0,5
1363762028188471296,0,5,0,0,5
886581103913512960,0,3,0,2,5
1077978708881883136,0,3,0,2,5
1301130592617074688,0,5,0,0,5
1335990734713917440,0,5,0,0,5
632145910,0,5,0,0,5
3231871458,0,5,0,0,5
4103513060,0,5,0,0,5
3116519922,0,5,0,0,5
2379507288,0,5,0,0,5
83478009,3,1,0,1,5
1196412332,0,5,0,0,5
1521787270260719616,2,2,0,1,5
721144917133811712,5,0,0,0,5
838961203,0,5,0,0,5
364427826,0,5,0,0,5
1524448356,1,3,1,0,5
3228697437,1,4,0,0,5
787194961,0,5,0,0,5
1856622134,0,5,0,0,5
1328767649975713792,0,5,0,0,5
4091674529,0,4,1,0,5
720622362866135040,0,5,0,0,5
1300342628265807872,0,5,0,0,5
755489251,0,5,0,0,5
1890202945,4,0,1,0,5
1235892025695916032,1,3,1,0,5
1299813976990191616,0,5,0,0,5
1235914460998635520,1,0,0,4,5
3230203121,0,3,0,2,5
114616674,2,0,0,3,5
2156780675,0,5,0,0,5
331915058,0,5,0,0,5
1211523929279356928,0,5,0,0,5
1897488078,0,5,0,0,5
835970301959655424,1,3,0,1,5
3093936551,0,3,0,2,5
121409209,0,4,1,0,5
1195218865384378368,1,4,0,0,5
364854252,0,5,0,0,5
940172221141590016,5,0,0,0,5
1328145616279457792,0,5,0,0,5
1519638172359081984,0,5,0,0,5
947955392,4,0,0,1,5
341670457,4,1,0,0,5
803526262966788096,0,5,0,0,5
635528630,0,4,1,0,5
804396258379055104,2,2,1,0,5
704997722529595392,0,5,0,0,5
966783984,0,1,0,4,5
484761114,0,5,0,0,5
1233588563532337152,0,5,0,0,5
366159951,0,5,0,0,5
329770455,0,5,0,0,5
1210531090168975360,3,2,0,0,5
2384686650,0,5,0,0,5
3085867816,2,2,0,1,5
2580391273,0,5,0,0,5
1188405355,1,4,0,0,5
1302154165913780224,0,5,0,0,5
1194631710819794944,0,5,0,0,5
1503157994,0,5,0,0,5
1484101640194035712,1,1,1,2,5
1480831585255571456,0,4,1,0,5
529813764,0,5,0,0,5
1233633433521397760,4,0,1,0,5
1156943181935603712,1,3,0,1,5
1484130099477860352,0,5,0,0,5
4432121413,2,3,0,0,5
119414445,0,5,0,0,5
947227537,0,4,1,0,5
14130252,0,5,0,0,5
336942724,0,5,0,0,5
166988187,0,5,0,0,5
1208711427973931008,0,5,0,0,5
723265528320516096,0,3,2,0,5
964474965469859840,0,5,0,0,5
881363239,0,5,0,0,5
923444642984615936,4,0,0,1,5
124084453,2,3,0,0,5
2583202341,0,5,0,0,5
813727380934107136,0,5,0,0,5
113295127,1,4,0,0,5
291727355,0,5,0,0,5
2676458119,0,5,0,0,5
1327458663167119360,0,5,0,0,5
1329699684005318656,0,5,0,0,5
531697240,0,5,0,0,5
1329739530644172800,0,5,0,0,5
165322495,0,5,0,0,5
447078017,0,5,0,0,5
113316539,0,5,0,0,5
1118801658027360256,0,5,0,0,5
1189238636,1,4,0,0,5
2659268907,2,3,0,0,5
1450591573,0,5,0,0,5
1208493639011225600,0,1,0,4,5
746726971686686720,0,5,0,0,5
1481268367898066944,0,4,1,0,5
980476135,0,5,0,0,5
1062760819191091200,0,5,0,0,5
1327133025210077184,4,0,0,1,5
2240622266,0,3,0,2,5
895252698718642176,0,5,0,0,5
531398203,3,1,1,0,5
3694499836,2,0,1,2,5
975277407988080640,0,5,0,0,5
2388964466,1,4,0,0,5
1327037310412656640,0,5,0,0,5
1233840905347649536,0,5,0,0,5
3086779255,3,2,0,0,5
86517969,0,0,0,5,5
868740030,0,0,0,5,5
1303875433537077248,2,0,1,2,5
1497145876711497728,0,5,0,0,5
516690505,0,5,0,0,5
350151449,0,5,0,0,5
735823282113482752,0,5,0,0,5
1319314059171430400,4,1,0,0,5
503956219,0,5,0,0,5
3156312477,1,4,0,0,5
516788863,0,5,0,0,5
1492948542213611520,0,5,0,0,5
1223847380291686400,5,0,0,0,5
846241404,0,2,3,0,5
18234412,0,5,0,0,5
469701518,0,1,1,3,5
3053604349,0,5,0,0,5
1201452249781813248,0,5,0,0,5
884956761580601344,0,5,0,0,5
2713437922,0,5,0,0,5
470094675,0,5,0,0,5
3024572538,5,0,0,0,5
1497237413218820096,2,1,0,2,5
842643922090377216,1,4,0,0,5
1497142524934520832,0,5,0,0,5
317768821,0,5,0,0,5
1129393831877763072,0,5,0,0,5
967296242978992128,0,5,0,0,5
350739927,2,3,0,0,5
1493855467231232000,1,4,0,0,5
1037376017126445056,0,5,0,0,5
936632275730681856,1,4,0,0,5
136263175,0,5,0,0,5
797306601560543232,0,5,0,0,5
1219291475839791104,0,5,0,0,5
3028039900,1,3,0,1,5
871413650,1,4,0,0,5
1068260117358026752,0,5,0,0,5
2715484841,1,4,0,0,5
1351251439620800512,0,0,0,5,5
4307525902,0,5,0,0,5
1011506395135594496,0,5,0,0,5
853186828383473664,0,5,0,0,5
735572166427746304,0,5,0,0,5
1203887463074344960,0,5,0,0,5
96774333,1,0,1,3,5
1071668027609899008,0,5,0,0,5
306037632,2,0,0,3,5
979417006918086656,0,5,0,0,5
94937853,1,4,0,0,5
1123974212039917568,2,3,0,0,5
94782078,5,0,0,0,5
1298165034,0,5,0,0,5
3061396566,0,5,0,0,5
1204507722554773504,0,5,0,0,5
4331107906,2,1,2,0,5
1216630354498465792,0,5,0,0,5
3190598322,0,5,0,0,5
1018564096441143296,0,5,0,0,5
304067927,0,5,0,0,5
3018094874,0,3,2,0,5
1344071916936601600,0,5,0,0,5
1629504288,0,5,0,0,5
1297762580,0,5,0,0,5
1041109890016653312,0,5,0,0,5
1321248485241442304,0,5,0,0,5
853345771,0,3,0,2,5
1123590398302130176,0,5,0,0,5
738459347815137280,0,5,0,0,5
1056962127745806336,1,2,0,2,5
104850697,0,0,2,3,5
1144164709731618816,0,5,0,0,5
1311718488591933440,5,0,0,0,5
1312630237008728064,1,4,0,0,5
144832371,0,5,0,0,5
517766827,0,5,0,0,5
134444979,0,5,0,0,5
1124440839948836864,0,5,0,0,5
104116757,0,5,0,0,5
894427515636244480,0,5,0,0,5
1143955586670833664,0,5,0,0,5
4246192519,2,3,0,0,5
1312331791957594112,1,4,0,0,5
3152699330,0,5,0,0,5
1312018855863164928,0,1,4,0,5
839977372120186880,0,5,0,0,5
3188814719,0,3,0,2,5
95167564,1,4,0,0,5
2602176076,0,5,0,0,5
501806489,4,1,0,0,5
1149726124404105216,0,5,0,0,5
1216871492526493696,0,5,0,0,5
1145351353490989056,0,5,0,0,5
799084113521233920,3,1,0,1,5
1072840779423457280,0,5,0,0,5
2720919823,0,5,0,0,5
1317101824093147136,0,1,0,4,5
1315968773514354688,0,5,0,0,5
896963316601331712,0,5,0,0,5
1315930452285435904,3,2,0,0,5
464643036,0,5,0,0,5
16962189,0,5,0,0,5
713366495527481344,0,5,0,0,5
968113876301737984,0,5,0,0,5
906410420973404160,1,4,0,0,5
311954831,2,3,0,0,5
353072669,3,1,1,0,5
1011941533619245056,0,5,0,0,5
1348343259685212160,2,3,0,0,5
4265299414,2,3,0,0,5
968074568970723328,0,5,0,0,5
1012452957596594176,0,5,0,0,5
2724044638,0,5,0,0,5
1496582235985625088,0,5,0,0,5
1315667079815737344,0,5,0,0,5
999011125,0,5,0,0,5
140234807,0,5,0,0,5
2217831097,1,4,0,0,5
1127056845850533888,1,4,0,0,5
100879344,0,5,0,0,5
313003526,1,4,0,0,5
312774279,1,2,2,0,5
798020900067143680,0,5,0,0,5
352311051,0,5,0,0,5
1220968513038192640,2,3,0,0,5
1347783931849027584,0,5,0,0,5
968179509248888832,0,5,0,0,5
466231188,0,5,0,0,5
139566306,2,2,1,0,5
1239829050,0,5,0,0,5
1347382596645376000,0,5,0,0,5
851837262425980928,0,4,0,1,5
1316327970202673152,0,4,0,1,5
732841536401121280,0,5,0,0,5
139947687,2,3,0,0,5
1127077114879119360,0,5,0,0,5
1146344659284877312,1,4,0,0,5
3042710618,0,5,0,0,5
731946512419323904,0,5,0,0,5
101791211,0,5,0,0,5
936896537812074496,0,5,0,0,5
1314481109539983360,5,0,0,0,5
1496761095952154624,0,5,0,0,5
102207210,2,1,0,2,5
1230562550,0,5,0,0,5
1494182273352343552,3,2,0,0,5
4493615086,0,5,0,0,5
920956809518682112,2,3,0,0,5
1222416675477344256,0,5,0,0,5
840928347324575744,0,5,0,0,5
1145639986999582720,0,5,0,0,5
3159821348,0,5,0,0,5
1125435625447071744,1,3,0,1,5
461774008,0,5,0,0,5
314894442,0,5,0,0,5
3965048477,0,0,0,5,5
98096633,0,5,0,0,5
936664216525819904,0,1,0,4,5
2219932454,0,5,0,0,5
1350410093276364800,0,5,0,0,5
904610626491760640,0,5,0,0,5
17674244,0,5,0,0,5
1125977938485137408,0,5,0,0,5
1348582109812846592,0,5,0,0,5
1314566805088731136,5,0,0,0,5
848844589,0,5,0,0,5
511385902,0,5,0,0,5
3044796743,0,5,0,0,5
2362355449,0,5,0,0,5
1315371762041921536,0,5,0,0,5
1312740907,1,4,0,0,5
17465522,0,5,0,0,5
1348944822002982912,3,0,1,1,5
3036363952,0,5,0,0,5
1346835681973317632,0,5,0,0,5
141334578,1,0,1,3,5
842241001842454528,0,5,0,0,5
467847413,0,5,0,0,5
925350832601751552,1,4,0,0,5
2608457073,0,5,0,0,5
723372277,1,4,0,0,5
797684506949885952,0,5,0,0,5
310348902,1,1,2,1,5
17621534,0,5,0,0,5
2408233724,0,5,0,0,5
709071186,0,2,0,3,5
294959915,0,5,0,0,5
1306573576955482112,0,5,0,0,5
139141293,2,2,0,1,5
323398310,0,5,0,0,5
323553381,0,5,0,0,5
708242955694268416,0,5,0,0,5
323599716,0,5,0,0,5
346764029,0,5,0,0,5
1131750655574470656,0,5,0,0,5
346721099,0,5,0,0,5
782529661,4,0,1,0,5
359462299,0,5,0,0,5
1121394796503994368,0,5,0,0,5
1214735655009284096,0,5,0,0,5
1647257418,0,5,0,0,5
838556314573758464,0,5,0,0,5
1229451110248845312,0,5,0,0,5
702702102,0,5,0,0,5
89226961,0,5,0,0,5
298115888,0,5,0,0,5
707865782676492288,0,5,0,0,5
1152112085096181760,0,5,0,0,5
717603560297525248,0,5,0,0,5
701346781,0,5,0,0,5
3139483733,3,1,1,0,5
811520092219510784,0,5,0,0,5
1228130774672560128,0,5,0,0,5
1014003394963484672,0,5,0,0,5
1356524573169053696,3,1,1,0,5
15336929,1,3,0,1,5
704740640,0,5,0,0,5
782111653,1,2,2,0,5
1214928254353756160,5,0,0,0,5
1151891002946277376,0,5,0,0,5
108112013,0,5,0,0,5
1056320955415441408,0,5,0,0,5
1141374193646411776,3,2,0,0,5
129174592,0,5,0,0,5
1306659191235334144,2,2,1,0,5
1214907179683074048,0,5,0,0,5
3139686201,0,5,0,0,5
475511669,1,4,0,0,5
708314086409412608,0,5,0,0,5
1228728681427685376,0,5,0,0,5
701410498,0,5,0,0,5
742040680604794880,1,3,0,1,5
2373096073,0,4,0,1,5
326879802,1,4,0,0,5
87374150,0,1,0,4,5
1667414192,0,5,0,0,5
327014498,0,4,0,1,5
812850482859294720,0,5,0,0,5
496075532,0,5,0,0,5
1231465163640803328,0,5,0,0,5
126849943,0,4,1,0,5
964719079,0,5,0,0,5
1139977517605851136,0,5,0,0,5
2998223181,0,4,0,1,5
2998175880,0,5,0,0,5
844853745439535104,0,5,0,0,5
880514579612172288,0,5,0,0,5
726072137522487296,0,4,0,1,5
110788643,5,0,0,0,5
1486185368924098560,0,5,0,0,5
771288336,0,5,0,0,5
785246875,1,0,4,0,5
14509000,0,5,0,0,5
1500739254707650560,0,5,0,0,5
794104863223382016,5,0,0,0,5
1075010959335481344,3,1,1,0,5
855352096853336064,1,4,0,0,5
1493642791,0,5,0,0,5
451462519,0,5,0,0,5
1340462095352156160,0,5,0,0,5
1153137397779050496,0,5,0,0,5
742114813082374144,0,5,0,0,5
1131946393671786496,0,5,0,0,5
740271582,0,5,0,0,5
20318742,2,3,0,0,5
109610668,0,5,0,0,5
20328817,0,5,0,0,5
2374212222,0,5,0,0,5
360429542,0,5,0,0,5
838040270000160768,1,4,0,0,5
1499313674468614144,0,5,0,0,5
801671705521483776,0,5,0,0,5
1140874918906798080,0,5,0,0,5
2687079408,3,2,0,0,5
1230744030754983936,0,5,0,0,5
2230949132,0,5,0,0,5
3008657802,0,5,0,0,5
801113838779240448,3,0,0,2,5
845030305,0,5,0,0,5
738994702897295360,0,5,0,0,5
707882390,4,1,0,0,5
521919469,1,3,1,0,5
500335127,0,5,0,0,5
348486984,0,5,0,0,5
1073520540240015360,0,5,0,0,5
1618682941,0,5,0,0,5
1490781224809517056,2,3,0,0,5
980804671668346880,0,5,0,0,5
456248512,1,3,0,1,5
1215858484870123520,0,1,1,3,5
1354554727221047296,0,5,0,0,5
2598734925,3,0,2,0,5
796043438932168704,4,0,1,0,5
1218999031,1,4,0,0,5
839057784968601600,0,5,0,0,5
455650613,4,0,1,0,5
1322242038742446080,0,5,0,0,5
1343165273696653312,1,4,0,0,5
709416069199486976,2,2,0,1,5
1354331450187902976,0,5,0,0,5
148242666,0,5,0,0,5
522413070,2,1,0,2,5
850322937123045376,0,5,0,0,5
356980852,2,2,0,1,5
1019946407875284992,0,5,0,0,5
1497733813354516480,0,2,0,3,5
132487956,1,0,3,1,5
319838655,0,5,0,0,5
1868289253,0,5,0,0,5
132215285,0,5,0,0,5
980651226646786048,0,5,0,0,5
1539310956,3,1,1,0,5
3191787452,0,4,0,1,5
1354038922712551424,0,5,0,0,5
1472066946,1,4,0,0,5
1354103494441988096,1,4,0,0,5
147756414,0,5,0,0,5
906062443906031616,1,3,0,1,5
2210706591,2,0,0,3,5
1123205309911011328,0,4,0,1,5
521310157,0,5,0,0,5
3014926378,1,4,0,0,5
3194069955,0,5,0,0,5
1217578566,0,5,0,0,5
300960262,0,5,0,0,5
1490280767976796160,0,5,0,0,5
1227806274559062016,0,5,0,0,5
885509644516446208,0,5,0,0,5
1013903638694170624,0,5,0,0,5
1227972605627584512,2,3,0,0,5
1342521604748632064,2,1,1,1,5
801063544007618560,2,3,0,0,5
107612608,0,5,0,0,5
850210991803518976,2,0,0,3,5
1131237989818994688,0,2,1,2,5
1664452296,0,5,0,0,5
881455636604743680,0,2,2,1,5
107675497,0,5,0,0,5
3815935215,1,4,0,0,5
358193757,0,5,0,0,5
1356211562814582784,3,2,0,0,5
1252992024,0,5,0,0,5
3196744099,0,5,0,0,5
454112584,0,5,0,0,5
1356369496085295104,4,1,0,0,5
706680578,1,4,0,0,5
149877093,0,5,0,0,5
348431773,0,5,0,0,5
347958455,0,5,0,0,5
739805472715374592,4,1,0,0,5
499876766,0,5,0,0,5
941568968434728960,1,4,0,0,5
522637990,0,5,0,0,5
473691972,0,5,0,0,5
91972756,0,5,0,0,5
3012159857,0,5,0,0,5
2208993433,5,0,0,0,5
1215424094285389824,2,3,0,0,5
1899838152,0,5,0,0,5
301838943,1,4,0,0,5
1151497378266001408,0,5,0,0,5
707014754,0,2,3,0,5
740017038370934784,0,5,0,0,5
988018153,0,5,0,0,5
1292426352,0,5,0,0,5
885416741286928384,0,5,0,0,5
944289646426521600,3,0,0,2,5
1490289572458078208,2,1,2,0,5
965928351134347264,0,5,0,0,5
487054259,0,5,0,0,5
1278610303123628032,0,4,1,0,5
3416123883,0,5,0,0,5
243800788,0,5,0,0,5
1284208025365078016,0,5,0,0,5
894762049,0,5,0,0,5
3310781479,0,5,0,0,5
1462481438230646784,3,1,0,1,5
243821449,0,5,0,0,5
1033259700580704256,0,5,0,0,5
1269553008213397504,3,0,2,0,5
1462392315721523200,0,5,0,0,5
1171472221459476480,3,1,1,0,5
4839819043,0,5,0,0,5
1257771499529723904,4,0,1,0,5
2181773726,4,1,0,0,5
3362154015,0,5,0,0,5
1283432700838326272,0,5,0,0,5
2799596954,0,5,0,0,5
51127088,0,5,0,0,5
827019740086362112,0,2,0,3,5
1416203030953742336,0,5,0,0,5
1052481456,0,5,0,0,5
1100502906619465728,2,0,0,3,5
65296773,3,0,0,2,5
894720362,0,5,0,0,5
192374137,0,5,0,0,5
1024022108089802752,0,5,0,0,5
1463537520050769920,0,5,0,0,5
375645857,0,3,0,2,5
1108085225899229184,3,2,0,0,5
818168777460383744,0,5,0,0,5
1257991095113433088,1,4,0,0,5
65676433,2,3,0,0,5
2796066938,3,0,1,1,5
243680352,0,5,0,0,5
1416866992896815104,0,5,0,0,5
573272182,0,5,0,0,5
1354452691,0,5,0,0,5
3278280936,0,5,0,0,5
375824784,0,5,0,0,5
1002698069513826304,0,4,0,1,5
756412087564402688,0,5,0,0,5
894264139,0,5,0,0,5
267119735,0,5,0,0,5
1391792048190238720,0,3,0,2,5
221186132,0,5,0,0,5
29510241,0,5,0,0,5
2281086927,0,5,0,0,5
895990850,0,5,0,0,5
1386942676034011136,0,5,0,0,5
4647692796,1,4,0,0,5
1148536825,0,0,2,3,5
1100798735485931520,3,2,0,0,5
2498397335,0,5,0,0,5
1271332931668078592,0,5,0,0,5
1187682627140161536,1,4,0,0,5
3288512224,2,3,0,0,5
2280344857,0,5,0,0,5
1561522843,0,5,0,0,5
558016133,0,5,0,0,5
898796903206223872,1,4,0,0,5
1562420778,1,1,1,2,5
1052654482528571392,0,0,0,5,5
1086222959599996928,0,1,2,2,5
1587820957,2,3,0,0,5
1247601355792896000,0,5,0,0,5
1187180025126064128,0,5,0,0,5
1271685451208941568,0,5,0,0,5
262881339,0,0,0,5,5
1441580800894398464,0,5,0,0,5
1394696795008106496,1,3,0,1,5
1105945757012688896,1,3,0,1,5
557576172,5,0,0,0,5
1440800803803959296,0,5,0,0,5
408084708,0,5,0,0,5
1393249912372928512,2,0,2,1,5
1150250298,0,5,0,0,5
407299764,0,5,0,0,5
1048185736086925312,0,5,0,0,5
1586919062,1,4,0,0,5
1120303099,3,2,0,0,5
609099268,0,5,0,0,5
3308160547,0,5,0,0,5
757227648372264960,2,0,0,3,5
1164536985345777664,0,5,0,0,5
3285150242,0,4,1,0,5
1170786870973751296,4,1,0,0,5
929027774353780736,0,5,0,0,5
1415055404208435200,0,0,0,5,5
898779224009519104,1,4,0,0,5
40089945,0,5,0,0,5
422053484,1,4,0,0,5
1188203216363638784,0,5,0,0,5
2559964469,1,3,0,1,5
2262055104,0,5,0,0,5
2894787904,0,5,0,0,5
784023505813766144,0,5,0,0,5
1108093388052533248,0,5,0,0,5
1600916864,0,5,0,0,5
1084637415283683328,1,4,0,0,5
186003942,0,4,0,1,5
753903462887333888,0,0,2,3,5
403996543,0,5,0,0,5
68652000,0,5,0,0,5
3261790883,1,0,0,4,5
996112324451848192,0,5,0,0,5
1267801729610977280,0,3,1,1,5
428488671,1,1,1,2,5
870281538243444736,1,1,1,2,5
392931629,2,2,1,0,5
1287631149112496128,0,5,0,0,5
614960192,0,5,0,0,5
41822226,0,3,2,0,5
49552992,0,5,0,0,5
49571474,2,1,0,2,5
949575309765984256,4,1,0,0,5
2468297768,0,5,0,0,5
1027980783124762624,0,5,0,0,5
1160457672,0,5,0,0,5
1161849867326509056,2,0,0,3,5
1113310022,0,5,0,0,5
272351935,4,0,1,0,5
1467515313172320256,2,2,0,1,5
996033758485729280,0,5,0,0,5
4766430266,2,3,0,0,5
224664403,0,5,0,0,5
224580746,0,5,0,0,5
772822817922355200,0,5,0,0,5
1387087418659151872,1,4,0,0,5
4595087797,0,5,0,0,5
2526387928,1,4,0,0,5
892731355381071872,0,5,0,0,5
1387315412338106368,0,5,0,0,5
1190657371347079168,0,5,0,0,5
753655177119399936,2,3,0,0,5
428550505,0,5,0,0,5
996015765282111488,0,5,0,0,5
185273725,0,5,0,0,5
185332175,0,5,0,0,5
949444351297339392,0,5,0,0,5
3436457163,0,5,0,0,5
373425996,0,5,0,0,5
1288292808726585344,0,0,5,0,5
185595375,0,5,0,0,5
753883974540390400,0,5,0,0,5
2887590341,0,0,0,5,5
1244141037456633856,0,5,0,0,5
3313615699,2,1,0,2,5
1285745374880243712,0,5,0,0,5
374136562,0,5,0,0,5
374136824,0,5,0,0,5
1046278355362942976,0,4,0,1,5
900821134370902016,0,5,0,0,5
1285950576753139712,0,5,0,0,5
810958099,1,4,0,0,5
425788443,0,5,0,0,5
1084362811143184384,1,0,0,4,5
866691853042823168,0,5,0,0,5
374538488,1,3,0,1,5
1465861633843027968,2,3,0,0,5
1154613224,0,5,0,0,5
2257006765,0,5,0,0,5
391961495,2,1,2,0,5
40918443,3,2,0,0,5
1189786283234738176,1,0,0,4,5
1285461211807653888,0,5,0,0,5
2472643020,1,3,0,1,5
991811291248517120,1,2,1,1,5
831642651971645440,0,5,0,0,5
67063379,4,1,0,0,5
1286250636502339584,0,3,1,1,5
1267973189872861184,0,5,0,0,5
2854796390,0,5,0,0,5
1388797289330733056,5,0,0,0,5
68181825,0,5,0,0,5
2254927938,0,5,0,0,5
2788920002,0,5,0,0,5
2888127270,2,3,0,0,5
860574403435823104,1,4,0,0,5
1161996511233708032,0,5,0,0,5
3267034616,0,5,0,0,5
785356542703009792,3,1,0,1,5
1190360429350080512,4,1,0,0,5
773438160751714304,4,1,0,0,5
2888450698,1,0,3,1,5
1697603371,1,1,0,3,5
2938566184,0,5,0,0,5
826357383395995648,0,5,0,0,5
2469953011,0,5,0,0,5
1244282095343673344,0,5,0,0,5
373889269,0,0,3,2,5
900682635545989120,0,5,0,0,5
67404966,0,4,0,1,5
1248142637237846016,0,5,0,0,5
1588073180,0,5,0,0,5
891688269603364864,0,5,0,0,5
203219244,1,4,0,0,5
1931082146,3,2,0,0,5
1453982089645264896,0,5,0,0,5
1251089687235702784,4,1,0,0,5
1101681946386608128,5,0,0,0,5
1400488212313694208,0,3,0,2,5
823885885,0,5,0,0,5
34843815,0,5,0,0,5
776761517421232128,0,5,0,0,5
1400861080012963840,0,0,0,5,5
3392470634,0,5,0,0,5
828973739530399744,0,5,0,0,5
1276816444253224960,0,5,0,0,5
1276800584704823296,1,4,0,0,5
1026368875989008384,0,5,0,0,5
760551858200948736,1,4,0,0,5
999753103779024896,3,1,1,0,5
1025724630441635840,0,5,0,0,5
1401639004706009088,3,2,0,0,5
599628533,0,5,0,0,5
805089864,1,4,0,0,5
3379278778,0,5,0,0,5
990182856520417280,0,5,0,0,5
204485412,0,5,0,0,5
411553655,0,5,0,0,5
1063623229,0,5,0,0,5
248930068,5,0,0,0,5
568290256,0,5,0,0,5
1250765989823893504,0,5,0,0,5
1169551780566327296,0,5,0,0,5
2819009640,3,0,1,1,5
1413164798,0,5,0,0,5
249240433,0,5,0,0,5
2485209116,0,5,0,0,5
2820124853,0,5,0,0,5
2548453517,0,4,0,1,5
387010813,0,5,0,0,5
34405290,0,5,0,0,5
1400118988248686592,0,5,0,0,5
804241634,0,5,0,0,5
249546550,0,5,0,0,5
1400292331950071808,0,5,0,0,5
4875242026,0,5,0,0,5
2271202729,0,5,0,0,5
2902743014,4,1,0,0,5
1254264930531852288,0,4,1,0,5
1168062874251513856,0,5,0,0,5
206814100,1,4,0,0,5
899125795746197504,0,2,3,0,5
209622134,0,5,0,0,5
2905319723,0,5,0,0,5
386035937,0,5,0,0,5
3381752290,0,5,0,0,5
1690899126,0,5,0,0,5
761277743224983552,1,4,0,0,5
1406534337516945408,0,0,0,5,5
2310281947,0,5,0,0,5
3385832319,0,5,0,0,5
777937999917096960,0,0,0,5,5
901392752985886720,1,4,0,0,5
901384058558611456,0,5,0,0,5
1089361608982196224,0,5,0,0,5
2832405609,1,4,0,0,5
56541037,1,4,0,0,5
3384172804,1,4,0,0,5
3299189154,0,5,0,0,5
3382988277,1,0,1,3,5
385765241,0,5,0,0,5
1169150189304778752,0,5,0,0,5
56371486,0,5,0,0,5
1718813785,0,0,0,5,5
414090918,1,4,0,0,5
596458348,0,5,0,0,5
1402940163957813248,0,4,0,1,5
253987740,0,5,0,0,5
951620247781498880,3,0,1,1,5
1047675419858817024,2,2,0,1,5
1402223707691503616,0,5,0,0,5
206999288,0,5,0,0,5
1402480155260592128,0,5,0,0,5
1102804191909724160,0,5,0,0,5
55570917,0,5,0,0,5
1402924908321984512,2,3,0,0,5
2910486957,1,4,0,0,5
1130787222,0,5,0,0,5
2904324101,0,5,0,0,5
55647391,2,3,0,0,5
384602781,0,5,0,0,5
2172479395,0,5,0,0,5
1956234972,1,0,4,0,5
1275459004525883392,1,4,0,0,5
55702332,1,0,0,4,5
386422163,0,5,0,0,5
923528006,0,5,0,0,5
1126479230,0,5,0,0,5
411312739,0,5,0,0,5
2923747222,0,5,0,0,5
1278202915728101376,0,5,0,0,5
1570984430,0,5,0,0,5
389038271,0,5,0,0,5
560207169,1,4,0,0,5
592843983,0,5,0,0,5
1396102195016261632,0,1,2,2,5
1248853385828155392,0,5,0,0,5
2899060498,0,5,0,0,5
1186377356035969024,1,2,0,2,5
1563339156,0,5,0,0,5
933799592247812096,0,5,0,0,5
3291356472,0,0,1,4,5
1442729681246060544,1,4,0,0,5
990586667261087744,0,5,0,0,5
260140484,0,5,0,0,5
199275996,4,1,0,0,5
3305022739,0,5,0,0,5
1280236214331809792,0,5,0,0,5
1165664550471053312,1,4,0,0,5
4883838394,5,0,0,0,5
570023083,1,4,0,0,5
53303731,0,5,0,0,5
1457687594859483136,0,5,0,0,5
1272135977574727680,2,3,0,0,5
1087220141392158720,0,5,0,0,5
1395240329125666816,0,5,0,0,5
3306245114,0,2,0,3,5
389445995,0,5,0,0,5
605422870,5,0,0,0,5
1394961588583550976,0,5,0,0,5
4851658544,0,5,0,0,5
4891315540,0,5,0,0,5
2265526550,1,4,0,0,5
1058075670,0,5,0,0,5
2898091530,0,5,0,0,5
1092149738986766336,0,5,0,0,5
61782046,1,4,0,0,5
2279135917,0,4,1,0,5
1595268781,3,2,0,0,5
1058958818,0,3,0,2,5
2303482809,0,5,0,0,5
2478892204,1,4,0,0,5
952590357467824128,2,0,3,0,5
409921715,0,5,0,0,5
1248633949091315712,1,2,0,2,5
52941510,0,0,4,1,5
53346758,1,4,0,0,5
1280056486572556288,0,5,0,0,5
2811714384,0,0,5,0,5
2901356831,2,2,1,0,5
2901176323,1,3,0,1,5
4728526638,0,5,0,0,5
1141412443,0,2,3,0,5
1687784322,0,5,0,0,5
387708886,0,5,0,0,5
59832229,0,5,0,0,5
4877762848,2,0,3,0,5
2549421622,0,5,0,0,5
1278535935722958848,0,5,0,0,5
54386976,0,5,0,0,5
60108137,0,1,0,4,5
1167107083835101184,0,5,0,0,5
1250386979885404160,0,5,0,0,5
1399386493253144576,0,5,0,0,5
990382790511296512,0,0,2,3,5
59509900,0,5,0,0,5
248806397,1,4,0,0,5
988475668299243520,0,5,0,0,5
829185237070458880,3,0,2,0,5
1372116271,0,0,0,5,5
1410391437481414656,0,5,0,0,5
827960101751320576,0,5,0,0,5
569978920,2,1,0,2,5
1279343361430745088,0,5,0,0,5
1456391604483330048,2,3,0,0,5
1104863599720226816,0,5,0,0,5
2315552700,1,4,0,0,5
1443255628927946752,0,5,0,0,5
1047804468413313024,0,5,0,0,5
1397507585176064000,0,5,0,0,5
988414949239218176,2,3,0,0,5
1272497439082033152,5,0,0,0,5
200879627,0,5,0,0,5
1443466088478609408,1,4,0,0,5
959268553366138880,0,5,0,0,5
38716180,1,1,1,2,5
1443624405809045504,0,5,0,0,5
1061998334,0,5,0,0,5
822099448201433088,0,5,0,0,5
1249829986095091712,0,5,0,0,5
1101137679297667072,0,5,0,0,5
929920808,0,5,0,0,5
1166829228937175040,0,5,0,0,5
201742898,1,0,0,4,5
1163030528,2,2,1,0,5
761905101573423104,0,5,0,0,5
1045011592683839488,0,5,0,0,5
397249593,1,4,0,0,5
1004320977218568192,0,5,0,0,5
24642391,0,5,0,0,5
833065587265908736,0,5,0,0,5
1112943276892545024,0,5,0,0,5
2511624290,1,4,0,0,5
1242430576432492544,2,0,1,2,5
1434798308191518720,0,5,0,0,5
624071090,0,5,0,0,5
1471737907891228672,5,0,0,0,5
1292289983320076288,3,2,0,0,5
1290683297580724224,0,5,0,0,5
770551402204626944,1,4,0,0,5
399620767,0,0,0,5,5
1113946270303969280,0,5,0,0,5
230180582,0,5,0,0,5
1478183766803693568,1,2,2,0,5
72932202,0,5,0,0,5
1160404441339781120,0,5,0,0,5
1096107829587435520,3,0,2,0,5
2863425861,0,5,0,0,5
1239449299345379328,0,0,1,4,5
1160347061201580032,0,2,0,3,5
910137871,0,5,0,0,5
948210091169275904,3,2,0,0,5
1022833411793317888,0,5,0,0,5
282429366,0,5,0,0,5
276818932,0,5,0,0,5
1381812998688268288,0,5,0,0,5
3321563251,1,0,0,4,5
1158210726483283968,0,0,0,5,5
394609986,1,4,0,0,5
888184057,0,5,0,0,5
438406580,0,5,0,0,5
877363459750596608,0,5,0,0,5
2958656599,0,4,0,1,5
71810010,0,0,2,3,5
699606534662201344,1,4,0,0,5
181437486,0,5,0,0,5
175594809,0,5,0,0,5
181182698,1,1,1,2,5
1110536587,0,5,0,0,5
228589876,2,3,0,0,5
236747838,4,1,0,0,5
955221505167642624,0,5,0,0,5
587351682,0,5,0,0,5
229450571,0,5,0,0,5
3599288955,0,0,0,5,5
892524747308662784,4,0,1,0,5
275587425,0,5,0,0,5
2862361952,1,3,0,1,5
48376460,0,5,0,0,5
1111168894432174080,0,5,0,0,5
2246461853,0,5,0,0,5
1434824397160910848,0,5,0,0,5
578377258,0,4,1,0,5
229449638,3,0,1,1,5
1261612929046151168,0,5,0,0,5
1264125429583089664,0,5,0,0,5
1468363967349555200,0,5,0,0,5
1081908974830534656,1,3,1,0,5
2961712864,0,5,0,0,5
1575795470,1,4,0,0,5
4817556171,1,1,1,2,5
1291415420172300288,2,3,0,0,5
2332086689,0,5,0,0,5
4541671637,0,5,0,0,5
1424684267548905472,0,2,0,3,5
1549656463,1,1,0,3,5
43359490,1,0,3,1,5
701302515510411264,0,5,0,0,5
1341708674,0,5,0,0,5
2875958458,0,5,0,0,5
1004488621930381312,0,5,0,0,5
1477191846384209920,0,5,0,0,5
993881131627016192,0,5,0,0,5
2571241085,0,4,0,1,5
2333633944,0,5,0,0,5
1294994310702792704,0,4,1,0,5
4542722901,0,5,0,0,5
1095051218228006912,0,5,0,0,5
1426881632410030080,0,5,0,0,5
993392453976604672,4,0,0,1,5
3344196250,0,5,0,0,5
993318741965352960,2,3,0,0,5
230621281,0,5,0,0,5
833602487575834624,0,4,0,1,5
1380358490783420416,4,1,0,0,5
281270976,3,0,0,2,5
44625505,1,0,2,2,5
1265610791283314688,0,5,0,0,5
1104675984,5,0,0,0,5
833382790800474112,0,1,3,1,5
75757054,0,4,0,1,5
174245971,0,5,0,0,5
1432922748989415424,0,5,0,0,5
2966835651,0,5,0,0,5
238162087,0,5,0,0,5
1192104652973715456,1,1,2,1,5
1472507990410334208,4,1,0,0,5
2288709747,0,5,0,0,5
44885702,0,5,0,0,5
789025338647056384,0,5,0,0,5
1381627285808222208,2,2,1,0,5
2864443986,0,5,0,0,5
1176506916274524160,4,1,0,0,5
586236516,1,2,0,2,5
1242098719337693184,0,5,0,0,5
1029970556601487360,0,5,0,0,5
433285842,0,5,0,0,5
2294415205,0,5,0,0,5
2461965451,2,2,0,1,5
2574677036,4,1,0,0,5
396790309,0,5,0,0,5
541376355,0,5,0,0,5
434705268,0,5,0,0,5
1381490104561250304,1,0,0,4,5
178863686,0,5,0,0,5
48163616,0,5,0,0,5
1098479613083234304,0,5,0,0,5
1112840951305834496,0,5,0,0,5
1294241565649575936,0,5,0,0,5
1472800091643678720,0,5,0,0,5
1173017665,0,5,0,0,5
3599308816,0,5,0,0,5
1444636220,1,1,3,0,5
46391287,0,5,0,0,5
230259857,5,0,0,0,5
549363463,1,1,0,3,5
2243601806,0,5,0,0,5
1468605922293747712,0,5,0,0,5
1373191871879639040,3,1,1,0,5
4576882632,0,5,0,0,5
233556510,1,2,0,2,5
1193914231248187392,5,0,0,0,5
2574174084,0,5,0,0,5
1475395814189060096,0,5,0,0,5
1606249855,0,5,0,0,5
273092389,0,5,0,0,5
4798542294,0,5,0,0,5
1708179012,0,5,0,0,5
1296069049789689856,0,5,0,0,5
1346262450,3,0,2,0,5
2460298526,0,5,0,0,5
1293369512730013696,1,4,0,0,5
1421431602278711296,1,4,0,0,5
1468584911045283840,0,5,0,0,5
429886113,3,2,0,0,5
769188771442987008,1,4,0,0,5
1556235997,0,5,0,0,5
909515698124226560,0,0,3,2,5
224960682,0,5,0,0,5
1099212647969538048,0,5,0,0,5
1238404772266311680,1,0,3,1,5
75518927,2,2,1,0,5
704018559337418752,0,5,0,0,5
992390491105882112,0,5,0,0,5
835221414,0,5,0,0,5
1243438539519361024,2,3,0,0,5
27388115,0,5,0,0,5
1173177649939636224,0,5,0,0,5
788384260512182272,0,5,0,0,5
393502504,0,5,0,0,5
579342153,0,5,0,0,5
1110481650062950400,0,0,2,3,5
694860277427212288,0,5,0,0,5
2287747403,1,4,0,0,5
183874419,0,5,0,0,5
1161315485419311104,2,0,0,3,5
815759943731134464,1,1,0,3,5
954745391605432320,0,0,0,5,5
770060198606147584,0,5,0,0,5
867637606099693568,0,5,0,0,5
2466279397,0,1,0,4,5
24760283,0,5,0,0,5
994468307343294464,1,2,2,0,5
4828958475,1,0,0,4,5
1468541781923209216,0,5,0,0,5
770512786069872640,0,5,0,0,5
1028721756851200000,0,5,0,0,5
402787015,0,5,0,0,5
2334729752,2,1,1,1,5
815831414168047616,0,5,0,0,5
283080797,0,5,0,0,5
1427841197737877504,0,5,0,0,5
581134913,0,5,0,0,5
4561954728,0,5,0,0,5
1372218967163555840,0,5,0,0,5
278902881,0,5,0,0,5
1377608029378596864,0,5,0,0,5
224933701,0,5,0,0,5
1110813766403407872,4,1,0,0,5
171174529,0,5,0,0,5
1422818053033660416,0,5,0,0,5
42534104,0,5,0,0,5
964149950484484096,0,5,0,0,5
403519307,0,5,0,0,5
1432378711328886784,2,0,2,1,5
1478460398517067776,0,5,0,0,5
4827754521,0,5,0,0,5
46508555,0,5,0,0,5
2943987554,0,4,1,0,5
1391600394,1,3,1,0,5
1478448376114995200,0,5,0,0,5
45523116,0,5,0,0,5
1181697792,0,5,0,0,5
1384541059133345792,0,5,0,0,5
1396874924,2,3,0,0,5
2784757639,1,3,0,1,5
549240803,0,5,0,0,5
1241026973209522176,3,0,2,0,5
239822129,0,5,0,0,5
2950714217,0,5,0,0,5
543987945,0,5,0,0,5
2973984783,1,4,0,0,5
226142269,0,5,0,0,5
617605448,0,5,0,0,5
786448846318473216,2,1,2,0,5
2166649470,0,5,0,0,5
369514045,0,4,0,1,5
1194174996454760448,0,5,0,0,5
815585948503248896,0,5,0,0,5
995036354051497984,0,2,0,3,5
4565935752,0,5,0,0,5
47577500,0,5,0,0,5
213571338,0,4,0,0,4
1693366561,1,3,0,0,4
763439293738221568,0,4,0,0,4
729746216037298176,0,4,0,0,4
776007473975230464,0,4,0,0,4
230525837,0,4,0,0,4
120084820,2,1,0,1,4
1255900526178217984,0,4,0,0,4
1272352341979774976,0,4,0,0,4
2708805151,0,2,0,2,4
1142807028152356864,0,4,0,0,4
120520987,4,0,0,0,4
910331688,0,4,0,0,4
799837281511206912,0,4,0,0,4
2707098336,0,4,0,0,4
2900316094,0,2,1,1,4
827955773435047936,0,0,4,0,4
388568001,0,4,0,0,4
2616124279,0,4,0,0,4
1321348002607489024,2,2,0,0,4
132935223,0,4,0,0,4
472157308,0,4,0,0,4
132767616,0,4,0,0,4
214784352,0,4,0,0,4
388467828,0,4,0,0,4
1099751767,0,4,0,0,4
1262160504153182208,0,4,0,0,4
471905210,1,3,0,0,4
843161495534026752,0,4,0,0,4
247653670,0,4,0,0,4
1216373406716743680,0,4,0,0,4
969842828,0,4,0,0,4
1262080130400178176,0,4,0,0,4
335818262,0,4,0,0,4
1320999897886150656,1,3,0,0,4
1321445277073580032,0,4,0,0,4
1137256321441382400,0,4,0,0,4
213876694,0,4,0,0,4
763670409904521216,1,0,0,3,4
2496322922,1,0,3,0,4
1321089567370432512,0,4,0,0,4
1329594568728338432,0,4,0,0,4
764185231637245952,0,4,0,0,4
1705172965,0,4,0,0,4
1321094996917919744,0,2,1,1,4
3098830240,0,4,0,0,4
246933232,0,4,0,0,4
2900399320,0,4,0,0,4
997751375118393344,1,3,0,0,4
319023631,1,3,0,0,4
120239522,0,4,0,0,4
132534830,0,4,0,0,4
247728074,0,4,0,0,4
235131044,2,2,0,0,4
767140387676835840,0,4,0,0,4
133815197,1,3,0,0,4
1039777688322363392,0,4,0,0,4
1253539112595963904,0,4,0,0,4
1253570053972258816,4,0,0,0,4
1318809835224371200,1,1,0,2,4
135770886,1,3,0,0,4
1318866084947234816,0,4,0,0,4
1703911530,0,4,0,0,4
972352129,0,4,0,0,4
1209496008301764608,0,4,0,0,4
1144888821512884224,0,4,0,0,4
1319009142896545792,0,4,0,0,4
250698923,0,4,0,0,4
316521753,1,3,0,0,4
1331812655514849280,0,4,0,0,4
903515982,2,2,0,0,4
730445290986188800,4,0,0,0,4
3052543558,0,4,0,0,4
1218583201720852480,1,1,2,0,4
1169287525237764096,0,4,0,0,4
2412464302,0,4,0,0,4
1331686487834890240,0,4,0,0,4
1319482339123171328,0,4,0,0,4
1263954070110220288,0,4,0,0,4
485761616,1,3,0,0,4
469545437,0,4,0,0,4
914889900222242816,0,4,0,0,4
762669633052614656,0,4,0,0,4
337652070,0,0,4,0,4
350339513,0,4,0,0,4
2870636271,0,4,0,0,4
977572616222359552,0,4,0,0,4
233146123,0,0,4,0,4
2386311784,0,4,0,0,4
252022818,1,3,0,0,4
315481330,0,4,0,0,4
2872793643,2,2,0,0,4
398722393,1,2,1,0,4
315518236,0,4,0,0,4
136645893,0,4,0,0,4
899257537941209088,0,4,0,0,4
136612549,0,4,0,0,4
210959043,0,4,0,0,4
842390761907843072,0,4,0,0,4
1274365411987881984,0,4,0,0,4
1130940072,0,4,0,0,4
762120694708768768,1,3,0,0,4
846774021727313920,1,3,0,0,4
911813376,2,2,0,0,4
762001528676757504,0,3,0,1,4
1274330661588021248,0,4,0,0,4
1716140436,1,3,0,0,4
233442302,2,0,1,1,4
1263709836824346624,0,4,0,0,4
2494012007,0,4,0,0,4
338285585,0,4,0,0,4
1318670601855315968,0,4,0,0,4
1013083421441216512,0,4,0,0,4
2516413854,0,4,0,0,4
1263047385044996096,2,1,1,0,4
1209886475996868608,0,4,0,0,4
118671093,1,3,0,0,4
248853228,0,4,0,0,4
387119233,0,4,0,0,4
2874498986,2,2,0,0,4
119515455,0,4,0,0,4
1651111998,0,2,2,0,4
248954610,1,3,0,0,4
1330417977418661888,1,0,3,0,4
723476153764319232,0,4,0,0,4
1262689141348851712,0,1,0,3,4
213216989,1,0,3,0,4
1217948182166036480,0,4,0,0,4
3060568190,0,4,0,0,4
213260631,0,4,0,0,4
340211958,0,4,0,0,4
1264292427155857408,0,4,0,0,4
804473524979171328,0,4,0,0,4
910635882,0,4,0,0,4
2409974659,4,0,0,0,4
1078396795,0,4,0,0,4
992967060,0,4,0,0,4
119730301,0,4,0,0,4
318296394,0,4,0,0,4
1320696386929606656,0,4,0,0,4
1705114004,0,2,0,2,4
2901983760,0,4,0,0,4
2838957734,2,2,0,0,4
992209789,0,4,0,0,4
336610201,0,4,0,0,4
1264292320054108160,2,2,0,0,4
777112509694304256,1,3,0,0,4
1169505498560946176,3,1,0,0,4
1331093401513574400,0,3,1,0,4
770513456919228416,0,4,0,0,4
1319659206438539264,0,4,0,0,4
895688090563620864,0,4,0,0,4
769561103491891200,4,0,0,0,4
1128378450,0,4,0,0,4
250059719,2,2,0,0,4
350129165,0,4,0,0,4
1218439086978916352,0,4,0,0,4
212485632,1,3,0,0,4
317114925,0,4,0,0,4
411616045,0,3,0,1,4
821485667523956736,0,4,0,0,4
2868990174,0,2,0,2,4
970545192,4,0,0,0,4
1016545663327309824,0,4,0,0,4
1144200769916137472,0,4,0,0,4
824373105749590016,0,4,0,0,4
1104551040,0,4,0,0,4
1144178085249585152,0,4,0,0,4
249778105,0,4,0,0,4
1210372317378990080,0,3,0,1,4
994538420037996544,0,4,0,0,4
2517355358,0,4,0,0,4
1254327180617793536,0,4,0,0,4
212955539,0,4,0,0,4
483395237,0,4,0,0,4
2620318328,0,4,0,0,4
1124915131,0,4,0,0,4
1269224766201688064,3,1,0,0,4
325410806,1,3,0,0,4
2861985535,0,4,0,0,4
1179456359508664320,0,4,0,0,4
1324342712552759296,2,0,1,1,4
2504189233,0,4,0,0,4
385748529,0,4,0,0,4
1213910055793254400,0,4,0,0,4
1212845735365922816,0,4,0,0,4
823515235403395072,0,0,0,4,4
1213879778844925952,0,4,0,0,4
222475722,0,4,0,0,4
2851857973,0,3,1,0,4
1089295957,0,4,0,0,4
1886273497,2,2,0,0,4
2883400317,0,4,0,0,4
1179255666092822528,0,4,0,0,4
123502238,0,1,0,3,4
477490841,1,3,0,0,4
1258473310897106944,0,3,0,1,4
964712029,0,0,2,2,4
1324771749553074176,1,3,0,0,4
862944919,0,4,0,0,4
2852368305,0,4,0,0,4
242682480,0,2,0,2,4
3088776368,0,4,0,0,4
1268584206533136384,0,4,0,0,4
1258691773897084928,0,4,0,0,4
726107100867231744,0,4,0,0,4
2504598239,1,3,0,0,4
239234223,0,4,0,0,4
1258098403701067776,0,4,0,0,4
1324058725439709184,2,2,0,0,4
2850296257,0,4,0,0,4
238248792,0,4,0,0,4
1028304790130970624,0,4,0,0,4
984462134,1,3,0,0,4
2402210804,0,4,0,0,4
1266393388615643136,0,4,0,0,4
1117885662,0,3,0,1,4
860797184,0,4,0,0,4
3074843052,1,1,0,2,4
1257924446288932864,0,4,0,0,4
324508481,0,3,0,1,4
1266591695002574848,0,4,0,0,4
724883874401112064,2,2,0,0,4
1260860392315727872,0,4,0,0,4
2691293724,0,4,0,0,4
330832728,0,2,0,2,4
1117705964,0,4,0,0,4
1324199258707427328,0,4,0,0,4
221366517,0,4,0,0,4
1269420851629142016,0,4,0,0,4
913824729198247936,0,4,0,0,4
1257965641857990656,0,4,0,0,4
227034516,0,4,0,0,4
826719745495941120,0,4,0,0,4
980251603,0,4,0,0,4
1177949063502675968,0,4,0,0,4
1257999868418838528,0,4,0,0,4
325158247,1,1,2,0,4
3075750407,0,4,0,0,4
481242852,2,0,2,0,4
2860954684,0,4,0,0,4
1947855434,0,4,0,0,4
392544077,0,4,0,0,4
2884155197,0,4,0,0,4
344647131,1,0,0,3,4
772695834198740992,0,4,0,0,4
2682328232,2,1,0,1,4
345109361,0,4,0,0,4
479890374,3,0,0,1,4
895731564675575808,0,4,0,0,4
124454836,0,4,0,0,4
981195140,0,2,0,2,4
975645522492043264,0,4,0,0,4
1173224458334679040,0,4,0,0,4
2396856942,0,4,0,0,4
2525778087,0,4,0,0,4
125257191,0,4,0,0,4
861922302,1,3,0,0,4
807004691519438848,0,4,0,0,4
1325679170454605824,4,0,0,0,4
1325691258598125568,1,2,0,1,4
1267419504147001344,0,4,0,0,4
1213428018808406016,0,4,0,0,4
823445830745001984,1,2,1,0,4
1325713026062880768,0,4,0,0,4
1325794297606705152,0,3,0,1,4
224296649,0,4,0,0,4
802828814028042240,0,4,0,0,4
1172970508385751040,0,4,0,0,4
905710579192442880,0,4,0,0,4
2526210658,0,4,0,0,4
965767094,0,4,0,0,4
825987902383472640,0,4,0,0,4
1267266067073810432,2,2,0,0,4
1213123486819868672,0,4,0,0,4
393744715,0,4,0,0,4
2505629423,0,4,0,0,4
345546876,0,4,0,0,4
766599887932850176,2,0,2,0,4
975770621329076224,0,4,0,0,4
223201920,0,4,0,0,4
480602108,0,4,0,0,4
239870254,0,4,0,0,4
223542549,1,3,0,0,4
991988544548716544,0,3,0,1,4
2398140824,4,0,0,0,4
123868670,0,4,0,0,4
1172781207152549888,0,3,0,1,4
1213726758316343296,0,4,0,0,4
1326562025242234880,0,4,0,0,4
478734815,1,3,0,0,4
1213547014706720768,0,4,0,0,4
2527748239,0,4,0,0,4
725936873479147520,0,4,0,0,4
3081155611,0,4,0,0,4
1259151154807820288,0,0,2,2,4
1709398344,2,0,0,2,4
1030058450036969472,0,1,0,3,4
239880115,1,3,0,0,4
225709835,0,4,0,0,4
344531395,2,1,1,0,4
895712281228484608,0,4,0,0,4
393979396,0,4,0,0,4
772502881026969600,0,4,0,0,4
826064151504101376,0,4,0,0,4
1212672354725187584,1,3,0,0,4
1327796121725505536,0,4,0,0,4
1208345257881944064,1,3,0,0,4
1261828081880387584,0,4,0,0,4
342332786,0,4,0,0,4
805824455679193088,3,1,0,0,4
216093732,0,4,0,0,4
483009293,1,3,0,0,4
724138221165273088,4,0,0,0,4
2497310946,0,4,0,0,4
896264250947227648,0,4,0,0,4
2645060291,0,4,0,0,4
1170243604578783232,0,4,0,0,4
2497558740,0,4,0,0,4
1881185678,0,4,0,0,4
1141963536865943552,0,4,0,0,4
1322878616846426112,0,4,0,0,4
1256484013952233472,0,0,2,2,4
2845423634,3,1,0,0,4
1015600139342368768,1,0,1,2,4
1141936805241065472,0,3,1,0,4
3094917613,0,4,0,0,4
968309137,2,2,0,0,4
2534809803,0,4,0,0,4
922078972246142976,1,3,0,0,4
1018083401600000000,0,3,1,0,4
409423857,1,3,0,0,4
245717485,0,4,0,0,4
1141765677524672512,0,4,0,0,4
1261576851035688960,0,4,0,0,4
974282367488675840,0,4,0,0,4
1170440512047853568,0,4,0,0,4
2534772175,0,4,0,0,4
215890085,3,0,1,0,4
1322312794574856192,4,0,0,0,4
221185915,0,4,0,0,4
1251721501,0,4,0,0,4
472937798,1,3,0,0,4
728780108228657152,1,2,1,0,4
131652780,1,3,0,0,4
1177203113138294784,0,0,1,3,4
1211423414214246400,0,4,0,0,4
1322043825779470336,0,4,0,0,4
215262551,0,4,0,0,4
229823662,1,3,0,0,4
388995799,0,4,0,0,4
1712723977,2,2,0,0,4
246562133,0,4,0,0,4
320628332,0,4,0,0,4
1702002295,0,4,0,0,4
395439143,0,4,0,0,4
1322080079539785728,0,4,0,0,4
341978838,0,4,0,0,4
389357537,0,4,0,0,4
1329019673942388736,0,4,0,0,4
2701651377,0,4,0,0,4
1211601534590414848,0,4,0,0,4
1256213863583883264,2,1,1,0,4
2646421692,0,4,0,0,4
1265109122967433216,3,0,0,1,4
977921539,0,4,0,0,4
1215694312178114560,0,4,0,0,4
321180828,0,4,0,0,4
389437594,0,4,0,0,4
905416400709316608,0,4,0,0,4
2844848518,0,4,0,0,4
1256830448828743680,0,4,0,0,4
332262559,0,4,0,0,4
409069730,0,4,0,0,4
332174911,0,4,0,0,4
129048152,3,1,0,0,4
1323746865549070336,0,4,0,0,4
827199623332786176,0,4,0,0,4
1171223670766940160,0,4,0,0,4
1119838124,0,2,2,0,4
475667665,0,4,0,0,4
2510350759,0,4,0,0,4
1141213967492116480,4,0,0,0,4
2501167224,0,4,0,0,4
476062833,1,3,0,0,4
406669494,0,4,0,0,4
401507232,0,4,0,0,4
122644867,0,4,0,0,4
2675769814,0,4,0,0,4
997065720981667840,3,1,0,0,4
997044887777398784,0,4,0,0,4
244232625,3,0,0,1,4
476066319,2,0,0,2,4
976044153741152256,0,0,0,4,4
1269867607525597184,0,4,0,0,4
1174023199975063552,1,3,0,0,4
244183075,0,4,0,0,4
1180071482673655808,0,4,0,0,4
1269692028448890880,2,2,0,0,4
1269677040812339200,2,2,0,0,4
913841083942969344,0,4,0,0,4
3092058549,0,4,0,0,4
996764947857199104,0,3,1,0,4
1214661987323580416,1,3,0,0,4
122385050,0,4,0,0,4
991371457501507584,0,4,0,0,4
219215110,2,0,1,1,4
218320986,0,4,0,0,4
1712460259,0,4,0,0,4
2521671494,0,3,0,1,4
322523697,1,3,0,0,4
1170634991732236288,1,3,0,0,4
1170639291174793216,0,4,0,0,4
822693840922480640,0,4,0,0,4
217763224,0,4,0,0,4
1215195110347902976,1,2,1,0,4
401003490,0,4,0,0,4
2498433732,0,4,0,0,4
1270807629145665536,0,4,0,0,4
3094278383,0,4,0,0,4
1270619084527267840,0,4,0,0,4
801287741132734464,3,0,1,0,4
218978347,4,0,0,0,4
991235382879518720,0,4,0,0,4
228478961,0,4,0,0,4
129555767,2,2,0,0,4
237740362,1,3,0,0,4
228110041,0,4,0,0,4
1323438575384326144,1,3,0,0,4
482387688,0,4,0,0,4
237774223,0,1,0,3,4
1180542135847641088,0,4,0,0,4
922830974932668416,0,0,1,3,4
2849040393,0,4,0,0,4
407806915,0,4,0,0,4
2880431377,3,0,0,1,4
2889746489,0,4,0,0,4
1296623835874127872,0,4,0,0,4
1219554407961907200,2,2,0,0,4
909487118946148352,0,3,1,0,4
939551990,0,4,0,0,4
182962392,0,3,1,0,4
1033998293812961280,0,4,0,0,4
273703510,0,4,0,0,4
1243243755181756416,0,2,1,1,4
897779443653128192,0,4,0,0,4
1289642955494395904,0,3,1,0,4
1034045050424971264,0,4,0,0,4
156758009,0,4,0,0,4
916627543956041728,2,2,0,0,4
1243108095691239424,0,4,0,0,4
361832594,0,4,0,0,4
449548957,0,0,0,4,4
2441031531,0,4,0,0,4
1165402724,1,3,0,0,4
1191338876973043712,3,0,0,1,4
2567825290,0,0,1,3,4
2996491966,0,4,0,0,4
1289479385310007296,0,4,0,0,4
273396340,1,3,0,0,4
449974691,3,0,0,1,4
1161211155651674112,4,0,0,0,4
184824509,0,4,0,0,4
2999224471,0,4,0,0,4
1198544464643608576,2,1,0,1,4
2944209164,0,4,0,0,4
429428538,0,4,0,0,4
373215148,0,4,0,0,4
1230808857846452224,4,0,0,0,4
1161510542479175680,0,4,0,0,4
184349229,0,4,0,0,4
1231059979844456448,0,4,0,0,4
2748752730,1,0,2,1,4
837325399168270336,2,2,0,0,4
2566929507,2,2,0,0,4
1289057638437867520,0,4,0,0,4
1198279287108853760,0,4,0,0,4
2567072328,2,0,0,2,4
1164086682,0,3,1,0,4
182285185,1,0,0,3,4
157621168,0,4,0,0,4
1303580914136444928,0,4,0,0,4
275919748,0,4,0,0,4
917019490944249856,0,2,0,2,4
275927831,0,4,0,0,4
793064510215090176,0,4,0,0,4
180002415,2,2,0,0,4
363064025,0,4,0,0,4
276339716,0,3,0,1,4
1302313389964886016,0,4,0,0,4
2952992409,0,4,0,0,4
1290777447835803648,0,4,0,0,4
1168982911,0,4,0,0,4
1197579260,0,4,0,0,4
816121862958841856,0,4,0,0,4
292545651,0,4,0,0,4
1290996104084033536,0,4,0,0,4
276979261,0,4,0,0,4
1196686187240534016,0,4,0,0,4
160047555,0,4,0,0,4
1233223002600484864,3,0,0,1,4
1023113419136933888,0,3,1,0,4
1232481021062336512,0,4,0,0,4
888257863,0,4,0,0,4
1289795530705567744,2,1,1,0,4
1242778917808848896,2,0,2,0,4
2783907168,0,4,0,0,4
898232920879517696,0,2,0,2,4
181577827,1,3,0,0,4
294131798,0,4,0,0,4
158017981,0,4,0,0,4
181488434,1,2,0,1,4
1160571508206579712,0,4,0,0,4
448147621,0,4,0,0,4
1242745915192102912,0,4,0,0,4
1242648615962591232,0,0,0,4,4
275404608,0,0,0,4,4
1197435818110902272,4,0,0,0,4
1034099191578910720,3,0,1,0,4
786628560093970432,0,4,0,0,4
431831132,4,0,0,0,4
373299249,1,2,1,0,4
1304583469952053248,2,1,0,1,4
433212422,2,2,0,0,4
1199470094209998848,0,4,0,0,4
740778027852963840,0,4,0,0,4
2790194565,3,1,0,0,4
2470408044,0,4,0,0,4
374121138,0,4,0,0,4
300039341,3,1,0,0,4
426651604,0,4,0,0,4
188483871,0,4,0,0,4
151801210,0,4,0,0,4
1162314438680207360,0,4,0,0,4
1288423341368528896,0,4,0,0,4
1190291776692768768,0,4,0,0,4
359144525,1,0,0,3,4
1158209388,0,4,0,0,4
359226321,0,4,0,0,4
1162071408303677440,0,4,0,0,4
1190361679999197184,4,0,0,0,4
187815817,0,4,0,0,4
1742685182,0,4,0,0,4
1228386797719212032,0,4,0,0,4
1162414385467252736,0,4,0,0,4
1286105891327152128,0,4,0,0,4
426367631,3,1,0,0,4
375215166,1,3,0,0,4
150708880,0,4,0,0,4
374567604,0,4,0,0,4
1199965614930120704,1,0,0,3,4
2935843686,4,0,0,0,4
300684661,4,0,0,0,4
300678471,0,4,0,0,4
838786684057575424,0,4,0,0,4
1285873782847090688,2,2,0,0,4
784704489181896704,0,3,0,1,4
1682971345,0,4,0,0,4
1964539285,4,0,0,0,4
897477040697470976,0,4,0,0,4
374452552,0,4,0,0,4
2791052791,0,0,1,3,4
817216875792896000,0,4,0,0,4
374173869,0,4,0,0,4
152345851,1,0,0,3,4
1214518700,1,3,0,0,4
152592550,3,0,1,0,4
360164560,0,4,0,0,4
1230135707735334912,0,4,0,0,4
2436207123,0,4,0,0,4
186063561,0,4,0,0,4
1160511110,2,1,1,0,4
1152840746732408832,0,4,0,0,4
154129464,0,4,0,0,4
742086558174576640,1,2,1,0,4
753899298581049344,1,1,2,0,4
154415802,0,4,0,0,4
272461999,0,4,0,0,4
1161617109891158016,1,3,0,0,4
2592540948,1,1,1,1,4
2437565401,0,3,0,1,4
296727689,2,2,0,0,4
154810187,0,4,0,0,4
876270032,0,4,0,0,4
373388516,1,3,0,0,4
1016941531,2,2,0,0,4
373489035,0,4,0,0,4
299252659,0,4,0,0,4
875389495,0,4,0,0,4
427819616,0,4,0,0,4
2595043700,2,0,1,1,4
187158161,0,4,0,0,4
186980225,1,3,0,0,4
152606632,0,4,0,0,4
298944107,0,3,0,1,4
427954411,0,4,0,0,4
1008799915244490752,0,3,0,1,4
428376116,0,4,0,0,4
298644198,1,1,0,2,4
2434735684,2,2,0,0,4
1160359153,0,4,0,0,4
1287615056973197312,0,0,4,0,4
298571177,0,4,0,0,4
359635634,0,4,0,0,4
451822352,0,4,0,0,4
794744239011807232,4,0,0,0,4
744140368858480640,1,2,0,1,4
160227702,2,2,0,0,4
1183380909048901632,0,4,0,0,4
166177619,2,0,2,0,4
282141400,0,3,0,1,4
985064397574881280,0,4,0,0,4
2966363182,1,3,0,0,4
790945674049286144,2,1,1,0,4
834315532232978432,2,1,1,0,4
1034217336,0,4,0,0,4
165939052,0,4,0,0,4
983865741215592448,0,4,0,0,4
1294966384070467584,3,1,0,0,4
1299260997731934208,2,2,0,0,4
1177853216,0,4,0,0,4
897905782859157504,0,1,3,0,4
366660837,0,4,0,0,4
368417899,0,4,0,0,4
172560108,3,0,0,1,4
441910416,0,4,0,0,4
2770225082,0,4,0,0,4
814789379302522880,0,4,0,0,4
2761247307,0,4,0,0,4
173961916,0,4,0,0,4
1294301232413081600,3,1,0,0,4
1156686259248648192,0,4,0,0,4
2961727349,0,4,0,0,4
909279465338839040,0,3,1,0,4
165062818,0,4,0,0,4
1189653440,0,2,0,2,4
1240193009792114688,0,4,0,0,4
1293702464877875200,1,3,0,0,4
287574893,0,4,0,0,4
1239981633152913408,0,4,0,0,4
287365630,0,3,0,1,4
1175105264,0,4,0,0,4
1158666108821487616,0,4,0,0,4
1912316617,0,4,0,0,4
1158623921509478400,2,0,2,0,4
835868068135993344,0,4,0,0,4
368963735,0,4,0,0,4
750049376056336384,0,4,0,0,4
1035002665,1,3,0,0,4
441747461,0,4,0,0,4
1297955383567249408,0,4,0,0,4
946972735,0,4,0,0,4
171107562,1,0,2,1,4
1006259708288819200,0,4,0,0,4
1297202512135688192,0,3,0,1,4
283201864,1,3,0,0,4
747982329352753152,3,0,0,1,4
2976222640,0,4,0,0,4
748018414032162816,1,3,0,0,4
903456939161427968,1,0,3,0,4
984663142289391616,0,4,0,0,4
1296200803531644928,1,1,2,0,4
834767890901372928,0,4,0,0,4
367619517,1,3,0,0,4
2766940091,1,3,0,0,4
815079644672167936,3,1,0,0,4
169036107,0,4,0,0,4
283897961,4,0,0,0,4
2767073855,2,0,2,0,4
169310612,0,4,0,0,4
1850166343,0,4,0,0,4
440806100,2,2,0,0,4
1297921073653129216,0,4,0,0,4
946045458,0,1,1,2,4
917648482336460800,1,3,0,0,4
172269590,1,2,1,0,4
1853886907,0,4,0,0,4
171932994,0,4,0,0,4
2969505852,0,4,0,0,4
1005855491673632768,0,1,0,3,4
1021917587829997568,0,4,0,0,4
1193825809619918848,0,4,0,0,4
881926662,0,4,0,0,4
167736456,0,3,1,0,4
1193831610048602112,0,4,0,0,4
2978660836,0,4,0,0,4
285245979,0,4,0,0,4
747538384323813376,0,4,0,0,4
834475083519385600,0,4,0,0,4
2765204831,0,4,0,0,4
367060731,0,4,0,0,4
2982800080,0,4,0,0,4
436109726,1,3,0,0,4
2444646074,0,4,0,0,4
745213853504507904,0,4,0,0,4
1241622673211265024,0,4,0,0,4
291126048,0,4,0,0,4
2462643239,0,4,0,0,4
2571267571,0,4,0,0,4
1034444249880653824,0,0,0,4,4
1301084127106494464,2,2,0,0,4
1034490865073500160,0,4,0,0,4
278439376,0,4,0,0,4
290974175,0,4,0,0,4
2983438481,0,4,0,0,4
787486449222451200,0,4,0,0,4
2956952382,0,4,0,0,4
1159517872646950912,0,4,0,0,4
370776083,0,4,0,0,4
942226236,0,4,0,0,4
1155790296690466816,1,2,1,0,4
1292380385326891008,0,4,0,0,4
176821593,3,1,0,0,4
2955642018,0,4,0,0,4
2755599366,4,0,0,0,4
1291795466989035520,0,0,0,4,4
291458860,0,0,0,4,4
1301610504557740032,0,3,1,0,4
178774037,2,2,0,0,4
2991363577,1,2,0,1,4
178701967,0,4,0,0,4
2586495453,0,4,0,0,4
1192129724539166720,0,4,0,0,4
815945837381619712,0,4,0,0,4
2780785365,0,4,0,0,4
2445032341,1,1,2,0,4
836793673119576064,0,4,0,0,4
2586020965,0,4,0,0,4
1196420945109569536,1,1,0,2,4
1022796662555717632,0,4,0,0,4
278084185,0,4,0,0,4
1671066811,0,4,0,0,4
1671352586,0,4,0,0,4
291468320,0,3,0,1,4
370639573,4,0,0,0,4
2779468699,0,4,0,0,4
2461106628,1,0,3,0,4
1158799565056704512,0,4,0,0,4
436034383,0,4,0,0,4
288958810,0,4,0,0,4
2759142186,0,4,0,0,4
1156262252443574272,1,3,0,0,4
1843761528,3,1,0,0,4
1293372151643246592,0,4,0,0,4
1299895568060219392,1,1,1,1,4
1240596683408330752,0,4,0,0,4
280173951,0,4,0,0,4
2776164811,1,3,0,0,4
2984338191,3,0,1,0,4
1299645707498987520,0,4,0,0,4
1195223444205555712,0,4,0,0,4
436069050,0,4,0,0,4
288152289,0,4,0,0,4
1005380665913688064,2,2,0,0,4
2449272162,0,4,0,0,4
983639979049062400,0,4,0,0,4
1035139569111334912,0,4,0,0,4
370638526,4,0,0,0,4
370397049,0,4,0,0,4
814063111435128832,0,4,0,0,4
745369895697801216,0,4,0,0,4
1159120297024299008,1,3,0,0,4
2959441436,0,2,0,2,4
370600535,0,4,0,0,4
2987172431,0,4,0,0,4
279102772,3,0,0,1,4
162748565,0,4,0,0,4
1195777586606964736,0,3,1,0,4
1156075834429640704,1,0,0,3,4
884596832,2,2,0,0,4
2986628520,3,1,0,0,4
2758373863,0,4,0,0,4
175998723,0,4,0,0,4
364991437,0,4,0,0,4
364992260,0,2,0,2,4
1293268689119334400,1,2,0,1,4
2740834912,0,4,0,0,4
755604517580832768,0,4,0,0,4
268768107,0,4,0,0,4
141700480,0,1,3,0,4
3035981456,0,4,0,0,4
1185517467302596608,0,4,0,0,4
1278378906572083200,1,0,1,2,4
2420073912,0,4,0,0,4
1314668233237188608,0,4,0,0,4
2420273269,0,4,0,0,4
141561902,0,2,2,0,4
2608260387,0,4,0,0,4
1238097189056008192,0,4,0,0,4
416492878,0,4,0,0,4
1025328867962220544,2,2,0,0,4
3034629666,0,4,0,0,4
310317124,4,0,0,0,4
202150353,0,4,0,0,4
2607781906,1,3,0,0,4
1222098166473867264,0,2,0,2,4
1278912229153419264,0,4,0,0,4
1278919902997303296,0,4,0,0,4
310730981,0,4,0,0,4
310752243,1,2,1,0,4
1221901680284971008,0,4,0,0,4
202972852,2,2,0,0,4
1140002503,0,4,0,0,4
1019468431152668672,3,1,0,0,4
1000438255,0,4,0,0,4
897041659485077504,0,4,0,0,4
1277855420980355072,0,4,0,0,4
382270334,0,4,0,0,4
1235493254,0,4,0,0,4
1905318102,1,0,3,0,4
921223039756386304,0,4,0,0,4
2419532727,0,4,0,0,4
1221695741044744192,0,4,0,0,4
1167221069918494720,0,4,0,0,4
1657361726,0,4,0,0,4
1250661792600244224,1,3,0,0,4
979012910818131968,0,4,0,0,4
2817302447,2,2,0,0,4
1202527901201117184,2,2,0,0,4
797476887870263296,0,4,0,0,4
1202257979178967040,0,4,0,0,4
201793271,0,4,0,0,4
2728897138,1,0,0,3,4
1061563194,0,4,0,0,4
2728926903,0,4,0,0,4
461297883,3,0,0,1,4
142703303,0,4,0,0,4
1148556522462388224,0,4,0,0,4
418665094,0,4,0,0,4
759303390044168192,3,1,0,0,4
1249545464271134720,1,2,0,1,4
380539184,0,0,2,2,4
1002409105,0,4,0,0,4
418725204,0,4,0,0,4
200400500,0,4,0,0,4
1185974430767276032,0,4,0,0,4
1279927663738699776,0,4,0,0,4
2481240683,0,4,0,0,4
1201932638979809280,0,4,0,0,4
2811707622,0,4,0,0,4
1314048013757829120,0,4,0,0,4
1001997313,0,3,0,1,4
1032214181238525952,1,3,0,0,4
2482317286,3,1,0,0,4
309515027,0,0,0,4,4
2550178776,0,4,0,0,4
1314282720139202560,0,4,0,0,4
1166960827129159680,0,0,0,4,4
840949070587932672,4,0,0,0,4
1185801573173088256,0,4,0,0,4
1279036678242533376,0,4,0,0,4
142300614,0,4,0,0,4
2606230534,2,2,0,0,4
780097129767276544,0,4,0,0,4
1025087704797732864,1,3,0,0,4
381073197,0,4,0,0,4
418557117,0,4,0,0,4
1314177817236721664,3,0,0,1,4
1019543867962548224,0,0,2,2,4
1148516614557569024,0,4,0,0,4
735038793435238400,0,4,0,0,4
140754063,0,4,0,0,4
1185120731941756928,0,4,0,0,4
1285511706110832640,0,3,0,1,4
828526380598042624,0,4,0,0,4
1876626193,0,4,0,0,4
3044846176,0,4,0,0,4
467393283,0,4,0,0,4
2491664966,0,0,0,4,4
1718843431,0,4,0,0,4
1183809666570227712,0,4,0,0,4
996854688,0,4,0,0,4
1145936418889318400,0,4,0,0,4
3043810343,3,0,1,0,4
140610735,0,4,0,0,4
958588333,0,4,0,0,4
253426758,0,4,0,0,4
1275406451977129984,0,4,0,0,4
1241440832,0,4,0,0,4
313652423,0,4,0,0,4
1134434846,4,0,0,0,4
1720077804,0,4,0,0,4
1184050908390232064,0,4,0,0,4
314246169,0,4,0,0,4
1219914560687288320,0,4,0,0,4
1275114868274679808,0,4,0,0,4
314478404,0,0,0,4,4
351121330,0,4,0,0,4
2541734173,1,3,0,0,4
995502204,0,0,0,4,4
413035600,2,0,0,2,4
842357902673297408,0,4,0,0,4
2906847475,0,4,0,0,4
998874959186399232,3,0,1,0,4
3046609091,0,4,0,0,4
1242780972,0,4,0,0,4
1145645827735506944,4,0,0,0,4
1718143904,0,4,0,0,4
252956411,0,4,0,0,4
384926007,0,4,0,0,4
1274966949731147776,0,4,0,0,4
828358502666088448,0,4,0,0,4
1168862843799842816,0,4,0,0,4
1317726556064722944,0,4,0,0,4
2720851096,0,4,0,0,4
2720908023,0,4,0,0,4
809688687965413376,0,4,0,0,4
1184714411505664000,4,0,0,0,4
1202851971918712832,0,4,0,0,4
140044212,0,4,0,0,4
2911734932,0,3,0,1,4
465341234,0,4,0,0,4
254988511,0,4,0,0,4
2911917789,3,0,0,1,4
2546601351,1,0,3,0,4
1721860489,0,4,0,0,4
1167703525926801408,0,4,0,0,4
760236339702865920,2,1,1,0,4
2912514317,0,4,0,0,4
1000305867386900480,0,4,0,0,4
204476969,0,4,0,0,4
2723466488,0,4,0,0,4
1251068665656565760,0,0,0,4,4
1251020261031198720,3,0,1,0,4
1238430890,0,4,0,0,4
1137401989,0,4,0,0,4
2546203996,0,4,0,0,4
1026020235751682048,1,1,0,2,4
1316442011591868416,0,4,0,0,4
2544734159,0,4,0,0,4
899148387013902336,1,3,0,0,4
1168233995945033728,0,4,0,0,4
732342179624968192,0,4,0,0,4
1317027355693617152,0,3,1,0,4
1202944617815138304,0,4,0,0,4
253952894,4,0,0,0,4
1316720157159428096,0,4,0,0,4
2610786610,0,4,0,0,4
139032040,0,4,0,0,4
732470069284851712,0,4,0,0,4
1184191728418467840,0,4,0,0,4
254361915,0,4,0,0,4
2826369146,1,1,0,2,4
1239622891,0,4,0,0,4
1276726052648136704,0,4,0,0,4
2824557344,0,1,0,3,4
199645001,0,4,0,0,4
308235943,0,4,0,0,4
143366039,2,0,2,0,4
783553228537552896,0,4,0,0,4
357247103,3,0,0,1,4
2429023207,2,2,0,0,4
264821728,0,4,0,0,4
796273364755185664,0,4,0,0,4
2799936654,0,4,0,0,4
796262567589117952,0,4,0,0,4
264950445,0,4,0,0,4
1188617594875584512,0,4,0,0,4
147852917,4,0,0,0,4
2918944759,0,4,0,0,4
818494097891721216,0,4,0,0,4
3015939068,0,4,0,0,4
147923342,0,4,0,0,4
1020007376341135360,0,4,0,0,4
1226868943220068352,0,4,0,0,4
302696759,0,4,0,0,4
2799527011,0,4,0,0,4
2475308144,0,4,0,0,4
1310130638029090816,0,3,0,1,4
2737963881,0,4,0,0,4
194895850,0,4,0,0,4
906833716416098304,0,4,0,0,4
457323161,0,4,0,0,4
2735465556,2,0,0,2,4
303995487,1,2,0,1,4
1221767150,1,3,0,0,4
987669156916072448,0,3,1,0,4
146994644,0,4,0,0,4
783009253703479296,0,4,0,0,4
738481922607861760,0,4,0,0,4
1053476772,0,4,0,0,4
783485030089785344,0,4,0,0,4
1188472732046053376,2,0,0,2,4
1164515812994105344,0,4,0,0,4
195033201,0,4,0,0,4
3016671420,1,3,0,0,4
376714494,3,1,0,0,4
2929243201,2,1,1,0,4
1684689961,0,4,0,0,4
1200466422092173312,0,4,0,0,4
376429928,2,0,2,0,4
1732844857,0,4,0,0,4
1163499651716341760,0,4,0,0,4
920045531581304832,0,4,0,0,4
301918835,0,4,0,0,4
1245509468756021248,0,4,0,0,4
1163395458770898944,0,3,0,1,4
455250660,0,4,0,0,4
2740015889,0,4,0,0,4
2933297684,0,3,1,0,4
919998697995255808,3,0,1,0,4
1227551299283116032,2,1,0,1,4
375731811,1,3,0,0,4
1227728927516311552,0,4,0,0,4
1020145167792144384,0,4,0,0,4
755962320195641344,0,4,0,0,4
150233413,0,4,0,0,4
935436955,0,4,0,0,4
358095364,0,4,0,0,4
1245228582726582272,0,4,0,0,4
818246999321419776,0,4,0,0,4
2932614110,0,4,0,0,4
2798989245,0,4,0,0,4
756445926735114240,0,4,0,0,4
1189202738539827200,0,4,0,0,4
756873420059598848,0,3,0,1,4
1200457733058621440,3,0,0,1,4
1245953680731299840,2,2,0,0,4
916184744685195264,0,4,0,0,4
1309329331949273088,1,2,1,0,4
266810324,3,1,0,0,4
987433921292926976,3,1,0,0,4
148642589,1,0,0,3,4
1051519117,0,4,0,0,4
1150940759031463936,0,4,0,0,4
266845680,3,0,0,1,4
902606851107282944,0,4,0,0,4
1227490149765873664,0,4,0,0,4
1152089382,0,4,0,0,4
783860337862901760,1,3,0,0,4
1051431847,1,0,0,3,4
987820980381904896,1,3,0,0,4
2477973888,0,4,0,0,4
1225448083787526144,0,4,0,0,4
2921523811,0,1,0,3,4
1312891771735748608,0,4,0,0,4
1248557704362115072,0,4,0,0,4
2603843168,0,4,0,0,4
1248538816413077504,3,1,0,0,4
796865739193884672,1,3,0,0,4
144426464,0,0,0,4,4
1032617786714017792,0,4,0,0,4
144594078,2,1,0,1,4
2807922602,0,4,0,0,4
197931487,0,4,0,0,4
1248442060975243264,0,4,0,0,4
197828355,0,4,0,0,4
1312685646931091456,2,2,0,0,4
1227426877,2,2,0,0,4
197732739,0,4,0,0,4
2923570457,0,4,0,0,4
736990728400822272,0,1,0,3,4
1145125154,0,4,0,0,4
3025577069,1,3,0,0,4
796801586886541312,0,4,0,0,4
306664702,0,4,0,0,4
1249285991275335680,1,3,0,0,4
379775712,0,4,0,0,4
758669249686765568,0,4,0,0,4
1186344549964304384,0,4,0,0,4
1280721457622863872,3,0,0,1,4
1313449753934405632,0,4,0,0,4
1248969462235176960,0,4,0,0,4
1201643736276578304,0,4,0,0,4
1143981060,0,4,0,0,4
2920919354,0,4,0,0,4
1726101216,0,4,0,0,4
830359032389042176,0,4,0,0,4
2479310096,3,1,0,0,4
1148946682924752896,1,3,0,0,4
2479297661,0,4,0,0,4
915943978268315648,0,4,0,0,4
1149018448133087232,0,4,0,0,4
420920072,0,4,0,0,4
1224602857736826880,2,2,0,0,4
146487163,0,4,0,0,4
458132051,0,4,0,0,4
796675366257618944,2,2,0,0,4
263369078,0,4,0,0,4
818796913642373120,0,4,0,0,4
377794501,0,4,0,0,4
1225047720651624448,0,4,0,0,4
421921631,0,4,0,0,4
933135534,0,4,0,0,4
2602022661,0,4,0,0,4
1225296693199065088,0,0,1,3,4
263675492,0,4,0,0,4
1247089070490206208,0,4,0,0,4
839725392546037760,0,4,0,0,4
2427582319,1,3,0,0,4
782827193000923136,0,4,0,0,4
1150040911822221312,0,4,0,0,4
2601849489,0,4,0,0,4
195767996,1,2,1,0,4
1224936957387526144,0,0,2,2,4
1247445958700331008,0,4,0,0,4
3022618620,0,4,0,0,4
1224839372857577472,0,4,0,0,4
1057368884,0,4,0,0,4
1281854475817238528,0,0,2,2,4
2602944564,0,4,0,0,4
819056108715278336,2,2,0,0,4
1036999008173088768,0,4,0,0,4
421079573,0,1,0,3,4
2425984848,0,4,0,0,4
262502407,0,4,0,0,4
1056015282,0,4,0,0,4
1165123055573774336,0,0,0,4,4
932527399,3,1,0,0,4
839866129807892480,4,0,0,0,4
1032682004817399808,0,0,0,4,4
1282014777674534912,0,4,0,0,4
3021497905,1,3,0,0,4
263060418,0,3,1,0,4
2734039175,0,4,0,0,4
1029599613697843200,0,4,0,0,4
130473177,0,4,0,0,4
1092114047858851840,0,4,0,0,4
498683260,3,1,0,0,4
1594117045,0,4,0,0,4
595247002,0,4,0,0,4
2162375264,0,4,0,0,4
571124664,1,3,0,0,4
103772833,0,4,0,0,4
778672399,0,4,0,0,4
627750610,0,4,0,0,4
1475348289801252864,0,4,0,0,4
541893670,0,4,0,0,4
103570413,0,4,0,0,4
58973463,3,1,0,0,4
570900477,0,4,0,0,4
93628408,1,0,3,0,4
790729873,0,4,0,0,4
103498617,4,0,0,0,4
82326779,0,4,0,0,4
1442672551,0,4,0,0,4
3296320187,0,4,0,0,4
2277228818,0,4,0,0,4
1443202968,1,3,0,0,4
20587289,1,3,0,0,4
952207652649652224,1,3,0,0,4
51880717,0,4,0,0,4
1429006398281723904,2,1,1,0,4
748816495,0,4,0,0,4
1129606614359728128,0,4,0,0,4
4481449578,0,2,0,2,4
1075537428608360448,2,1,0,1,4
4481752993,0,4,0,0,4
2313274468,0,4,0,0,4
715815599692193792,0,4,0,0,4
715833713980997632,1,1,0,2,4
1047957616201273344,3,1,0,0,4
1378756785905930240,0,4,0,0,4
595726221,0,4,0,0,4
3192055903,1,2,0,1,4
1487067348011864064,1,3,0,0,4
3192047210,2,0,2,0,4
532897712,0,4,0,0,4
866290168533266432,0,4,0,0,4
15888299,0,0,2,2,4
621564839,2,0,0,2,4
82728783,0,2,0,2,4
2175523945,1,3,0,0,4
1123181650999824384,0,4,0,0,4
1474863883630387200,0,4,0,0,4
2313341894,1,3,0,0,4
533014614,0,4,0,0,4
93124271,0,1,0,3,4
1338147217,0,4,0,0,4
2368760118,0,4,0,0,4
1299825764,4,0,0,0,4
4536608909,2,2,0,0,4
3153186918,0,4,0,0,4
3638611213,0,4,0,0,4
59400003,4,0,0,0,4
1445950737092161536,0,4,0,0,4
1399639967568171008,4,0,0,0,4
924978188165484544,1,0,3,0,4
1427912152371826688,2,2,0,0,4
51782243,0,4,0,0,4
715521814752071680,0,4,0,0,4
4873627467,4,0,0,0,4
864307738293092352,0,2,2,0,4
4523457616,0,4,0,0,4
627168980,0,4,0,0,4
1375183705472335872,4,0,0,0,4
2185857292,0,4,0,0,4
593123867,1,1,1,1,4
39323338,4,0,0,0,4
1102845246180900864,2,2,0,0,4
564910505,2,2,0,0,4
1402153686688624640,0,4,0,0,4
1056008255531638784,4,0,0,0,4
622711578,0,3,0,1,4
4485950740,2,2,0,0,4
102391476,3,0,1,0,4
1346411533731909632,2,2,0,0,4
1402247876663775232,0,4,0,0,4
81999145,0,4,0,0,4
4054111874,4,0,0,0,4
4301332158,0,4,0,0,4
14575130,0,4,0,0,4
519564489,0,4,0,0,4
1353398316806139904,0,4,0,0,4
1442034362485071872,2,2,0,0,4
3160052592,0,4,0,0,4
1402505272711544832,0,4,0,0,4
1495641286329905152,4,0,0,0,4
1462643299,0,4,0,0,4
592458532,0,4,0,0,4
1430561157836943360,0,0,0,4,4
845486850,0,4,0,0,4
851204513545547776,0,4,0,0,4
1401705124783742976,0,4,0,0,4
520463653,0,4,0,0,4
715156878,0,4,0,0,4
1400497676022648832,0,4,0,0,4
929747590278676480,2,1,1,0,4
1394523895,0,4,0,0,4
966619397199683584,0,4,0,0,4
1505718986444447744,0,0,0,4,4
856845398681554944,0,4,0,0,4
845095003,0,4,0,0,4
1129280286225719296,0,4,0,0,4
851160929840517120,0,4,0,0,4
4848018612,1,3,0,0,4
45712854,0,4,0,0,4
541272792,0,4,0,0,4
1429440202741854208,0,4,0,0,4
1302494612,0,4,0,0,4
963977088486211584,4,0,0,0,4
1353636247135117312,0,3,1,0,4
3369980373,0,4,0,0,4
38944837,1,2,0,1,4
102733483,0,4,0,0,4
82058194,0,2,0,2,4
633628150,3,0,1,0,4
3629339053,0,4,0,0,4
1102975912105201664,1,2,0,1,4
24815642,0,4,0,0,4
732932383,0,4,0,0,4
948228761467736064,0,4,0,0,4
3751476613,0,4,0,0,4
4734274567,0,4,0,0,4
1122977780717772800,2,2,0,0,4
1090611375968120832,0,4,0,0,4
20502607,2,0,0,2,4
13208022,1,0,3,0,4
872539455827169280,0,4,0,0,4
4077046383,0,4,0,0,4
1492662936279605248,0,4,0,0,4
3386862568,0,4,0,0,4
3774679287,1,0,0,3,4
1568220595,0,4,0,0,4
1415748437002244096,2,0,1,1,4
1497587896387260416,1,3,0,0,4
106760890,0,4,0,0,4
717039840399896576,0,4,0,0,4
2188781025,0,4,0,0,4
970106406828257280,0,4,0,0,4
4843687816,0,4,0,0,4
1089318565776248832,1,2,1,0,4
1379924875628924928,0,4,0,0,4
3293441323,0,4,0,0,4
1492698546679980032,2,0,0,2,4
1472706862793445376,0,4,0,0,4
3145529009,0,4,0,0,4
1496526107792887808,0,4,0,0,4
805852652,0,4,0,0,4
2203143379,1,0,3,0,4
1377439021,0,4,0,0,4
876939178830942208,0,4,0,0,4
1449869837992333312,0,4,0,0,4
1397200321399689216,2,2,0,0,4
969952494972530688,0,4,0,0,4
60837608,0,4,0,0,4
4078745773,2,1,0,1,4
1354783932982693888,2,0,0,2,4
25781485,0,4,0,0,4
2202786639,0,4,0,0,4
3247986894,0,4,0,0,4
1122730204076695552,0,4,0,0,4
26098611,0,4,0,0,4
12531062,1,0,0,3,4
3227542806,0,0,0,4,4
3957369568,4,0,0,0,4
966356131177287680,0,4,0,0,4
4884059844,0,4,0,0,4
1451426460477108224,1,3,0,0,4
1131223923796922368,0,2,0,2,4
1451241212309090304,3,0,0,1,4
1131212498701565952,0,4,0,0,4
2344655338,0,4,0,0,4
499296796,0,4,0,0,4
805172677,1,3,0,0,4
1355074650594803712,0,0,0,4,4
876869331845390336,0,4,0,0,4
3321661092,0,4,0,0,4
1397042356528975872,4,0,0,0,4
1451105115197353984,0,4,0,0,4
1426844663344943104,1,3,0,0,4
948621070810071040,0,4,0,0,4
1397085246147887104,2,2,0,0,4
1089247297249202176,0,4,0,0,4
3387897569,0,4,0,0,4
1518681654734299136,2,0,1,1,4
3880649236,0,4,0,0,4
1342782284936617984,0,4,0,0,4
4705560876,0,3,0,1,4
947090977826668544,0,4,0,0,4
1446963901837496320,0,4,0,0,4
3246310327,0,4,0,0,4
806305806,0,4,0,0,4
716488470219325440,0,4,0,0,4
2302150416,1,3,0,0,4
1415175695135805440,2,2,0,0,4
3885544692,0,4,0,0,4
1354509084070977536,0,4,0,0,4
2370125906,0,4,0,0,4
3520689977,3,1,0,0,4
2248950821,1,2,0,1,4
1104478427770281984,0,3,0,1,4
92438100,2,2,0,0,4
1427443902034944000,0,4,0,0,4
1049028559329796096,0,4,0,0,4
1447628602393067520,2,1,0,1,4
1379342905366568960,0,4,0,0,4
1480845040851116032,1,2,0,1,4
709965077416435712,0,4,0,0,4
877107733714960384,0,4,0,0,4
1398787034915999744,0,4,0,0,4
1113221430186000384,0,4,0,0,4
1511092466510086144,1,1,2,0,4
1447133346488889344,0,4,0,0,4
1487218765213634560,0,1,0,3,4
2204274610,0,4,0,0,4
966534426292301824,3,1,0,0,4
543802664,0,4,0,0,4
716315306453434368,1,3,0,0,4
2172179541,0,4,0,0,4
1097024763040620544,0,2,0,2,4
1354597472920686592,4,0,0,0,4
1343541564585377792,1,3,0,0,4
2274123668,1,0,0,3,4
2250107902,0,4,0,0,4
598408457,1,3,0,0,4
1397452366006210560,0,4,0,0,4
3324442529,0,2,0,2,4
1390050931,2,0,2,0,4
561863514,0,4,0,0,4
46931035,0,4,0,0,4
1097095607129436160,1,3,0,0,4
620121400,0,4,0,0,4
1097085219021164544,0,4,0,0,4
1081542317356601344,0,4,0,0,4
1377399956,0,4,0,0,4
1472983947009089536,0,4,0,0,4
597581721,3,1,0,0,4
2184690243,0,4,0,0,4
721347825,0,4,0,0,4
1397831627791912960,1,2,1,0,4
3770574616,3,1,0,0,4
1343856627275862016,2,2,0,0,4
1071368180055056384,0,4,0,0,4
60283734,2,0,0,2,4
4880968707,1,3,0,0,4
935977000438812672,0,4,0,0,4
1580265894,0,4,0,0,4
782996995,2,2,0,0,4
824715092,1,2,0,1,4
1296368268,0,4,0,0,4
1339020913,4,0,0,0,4
76904458,0,4,0,0,4
1403026512715124736,2,1,1,0,4
1571076720,0,4,0,0,4
958065330345168896,0,4,0,0,4
1436198147563442176,0,4,0,0,4
1050320336305250304,0,4,0,0,4
1494694132664520704,0,4,0,0,4
3703430473,1,0,3,0,4
1479377312592367616,0,4,0,0,4
23744918,0,0,1,3,4
98968489,0,4,0,0,4
789656634,0,4,0,0,4
2193088572,0,4,0,0,4
1316936574,0,4,0,0,4
712483855161143296,0,4,0,0,4
958089425933742080,1,3,0,0,4
42238163,1,3,0,0,4
517304517,0,3,1,0,4
772229095,0,4,0,0,4
710955910491979776,0,4,0,0,4
927388080830545920,0,4,0,0,4
1094379608068292608,0,4,0,0,4
838563745,0,4,0,0,4
1498597450134659072,0,4,0,0,4
537389681,1,3,0,0,4
3301532800,1,3,0,0,4
1484580913120178176,0,4,0,0,4
4018917334,0,4,0,0,4
712287711730778112,1,3,0,0,4
1448637420,0,4,0,0,4
2207489075,4,0,0,0,4
514354801,0,4,0,0,4
925747539311181824,0,4,0,0,4
569694013,0,4,0,0,4
2173211368,1,3,0,0,4
1480219207,0,4,0,0,4
1494382011418816512,0,3,0,1,4
2340865182,0,4,0,0,4
17659856,4,0,0,0,4
1371394860264026112,1,3,0,0,4
1411667197701799936,0,4,0,0,4
1101081708466712576,0,4,0,0,4
589040327,1,1,0,2,4
1115986996655263744,0,4,0,0,4
23830200,0,4,0,0,4
1093925536932347904,0,4,0,0,4
1432369204443815936,0,4,0,0,4
3922451176,0,4,0,0,4
3922660414,0,4,0,0,4
1348894360222445568,0,4,0,0,4
15583503,0,4,0,0,4
865646211625136128,0,0,0,4,4
1411355579352698880,0,4,0,0,4
3186040638,0,4,0,0,4
55561573,0,3,0,1,4
710908151042871296,1,3,0,0,4
588479592,0,4,0,0,4
3301276074,0,4,0,0,4
55503465,0,4,0,0,4
3235303774,0,4,0,0,4
4784059584,0,4,0,0,4
1349146522466717696,1,1,0,2,4
1498884208844066816,2,0,0,2,4
937372591324565504,1,0,3,0,4
79536341,0,4,0,0,4
710975252646510592,0,4,0,0,4
3918862093,0,4,0,0,4
1350777482295693312,4,0,0,0,4
1434660560428208128,0,0,0,4,4
857404628077600768,0,3,0,1,4
1484805014485110784,2,2,0,0,4
54435182,2,2,0,0,4
1124907634597847040,0,4,0,0,4
1410110831115878400,0,4,0,0,4
569057224,0,2,0,2,4
3181146550,0,4,0,0,4
711243412285104128,0,3,0,1,4
43096259,0,4,0,0,4
1498261373955969024,0,4,0,0,4
1350759208388616192,0,4,0,0,4
1434099591012573184,2,1,1,0,4
1433996817214095360,0,4,0,0,4
1042837236335738880,0,4,0,0,4
1491826902,3,1,0,0,4
812840910,0,4,0,0,4
1433961372312686592,0,4,0,0,4
1498263347610927104,0,3,0,1,4
1372348016,0,4,0,0,4
1372424840,0,4,0,0,4
954270003015991296,1,3,0,0,4
3608051235,0,4,0,0,4
1042784660391120896,0,4,0,0,4
1124943423180460032,0,4,0,0,4
1351424154981945344,1,1,0,2,4
957806813948211200,3,1,0,0,4
3233728436,0,3,0,1,4
711196308439220224,1,2,0,1,4
1351751524641169408,0,4,0,0,4
2307292392,2,0,2,0,4
1435005099303215104,1,3,0,0,4
1408729276057329664,0,4,0,0,4
79726177,0,4,0,0,4
3347335191,2,0,0,2,4
1498518575006425088,0,3,0,1,4
852509444978216960,0,4,0,0,4
892220239479316480,0,4,0,0,4
1484887107294285824,2,2,0,0,4
3178972576,0,4,0,0,4
4772564864,0,4,0,0,4
1435156663443599360,4,0,0,0,4
1371436952,1,3,0,0,4
711032462541848576,1,3,0,0,4
569091798,0,4,0,0,4
1368967955531198464,0,4,0,0,4
586768008,0,4,0,0,4
15381992,1,3,0,0,4
947398390039457792,0,4,0,0,4
3715624995,3,0,0,1,4
1434952202511020032,0,4,0,0,4
4860579907,0,4,0,0,4
1069901561990660096,0,4,0,0,4
568551590,0,4,0,0,4
3184796793,0,4,0,0,4
1498221455741489152,1,0,3,0,4
1101450509276364800,3,0,1,0,4
777673170,0,4,0,0,4
515469195,1,1,0,2,4
1479047047764328448,4,0,0,0,4
936676816835706880,0,4,0,0,4
865751566095187968,0,4,0,0,4
39779672,0,4,0,0,4
3733074498,0,4,0,0,4
716341834,0,4,0,0,4
1499822307430133760,0,4,0,0,4
1405331264,0,4,0,0,4
94976172,1,3,0,0,4
539876155,0,4,0,0,4
633889156,0,4,0,0,4
77450339,0,4,0,0,4
101258813,0,4,0,0,4
95008403,0,4,0,0,4
930707310279905280,1,3,0,0,4
1497968595670028288,0,1,1,2,4
1404198069164339200,0,4,0,0,4
101196136,0,4,0,0,4
24304618,0,4,0,0,4
584368424,0,4,0,0,4
565845128,0,3,1,0,4
713638171116978176,0,3,0,1,4
1092999744945876992,4,0,0,0,4
856976478684291072,0,3,0,1,4
3231750253,0,2,2,0,4
590541509,4,0,0,0,4
1366818837623005184,0,2,1,1,4
1077105740500881408,0,4,0,0,4
56721372,1,0,1,2,4
1431135872527880192,0,4,0,0,4
1438819939591376896,0,4,0,0,4
776780311,0,3,0,1,4
2205916578,0,4,0,0,4
2280715251,0,4,0,0,4
24420553,0,4,0,0,4
2282728129,0,4,0,0,4
101770915,0,4,0,0,4
2279822997,2,1,0,1,4
879336989362880512,0,4,0,0,4
1353298308437950464,1,3,0,0,4
1346929597766627328,1,0,1,2,4
15770843,0,4,0,0,4
883305192942206976,0,4,0,0,4
1080434054854512640,0,4,0,0,4
1057890761272889344,0,2,0,2,4
17238730,2,2,0,0,4
714422402122383360,0,4,0,0,4
1484098969085313024,2,2,0,0,4
1100806809491693568,0,4,0,0,4
1353041960265789440,0,4,0,0,4
1403340933643390976,0,4,0,0,4
591231865,0,4,0,0,4
864696697699651584,0,4,0,0,4
1477001979108888576,0,4,0,0,4
1055125062674726912,0,4,0,0,4
1413743115639345152,0,4,0,0,4
1403589024728731648,0,4,0,0,4
1608529046,0,4,0,0,4
4047596801,0,4,0,0,4
1619526139,0,4,0,0,4
858188252414705664,0,4,0,0,4
742450412,0,4,0,0,4
57237881,0,4,0,0,4
44877071,1,0,1,2,4
3239160747,0,4,0,0,4
1127239691596550144,0,4,0,0,4
1477517371375902720,0,3,0,1,4
1126612002166587392,0,4,0,0,4
2287629302,0,4,0,0,4
626408825,0,4,0,0,4
1405626340401836032,0,4,0,0,4
78044444,0,4,0,0,4
1437787023973232640,0,1,3,0,4
713252603644088320,0,4,0,0,4
78132388,0,4,0,0,4
585487622,1,3,0,0,4
14940946,1,0,0,3,4
1499066624497704960,0,4,0,0,4
1333875163,0,2,2,0,4
100194695,0,4,0,0,4
704130069351022592,2,0,2,0,4
1591253966,4,0,0,0,4
1126921063047356416,0,4,0,0,4
1402387272,0,0,0,4,4
853478128378716160,0,4,0,0,4
1064628606482243584,2,2,0,0,4
99917671,0,1,0,3,4
1590927708,4,0,0,0,4
1093749165845299200,1,3,0,0,4
892867403666862080,1,1,1,1,4
53198936,0,4,0,0,4
712925855585058816,0,4,0,0,4
958336984732270592,0,4,0,0,4
4786876222,0,4,0,0,4
1590702709,3,0,1,0,4
2176649052,0,4,0,0,4
1115811428395560960,1,3,0,0,4
1437841862891425792,0,4,0,0,4
566682549,0,2,1,1,4
942848180407980032,1,2,1,0,4
2233495160,0,4,0,0,4
623594529,0,4,0,0,4
953021743324647424,0,4,0,0,4
1366924851726987264,0,4,0,0,4
77844550,0,0,3,1,4
3586082896,0,4,0,0,4
4751197098,2,2,0,0,4
1438594627930447872,0,4,0,0,4
3730490777,0,4,0,0,4
940964142101413888,0,4,0,0,4
584992310,0,4,0,0,4
539641530,2,2,0,0,4
4297693333,1,3,0,0,4
1331764711,0,4,0,0,4
40879267,0,4,0,0,4
1412803028302929920,0,4,0,0,4
1124254465274646528,0,4,0,0,4
1347938834634469376,1,2,1,0,4
1477891589523611648,0,4,0,0,4
2245024938,0,4,0,0,4
2233530666,0,4,0,0,4
1477936451811688448,1,1,2,0,4
1624602948,1,3,0,0,4
590012150,0,4,0,0,4
81041240,0,4,0,0,4
1102245363816321024,2,0,2,0,4
589837127,0,4,0,0,4
100348291,0,4,0,0,4
1317784424,0,4,0,0,4
599428028,1,0,1,2,4
964890768514146304,0,4,0,0,4
91775505,0,4,0,0,4
113865302,0,4,0,0,4
16335397,1,0,2,1,4
1085974913364697088,0,4,0,0,4
1491481967162183680,0,3,0,1,4
1107225556364464128,3,1,0,0,4
19725414,0,4,0,0,4
1324023456,0,4,0,0,4
27918523,0,4,0,0,4
1335891358998007808,0,4,0,0,4
3221867083,2,1,0,1,4
4250835111,4,0,0,0,4
1422639230153547776,1,3,0,0,4
85488038,0,4,0,0,4
1355797878,0,4,0,0,4
2199770597,0,4,0,0,4
1496781877696475136,0,4,0,0,4
1083280210953416704,0,4,0,0,4
3408817241,0,3,1,0,4
4659364469,0,4,0,0,4
2350162736,2,0,2,0,4
573642305,0,4,0,0,4
3803073193,0,4,0,0,4
2297719729,0,4,0,0,4
16685803,3,1,0,0,4
615103079,0,4,0,0,4
1043532032528343040,0,4,0,0,4
1467999132354629632,0,4,0,0,4
1489104429530095616,0,4,0,0,4
2181751346,0,4,0,0,4
923584810567815168,1,3,0,0,4
529167304,0,4,0,0,4
720362504292016128,0,4,0,0,4
1388521881888641024,0,4,0,0,4
1461047232346693632,0,4,0,0,4
1560679711,0,4,0,0,4
1334922746287943680,0,4,0,0,4
4651958596,1,3,0,0,4
1526947349498433536,1,3,0,0,4
950332959038558208,2,1,0,1,4
1060400052663959552,0,4,0,0,4
3263173682,0,4,0,0,4
708346173,0,4,0,0,4
3262315090,0,0,1,3,4
608844049,0,4,0,0,4
525984712,0,4,0,0,4
68538519,0,4,0,0,4
1460652636386971648,0,4,0,0,4
576160232,1,3,0,0,4
1060418580964106240,0,4,0,0,4
16645838,0,4,0,0,4
1045705959736315904,4,0,0,0,4
1460508092592885760,2,2,0,0,4
4829306806,2,0,0,2,4
1357777999500836864,0,4,0,0,4
794140836,0,3,1,0,4
1422548658449371136,0,0,0,4,4
3412874044,0,4,0,0,4
1600177009,4,0,0,0,4
3412597017,2,2,0,0,4
2183433789,0,4,0,0,4
1435187862,1,3,0,0,4
3221169342,4,0,0,0,4
923980829994487808,3,0,0,1,4
1133432988421808128,0,4,0,0,4
1074334235505385472,3,0,1,0,4
3796529361,0,4,0,0,4
84865415,1,3,0,0,4
1520947787843911680,0,1,0,3,4
1337276679526309888,0,4,0,0,4
890522725458087936,0,4,0,0,4
961953798712414208,0,4,0,0,4
3201060827,0,4,0,0,4
758572105,1,3,0,0,4
70082685,0,4,0,0,4
70114016,1,3,0,0,4
8627002,2,2,0,0,4
1055625987768139776,0,0,0,4,4
2266501552,0,4,0,0,4
719613033224515584,0,4,0,0,4
1457824195983773696,0,4,0,0,4
89647511,0,4,0,0,4
719444887813361664,3,1,0,0,4
1457794511044743168,2,1,0,1,4
630444922,0,4,0,0,4
1491726186501709824,0,4,0,0,4
1110122656324640768,0,4,0,0,4
604650608,1,3,0,0,4
493639272,0,4,0,0,4
3199813772,0,4,0,0,4
3286803637,1,2,0,1,4
615392412,0,4,0,0,4
1068853171584409600,0,4,0,0,4
955963325715755008,0,4,0,0,4
529532421,0,4,0,0,4
3317104381,4,0,0,0,4
855712244532957184,0,4,0,0,4
492567348,0,4,0,0,4
2254023707,0,4,0,0,4
1086656520358715392,0,0,0,4,4
1457096371,0,4,0,0,4
1056728116477992960,3,1,0,0,4
1488092222,3,0,0,1,4
1458670567104860160,0,4,0,0,4
2174627479,0,4,0,0,4
1098955216026779648,0,4,0,0,4
1468406305601691648,1,1,1,1,4
1417407415088078848,0,4,0,0,4
3317326076,2,2,0,0,4
1472838104,0,4,0,0,4
1074307143778611200,0,0,2,2,4
48364707,2,2,0,0,4
64187925,4,0,0,0,4
64182249,0,4,0,0,4
27567038,1,0,0,3,4
493047813,0,4,0,0,4
946245567738347520,0,4,0,0,4
493064919,1,3,0,0,4
769733575,0,3,0,1,4
605757334,0,4,0,0,4
1055568774580109312,1,3,0,0,4
2346173992,0,4,0,0,4
4611985095,2,1,0,1,4
1528173923912794112,0,4,0,0,4
1361708196281405440,0,4,0,0,4
116676010,0,1,0,3,4
4620188175,1,3,0,0,4
3312750531,0,4,0,0,4
4912210567,0,4,0,0,4
3111710156,0,4,0,0,4
2323701579,2,0,0,2,4
4137248114,0,4,0,0,4
1418606917811904512,1,3,0,0,4
1380068730,0,4,0,0,4
4358457143,0,4,0,0,4
1352385061,0,4,0,0,4
855294862102376448,0,4,0,0,4
2325255286,0,4,0,0,4
881607166372839424,0,3,0,1,4
116445780,0,4,0,0,4
1463162207236096000,0,1,3,0,4
2325587051,2,2,0,0,4
1053235673652576256,0,4,0,0,4
884534756423213056,1,1,0,2,4
1100125724332171264,0,4,0,0,4
116328603,0,4,0,0,4
3215218853,0,4,0,0,4
928692716371787776,0,4,0,0,4
1465293246456905728,0,4,0,0,4
973019915727900672,0,4,0,0,4
961050240764858368,1,2,1,0,4
961678255450357760,0,4,0,0,4
706901519350693888,0,4,0,0,4
2323788350,0,4,0,0,4
2258159569,0,4,0,0,4
1496849555127947264,0,4,0,0,4
4355560637,2,2,0,0,4
1390105953828278272,0,4,0,0,4
4624846821,0,4,0,0,4
1078163434628358144,1,1,2,0,4
3108482523,0,4,0,0,4
117204484,0,4,0,0,4
3272308752,0,4,0,0,4
117101359,2,0,0,2,4
860932653964550144,0,0,0,4,4
67019781,0,4,0,0,4
875868069511352320,0,4,0,0,4
875857756636536832,0,4,0,0,4
1496945886504624128,1,3,0,0,4
527218895,0,3,0,1,4
875833126366437376,2,1,1,0,4
1380477536,0,4,0,0,4
1639073472,2,0,0,2,4
1358833884348231680,0,4,0,0,4
3109847133,0,2,0,2,4
1108228230052528128,0,4,0,0,4
66331433,1,2,0,1,4
116867677,0,4,0,0,4
2257749567,0,4,0,0,4
890677626418991104,2,0,0,2,4
28675431,2,0,1,1,4
1359737282790649856,0,3,0,1,4
1558805497,0,4,0,0,4
1358713872228753408,0,0,0,4,4
1534389820201521152,0,4,0,0,4
1068057982808834048,2,2,0,0,4
1422007822485794816,0,4,0,0,4
115109785,4,0,0,0,4
1085511483767836672,0,4,0,0,4
708324222,3,1,0,0,4
1273434380,0,4,0,0,4
68142840,2,1,0,1,4
960823904724926464,0,3,0,1,4
960776909889007616,1,3,0,0,4
1462112079083556864,0,4,0,0,4
1083801202633121792,0,4,0,0,4
1482964959030317056,4,0,0,0,4
4829712868,0,2,2,0,4
2181772875,0,4,0,0,4
28334056,1,0,0,3,4
4612480704,0,4,0,0,4
2198424034,0,4,0,0,4
4644189808,0,4,0,0,4
28286494,3,0,0,1,4
3417972406,0,4,0,0,4
3117444298,0,4,0,0,4
1135159786331353088,0,0,0,4,4
1482966512336257024,0,4,0,0,4
68324389,0,4,0,0,4
2322431192,0,4,0,0,4
1428090090,0,4,0,0,4
706842308470247424,0,4,0,0,4
1083676752923156480,0,2,2,0,4
1491357333645058048,0,4,0,0,4
5673292,0,4,0,0,4
1119966532577185792,0,4,0,0,4
1466071296836575232,0,4,0,0,4
1389164379006963712,4,0,0,0,4
2155839873,0,4,0,0,4
1073276946992181248,0,3,1,0,4
1358297500872892416,1,0,3,0,4
1583103715,0,4,0,0,4
3113840174,3,0,0,1,4
960951325331730432,0,4,0,0,4
936170605090623488,0,4,0,0,4
1053198870082215936,3,1,0,0,4
115699808,0,4,0,0,4
1485218402,2,2,0,0,4
889478419779661824,0,4,0,0,4
1108046624423501824,4,0,0,0,4
1059886172946616320,0,4,0,0,4
610296428,0,4,0,0,4
86139343,0,4,0,0,4
950085299660468224,0,4,0,0,4
1099638730397167616,4,0,0,0,4
4157686035,0,4,0,0,4
936396498580905984,0,4,0,0,4
1358269767182913536,0,3,0,1,4
3671339362,0,4,0,0,4
1421660611461582848,3,0,0,1,4
610071719,0,4,0,0,4
1482882987658477568,1,3,0,0,4
554745156,0,4,0,0,4
1099370807372009472,0,4,0,0,4
1135227298695659520,3,1,0,0,4
1046625733370675200,0,4,0,0,4
848831443509927936,0,4,0,0,4
32396409,1,3,0,0,4
1433754340066533376,0,4,0,0,4
1356501322061647872,1,0,0,3,4
1378589083,1,3,0,0,4
1384910386562994176,0,1,3,0,4
72952502,1,0,0,3,4
1106106434704588800,4,0,0,0,4
547566259,0,4,0,0,4
2171721500,0,4,0,0,4
3310379782,4,0,0,0,4
1496708324611477504,1,3,0,0,4
2373608546,3,1,0,0,4
1328246376,0,4,0,0,4
879038995572953088,0,2,1,1,4
34881706,0,4,0,0,4
547613640,2,2,0,0,4
966186141174190080,4,0,0,0,4
966233946773250048,0,4,0,0,4
859524223471042560,0,4,0,0,4
1425711196871725056,1,3,0,0,4
1359153374,0,4,0,0,4
3196777339,0,4,0,0,4
3310374215,0,4,0,0,4
1340905003851145216,0,2,0,2,4
1383090623981424640,4,0,0,0,4
1488067109447897088,0,4,0,0,4
3224990459,0,4,0,0,4
3310484979,0,4,0,0,4
603006705,0,4,0,0,4
3249460160,0,4,0,0,4
2271394905,0,4,0,0,4
1356751005661061120,0,4,0,0,4
1634844997,0,4,0,0,4
3197608881,0,0,0,4,4
933785217898295296,0,4,0,0,4
2296483424,0,4,0,0,4
1519063718566543360,0,4,0,0,4
1100498424418381824,0,3,0,1,4
755409601,0,4,0,0,4
3289090174,0,4,0,0,4
1344343052,0,4,0,0,4
1425165742685577216,2,1,1,0,4
930921959633891328,0,4,0,0,4
1355605256151969792,0,4,0,0,4
26959151,0,4,0,0,4
2318206121,1,1,1,1,4
1394570295009181696,0,4,0,0,4
603088287,2,2,0,0,4
1077609803680235520,0,4,0,0,4
1481729726309974016,0,4,0,0,4
1074613085724467200,0,4,0,0,4
1492105506873540608,3,1,0,0,4
108859165,0,4,0,0,4
4091783176,0,4,0,0,4
3136498481,0,4,0,0,4
1454790741545340928,0,4,0,0,4
4558394114,0,3,0,1,4
1340549097074397184,1,0,0,3,4
1481532508076490752,3,1,0,0,4
951366833713680384,1,3,0,0,4
4564441039,0,4,0,0,4
856199580223799296,2,2,0,0,4
3251244769,1,3,0,0,4
944857448342372352,0,4,0,0,4
1451884243,1,2,0,1,4
3784967422,0,4,0,0,4
109136142,0,4,0,0,4
970704308818849792,4,0,0,0,4
3136152450,1,2,0,1,4
1105413353093107712,0,4,0,0,4
4820560893,0,4,0,0,4
109352502,0,4,0,0,4
1054325349092352000,0,4,0,0,4
1340295791269666816,4,0,0,0,4
1454822912792334336,0,4,0,0,4
1286545502,0,4,0,0,4
62123942,0,4,0,0,4
1072116653213782016,0,4,0,0,4
3480213916,0,4,0,0,4
878545370049122304,0,4,0,0,4
717697621113106432,0,3,1,0,4
1344627685,0,4,0,0,4
1437893292,0,4,0,0,4
618967981,1,0,0,3,4
3319763862,1,3,0,0,4
1455597602976636928,0,1,1,2,4
939982659664646144,0,4,0,0,4
33971020,0,4,0,0,4
1382026308939563008,0,4,0,0,4
108961632,0,4,0,0,4
1416387681920028672,2,2,0,0,4
1051880684317548544,2,2,0,0,4
601967955,0,4,0,0,4
578241568,0,4,0,0,4
1455411377095467008,0,4,0,0,4
700439546002063360,2,2,0,0,4
2374822296,1,3,0,0,4
884381533619933184,0,4,0,0,4
3196174818,2,2,0,0,4
930919824666095616,0,4,0,0,4
695747756040830976,0,1,3,0,4
1088332734852849664,0,4,0,0,4
833888316,0,4,0,0,4
951467633781682176,0,4,0,0,4
719116790136045568,0,4,0,0,4
1071751384683438080,0,4,0,0,4
4822056974,1,3,0,0,4
872761472727830528,0,4,0,0,4
3128359511,2,1,0,1,4
4442248156,1,3,0,0,4
819178735,0,3,0,1,4
1347302233,0,4,0,0,4
1043509106789830656,0,4,0,0,4
1074674476586057728,0,4,0,0,4
786446593,0,4,0,0,4
90117365,0,4,0,0,4
494872071,1,2,0,1,4
936515469955051520,1,1,0,2,4
18474950,1,3,0,0,4
616313649,0,4,0,0,4
616623982,0,4,0,0,4
1632232225,0,3,0,1,4
22487595,0,4,0,0,4
1424774039952842752,0,4,0,0,4
1497320184486453248,0,4,0,0,4
881197285769654272,0,4,0,0,4
3140472711,1,3,0,0,4
3392277700,0,4,0,0,4
928182816201936896,0,4,0,0,4
1338459550870073344,4,0,0,0,4
498241523,0,4,0,0,4
1071746088284143616,1,0,1,2,4
1424908874595934208,0,4,0,0,4
1469537759459102720,1,3,0,0,4
951414482974203904,0,4,0,0,4
1072812858768015360,0,4,0,0,4
3257831887,0,4,0,0,4
891325495626919936,0,2,2,0,4
70318789,0,4,0,0,4
577935283,0,4,0,0,4
1470027577536385024,2,2,0,0,4
4098993063,0,4,0,0,4
849336343876567040,0,4,0,0,4
84645524,1,3,0,0,4
1357100030230994944,0,4,0,0,4
1519656413701804032,0,4,0,0,4
3257007001,0,3,0,1,4
2351432133,3,1,0,0,4
603547258,0,4,0,0,4
941778837851066368,1,3,0,0,4
709099231768944640,0,4,0,0,4
1396141108292317184,1,3,0,0,4
1386188963921137664,1,0,3,0,4
4928683204,0,4,0,0,4
1291191374,0,4,0,0,4
1457467793016639488,2,1,0,1,4
1100633796318236672,0,4,0,0,4
2319464377,4,0,0,0,4
1048271577576591360,0,3,0,0,3
4837573787,0,3,0,0,3
1696737355,0,3,0,0,3
292147170,2,0,1,0,3
3312987425,0,3,0,0,3
1272420649491787776,0,3,0,0,3
293119259,0,3,0,0,3
1196626145296338944,2,0,1,0,3
405065800,0,3,0,0,3
1021415242226634752,0,3,0,0,3
49896590,0,3,0,0,3
407567503,1,2,0,0,3
1911930780,0,3,0,0,3
1268409696580329472,1,2,0,0,3
1584755346,0,3,0,0,3
945942552393502720,0,3,0,0,3
1268417746854916096,0,3,0,0,3
1172193377175121920,1,0,0,2,3
991931888330735616,0,3,0,0,3
49801094,0,2,1,0,3
3308881334,0,3,0,0,3
223231212,0,3,0,0,3
223109601,0,0,2,1,3
2755887604,1,2,0,0,3
214037616,3,0,0,0,3
1483649675987238912,0,3,0,0,3
1270048503515889664,1,2,0,0,3
1268793224874938368,0,3,0,0,3
1270287150647517184,0,3,0,0,3
3309374924,0,3,0,0,3
792656355266093056,3,0,0,0,3
1545934860,0,2,0,1,3
914018288363098112,0,3,0,0,3
569425982,0,3,0,0,3
1418159369414447104,0,3,0,0,3
407251342,0,3,0,0,3
214280715,0,3,0,0,3
51052182,0,3,0,0,3
793200027879542784,0,3,0,0,3
2754961925,0,2,1,0,3
219457059,0,0,3,0,3
573964261,1,0,2,0,3
765901536467836928,0,3,0,0,3
51266625,2,1,0,0,3
1418696535584411648,3,0,0,0,3
2892810858,1,0,2,0,3
220123776,0,3,0,0,3
1101113472337625088,0,3,0,0,3
1410538719556214784,0,3,0,0,3
4835584722,0,2,0,1,3
1101140155220541440,0,3,0,0,3
406622781,0,3,0,0,3
1456749710,0,3,0,0,3
1695666805,0,3,0,0,3
763777686267453440,0,3,0,0,3
1030396048437641216,3,0,0,0,3
213999070,0,3,0,0,3
765951710711975936,0,3,0,0,3
3303652221,0,3,0,0,3
3304206764,2,1,0,0,3
1119826993,0,3,0,0,3
1119016982,0,3,0,0,3
991914385412149248,2,1,0,0,3
1268733944205320192,0,3,0,0,3
2304791010,1,0,0,2,3
3691912873,0,3,0,0,3
1171120111312203776,2,1,0,0,3
1233051685427302400,0,0,0,3,3
223051655,3,0,0,0,3
214645916,1,2,0,0,3
2754885460,3,0,0,0,3
50072748,0,3,0,0,3
50057897,0,3,0,0,3
223039363,2,1,0,0,3
572376187,0,3,0,0,3
1022429659,0,3,0,0,3
407223551,0,3,0,0,3
4855400355,0,3,0,0,3
1272578469306658816,1,1,1,0,3
3312762027,0,2,0,1,3
410681969,0,3,0,0,3
3309829364,2,0,1,0,3
363534987,0,3,0,0,3
1270990737799340032,0,3,0,0,3
571718122,0,3,0,0,3
1171163131575324672,0,3,0,0,3
217918583,0,3,0,0,3
1379233334,0,3,0,0,3
4837985183,0,3,0,0,3
363233907,0,0,2,1,3
3307400673,0,3,0,0,3
1170503277190025216,0,3,0,0,3
1234448893305331712,1,2,0,0,3
1378678410,0,3,0,0,3
1376864118,0,3,0,0,3
1021064080210178048,0,3,0,0,3
764635615765815296,0,3,0,0,3
221716836,0,3,0,0,3
2891815935,0,3,0,0,3
632232388,1,1,1,0,3
1170670176997642240,0,3,0,0,3
1170491859287724032,0,3,0,0,3
291399592,1,0,2,0,3
363282733,0,3,0,0,3
21670169,0,3,0,0,3
991219890630541312,0,3,0,0,3
1269221671854116864,0,3,0,0,3
1376072016,0,3,0,0,3
570663307,0,3,0,0,3
1196454638616285184,0,3,0,0,3
408007023,0,3,0,0,3
1100772508121395200,0,3,0,0,3
2173906322,0,3,0,0,3
632227933,0,3,0,0,3
4845372579,0,2,0,1,3
1416641624940163072,1,1,1,0,3
957310400349069312,2,1,0,0,3
1585240448,0,1,0,2,3
2891158997,0,3,0,0,3
765454955264172032,0,3,0,0,3
1378740463,0,3,0,0,3
1694741569,0,3,0,0,3
570789842,0,3,0,0,3
573078734,0,3,0,0,3
2186397991,1,1,0,1,3
408392322,0,3,0,0,3
1414189168972939264,0,3,0,0,3
1414204542200295424,1,2,0,0,3
291528635,0,3,0,0,3
1170632982576545792,2,0,0,1,3
1233636179880230912,1,2,0,0,3
4436325676,0,3,0,0,3
1170591369955631104,0,3,0,0,3
573299538,0,3,0,0,3
3311172460,0,3,0,0,3
217044098,0,3,0,0,3
1271356804279070720,1,1,0,1,3
1376738887,0,3,0,0,3
363154252,0,3,0,0,3
216959858,0,3,0,0,3
221474601,0,3,0,0,3
1585291406,0,3,0,0,3
1414343057227620352,0,3,0,0,3
570785610,1,2,0,0,3
1077427573938929664,0,3,0,0,3
1100296168356134912,0,3,0,0,3
792756662226587648,1,1,0,1,3
2891735306,0,3,0,0,3
1414132397046525952,0,3,0,0,3
217711495,0,3,0,0,3
764666755381735424,0,3,0,0,3
291612160,0,3,0,0,3
21332426,0,3,0,0,3
949108940,0,3,0,0,3
1545657277,0,3,0,0,3
1586948678,0,3,0,0,3
570104652,0,3,0,0,3
2898611184,1,2,0,0,3
2889839837,0,3,0,0,3
1272143784818511872,2,0,1,0,3
1269670641797599232,3,0,0,0,3
408523368,1,2,0,0,3
2173340981,0,3,0,0,3
1030550197632294912,0,3,0,0,3
222263486,0,3,0,0,3
903796708332724224,0,3,0,0,3
1170813646177542144,0,3,0,0,3
1171442795590012928,1,2,0,0,3
215609024,0,3,0,0,3
1269613348003471360,2,1,0,0,3
407647218,0,3,0,0,3
1022330150,0,2,1,0,3
570092603,0,1,2,0,3
220692443,3,0,0,0,3
1268840955525754880,0,3,0,0,3
215324957,0,3,0,0,3
218813424,0,3,0,0,3
1100268873671196672,0,3,0,0,3
865844259240505344,0,1,0,2,3
1412290682069217280,0,3,0,0,3
1100427562101149696,0,2,0,1,3
899614843426222080,3,0,0,0,3
1412261447254614016,0,3,0,0,3
220668134,2,0,1,0,3
4854073347,0,3,0,0,3
215182448,0,0,0,3,3
1170924587942653952,0,3,0,0,3
879206399816986624,0,3,0,0,3
2898523238,3,0,0,0,3
2301222555,3,0,0,0,3
52649214,0,3,0,0,3
1170332174282719232,2,1,0,0,3
221028149,0,3,0,0,3
409571161,1,0,1,1,3
866683600837718016,0,3,0,0,3
950530418,0,3,0,0,3
1588084602,0,3,0,0,3
2587530276,0,0,0,3,3
52588115,2,1,0,0,3
1171501265609621504,0,3,0,0,3
50315668,2,0,1,0,3
764551791778336768,0,3,0,0,3
1484208297914028032,0,3,0,0,3
4852019325,0,3,0,0,3
1197081496122736640,0,3,0,0,3
222053881,3,0,0,0,3
1268851280195268608,2,1,0,0,3
957532367790444544,0,3,0,0,3
1121530514,0,3,0,0,3
1171461395986210816,0,3,0,0,3
1172046907364921344,0,3,0,0,3
899850577055588352,0,3,0,0,3
291194339,0,3,0,0,3
571434510,0,3,0,0,3
2890277818,0,1,1,1,3
1269600267609280512,0,3,0,0,3
2752485975,0,3,0,0,3
1268903369562886144,0,3,0,0,3
1121265222,0,3,0,0,3
1116707478,0,2,0,1,3
1233306894619619328,2,1,0,0,3
1412707198984196096,0,2,1,0,3
1209243582051299328,3,0,0,0,3
1126017198,2,1,0,0,3
1032619352091189248,0,3,0,0,3
2478314774,0,3,0,0,3
1199276331848130560,0,1,0,2,3
1106168065190846464,3,0,0,0,3
1164915790937821184,3,0,0,0,3
2318516275,0,3,0,0,3
1199258280696127488,2,0,1,0,3
196694478,0,3,0,0,3
2925065990,2,0,0,1,3
1488606395708715008,0,3,0,0,3
1488592064040239104,1,2,0,0,3
944828874369781760,0,3,0,0,3
3789251777,0,3,0,0,3
4892024812,0,3,0,0,3
987997105804341248,2,0,1,0,3
63202029,0,3,0,0,3
197117401,1,2,0,0,3
4891611712,0,0,0,3,3
1281899301220868096,0,3,0,0,3
757964440536948736,0,3,0,0,3
197359576,0,3,0,0,3
863123775642107904,0,3,0,0,3
1488526976411660288,3,0,0,0,3
20047930,1,0,0,2,3
702975730,0,3,0,0,3
62331191,0,3,0,0,3
197695309,0,3,0,0,3
1008776474940399616,0,3,0,0,3
1395008458970128384,2,0,0,1,3
1488759695326457856,0,3,0,0,3
63239539,0,3,0,0,3
54122224,0,3,0,0,3
2478130113,0,3,0,0,3
557133146,1,2,0,0,3
63941153,1,1,1,0,3
2742406431,0,3,0,0,3
3285170184,0,3,0,0,3
987661513463918592,0,3,0,0,3
422207151,0,3,0,0,3
1357730042,1,2,0,0,3
2319914837,0,3,0,0,3
63728071,0,3,0,0,3
1009096450859364352,3,0,0,0,3
359221471,0,3,0,0,3
960022382076456960,0,3,0,0,3
2926656317,0,3,0,0,3
1393599220792233984,0,3,0,0,3
2925535412,1,1,1,0,3
881234808655011840,2,0,0,1,3
2926580092,0,3,0,0,3
2478171033,0,3,0,0,3
1229078506870628352,0,3,0,0,3
2478185364,0,3,0,0,3
4893651887,1,2,0,0,3
2318716198,1,2,0,0,3
944812548901105664,1,2,0,0,3
825966486,0,3,0,0,3
953381504,1,2,0,0,3
1009068422884253696,3,0,0,0,3
63255209,0,3,0,0,3
1164832049963732992,0,3,0,0,3
62224944,0,3,0,0,3
1281673937395621888,2,1,0,0,3
1281667555795574784,0,3,0,0,3
560931307,0,3,0,0,3
1280834632804597760,1,2,0,0,3
830323021609054208,0,3,0,0,3
1396224683717111808,1,2,0,0,3
1686805202,1,2,0,0,3
61450833,0,3,0,0,3
1015754233,0,3,0,0,3
2479577250,0,1,1,1,3
1280631635910819840,0,3,0,0,3
360109523,3,0,0,0,3
297802567,0,3,0,0,3
1280557571749883904,0,3,0,0,3
20217198,0,3,0,0,3
20220913,0,3,0,0,3
1105036718850363392,0,2,1,0,3
1074613367619444736,0,3,0,0,3
944978286752366592,2,0,1,0,3
199595348,0,3,0,0,3
561020398,0,3,0,0,3
199624934,1,1,1,0,3
863433298449715200,2,1,0,0,3
1360965746,0,3,0,0,3
1397036219591270400,2,1,0,0,3
812291410456170496,0,3,0,0,3
1397113187355353088,0,3,0,0,3
2481617302,0,3,0,0,3
1032275967388135424,0,3,0,0,3
200008365,0,3,0,0,3
2592607476,0,3,0,0,3
198831061,3,0,0,0,3
1396185782847631360,0,3,0,0,3
4385928856,2,1,0,0,3
560212349,0,2,1,0,3
20061144,0,3,0,0,3
3290210263,0,3,0,0,3
988008620456587264,0,3,0,0,3
2478780628,0,3,0,0,3
929398734609293312,3,0,0,0,3
4385611643,0,3,0,0,3
198054116,0,3,0,0,3
953138785,2,1,0,0,3
1488135302736539648,1,2,0,0,3
907181825994489856,0,3,0,0,3
1395845369167290368,1,2,0,0,3
1281369360087613440,0,3,0,0,3
3291008858,2,0,0,1,3
3781173434,0,2,0,1,3
1395967254400016384,3,0,0,0,3
758341782539087872,0,3,0,0,3
2921454430,1,0,2,0,3
1281277658135846912,3,0,0,0,3
61747175,0,3,0,0,3
61745442,0,3,0,0,3
1199001244959793152,0,3,0,0,3
1281252631629819904,1,1,0,1,3
1396061141009190912,1,2,0,0,3
1281195067894632448,0,3,0,0,3
198613555,0,3,0,0,3
298230356,0,3,0,0,3
1396131097218531328,0,3,0,0,3
795200275250167808,0,0,2,1,3
299799767,0,3,0,0,3
929027594380562432,1,0,1,1,3
2323147022,1,0,2,0,3
425214012,0,3,0,0,3
987197497905823744,0,3,0,0,3
1391297143919497216,2,1,0,0,3
65751546,0,3,0,0,3
1153112732,1,2,0,0,3
1285218619719286784,0,3,0,0,3
2933534512,1,1,1,0,3
2933463477,0,3,0,0,3
1285162762860019712,0,3,0,0,3
961049599334141952,0,3,0,0,3
19490590,0,3,0,0,3
2598047473,1,2,0,0,3
191624671,1,2,0,0,3
928856388075474944,0,3,0,0,3
358269580,0,2,0,1,3
893458615562096640,1,2,0,0,3
893849270,0,3,0,0,3
424399799,0,3,0,0,3
1489717426807885824,1,0,2,0,3
811459671651446784,0,3,0,0,3
1284932010625114112,0,3,0,0,3
65562050,1,2,0,0,3
554703867,0,2,0,1,3
1284852893695254528,0,3,0,0,3
1284821726275108864,0,3,0,0,3
2170485907,0,3,0,0,3
987266312337371136,0,3,0,0,3
1354284168,0,3,0,0,3
1600773192,0,3,0,0,3
66030419,0,3,0,0,3
19439615,0,3,0,0,3
2934175713,0,3,0,0,3
4909957220,0,3,0,0,3
1390157486963920896,3,0,0,0,3
1285868172046983168,0,3,0,0,3
189989146,0,3,0,0,3
961429378235322368,0,3,0,0,3
755383790348931072,0,3,0,0,3
1683006324,0,0,0,3,3
1390274299060269056,0,3,0,0,3
301880767,0,1,2,0,3
1390488644268433408,3,0,0,0,3
1285737475789295616,0,3,0,0,3
1351608678,0,3,0,0,3
1390623182021816320,0,3,0,0,3
190203516,0,3,0,0,3
66417805,0,3,0,0,3
3829808354,0,3,0,0,3
2471511194,0,3,0,0,3
1033378996833083392,0,3,0,0,3
3274122354,0,3,0,0,3
425667612,0,3,0,0,3
755674452340379648,0,3,0,0,3
706902160,0,3,0,0,3
4909333575,0,3,0,0,3
4356085096,1,1,1,0,3
1390822068925734912,0,3,0,0,3
1227606981076291584,0,3,0,0,3
706892475,0,3,0,0,3
1152021800,0,3,0,0,3
65316801,0,3,0,0,3
422582167,0,3,0,0,3
756970951758192640,0,3,0,0,3
3801747492,0,2,0,1,3
2476630496,0,3,0,0,3
64656916,0,3,0,0,3
194154340,0,3,0,0,3
1599930595,0,3,0,0,3
1046995431471890432,0,3,0,0,3
862228678939430912,0,3,0,0,3
423168232,0,3,0,0,3
1392421836672045056,1,2,0,0,3
300146116,0,2,0,1,3
1164363895915417600,0,0,0,3,3
1107104826528354304,2,0,0,1,3
556527302,1,2,0,0,3
944625932345655296,1,0,0,2,3
1489559062157082624,0,0,0,3,3
1033056648431116288,0,3,0,0,3
1489078879231025152,0,3,0,0,3
1164490365191303168,0,3,0,0,3
2171120637,0,3,0,0,3
194897712,0,3,0,0,3
757204857686196224,0,3,0,0,3
1199615373101785088,1,2,0,0,3
2929141961,0,3,0,0,3
2929028001,0,3,0,0,3
944800280478191616,3,0,0,0,3
830728389615054848,0,3,0,0,3
1598761512,0,3,0,0,3
3284321905,1,0,0,2,3
1283463602331156480,0,3,0,0,3
1150499467,0,3,0,0,3
193920577,0,3,0,0,3
704696875,0,3,0,0,3
358370835,2,1,0,0,3
1228051703905300480,0,2,0,1,3
555216334,0,3,0,0,3
423908648,0,3,0,0,3
192652909,0,3,0,0,3
704832963,0,3,0,0,3
1107683999357566976,0,3,0,0,3
1683749774,3,0,0,0,3
1107663446542336000,0,3,0,0,3
19697541,0,2,1,0,3
987512684496109568,0,3,0,0,3
2741603543,0,3,0,0,3
2170520006,3,0,0,0,3
1600449823,1,2,0,0,3
1489513010699792384,0,3,0,0,3
2170536643,0,3,0,0,3
1469619744,0,3,0,0,3
193492588,0,3,0,0,3
893376080588832768,0,3,0,0,3
423612336,0,3,0,0,3
3281548483,1,2,0,0,3
193643973,0,3,0,0,3
756902027746275328,0,2,0,1,3
193816679,2,1,0,0,3
827314154,0,3,0,0,3
1228275590341386240,0,3,0,0,3
423417032,0,3,0,0,3
60908845,0,3,0,0,3
2481836124,0,3,0,0,3
915816215238541312,0,3,0,0,3
2172781116,0,3,0,0,3
2907942934,0,3,0,0,3
1485852449541963776,0,3,0,0,3
209495697,1,2,0,0,3
3298663694,3,0,0,0,3
4870509879,0,3,0,0,3
761462082499903488,0,3,0,0,3
3298922034,0,3,0,0,3
1102301887586619392,0,3,0,0,3
880040084208222208,0,3,0,0,3
294943948,0,3,0,0,3
361762485,0,3,0,0,3
761582275611987968,0,3,0,0,3
294860819,1,0,1,1,3
2309898182,0,3,0,0,3
4868958250,0,3,0,0,3
413121533,2,0,0,1,3
1131726769,0,2,0,1,3
210423769,0,3,0,0,3
1169095253984448512,0,3,0,0,3
2309852314,0,3,0,0,3
294533060,0,3,0,0,3
20939926,0,3,0,0,3
210715221,0,3,0,0,3
1169145051567611904,0,3,0,0,3
2493149908,3,0,0,0,3
1405720999409168384,0,3,0,0,3
56285651,0,3,0,0,3
1274419842687238144,0,0,0,3,3
209206714,0,3,0,0,3
929958912694063104,0,3,0,0,3
3740334387,0,3,0,0,3
57083574,0,3,0,0,3
207161111,0,3,0,0,3
760875348405944320,0,0,3,0,3
2910172843,3,0,0,0,3
784936070,0,3,0,0,3
57599465,1,1,1,0,3
1592205739,0,3,0,0,3
2909879823,1,1,0,1,3
1956865202,0,3,0,0,3
1231891291056877568,0,3,0,0,3
20757888,0,3,0,0,3
207585764,0,3,0,0,3
1047529714645004288,1,1,0,1,3
793498441884119040,0,3,0,0,3
828532752618287104,0,3,0,0,3
208009097,0,3,0,0,3
208375778,0,3,0,0,3
2909445183,0,3,0,0,3
864841352076505088,0,3,0,0,3
1690638048,0,3,0,0,3
2491275000,0,3,0,0,3
958633961936314368,1,1,1,0,3
295417028,1,2,0,0,3
1486100693610299392,0,3,0,0,3
1275367670582476800,3,0,0,0,3
1133084154,0,3,0,0,3
635977721,0,3,0,0,3
793482002318106624,0,3,0,0,3
2750977957,0,3,0,0,3
1485602602498863104,0,0,0,3,3
1486233109985067008,0,3,0,0,3
1589995549,0,3,0,0,3
1408365643490119680,0,3,0,0,3
1408560941869023232,0,3,0,0,3
2903188866,0,0,0,3,3
1273544552205426688,0,3,0,0,3
1273500755731734528,3,0,0,0,3
54958386,0,3,0,0,3
1273476163948572672,0,3,0,0,3
1101608086786244608,0,3,0,0,3
2234232591,0,3,0,0,3
212994462,0,3,0,0,3
2902715738,0,3,0,0,3
879697287944863744,0,3,0,0,3
1232728389422698496,0,3,0,0,3
1273281492890738688,2,1,0,0,3
1369729482,0,3,0,0,3
411324267,0,3,0,0,3
3712782492,0,3,0,0,3
2902105185,0,3,0,0,3
1169564155415879680,0,3,0,0,3
213293510,0,3,0,0,3
4860014752,0,3,0,0,3
213370364,0,3,0,0,3
2901677840,0,3,0,0,3
54232520,1,1,1,0,3
634547384,0,3,0,0,3
763376117428301824,0,3,0,0,3
1169631747899887616,0,3,0,0,3
54216239,0,3,0,0,3
1273622792546578432,0,3,0,0,3
4863491107,0,3,0,0,3
212459912,1,2,0,0,3
1101700990422536192,0,3,0,0,3
56073267,0,3,0,0,3
2493938486,0,3,0,0,3
2905364467,0,3,0,0,3
1485295519329325056,0,3,0,0,3
1274285714029584384,1,2,0,0,3
865062378936954880,0,3,0,0,3
1407157114980605952,0,0,3,0,3
2308181314,0,3,0,0,3
1007926702268436480,0,3,0,0,3
762227215501291520,0,3,0,0,3
1169205244263202816,0,3,0,0,3
294301214,1,2,0,0,3
1370605716,0,3,0,0,3
762507151919058944,3,0,0,0,3
294268652,0,3,0,0,3
55608003,0,0,2,1,3
1273937379372367872,0,3,0,0,3
411797988,0,3,0,0,3
1007829272642424832,0,3,0,0,3
1169350887107698688,0,3,0,0,3
212185659,0,3,0,0,3
1407653065654689792,0,3,0,0,3
1407730842038845440,0,3,0,0,3
989929005657735168,2,1,0,0,3
1407811010287779840,1,2,0,0,3
1407983725732929536,0,3,0,0,3
2903592235,0,3,0,0,3
1275972412543123456,0,3,0,0,3
1275981364425134080,0,3,0,0,3
1543048314,0,3,0,0,3
417283496,1,2,0,0,3
988425990513807360,1,0,2,0,3
3294793596,0,3,0,0,3
59972743,0,3,0,0,3
2747989952,0,3,0,0,3
1464061704,3,0,0,0,3
1543400209,0,3,0,0,3
1167038181323075584,0,3,0,0,3
1399210737000534016,1,0,2,0,3
4409336777,0,3,0,0,3
417553124,0,3,0,0,3
829468399235395584,1,2,0,0,3
794109325757313024,0,3,0,0,3
1362943159,0,3,0,0,3
1020598603717505024,0,3,0,0,3
2231265180,0,3,0,0,3
1017739327,0,3,0,0,3
59460799,0,3,0,0,3
360615922,1,0,0,2,3
1140619285,0,3,0,0,3
1198425808726974464,0,1,1,1,3
203131060,0,3,0,0,3
417059747,2,0,1,0,3
1363182174,0,3,0,0,3
1167295565597741056,0,3,0,0,3
1486921113498275840,0,3,0,0,3
2484750282,0,3,0,0,3
959113660546379776,0,0,0,3,3
203490034,3,0,0,0,3
417878375,0,3,0,0,3
959242570139348992,0,3,0,0,3
4878480239,0,3,0,0,3
562694525,0,3,0,0,3
899713386,3,0,0,0,3
200453864,2,0,0,1,3
2917215520,0,3,0,0,3
988386606687096832,1,2,0,0,3
1397446172764082176,0,1,2,0,3
1142286937,0,3,0,0,3
297040645,0,3,0,0,3
1361590843,0,0,3,0,3
1465058042,0,3,0,0,3
418662877,0,0,3,0,3
20329565,0,3,0,0,3
2315284194,0,3,0,0,3
1397628462161141760,0,2,0,1,3
418639778,2,1,0,0,3
360419172,0,3,0,0,3
1279338877442916352,0,3,0,0,3
4881430240,0,3,0,0,3
1141956350,1,1,0,1,3
360480624,0,3,0,0,3
4406401815,0,3,0,0,3
201454497,0,3,0,0,3
899738786,1,2,0,0,3
1279098820564058112,0,3,0,0,3
418120886,0,0,0,3,3
951842702,0,3,0,0,3
1166740424960004096,2,1,0,0,3
3294590753,1,2,0,0,3
296126041,0,3,0,0,3
3755083814,0,3,0,0,3
295618660,0,3,0,0,3
988804973860413440,0,3,0,0,3
1103041521882988544,0,2,0,1,3
793818497713213440,0,3,0,0,3
3297089191,2,1,0,0,3
823596175,0,3,0,0,3
295779626,0,3,0,0,3
1401589728114135040,0,2,1,0,3
1198263245783621632,0,3,0,0,3
760574480649449472,3,0,0,0,3
1276667964176162816,0,3,0,0,3
295752582,0,0,1,2,3
206352021,2,0,0,1,3
1168015134159228928,0,3,0,0,3
1168043658098040832,2,0,1,0,3
415294882,3,0,0,0,3
59129716,2,1,0,0,3
2311039266,0,3,0,0,3
1401725585391489024,1,2,0,0,3
1075741827112804352,0,3,0,0,3
889582544223645696,0,3,0,0,3
1276238602054389760,0,3,0,0,3
57871327,3,0,0,0,3
2489521605,0,2,0,1,3
1402429930101739520,0,3,0,0,3
1276139113008099328,0,3,0,0,3
631894531,0,3,0,0,3
1276089182285377536,0,3,0,0,3
207050426,1,2,0,0,3
1276003698204831744,1,2,0,0,3
58247993,0,0,2,1,3
295798654,2,0,0,1,3
1401342539785900032,0,3,0,0,3
1103212686572167168,0,3,0,0,3
1399960173653938176,3,0,0,0,3
1363844155,1,1,0,1,3
296039887,0,2,0,1,3
1277659506831290368,2,1,0,0,3
3295691563,2,0,1,0,3
204073423,0,2,1,0,3
563591663,0,3,0,0,3
1103618481264779264,0,3,0,0,3
295958541,0,3,0,0,3
204423805,0,3,0,0,3
1138876022,3,0,0,0,3
1277279032145440768,0,3,0,0,3
204657496,0,3,0,0,3
416278287,0,3,0,0,3
361131970,0,3,0,0,3
20614803,0,3,0,0,3
2748879740,0,3,0,0,3
1103412714960027648,1,1,1,0,3
3296744429,0,3,0,0,3
1031872002074836992,3,0,0,0,3
2486213469,0,3,0,0,3
1103318654031142912,0,3,0,0,3
3296779893,0,1,1,1,3
1688827380,0,3,0,0,3
415828639,0,3,0,0,3
1401171433259028480,0,3,0,0,3
415796237,0,3,0,0,3
117442385,2,0,1,0,3
3326619568,0,3,0,0,3
2756512046,0,0,2,1,3
277011555,1,0,2,0,3
2829310508,0,3,0,0,3
2829329386,0,3,0,0,3
253459210,0,3,0,0,3
4549605137,0,3,0,0,3
1719504607,3,0,0,0,3
253288870,3,0,0,0,3
1450685544548077568,2,1,0,0,3
1172728412903018496,0,0,1,2,3
3504288372,0,3,0,0,3
777989855166869504,3,0,0,0,3
1440974520,0,0,1,2,3
951816309225877504,3,0,0,0,3
3385739158,0,0,0,3,3
1081653152976392192,0,3,0,0,3
778211463861243904,0,3,0,0,3
911230830814679040,0,3,0,0,3
1089251287688830976,0,3,0,0,3
1184036671140093952,0,3,0,0,3
599253408,0,3,0,0,3
2828338730,0,3,0,0,3
1184045009877852160,0,3,0,0,3
2828072310,3,0,0,0,3
3389229561,0,3,0,0,3
35664763,0,3,0,0,3
276829687,0,3,0,0,3
35595059,0,3,0,0,3
254142787,1,2,0,0,3
1566985364,0,0,3,0,3
1720876225,0,3,0,0,3
1192101632173072384,0,3,0,0,3
254277332,0,3,0,0,3
3384528748,0,2,1,0,3
2781160735,1,2,0,0,3
385005375,0,3,0,0,3
2571157148,0,3,0,0,3
1253173618621767680,0,1,1,1,3
1026180107017351168,0,3,0,0,3
3518228412,1,2,0,0,3
3381911855,0,3,0,0,3
806147881,0,3,0,0,3
36566678,0,3,0,0,3
36563187,2,0,0,1,3
385897719,0,3,0,0,3
277997041,0,3,0,0,3
1252923850234515456,1,1,0,1,3
2831849002,0,3,0,0,3
1252915609547005952,0,3,0,0,3
1252911224255324160,0,3,0,0,3
371205372,1,2,0,0,3
2831762898,0,3,0,0,3
2542944522,0,3,0,0,3
3383116294,0,3,0,0,3
252069651,1,2,0,0,3
872295080207327232,0,3,0,0,3
1241741248387518464,1,2,0,0,3
1089641246426099712,0,3,0,0,3
1051711307106332672,0,3,0,0,3
2780945120,0,3,0,0,3
1252784039334825984,0,3,0,0,3
1449385757404119040,0,2,0,1,3
1089530607573454848,3,0,0,0,3
371420983,0,3,0,0,3
1252657935685058560,0,3,0,0,3
4706627486,0,3,0,0,3
36186733,0,3,0,0,3
35484409,0,3,0,0,3
3391539149,0,3,0,0,3
1251731620949827584,0,3,0,0,3
2819287462,1,2,0,0,3
1554799686,0,3,0,0,3
382905486,0,3,0,0,3
1088582419320590336,3,0,0,0,3
779341465218580480,0,3,0,0,3
910882906326872064,0,3,0,0,3
786659190408380416,0,3,0,0,3
1004232812508037120,0,3,0,0,3
1926978152,3,0,0,0,3
1454674623669288960,2,1,0,0,3
1439410740,1,2,0,0,3
1454694817787637760,0,1,2,0,3
1454728712935682048,0,3,0,0,3
3395179498,0,3,0,0,3
934803574168735744,0,3,0,0,3
256536659,0,3,0,0,3
3491788453,0,3,0,0,3
26566389,0,3,0,0,3
2817675727,1,2,0,0,3
1250702220968034304,0,3,0,0,3
1454941657812672512,0,3,0,0,3
1722847334,2,0,1,0,3
1185453883444867072,0,3,0,0,3
1723004568,0,3,0,0,3
2270091732,2,1,0,0,3
1185505022143942656,3,0,0,0,3
2270051957,0,3,0,0,3
910814056767938560,2,1,0,0,3
1455231300399509504,0,3,0,0,3
933761245102055424,0,3,0,0,3
1082372909530861568,0,3,0,0,3
1242518557813956608,2,1,0,0,3
3394310051,0,3,0,0,3
1089215857765634048,0,3,0,0,3
1251420777779355648,0,3,0,0,3
1004394339408252928,0,3,0,0,3
778502300172062720,0,3,0,0,3
1191986796432969728,0,3,0,0,3
1472002640427073536,0,3,0,0,3
35168442,0,2,1,0,3
35151043,0,3,0,0,3
4551671298,1,2,0,0,3
948770742740701184,0,3,0,0,3
254682558,0,3,0,0,3
3392171943,1,0,1,1,3
1251459965124034560,1,1,0,1,3
383681866,0,3,0,0,3
1242412273383223296,0,3,0,0,3
1184763700005277696,0,3,0,0,3
2546485574,3,0,0,0,3
1453995904789319680,0,3,0,0,3
254918117,0,3,0,0,3
1452913611060416512,1,0,0,2,3
255096930,0,3,0,0,3
1184839075808907264,1,1,0,1,3
999983477146771456,0,3,0,0,3
1554729288,3,0,0,0,3
1025446140164993024,1,1,1,0,3
600044830,0,3,0,0,3
872858880539332608,0,3,0,0,3
1242455145964855296,0,3,0,0,3
4554755444,0,3,0,0,3
275958437,0,3,0,0,3
383090778,1,2,0,0,3
1088722078566498304,1,0,0,2,3
1448215445761232896,0,3,0,0,3
1253216961149968384,0,0,0,3,3
2179670614,0,3,0,0,3
1181960847452540928,1,2,0,0,3
1255750684408000512,0,3,0,0,3
247308713,0,3,0,0,3
1181826009399562240,2,0,0,1,3
1255736525771309056,1,0,0,2,3
1255694663136182272,0,3,0,0,3
38868552,0,3,0,0,3
38777130,0,3,0,0,3
775700250962960384,0,3,0,0,3
2178349431,0,3,0,0,3
997802078230675456,0,3,0,0,3
788316517133914112,0,3,0,0,3
1845253952,0,3,0,0,3
2841266997,0,3,0,0,3
3371391370,0,0,1,2,3
370048675,0,3,0,0,3
2842440690,0,3,0,0,3
3547099752,0,3,0,0,3
1255344708827611136,0,2,0,1,3
2277592022,0,3,0,0,3
952276390111358976,0,3,0,0,3
1026717056039772160,3,0,0,0,3
4528520773,0,3,0,0,3
775800032159117312,0,3,0,0,3
775805403783393280,0,3,0,0,3
1444247767673606144,2,1,0,0,3
1005092634824708096,0,2,0,1,3
1091254650089672704,0,2,0,1,3
775881044964757504,0,0,1,2,3
1254861273038110720,2,0,1,0,3
1444734001609052160,0,0,0,3,3
2842358214,3,0,0,0,3
3369888724,0,3,0,0,3
2572849730,3,0,0,0,3
593140384,0,3,0,0,3
369510706,0,3,0,0,3
1442040752897363968,1,0,0,2,3
2775425189,1,1,1,0,3
2775481914,0,3,0,0,3
1408848324,0,3,0,0,3
592664135,0,3,0,0,3
246323523,0,3,0,0,3
1712606768,1,2,0,0,3
2844322396,0,3,0,0,3
1193210522864254976,0,3,0,0,3
246430977,0,3,0,0,3
808431948,2,1,0,0,3
246498739,0,3,0,0,3
1240391957471547392,0,3,0,0,3
1181465179785175040,3,0,0,0,3
2536662670,1,2,0,0,3
1240472807861075968,0,3,0,0,3
1005333818289598464,0,3,0,0,3
1442730581792477184,0,3,0,0,3
1022512204820688896,0,3,0,0,3
593487511,3,0,0,0,3
3551280317,0,3,0,0,3
1442878819950497792,3,0,0,0,3
24789294,0,3,0,0,3
775415519620898816,0,3,0,0,3
911825335854829568,0,3,0,0,3
1080652707281674240,3,0,0,0,3
2573582200,1,0,2,0,3
775605794008133632,1,2,0,0,3
247189997,0,3,0,0,3
1254826143355723776,0,3,0,0,3
594890003,0,3,0,0,3
1473200384462123008,1,0,2,0,3
370910803,0,0,0,3,3
1413744770,0,3,0,0,3
1254161774947041280,0,3,0,0,3
1051475119477088256,0,3,0,0,3
1081213036692676608,0,3,0,0,3
1474725393718382592,0,3,0,0,3
4716427349,2,0,0,1,3
3531513686,1,0,2,0,3
1442286169,0,3,0,0,3
952187432199426048,0,3,0,0,3
1446909206834077696,0,3,0,0,3
3526965135,0,3,0,0,3
815874845414035456,2,0,0,1,3
935036843472703488,0,3,0,0,3
2834482673,1,2,0,0,3
3524976623,0,3,0,0,3
776446214644633600,1,1,1,0,3
596212099,0,3,0,0,3
922977312,0,3,0,0,3
1447150441481965568,3,0,0,0,3
806879964,0,3,0,0,3
4714159115,0,3,0,0,3
37204163,0,3,0,0,3
891457913893658624,3,0,0,0,3
278343420,0,3,0,0,3
4714059261,0,3,0,0,3
1253427050255249408,0,3,0,0,3
1473903495853920256,0,2,0,1,3
4713044511,0,3,0,0,3
1241624598703042560,0,3,0,0,3
36950954,1,2,0,0,3
1446076371214684160,0,3,0,0,3
1254316824633552896,0,3,0,0,3
1254729004310880256,3,0,0,0,3
595163733,0,3,0,0,3
1240964484207972352,3,0,0,0,3
1240965682377953280,0,3,0,0,3
775987987226071040,1,0,1,1,3
1080913769629343744,2,1,0,0,3
1078557918,0,3,0,0,3
594905665,0,3,0,0,3
1475358229412651008,0,3,0,0,3
1182251901615779840,0,0,1,2,3
1078443487,0,3,0,0,3
1445088650820308992,0,3,0,0,3
1445146636343300096,0,3,0,0,3
3373886427,0,3,0,0,3
942363254,1,2,0,0,3
4726680257,0,3,0,0,3
1254533389706764288,0,3,0,0,3
1445997621861130240,0,0,2,1,3
948373753024491520,0,3,0,0,3
877484927587110912,1,0,0,2,3
997863539208486912,0,3,0,0,3
1474913482948575232,0,3,0,0,3
871950767409815552,1,0,0,2,3
1090745235091742720,0,3,0,0,3
1931393970,0,3,0,0,3
776337241820061696,1,2,0,0,3
952189617150849024,1,1,1,0,3
1917386689,0,3,0,0,3
1413469728,0,3,0,0,3
387074424,1,1,0,1,3
4718729197,0,3,0,0,3
776435794164658176,0,3,0,0,3
257391491,0,3,0,0,3
372316140,0,3,0,0,3
1242776570420285440,0,3,0,0,3
1429050337,2,0,0,1,3
1560515610,0,3,0,0,3
874971365476114432,2,1,0,0,3
1246431946621612032,0,3,0,0,3
3416779347,0,3,0,0,3
4644060134,0,3,0,0,3
3419915787,2,1,0,0,3
2789479908,0,3,0,0,3
1052899407782391808,0,3,0,0,3
1188698099998482432,0,3,0,0,3
1246155062692454400,0,3,0,0,3
1188699710846066688,0,3,0,0,3
1462132622486872064,2,0,1,0,3
785180273336000512,0,3,0,0,3
783713485465214976,0,1,0,2,3
785144142179348480,2,1,0,0,3
1052526938,0,3,0,0,3
376203056,3,0,0,0,3
1188804162667966464,1,1,0,1,3
266067863,2,0,1,0,3
2561515119,0,2,0,1,3
1246053343144759296,1,2,0,0,3
1083863546864103424,2,0,0,1,3
4642326075,0,3,0,0,3
1462292708488192000,1,2,0,0,3
1246014148581916672,0,3,0,0,3
29923064,1,0,2,0,3
3434540242,3,0,0,0,3
1245881198393483264,0,3,0,0,3
613368885,0,3,0,0,3
875622418923921408,0,3,0,0,3
1466251076114386944,1,1,1,0,3
30455883,0,3,0,0,3
29637969,0,3,0,0,3
264032237,2,1,0,0,3
1918663266,0,3,0,0,3
782460105757487104,1,2,0,0,3
782488658599370752,2,1,0,0,3
3410051284,3,0,0,0,3
377706148,0,1,0,2,3
272289571,0,3,0,0,3
608245511,0,3,0,0,3
608250871,0,3,0,0,3
2788488842,2,0,0,1,3
1433309324,0,3,0,0,3
2262530288,0,3,0,0,3
31077930,0,3,0,0,3
1460284905393311744,0,3,0,0,3
876183410993238016,0,3,0,0,3
264089255,2,1,0,0,3
1466348409527300096,0,3,0,0,3
1246914340562915328,0,3,0,0,3
1054462812,0,3,0,0,3
934353452,0,3,0,0,3
264154837,0,3,0,0,3
271923956,1,1,0,1,3
2559962837,0,0,0,3,3
4654532832,1,2,0,0,3
1188139020250963968,0,3,0,0,3
608821680,0,3,0,0,3
271776179,0,3,0,0,3
3413416047,0,3,0,0,3
782959192374214656,0,3,0,0,3
1246746787269898240,0,3,0,0,3
1083634634401988608,0,3,0,0,3
266832421,0,3,0,0,3
29635287,0,3,0,0,3
782411649445601280,1,2,0,0,3
1464283301666226176,0,3,0,0,3
270043323,0,3,0,0,3
2562349395,0,3,0,0,3
1050318234,1,2,0,0,3
784781041487740928,0,3,0,0,3
2792188731,0,3,0,0,3
2562445123,0,3,0,0,3
817279147617742848,0,3,0,0,3
1189737513889480704,0,3,0,0,3
875747846636679168,1,1,0,1,3
1464159441327120384,0,3,0,0,3
612061923,0,3,0,0,3
1049973331,0,3,0,0,3
1049923992,0,3,0,0,3
268881410,0,3,0,0,3
1464378043494199296,0,0,0,3,3
3429664601,0,3,0,0,3
1245088947484549120,2,0,1,0,3
1189838791562932224,0,3,0,0,3
612374141,0,3,0,0,3
784419956528001024,0,3,0,0,3
1245061164041732096,0,3,0,0,3
936227640,0,3,0,0,3
28857276,0,3,0,0,3
817711378857234432,2,1,0,0,3
934410667532136448,0,3,0,0,3
612733687,0,3,0,0,3
28752702,0,3,0,0,3
1464560409034244096,0,0,3,0,3
28759697,0,3,0,0,3
374702275,0,3,0,0,3
1189541696557735936,0,3,0,0,3
268264124,2,1,0,0,3
376096242,2,0,0,1,3
2796568750,3,0,0,0,3
3434125545,0,3,0,0,3
1559849544,2,1,0,0,3
1462771042447994880,0,3,0,0,3
1430131452,0,2,1,0,3
1432302427,0,3,0,0,3
1084135045189783552,0,3,0,0,3
267151456,0,3,0,0,3
1430729534,1,2,0,0,3
1190171022680457216,0,3,0,0,3
2258705275,0,3,0,0,3
1733162454,1,2,0,0,3
2796743348,0,3,0,0,3
267588898,0,0,1,2,3
4619498836,0,3,0,0,3
818255308967514112,3,0,0,0,3
1002733640252579840,1,2,0,0,3
875717516353568768,2,0,0,1,3
2562143528,0,3,0,0,3
1465274522400346112,1,0,2,0,3
375863147,0,3,0,0,3
1245630389369991168,1,1,0,1,3
1190160393026465792,2,1,0,0,3
267908761,3,0,0,0,3
3427021157,0,3,0,0,3
1463228416665083904,0,3,0,0,3
2258518722,0,3,0,0,3
3428104246,2,1,0,0,3
1463534007468150784,2,0,0,1,3
375644241,0,3,0,0,3
1245361200814125056,1,2,0,0,3
1247400022242512896,1,0,1,1,3
31226372,0,2,0,1,3
1087971054360907776,0,3,0,0,3
2811381032,0,3,0,0,3
1470216942963286016,0,3,0,0,3
1024904216035381248,0,3,0,0,3
259321405,1,0,2,0,3
1024897699781337088,2,1,0,0,3
372570563,0,3,0,0,3
780718083052666880,0,3,0,0,3
603558257,1,2,0,0,3
2554190946,0,1,2,0,3
780855334189486080,3,0,0,0,3
4581765448,3,0,0,0,3
1082925946016010240,0,3,0,0,3
380099332,0,2,0,1,3
259868944,0,3,0,0,3
1243338358077698048,0,2,0,1,3
3400801348,0,3,0,0,3
33249295,0,0,0,3,3
785795387705753600,0,3,0,0,3
1249139063774269440,0,3,0,0,3
1563509983,2,1,0,0,3
1186338563115241472,0,3,0,0,3
949175975190978560,0,3,0,0,3
910428821135949824,2,1,0,0,3
910416342355869696,0,3,0,0,3
1436498006,2,1,0,0,3
372787373,0,3,0,0,3
273440908,1,2,0,0,3
1191078078132322304,0,3,0,0,3
3444708313,1,2,0,0,3
379326749,0,3,0,0,3
2786464675,0,3,0,0,3
780564830285463552,0,2,1,0,3
4688327713,0,2,0,1,3
1726065793,0,3,0,0,3
910743784278945792,0,3,0,0,3
1250048745883889664,1,0,1,1,3
786507110444040192,0,3,0,0,3
2180087114,1,2,0,0,3
873272609747726336,0,3,0,0,3
1185838362902450176,2,0,0,1,3
786452184749645824,0,3,0,0,3
1191389642572083200,0,1,2,0,3
602747043,0,3,0,0,3
792770954,0,3,0,0,3
33859422,1,1,0,1,3
258225599,0,3,0,0,3
786367944666275840,0,3,0,0,3
3398055658,0,3,0,0,3
4571520855,0,3,0,0,3
258370733,0,3,0,0,3
3451235541,0,3,0,0,3
1191347904058986496,0,3,0,0,3
381253891,0,3,0,0,3
1455865368531116032,0,3,0,0,3
2814679530,0,3,0,0,3
1470678775364943872,0,3,0,0,3
1455973097031356416,0,3,0,0,3
1455973528537374720,0,3,0,0,3
1061725050,0,3,0,0,3
786242782948012032,0,3,0,0,3
2567745316,0,3,0,0,3
4688372731,0,3,0,0,3
1243125558319316992,1,2,0,0,3
786171127114653696,0,3,0,0,3
1456293517651849216,0,3,0,0,3
1001460244466356224,0,3,0,0,3
604436259,3,0,0,0,3
1190616306883543040,0,3,0,0,3
262588573,0,3,0,0,3
1186939106133233664,0,3,0,0,3
2805395629,0,3,0,0,3
262140758,0,3,0,0,3
2181214972,0,3,0,0,3
1458466124086247424,0,2,0,1,3
949387676087717888,0,3,0,0,3
1086708011723358208,3,0,0,0,3
262311365,3,0,0,0,3
262380143,1,0,2,0,3
4664622915,0,3,0,0,3
1003681901918478336,0,2,1,0,3
3438712452,0,3,0,0,3
27614252,0,3,0,0,3
262554664,0,3,0,0,3
932426820,0,1,2,0,3
819071721185492992,1,0,2,0,3
1053908822010531840,1,0,0,2,3
1247785765842472960,2,1,0,0,3
1425263492,1,2,0,0,3
378188401,1,2,0,0,3
2263734363,2,0,0,1,3
782276833316220928,0,3,0,0,3
615125926,0,0,0,3,3
2263224712,0,3,0,0,3
272468946,0,3,0,0,3
1187377360431128576,0,3,0,0,3
2558418653,0,2,0,1,3
4599671013,0,3,0,0,3
263289581,0,3,0,0,3
1003675878306480128,1,2,0,0,3
2556524864,0,0,0,3,3
2265015521,0,3,0,0,3
1248857851814010880,0,0,1,2,3
1190914262392172544,2,1,0,0,3
1469055870642257920,0,3,0,0,3
2809657193,0,3,0,0,3
910243938065412096,0,3,0,0,3
3403189061,0,3,0,0,3
4676235805,0,3,0,0,3
260775209,0,3,0,0,3
2809288603,3,0,0,0,3
2555284854,0,3,0,0,3
379199160,0,3,0,0,3
260986607,0,3,0,0,3
261138361,0,3,0,0,3
1457863718394638336,1,2,0,0,3
793309956,2,1,0,0,3
1468794738983596032,1,0,1,1,3
32576902,0,1,2,0,3
1024598534673317888,0,3,0,0,3
604857591,1,1,0,1,3
1186665156467519488,0,0,0,3,3
2807358057,0,0,3,0,3
1436012293,2,1,0,0,3
910203771891920896,1,2,0,0,3
949344373090680832,0,3,0,0,3
261396372,0,3,0,0,3
781803808330571776,0,0,1,2,3
874156396215902208,1,0,2,0,3
378929921,0,3,0,0,3
874176233143250944,0,3,0,0,3
1045050522,1,0,2,0,3
902439186644566016,0,3,0,0,3
615242823,1,2,0,0,3
1082536682,3,0,0,0,3
1441833313593790464,0,3,0,0,3
24692175,0,3,0,0,3
769381991275962368,1,1,1,0,3
1389521532,2,0,0,1,3
3645293834,0,3,0,0,3
47130663,0,3,0,0,3
1264518785001754624,0,3,0,0,3
230752570,0,0,0,3,3
1175379515406716928,0,3,0,0,3
1029752173377323008,0,3,0,0,3
230782428,0,3,0,0,3
628434069,3,0,0,0,3
4474697183,3,0,0,0,3
47055779,2,1,0,0,3
231090734,1,2,0,0,3
580521289,3,0,0,0,3
46867458,0,1,1,1,3
868108943884787712,0,3,0,0,3
815695098,0,3,0,0,3
46862866,0,3,0,0,3
231482923,0,3,0,0,3
900307044024111104,0,3,0,0,3
707309853,1,2,0,0,3
1264168071062790144,0,3,0,0,3
1264160915949260800,0,3,0,0,3
824699415030071296,0,3,0,0,3
2512892875,0,3,0,0,3
2761724508,0,3,0,0,3
2513085882,0,3,0,0,3
790824040189558784,0,0,0,3,3
232205394,0,3,0,0,3
1427688409859076096,0,3,0,0,3
399433571,3,0,0,0,3
815631860,0,3,0,0,3
47293908,1,2,0,0,3
2873632235,0,3,0,0,3
1426238258405588992,0,3,0,0,3
47807426,1,2,0,0,3
400663923,0,0,0,3,3
1265236079080341504,0,3,0,0,3
1027184180,3,0,0,0,3
47706412,2,0,1,0,3
1236413954458607616,0,3,0,0,3
2877504891,0,3,0,0,3
1097740664698212352,0,3,0,0,3
3320587278,1,1,0,1,3
400547260,0,3,0,0,3
1236451664766185472,2,0,0,1,3
1175042858811678720,1,2,0,0,3
1264957606382063616,0,3,0,0,3
955281887429320704,0,3,0,0,3
1097697990142320640,1,2,0,0,3
1481430630030364672,0,3,0,0,3
1426441603913326592,0,3,0,0,3
1426495955008843776,0,3,0,0,3
1236504327554023424,0,2,1,0,3
815977537,0,3,0,0,3
1175314693277265920,1,2,0,0,3
1264825233950871552,1,2,0,0,3
1097595138438762496,1,0,0,2,3
47419539,0,3,0,0,3
2876659054,0,3,0,0,3
1194926694446055424,0,3,0,0,3
903657104128520192,2,1,0,0,3
1078745905606676480,0,3,0,0,3
1097405886555815936,0,0,0,3,3
993857539157585920,0,3,0,0,3
824647236441174016,1,2,0,0,3
955013866160840704,0,3,0,0,3
400882120,0,0,0,3,3
1479881248948436992,0,3,0,0,3
45535390,0,3,0,0,3
1704605556,1,2,0,0,3
908607149520986112,0,3,0,0,3
2516925103,3,0,0,0,3
45532524,0,3,0,0,3
285382362,0,3,0,0,3
45316636,0,3,0,0,3
1395473978,0,3,0,0,3
234317636,0,3,0,0,3
2175711625,2,1,0,0,3
583697780,0,3,0,0,3
397251083,2,0,1,0,3
2175904005,1,0,2,0,3
3336778533,0,3,0,0,3
1914067015,1,2,0,0,3
1263296515587670016,0,3,0,0,3
234517460,1,2,0,0,3
1430647893434699776,2,1,0,0,3
397081687,0,3,0,0,3
1479853532773683200,0,3,0,0,3
234686569,1,2,0,0,3
1237665773872701440,0,0,0,3,3
4793096717,2,0,1,0,3
2868845871,0,3,0,0,3
1022020001543413760,0,3,0,0,3
1022059563930083328,1,1,1,0,3
1095749831434342400,0,3,0,0,3
626939996,1,2,0,0,3
1479695898787549184,1,2,0,0,3
869191133527629824,1,1,1,0,3
45549066,0,3,0,0,3
285610186,0,3,0,0,3
1263796467740954624,0,3,0,0,3
911756299,0,3,0,0,3
3327831430,0,3,0,0,3
1263735142662766592,0,3,0,0,3
2873370816,0,3,0,0,3
46411962,0,3,0,0,3
581365037,0,0,1,2,3
22675984,0,3,0,0,3
1096643075768811520,0,3,0,0,3
954806147462127616,0,3,0,0,3
1480782741725581312,0,3,0,0,3
1428456508778598400,0,1,0,2,3
233039234,1,2,0,0,3
1480536222493593600,0,3,0,0,3
45869611,0,3,0,0,3
582231440,1,2,0,0,3
2515206177,0,3,0,0,3
868782587828998144,0,3,0,0,3
769840885798346752,1,0,1,1,3
366753445,2,1,0,0,3
1263504054304428032,3,0,0,0,3
1176062767033282560,1,0,2,0,3
45809973,0,2,1,0,3
2241184014,0,3,0,0,3
824398653213253632,0,3,0,0,3
1263397771551399936,0,1,0,2,3
1429391667002593280,1,0,0,2,3
45754147,1,2,0,0,3
397924696,0,3,0,0,3
1263394437197111296,0,3,0,0,3
397891548,0,3,0,0,3
3629912121,1,2,0,0,3
287614298,0,3,0,0,3
1581477086,0,3,0,0,3
1431092082886602752,0,2,1,0,3
1267276781263785984,0,3,0,0,3
767124715282411520,1,1,0,1,3
956307218005221376,3,0,0,0,3
224784774,0,3,0,0,3
22010261,1,2,0,0,3
956293594566053888,0,3,0,0,3
575777340,0,3,0,0,3
225139612,1,2,0,0,3
1267392980526272512,0,3,0,0,3
2885497716,0,3,0,0,3
767278630028255232,0,0,0,3,3
631269945,0,3,0,0,3
2298426193,0,3,0,0,3
1482055049337458688,0,3,0,0,3
817945962,0,3,0,0,3
2885119256,0,3,0,0,3
2299035443,0,3,0,0,3
4829543872,1,0,1,1,3
1422241706506915840,0,3,0,0,3
1422459820859215872,1,0,0,2,3
402987368,0,3,0,0,3
1235478242141843456,0,3,0,0,3
1235478769743392768,0,3,0,0,3
1195711919308472320,0,3,0,0,3
225949255,1,2,0,0,3
2758686129,0,0,1,2,3
3668097072,0,3,0,0,3
1235662722953441280,3,0,0,0,3
913607658111938560,0,3,0,0,3
956147373918470144,0,3,0,0,3
3316045519,0,3,0,0,3
1382683628,2,1,0,0,3
49245568,0,3,0,0,3
365310915,3,0,0,0,3
1078250240384200704,3,0,0,0,3
1235012989042012160,0,3,0,0,3
1268093283772882944,0,3,0,0,3
364317627,0,3,0,0,3
290469969,0,3,0,0,3
1419519175324684288,0,3,0,0,3
49701662,2,1,0,0,3
2238776830,0,3,0,0,3
3313361686,0,3,0,0,3
2173987309,0,3,0,0,3
2505790462,0,2,0,1,3
1267921813239148544,0,3,0,0,3
1007292736192634880,1,2,0,0,3
826094671571058688,0,3,0,0,3
1113430128,0,3,0,0,3
1099933871334920192,0,3,0,0,3
4833127283,0,0,0,3,3
49574149,0,3,0,0,3
814155727342211072,0,3,0,0,3
49567705,2,0,1,0,3
3671700136,2,1,0,0,3
766954393904279552,0,3,0,0,3
3313916560,0,3,0,0,3
1583196908,0,3,0,0,3
1195882589036404736,0,3,0,0,3
956444883140665344,0,3,0,0,3
956430015414939648,0,3,0,0,3
2506743182,0,3,0,0,3
1267635879062892544,0,3,0,0,3
631642479,0,0,0,3,3
364749467,0,3,0,0,3
1422904192797188096,0,3,0,0,3
2583380665,0,3,0,0,3
1425458252230266880,0,2,1,0,3
1235996325046517760,0,3,0,0,3
825306379531468800,0,3,0,0,3
1265942278436196352,0,3,0,0,3
1098380310624911360,0,0,0,3,3
1701653582,0,1,0,2,3
227971408,0,3,0,0,3
1195219820834369536,1,1,0,1,3
909743978,0,3,0,0,3
1098247145918873600,0,3,0,0,3
630107125,2,1,0,0,3
401389057,1,2,0,0,3
825219691325042688,0,3,0,0,3
48025099,0,3,0,0,3
288150746,0,3,0,0,3
1265681523858190336,0,3,0,0,3
3654881355,0,3,0,0,3
227622333,0,3,0,0,3
47982690,0,3,0,0,3
2879085699,0,3,0,0,3
1265587778399752192,0,3,0,0,3
401228635,0,3,0,0,3
228650000,0,2,1,0,3
909781273,0,3,0,0,3
1265441445873360896,0,2,0,1,3
1006742115630665728,0,3,0,0,3
2878431206,0,3,0,0,3
955717081944805376,0,3,0,0,3
47937967,0,3,0,0,3
1265302204325470208,0,3,0,0,3
578258662,0,3,0,0,3
229047849,0,3,0,0,3
1945518829,0,3,0,0,3
3318877504,2,0,1,0,3
767627845443084288,0,1,0,2,3
946425941009616896,0,3,0,0,3
1266836163316396032,0,3,0,0,3
1481983458188697600,1,0,1,1,3
1266818529422118912,1,2,0,0,3
992762429556785152,0,3,0,0,3
2882960843,1,2,0,0,3
1481959626254225408,0,3,0,0,3
288965440,0,0,1,2,3
1454849414,0,3,0,0,3
3664920377,0,3,0,0,3
2882315776,0,2,0,1,3
1423655058156265472,0,3,0,0,3
402079357,0,3,0,0,3
1235864731182743552,0,3,0,0,3
227005059,3,0,0,0,3
1423707009657057280,0,3,0,0,3
3318505617,2,0,0,1,3
630666565,0,3,0,0,3
867342633336745984,0,3,0,0,3
878620006300495872,0,3,0,0,3
227207401,0,1,1,1,3
630560117,0,3,0,0,3
1266469782284570624,0,3,0,0,3
1700386615,1,2,0,0,3
878608936689168384,0,3,0,0,3
3661684775,0,3,0,0,3
365376053,0,3,0,0,3
577022532,0,3,0,0,3
2296704636,0,3,0,0,3
2239736236,1,2,0,0,3
227584977,0,0,0,3,3
2288308578,2,0,1,0,3
367176959,0,3,0,0,3
1476106331828355072,0,1,2,0,3
1258511762057543680,0,3,0,0,3
23939028,0,3,0,0,3
282593458,1,2,0,0,3
1239187050332672000,0,3,0,0,3
996327501675814912,0,1,2,0,3
3594387918,0,3,0,0,3
1401699025,0,3,0,0,3
589447648,0,3,0,0,3
1401743958,0,3,0,0,3
242668058,0,3,0,0,3
2244739986,0,3,0,0,3
2852444384,1,0,0,2,3
900816038467600384,0,3,0,0,3
918349566,2,1,0,0,3
1093704354282889216,0,3,0,0,3
282502688,0,3,0,0,3
2854388415,0,3,0,0,3
41175978,0,3,0,0,3
870355689545371648,0,3,0,0,3
1438047946591801344,0,3,0,0,3
1446155155,1,0,2,0,3
1258452917066981376,1,2,0,0,3
589842415,0,3,0,0,3
1022389076488544256,1,1,0,1,3
909156725659402240,0,3,0,0,3
1258332857103273984,0,2,0,1,3
1258265771047817216,0,3,0,0,3
1438452369394704384,0,3,0,0,3
870390608992624640,0,3,0,0,3
1477889570679271424,0,3,0,0,3
1179538167034241024,0,3,0,0,3
282737738,0,3,0,0,3
2771134918,0,3,0,0,3
1239489496707665920,0,3,0,0,3
2855842347,0,3,0,0,3
1478523209813159936,0,3,0,0,3
892008543821365248,0,3,0,0,3
891978916214255616,0,3,0,0,3
1091942744,1,0,0,2,3
23819224,0,0,2,1,3
916650146,0,3,0,0,3
2857100973,0,3,0,0,3
2526608959,0,3,0,0,3
241501044,0,3,0,0,3
2856571103,0,3,0,0,3
4762766661,0,3,0,0,3
1238900457596207104,0,3,0,0,3
41757618,0,3,0,0,3
2283701939,3,0,0,0,3
932513746223882240,0,3,0,0,3
1915578642,0,3,0,0,3
1178735610053480448,0,0,0,3,3
1709573593,0,3,0,0,3
916875469,0,3,0,0,3
41554147,1,2,0,0,3
1478236936334725120,0,3,0,0,3
1259051800243638272,0,3,0,0,3
1437024951454744576,2,1,0,0,3
2770515659,0,3,0,0,3
917187522,0,3,0,0,3
1401343050,3,0,0,0,3
1259008551319715840,0,3,0,0,3
1401388051,0,3,0,0,3
2854651280,0,3,0,0,3
1258993925236199424,3,0,0,0,3
243317554,0,3,0,0,3
40849408,0,3,0,0,3
1436368721300312064,0,3,0,0,3
1050977385124745216,0,3,0,0,3
774329308294905856,0,3,0,0,3
1239933324941856768,1,2,0,0,3
1440793385502068736,0,3,0,0,3
2848625032,1,2,0,0,3
368987601,0,3,0,0,3
1092709763807232000,0,3,0,0,3
1239944311808147456,0,3,0,0,3
40008434,1,1,1,0,3
788837974599348224,2,0,0,1,3
1180710185666564096,0,3,0,0,3
1180751073264357376,0,3,0,0,3
369180156,0,3,0,0,3
24491044,2,0,1,0,3
2847670316,0,3,0,0,3
1180905203073273856,2,1,0,0,3
244483317,0,3,0,0,3
245346692,0,3,0,0,3
2774517023,0,3,0,0,3
4744146672,1,2,0,0,3
4517069795,0,3,0,0,3
788775839294976000,0,3,0,0,3
3558410837,1,0,2,0,3
1441128301238554624,0,3,0,0,3
911906580765007872,0,2,0,1,3
1092516196883316736,1,2,0,0,3
2846420008,2,1,0,0,3
1476324947547066368,0,3,0,0,3
808941686,0,3,0,0,3
775044804162060288,0,3,0,0,3
4521889936,0,3,0,0,3
952834075286495232,0,0,0,3,3
244474613,0,3,0,0,3
2850382417,0,3,0,0,3
1087343498,0,3,0,0,3
2574936643,0,2,1,0,3
2245337541,0,3,0,0,3
282225500,0,3,0,0,3
1088095446,0,3,0,0,3
3360065601,0,3,0,0,3
1257936314579681280,0,2,0,1,3
788974113176117248,0,3,0,0,3
2773303402,1,2,0,0,3
1438838381081882624,3,0,0,0,3
40628438,0,3,0,0,3
282065559,0,0,0,3,3
3579607105,3,0,0,0,3
368954866,0,3,0,0,3
391215709,2,1,0,0,3
1439186751776514048,0,3,0,0,3
997072529662660608,3,0,0,0,3
774110381933404160,0,2,1,0,3
1404215023,0,3,0,0,3
1092920258971594752,1,0,0,2,3
1239867746990444544,0,2,0,1,3
1257658660794368000,1,1,0,1,3
3362537187,0,3,0,0,3
1439510517001846784,0,3,0,0,3
3362805058,1,2,0,0,3
1549847046,0,2,1,0,3
281689622,0,3,0,0,3
1445596956,2,1,0,0,3
1405292598,0,3,0,0,3
891806519620022272,0,2,0,1,3
1440499429765566464,2,0,1,0,3
2857855204,0,3,0,0,3
3350679329,0,3,0,0,3
1262603557141975040,0,3,0,0,3
1577337830,0,3,0,0,3
23218989,0,3,0,0,3
3613187359,2,1,0,0,3
585870593,0,3,0,0,3
1177252959610200064,0,3,0,0,3
1095276731827699712,0,3,0,0,3
4783712908,0,3,0,0,3
236759797,0,3,0,0,3
586062902,0,3,0,0,3
1261691664667680768,0,3,0,0,3
771454229777117184,0,3,0,0,3
4782824516,0,3,0,0,3
1397178936,1,2,0,0,3
1479363144782778368,1,2,0,0,3
1238032899108220928,0,3,0,0,3
43648433,3,0,0,0,3
395510667,0,3,0,0,3
284182933,0,3,0,0,3
1940690803,0,3,0,0,3
1030945789,0,3,0,0,3
823755885054869504,0,3,0,0,3
237399637,1,2,0,0,3
3344051025,0,3,0,0,3
3610349368,0,3,0,0,3
1097854831,0,3,0,0,3
395270520,0,3,0,0,3
1261328199457349632,0,3,0,0,3
3344318555,3,0,0,0,3
1479243288787898368,3,0,0,0,3
1261260486479278080,2,0,1,0,3
3344608481,2,1,0,0,3
1261955822164287488,0,3,0,0,3
1261970488798003200,0,3,0,0,3
586542344,0,3,0,0,3
2866727872,0,3,0,0,3
913031935,0,3,0,0,3
1176756186923687936,0,3,0,0,3
235255074,0,3,0,0,3
1431113923940343808,0,3,0,0,3
1262552305536315392,0,3,0,0,3
1479665503786258432,1,2,0,0,3
1479658828400508928,0,3,0,0,3
3617257645,0,3,0,0,3
1099324914,0,3,0,0,3
1431187080890159104,1,0,0,2,3
890112351952920576,0,3,0,0,3
3617104995,0,0,0,3,3
585190686,1,1,1,0,3
396049378,1,2,0,0,3
1095612808371359744,0,3,0,0,3
2866140311,0,3,0,0,3
44464552,0,3,0,0,3
626443012,2,0,0,1,3
44419855,0,3,0,0,3
4789218204,0,3,0,0,3
1705456440,0,3,0,0,3
585697598,0,0,0,3,3
236388946,0,3,0,0,3
236410516,0,3,0,0,3
2520598592,1,2,0,0,3
1431846151800573952,3,0,0,0,3
284422980,0,3,0,0,3
1177197673864151040,3,0,0,0,3
2866149777,1,1,1,0,3
890148292197097472,0,3,0,0,3
1433552569964503040,2,1,0,0,3
790055394903293952,0,3,0,0,3
1478633507148623872,0,3,0,0,3
2525411705,0,3,0,0,3
3347507350,0,3,0,0,3
2860871068,0,3,0,0,3
1238682711788679168,0,3,0,0,3
283520846,0,3,0,0,3
2525155376,0,3,0,0,3
42386100,0,3,0,0,3
1478739355476762624,0,3,0,0,3
945342546,1,2,0,0,3
23634689,0,3,0,0,3
1094683520,0,3,0,0,3
42352295,0,3,0,0,3
4768483452,0,3,0,0,3
900601384114040832,0,3,0,0,3
1435646964159418368,0,3,0,0,3
42291979,0,3,0,0,3
283542223,0,3,0,0,3
1399010820,0,3,0,0,3
1193919606328565760,0,3,0,0,3
625100946,0,3,0,0,3
588055865,0,3,0,0,3
2243705821,0,2,1,0,3
2526027441,1,2,0,0,3
393423439,0,3,0,0,3
995729109144686592,1,0,1,1,3
1478672676076015616,2,0,0,1,3
240918540,1,2,0,0,3
1938787387,0,1,0,2,3
241003267,0,3,0,0,3
953895709878571008,0,0,0,3,3
241076071,1,1,0,1,3
1435464609381552128,0,3,0,0,3
1022107876616269824,0,3,0,0,3
395179767,1,1,1,0,3
283875084,0,3,0,0,3
283966951,0,3,0,0,3
3345363496,0,3,0,0,3
395103854,0,3,0,0,3
2185675592,1,2,0,0,3
1448133271,0,3,0,0,3
367367289,0,3,0,0,3
1079435788562153472,0,3,0,0,3
1094694814606602240,0,3,0,0,3
915525697,0,3,0,0,3
2523608698,0,3,0,0,3
3345880751,0,3,0,0,3
586747464,0,3,0,0,3
1434724068683550720,3,0,0,0,3
1479059881508278272,1,1,0,1,3
42855351,0,3,0,0,3
239515213,3,0,0,0,3
42844936,0,3,0,0,3
2523720051,0,3,0,0,3
239016047,1,2,0,0,3
869861023431380992,1,2,0,0,3
23457538,0,3,0,0,3
587249986,0,3,0,0,3
1434869439393112064,0,3,0,0,3
1178015850642771968,1,2,0,0,3
1094576118361964544,0,3,0,0,3
1095836894,0,3,0,0,3
1478852295957880832,0,2,0,1,3
42660948,0,2,1,0,3
916048106,0,3,0,0,3
1478807288886538240,0,3,0,0,3
889445227282538496,0,3,0,0,3
3431762949,2,1,0,0,3
189843602,2,1,0,0,3
2208096543,0,3,0,0,3
347254197,0,3,0,0,3
97714944,0,3,0,0,3
15470411,0,1,1,1,3
3031396125,0,3,0,0,3
3031568039,0,3,0,0,3
515371565,0,3,0,0,3
461407414,0,3,0,0,3
102010145,0,3,0,0,3
97871730,0,3,0,0,3
2207958513,0,3,0,0,3
711992881091842048,0,3,0,0,3
847342921,0,3,0,0,3
847351520,0,3,0,0,3
1314875857,0,3,0,0,3
870937573,0,3,0,0,3
3030918712,0,3,0,0,3
3030733054,0,3,0,0,3
1498285267802804224,2,1,0,0,3
142910539,0,3,0,0,3
1042721093625114624,1,2,0,0,3
461084128,0,3,0,0,3
2148494875,0,3,0,0,3
1313736147982573568,0,3,0,0,3
1042769674793046016,0,0,2,1,3
967248109549039616,0,2,0,1,3
347380956,0,3,0,0,3
97405289,2,0,1,0,3
515804748,1,2,0,0,3
853163204364693504,2,1,0,0,3
97305688,0,3,0,0,3
1351064784205213696,3,0,0,0,3
1498442386275545088,1,2,0,0,3
1125480110285565952,3,0,0,0,3
98288279,0,1,0,2,3
1882278636,0,3,0,0,3
2420188774,0,2,1,0,3
1349302964347928576,0,3,0,0,3
1147705156508835840,1,2,0,0,3
1042073393682513920,2,0,0,1,3
1126137521174454272,0,3,0,0,3
141580966,0,3,0,0,3
462677607,0,3,0,0,3
885527820285468672,0,3,0,0,3
897192751669723136,0,0,2,1,3
323284789,0,3,0,0,3
2621283747,0,3,0,0,3
98878742,0,3,0,0,3
3177631056,1,2,0,0,3
852386885389385728,0,3,0,0,3
98711207,3,0,0,0,3
870665965,0,3,0,0,3
3034237522,2,1,0,0,3
1148016840389480448,0,2,1,0,3
2694427444,0,3,0,0,3
897216479334027264,0,3,0,0,3
2694480480,3,0,0,0,3
98443617,0,3,0,0,3
514440497,0,3,0,0,3
1215044611149910016,0,3,0,0,3
142044750,0,3,0,0,3
142112857,2,1,0,0,3
734749688331702272,0,3,0,0,3
462035293,0,3,0,0,3
734762107007295488,0,3,0,0,3
937167712349962240,1,2,0,0,3
1316167470,2,1,0,0,3
15478882,0,3,0,0,3
967069477262118912,2,0,0,1,3
1352572883864870912,0,2,1,0,3
95710481,0,3,0,0,3
4233775393,0,3,0,0,3
3023407216,2,1,0,0,3
710842290428895232,0,3,0,0,3
1352380729355870208,0,3,0,0,3
1352391377301200896,0,3,0,0,3
2618386603,3,0,0,0,3
95622081,1,2,0,0,3
1205166954115256320,0,3,0,0,3
3186843841,0,3,0,0,3
1215570618600607744,0,3,0,0,3
459190679,0,3,0,0,3
2356764103,0,1,1,1,3
871758098,3,0,0,0,3
737018334475096064,1,2,0,0,3
1317108134,0,3,0,0,3
962855893,0,3,0,0,3
1661503693,2,1,0,0,3
1312074173250895872,1,2,0,0,3
2426136627,3,0,0,0,3
845675522,0,3,0,0,3
1880776159,2,1,0,0,3
95180271,3,0,0,0,3
95138568,2,1,0,0,3
320749349,0,3,0,0,3
518491042,2,1,0,0,3
145628330,2,1,0,0,3
4009577482,0,3,0,0,3
95007481,0,3,0,0,3
1215729618122149888,0,0,3,0,3
710872505280544768,1,2,0,0,3
4232644047,0,3,0,0,3
96865198,2,0,1,0,3
2148175243,3,0,0,0,3
3027719049,2,1,0,0,3
143515459,3,0,0,0,3
2696902768,0,3,0,0,3
143731106,0,3,0,0,3
1013851813467082752,2,0,0,1,3
920709383176077312,0,3,0,0,3
1013800359087702016,0,3,0,0,3
143888652,1,1,0,1,3
460378900,0,3,0,0,3
1042892075640020992,0,3,0,0,3
979755757515177984,0,3,0,0,3
1313217503057846272,2,0,0,1,3
3185622217,1,2,0,0,3
1313143335373148160,0,3,0,0,3
1498200383231262720,0,3,0,0,3
2424936983,0,3,0,0,3
144111011,3,0,0,0,3
3025610674,0,3,0,0,3
871571802,0,3,0,0,3
1498198383504154624,0,3,0,0,3
710919779507380224,0,3,0,0,3
2424205708,0,3,0,0,3
979959503457325056,3,0,0,0,3
2208849576,0,3,0,0,3
2697945751,0,3,0,0,3
3186063336,1,1,0,1,3
459377291,3,0,0,0,3
840221321791442944,0,3,0,0,3
736809351558483968,0,3,0,0,3
95872056,0,1,2,0,3
937370793306214400,1,2,0,0,3
99062509,0,3,0,0,3
15117889,0,3,0,0,3
3041295449,2,0,0,1,3
968279033405460480,0,3,0,0,3
2625342923,0,3,0,0,3
1214067422606442496,3,0,0,0,3
509739207,3,0,0,0,3
885812079172534272,0,3,0,0,3
1214122195711954944,0,3,0,0,3
2416224194,0,3,0,0,3
1316702118489849856,0,3,0,0,3
801700889559961600,1,2,0,0,3
1146457753822609408,0,3,0,0,3
1316676013351333888,0,3,0,0,3
101003921,0,2,0,1,3
101002059,1,1,0,1,3
2689873356,0,3,0,0,3
3166236423,0,1,0,2,3
4040614828,1,2,0,0,3
940928190444269568,0,3,0,0,3
100828909,0,3,0,0,3
3166312871,0,3,0,0,3
740782088,0,3,0,0,3
841643884425969664,1,2,0,0,3
732599967458676736,1,1,0,1,3
4211872994,2,0,1,0,3
346163240,0,0,2,1,3
3166992713,0,3,0,0,3
1316418674098679808,0,3,0,0,3
510084343,0,3,0,0,3
139661734,0,2,0,1,3
1316386235733217280,2,1,0,0,3
1316351558473248768,0,0,0,3,3
101307237,0,3,0,0,3
4041344854,0,3,0,0,3
1347914275738816512,1,2,0,0,3
326437621,0,3,0,0,3
885857112026484736,0,3,0,0,3
101947366,0,2,0,1,3
326721022,1,2,0,0,3
1317663715169284096,0,3,0,0,3
1500386970408792064,0,2,0,1,3
1317570136379920384,1,0,0,2,3
345882933,0,3,0,0,3
982984872,0,3,0,0,3
101805752,0,3,0,0,3
937676699935920128,0,3,0,0,3
1146049365959684096,0,3,0,0,3
1146124178766127104,0,3,0,0,3
1625134080,2,1,0,0,3
842029626608123904,2,1,0,0,3
467157125,0,3,0,0,3
101315053,0,3,0,0,3
1213881801547997184,0,3,0,0,3
732234742888841216,0,3,0,0,3
742519254,0,3,0,0,3
467150595,1,2,0,0,3
1347189297099599872,0,3,0,0,3
3043219108,0,3,0,0,3
1240280636,0,3,0,0,3
1317128855233101824,0,3,0,0,3
925427687715495936,0,3,0,0,3
1206284378642370560,0,3,0,0,3
849551382,0,3,0,0,3
1064271017550467072,0,3,0,0,3
326001533,0,3,0,0,3
841951035551846400,0,3,0,0,3
465387214,1,2,0,0,3
1214242129750323200,0,3,0,0,3
323632082,3,0,0,0,3
99457440,0,0,0,3,3
1499053620796534784,0,3,0,0,3
841563238269628416,1,0,2,0,3
1037738152255995904,0,3,0,0,3
2193687328,2,0,0,1,3
1147126249464246272,0,3,0,0,3
869218314,2,0,0,1,3
1315555633492619264,0,3,0,0,3
1315532639798001664,0,3,0,0,3
1037722611596369920,0,3,0,0,3
140855572,0,2,1,0,3
968004254320361472,0,3,0,0,3
1017965020670406656,0,3,0,0,3
3173076421,0,3,0,0,3
140885019,0,3,0,0,3
511712904,3,0,0,0,3
140719051,3,0,0,0,3
1656309752,0,3,0,0,3
1499016369219768320,2,0,0,1,3
733806961582571520,0,3,0,0,3
1656370069,0,3,0,0,3
905837661189021696,0,3,0,0,3
1315223869821726720,0,3,0,0,3
2623023106,1,2,0,0,3
1498980214478897152,2,1,0,0,3
463653182,0,0,1,2,3
1214761893035798528,3,0,0,0,3
3036336178,0,3,0,0,3
1315007027492651008,2,0,0,1,3
852206239211716608,2,1,0,0,3
963721693,0,3,0,0,3
464095712,0,3,0,0,3
968068444842352640,0,2,0,1,3
3039708623,0,3,0,0,3
940982173984808960,0,3,0,0,3
1127121974784741376,0,3,0,0,3
139881542,0,3,0,0,3
465364185,0,3,0,0,3
1316301124958408704,0,3,0,0,3
3167410834,0,3,0,0,3
1316277136458735616,0,3,0,0,3
1308044526,0,3,0,0,3
732845008592723968,0,3,0,0,3
465306256,0,3,0,0,3
510294041,0,3,0,0,3
140241168,0,3,0,0,3
3039225459,0,0,3,0,3
921400532052336640,0,2,0,1,3
2417750576,0,3,0,0,3
140331707,0,3,0,0,3
14963281,2,0,0,1,3
4035087672,0,3,0,0,3
740311177,0,3,0,0,3
14917151,3,0,0,0,3
324867430,0,3,0,0,3
100325195,0,3,0,0,3
464727783,0,3,0,0,3
510408899,0,3,0,0,3
324842593,0,3,0,0,3
1315907897470128128,0,3,0,0,3
732943512564596736,0,3,0,0,3
1238720941,3,0,0,0,3
984178898,0,3,0,0,3
2362930993,1,0,2,0,3
968074919450988544,0,3,0,0,3
853590632123813888,0,3,0,0,3
1311733387632291840,0,3,0,0,3
1066370484953071616,0,2,0,1,3
452350565,0,3,0,0,3
2350668594,0,3,0,0,3
740960772092792832,0,3,0,0,3
1357175666425253888,0,3,0,0,3
708216174505500672,0,3,0,0,3
1357303119957299200,3,0,0,0,3
1152122665932611584,0,3,0,0,3
941802280151420928,1,1,0,1,3
524798584,3,0,0,0,3
452546243,0,3,0,0,3
349818632,0,2,1,0,3
3005755239,0,3,0,0,3
89431746,0,3,0,0,3
1306176164738805760,0,3,0,0,3
3201470985,0,3,0,0,3
2350661273,0,3,0,0,3
1357054308739670016,0,3,0,0,3
525131716,0,3,0,0,3
349915986,0,3,0,0,3
1323875419,2,0,1,0,3
838480041260376064,0,3,0,0,3
1067798461276291072,0,3,0,0,3
1357337336669896704,1,2,0,0,3
741453925333803008,1,2,0,0,3
89322683,0,0,2,1,3
1497227458298486784,2,0,1,0,3
89293722,1,2,0,0,3
741525858003910656,1,2,0,0,3
1209886118,0,3,0,0,3
838378247230525440,2,0,0,1,3
842463680,0,3,0,0,3
1218203416587051008,0,3,0,0,3
317729114,3,0,0,0,3
1152449295477592064,0,3,0,0,3
523617592,0,3,0,0,3
3993918701,0,3,0,0,3
91052791,2,0,1,0,3
906170641702727680,0,3,0,0,3
1151740373145800704,0,3,0,0,3
454067657,0,0,2,1,3
1488666457,3,0,0,0,3
2433206162,0,3,0,0,3
1204326130448314368,0,3,0,0,3
1306961511441559552,0,3,0,0,3
1322859828,0,3,0,0,3
874863350,2,1,0,0,3
1497468390365093888,0,1,2,0,3
151186223,0,3,0,0,3
1151825563163791360,0,1,1,1,3
2192583236,0,3,0,0,3
1356960409991995392,0,3,0,0,3
3197526121,0,3,0,0,3
3007914417,0,3,0,0,3
981276149417463808,0,3,0,0,3
1306832265557676032,0,3,0,0,3
1067631078775693312,2,1,0,0,3
1306761067415175168,1,0,0,2,3
1218191538762715136,0,3,0,0,3
3198290447,0,3,0,0,3
3198447541,0,3,0,0,3
151841363,1,2,0,0,3
1151941507546374144,1,0,2,0,3
1151983125792251904,0,1,0,2,3
152179276,1,2,0,0,3
317736670,0,3,0,0,3
3003723206,1,2,0,0,3
2713928958,3,0,0,0,3
454187516,1,2,0,0,3
87681988,0,3,0,0,3
707530516635983872,0,3,0,0,3
1497032378358931456,0,3,0,0,3
3214736993,0,3,0,0,3
1304451681372041216,0,3,0,0,3
1218956707856027648,0,3,0,0,3
1203864972830355456,0,3,0,0,3
155508365,1,2,0,0,3
1035573415493750784,1,1,0,1,3
155590285,2,0,0,1,3
16492847,0,3,0,0,3
155597614,0,1,0,2,3
2999162467,1,2,0,0,3
155638372,2,1,0,0,3
350618935,0,3,0,0,3
2439614112,0,3,0,0,3
16448706,0,3,0,0,3
1878483764,0,3,0,0,3
155956621,0,3,0,0,3
981907370660986880,0,3,0,0,3
1304234198648213504,1,0,0,2,3
1485758250,0,3,0,0,3
1304135458641899520,0,3,0,0,3
1219154577238503424,0,3,0,0,3
1359030930178932736,1,2,0,0,3
919044972451651584,0,3,0,0,3
2715689509,0,3,0,0,3
2440035287,1,0,0,2,3
156198185,1,0,0,2,3
918866154462031872,0,3,0,0,3
3217721981,0,3,0,0,3
16457988,2,0,0,1,3
2438116014,1,2,0,0,3
3204468610,3,0,0,0,3
1204028000481751040,2,1,0,0,3
1013174542683049984,0,3,0,0,3
88887465,0,3,0,0,3
838241233096974336,1,0,0,2,3
1357691591113252864,1,0,2,0,3
1121227748909953024,0,3,0,0,3
1035750754273959936,2,0,1,0,3
316918050,0,0,1,2,3
2349831570,0,3,0,0,3
876100142,0,3,0,0,3
1218600636989575168,0,0,0,3,3
525911138,0,3,0,0,3
884922595027582976,1,0,2,0,3
2714602075,0,3,0,0,3
3206736045,1,2,0,0,3
154453122,2,0,0,1,3
1304663709206433792,0,3,0,0,3
965664679153451008,0,3,0,0,3
3001273615,0,2,1,0,3
316652581,2,0,0,1,3
2164796017,0,3,0,0,3
1057669962762981376,0,2,0,1,3
154681571,0,3,0,0,3
726720120,0,3,0,0,3
1304854999604879360,1,2,0,0,3
3001136328,0,3,0,0,3
4252368673,0,3,0,0,3
1497119294966345728,1,2,0,0,3
837913903027867648,0,3,0,0,3
1207262264,0,3,0,0,3
88136479,3,0,0,0,3
454140666,0,3,0,0,3
150630882,0,3,0,0,3
1497873017166340096,1,0,1,1,3
738766754843877376,0,3,0,0,3
1043289405597802496,1,2,0,0,3
147080504,0,3,0,0,3
962189629,0,0,0,3,3
738533304845139968,0,3,0,0,3
1490655764,2,1,0,0,3
1066977252393607168,0,3,0,0,3
15848832,1,2,0,0,3
93949528,0,3,0,0,3
1123386851035717632,0,1,2,0,3
732285374,0,3,0,0,3
319592199,0,3,0,0,3
1220775295,0,3,0,0,3
520767128,0,3,0,0,3
1067006464974295040,0,1,0,2,3
2429408276,2,1,0,0,3
966651709874491392,0,3,0,0,3
1204810507334627328,0,3,0,0,3
1978981712,1,2,0,0,3
1309895353009950720,0,3,0,0,3
2429471475,0,3,0,0,3
93194555,0,3,0,0,3
456595925,0,3,0,0,3
349138618,0,3,0,0,3
1067037722366418944,0,3,0,0,3
456542851,0,1,2,0,3
1319867221,0,3,0,0,3
738864516730085376,2,1,0,0,3
147968669,0,3,0,0,3
1123107975172972544,3,0,0,0,3
92961161,0,3,0,0,3
1318994767,0,0,0,3,3
1221013968,0,3,0,0,3
1309462682811146240,1,2,0,0,3
1353369677766995968,1,2,0,0,3
3189294874,0,3,0,0,3
1149834471560163328,0,3,0,0,3
920433840450977792,0,3,0,0,3
980147867867328512,0,3,0,0,3
3020596441,0,3,0,0,3
15734962,1,2,0,0,3
1013691739482173440,1,1,1,0,3
710383228805320704,0,3,0,0,3
94834249,0,3,0,0,3
4236838647,0,3,0,0,3
1353262750798127104,2,1,0,0,3
3019606069,0,3,0,0,3
3019605488,0,3,0,0,3
1353366866660634624,1,1,0,1,3
1222691623,0,3,0,0,3
3017676103,0,3,0,0,3
457558572,0,3,0,0,3
519596657,0,3,0,0,3
1216001631751372800,0,3,0,0,3
845313296,0,3,0,0,3
2703861968,0,3,0,0,3
3018650441,0,3,0,0,3
348580399,1,1,1,0,3
1013553343665491968,0,3,0,0,3
1353559069555007488,0,3,0,0,3
146752794,0,3,0,0,3
3018279549,0,3,0,0,3
457236709,1,2,0,0,3
94304792,0,3,0,0,3
839482452355727360,0,3,0,0,3
2353715336,0,3,0,0,3
3192657041,0,3,0,0,3
454202884,0,3,0,0,3
992624257,0,3,0,0,3
3194740021,1,2,0,0,3
3194913091,0,3,0,0,3
739861430447509504,2,1,0,0,3
1355329401211260928,0,3,0,0,3
318635140,1,2,0,0,3
15977444,0,3,0,0,3
2615028042,0,3,0,0,3
318550869,0,2,0,1,3
149837539,0,3,0,0,3
91576334,0,3,0,0,3
349473283,0,3,0,0,3
1308094683013242880,0,3,0,0,3
91533423,0,2,1,0,3
2163511259,0,3,0,0,3
3010681729,0,3,0,0,3
455308081,0,3,0,0,3
1307879793170366464,0,0,0,3,3
150188010,0,2,1,0,3
15993931,0,3,0,0,3
740194716952723456,0,2,0,1,3
523063566,0,3,0,0,3
1151563337794293760,0,3,0,0,3
2711410996,0,3,0,0,3
740251905763475456,0,3,0,0,3
992911105,0,3,0,0,3
91291866,1,2,0,0,3
1356144084122034176,1,2,0,0,3
91283955,0,3,0,0,3
2711689925,0,3,0,0,3
1217726238313218048,0,3,0,0,3
885105645304782848,0,3,0,0,3
874309465,0,3,0,0,3
980760157264252928,0,3,0,0,3
1151102865596747776,2,0,1,0,3
3014530882,1,2,0,0,3
1150783487152021504,0,3,0,0,3
894205988890451968,0,3,0,0,3
1309317756785958912,1,0,0,2,3
2430631222,0,3,0,0,3
92356198,0,3,0,0,3
709785602896629760,0,3,0,0,3
739121312262684672,0,3,0,0,3
148653675,0,3,0,0,3
349173325,0,3,0,0,3
2353388936,0,3,0,0,3
2353158913,0,3,0,0,3
709644999722283008,0,0,0,3,3
1018575020677885952,1,1,1,0,3
980890493427990528,3,0,0,0,3
3012193755,3,0,0,0,3
1497622932377513984,0,3,0,0,3
1354629095976431616,0,3,0,0,3
1497618477032652800,0,3,0,0,3
1497595669170827264,0,3,0,0,3
1308723986360987648,1,2,0,0,3
885112537913729024,0,3,0,0,3
873935508,0,3,0,0,3
1354743312360611840,0,3,0,0,3
2431568657,0,0,0,3,3
1308595890295312384,0,1,1,1,3
1217043228,0,2,1,0,3
1497585181594722304,0,3,0,0,3
1122747523683061760,3,0,0,0,3
739812916438958080,3,0,0,0,3
1304988548,2,1,0,0,3
2684901655,0,3,0,0,3
1359373737154367488,3,0,0,0,3
1336936443281723392,0,3,0,0,3
1133524119390236672,2,0,1,0,3
3086257373,0,3,0,0,3
335484874,0,3,0,0,3
123947377,0,3,0,0,3
923979721901330432,0,3,0,0,3
493092154,1,2,0,0,3
2393702328,0,3,0,0,3
1038193408169242624,1,2,0,0,3
1644600883,0,3,0,0,3
1280377266,0,3,0,0,3
1138365142117343232,0,3,0,0,3
2660299217,0,3,0,0,3
923774693953490944,0,3,0,0,3
335802622,0,3,0,0,3
1208364982804647936,0,3,0,0,3
112701599,0,3,0,0,3
1208364439499493376,0,3,0,0,3
340955050,0,3,0,0,3
479952632,0,3,0,0,3
2377744292,2,0,1,0,3
1521009007,2,1,0,0,3
2395708651,1,2,0,0,3
1337365554630422528,0,3,0,0,3
4100678053,1,1,0,1,3
124505589,0,0,0,3,3
112492891,0,3,0,0,3
3083863360,0,3,0,0,3
2646969284,0,0,0,3,3
2377596013,2,0,1,0,3
2377547251,0,3,0,0,3
479351259,2,0,1,0,3
719895302493310976,0,3,0,0,3
1513875601,0,3,0,0,3
113275459,0,3,0,0,3
1336553611610865664,0,3,0,0,3
2154741854,0,3,0,0,3
2391418224,0,3,0,0,3
482227685,0,3,0,0,3
1327882721012670464,0,3,0,0,3
4167014353,0,3,0,0,3
1523925711010029568,1,0,2,0,3
336396447,0,3,0,0,3
1336182163054714880,2,1,0,0,3
2379308664,0,3,0,0,3
122895201,0,3,0,0,3
1137994039989559296,0,3,0,0,3
2659236222,0,3,0,0,3
492169787,0,3,0,0,3
113484813,0,3,0,0,3
1210779040321130496,0,3,0,0,3
3089367406,1,0,1,1,3
123053416,0,3,0,0,3
2392359307,0,3,0,0,3
1138106346082115584,0,3,0,0,3
113397530,3,0,0,0,3
1513966333,0,3,0,0,3
3090298063,1,0,2,0,3
1522971341602840576,0,1,1,1,3
7455282,2,0,1,0,3
3089782029,0,3,0,0,3
1133765876837113856,0,3,0,0,3
845621494252257280,0,0,0,3,3
1280156383,0,3,0,0,3
113304306,0,3,0,0,3
760093950,0,3,0,0,3
939656588499062784,2,1,0,0,3
124962219,0,3,0,0,3
1208106265395617792,2,0,0,1,3
1324762533752918016,0,3,0,0,3
3079954404,0,3,0,0,3
971455042589880320,0,2,0,1,3
1061659472383410176,1,0,0,2,3
1139940247121408000,1,2,0,0,3
862732914,0,3,0,0,3
1634802222,0,3,0,0,3
126413854,0,0,0,3,3
126451088,0,3,0,0,3
342569638,1,1,1,0,3
1139986837718671360,0,3,0,0,3
1896840361,0,3,0,0,3
1132320481506406400,2,0,0,1,3
1132258233677221888,0,3,0,0,3
3079041268,0,3,0,0,3
2399405035,0,3,0,0,3
342133551,0,3,0,0,3
862980542,2,1,0,0,3
1140173300871704576,0,3,0,0,3
863135287,0,3,0,0,3
2666004198,0,1,0,2,3
3077967339,0,3,0,0,3
755728465,1,1,1,0,3
1324597578680459264,0,3,0,0,3
1339473976570032128,2,0,0,1,3
978555372,0,3,0,0,3
477106458,0,3,0,0,3
1039011280735154176,0,3,0,0,3
476877287,0,3,0,0,3
1339520246735130624,0,1,0,2,3
1339554291070062592,0,3,0,0,3
1339212595824357376,0,2,0,1,3
1139832894635950080,0,3,0,0,3
1211506903223652352,0,3,0,0,3
125378643,2,1,0,0,3
769827120,0,3,0,0,3
922395316753637376,0,3,0,0,3
1520076504402731008,0,3,0,0,3
2396350303,0,2,1,0,3
1208092821430964224,0,3,0,0,3
1338065041728352256,0,3,0,0,3
334714216,0,3,0,0,3
1520008056763207680,1,0,0,2,3
2376915344,0,3,0,0,3
1338377663673581568,3,0,0,0,3
111545880,2,1,0,0,3
1896529466,0,0,0,3,3
111332593,0,3,0,0,3
3129614606,0,3,0,0,3
478886941,1,2,0,0,3
1285458360,0,3,0,0,3
844938338478047232,0,3,0,0,3
3129647792,0,3,0,0,3
849291587918188544,2,1,0,0,3
1039176738687700992,0,3,0,0,3
1325338544726974464,0,3,0,0,3
2646427760,1,0,2,0,3
1325260926962950144,0,3,0,0,3
111211074,0,3,0,0,3
2375791278,0,3,0,0,3
1339028312094601216,0,3,0,0,3
1257718879,0,3,0,0,3
478669971,3,0,0,0,3
1058458881284866048,0,3,0,0,3
4177226173,0,2,0,1,3
3092620431,0,1,2,0,3
720289078214692864,0,2,1,0,3
2379763955,0,3,0,0,3
1895353393,0,3,0,0,3
116665330,1,2,0,0,3
3103299212,0,3,0,0,3
3111717334,0,3,0,0,3
1016730015994556416,2,1,0,0,3
3111992550,2,1,0,0,3
1516187430,0,3,0,0,3
3102715056,1,2,0,0,3
1330904227477065728,0,3,0,0,3
846960539662274560,1,1,0,1,3
118930948,1,2,0,0,3
1330779880087318528,0,3,0,0,3
1135652142323253248,0,3,0,0,3
895605515383971840,1,0,2,0,3
3101939425,2,0,1,0,3
3112550864,0,3,0,0,3
338267206,0,3,0,0,3
484941072,3,0,0,0,3
923021071816601600,0,3,0,0,3
1265067817,0,3,0,0,3
1039980930029563904,0,3,0,0,3
723472430539366400,0,3,0,0,3
721604902200483840,0,3,0,0,3
115910049,1,2,0,0,3
1136896372672815104,0,3,0,0,3
1333882432001609728,1,2,0,0,3
1209797245979238400,0,3,0,0,3
484486775,0,3,0,0,3
1272819800,1,2,0,0,3
1264303692,0,3,0,0,3
3099703632,0,3,0,0,3
1519976640,0,3,0,0,3
338268038,2,1,0,0,3
1136970289714274304,0,3,0,0,3
117052198,3,0,0,0,3
1332632989289865216,0,2,0,1,3
805210202186383360,0,3,0,0,3
1135981919160553472,1,2,0,0,3
805137888958697472,0,3,0,0,3
3107823977,0,3,0,0,3
1135791369228816384,0,3,0,0,3
117341432,0,1,1,1,3
1209328311459090432,0,3,0,0,3
1136145468801585152,0,3,0,0,3
3108688985,1,2,0,0,3
117762867,0,3,0,0,3
1136189044097003520,0,3,0,0,3
3108770149,0,3,0,0,3
3107400051,3,0,0,0,3
117883274,0,3,0,0,3
767838450,1,1,0,1,3
1136227168420225024,0,3,0,0,3
905087751997063168,0,3,0,0,3
3109285936,0,3,0,0,3
118059086,1,2,0,0,3
118066812,0,3,0,0,3
118083001,1,0,0,2,3
338385537,0,3,0,0,3
2196444530,0,3,0,0,3
3105725275,0,3,0,0,3
3105079623,0,1,2,0,3
1640346066,0,3,0,0,3
338941211,0,3,0,0,3
859589090,1,0,0,2,3
1331705185228513280,1,0,2,0,3
484289314,0,3,0,0,3
1272883170,0,3,0,0,3
1060513427565801472,0,1,0,2,3
482858660,0,3,0,0,3
768809352,0,3,0,0,3
3095815429,0,0,3,0,3
1060251212170346496,1,2,0,0,3
1642700995,0,3,0,0,3
1137416561600450560,0,3,0,0,3
1274515956,0,3,0,0,3
1637260062,3,0,0,0,3
2382659762,0,3,0,0,3
336839378,0,3,0,0,3
804584972233228288,0,3,0,0,3
3095256917,0,3,0,0,3
848160505617408000,0,3,0,0,3
1328419313418690560,0,3,0,0,3
845984788569870336,1,2,0,0,3
114180822,0,0,0,3,3
4162886175,3,0,0,0,3
1328367032040124416,0,3,0,0,3
490738707,1,2,0,0,3
1335216227656994816,2,1,0,0,3
1328255043477196800,0,3,0,0,3
860676404,0,2,0,1,3
122037326,0,3,0,0,3
2390648829,1,2,0,0,3
1134366558027993088,0,3,0,0,3
2380334834,0,1,1,1,3
491429875,0,3,0,0,3
491616984,0,3,0,0,3
761480786,0,3,0,0,3
1279430694,0,3,0,0,3
724608026368421888,2,1,0,0,3
1334629345873207296,0,3,0,0,3
1334619877869490176,0,3,0,0,3
847379273589506048,1,2,0,0,3
895452794479558656,0,2,1,0,3
1137186697811091456,0,1,1,1,3
1329899442875535360,1,2,0,0,3
3200661,2,1,0,0,3
1264020614,0,3,0,0,3
119991421,0,3,0,0,3
857861496,3,0,0,0,3
120061459,2,0,1,0,3
1329755773140938752,0,3,0,0,3
721224737708445696,0,3,0,0,3
1894391672,0,3,0,0,3
805467502939668480,2,0,1,0,3
1329663443050250240,0,3,0,0,3
1263986545,2,1,0,0,3
337207296,0,3,0,0,3
3098264587,0,3,0,0,3
1329028580639002624,2,0,0,1,3
115083073,0,3,0,0,3
2389275150,0,3,0,0,3
1329344195887325184,0,3,0,0,3
2389376698,0,3,0,0,3
337189106,0,3,0,0,3
1263741518,2,1,0,0,3
4127503461,0,3,0,0,3
3097862137,2,0,0,1,3
1329132600003162112,3,0,0,0,3
121061258,0,3,0,0,3
114835698,0,3,0,0,3
763716493,2,1,0,0,3
972787664473804800,0,3,0,0,3
121166029,0,3,0,0,3
110289532,0,3,0,0,3
3132711951,0,3,0,0,3
1339841857304596480,0,3,0,0,3
4067069693,0,3,0,0,3
1015238873591533568,0,3,0,0,3
470652740,0,3,0,0,3
1651504064,0,3,0,0,3
1246145426,3,0,0,0,3
328808940,0,3,0,0,3
1508850669796663296,0,3,0,0,3
104018867,0,3,0,0,3
134552828,0,0,3,0,3
2681307529,1,0,2,0,3
1213332613382828032,0,3,0,0,3
1015137490569551872,0,3,0,0,3
4068859516,0,3,0,0,3
2160285257,0,3,0,0,3
1345385383933206528,1,2,0,0,3
1213395974413926400,2,0,0,1,3
807130693524484096,0,3,0,0,3
503055396,0,3,0,0,3
134862572,0,3,0,0,3
1063483723948150784,0,0,0,3,3
730213755645267968,0,3,0,0,3
2412038367,0,3,0,0,3
1319736183656751104,0,2,0,1,3
866975419,0,3,0,0,3
1507054201867808768,0,3,0,0,3
1213452781341663232,0,3,0,0,3
135012530,0,3,0,0,3
503773891,0,3,0,0,3
1206591893326442496,0,0,1,2,3
1319609170853810176,1,2,0,0,3
2412267667,0,3,0,0,3
3058945316,1,1,0,1,3
852285122,0,3,0,0,3
2204311063,0,3,0,0,3
329182780,0,3,0,0,3
921920451575676928,0,3,0,0,3
1344200451021889536,3,0,0,0,3
853181058,0,3,0,0,3
940623939985842176,0,3,0,0,3
716329456260894720,3,0,0,0,3
1321048369536638976,1,1,0,1,3
3150512738,1,2,0,0,3
501400583,1,2,0,0,3
2409220966,0,3,0,0,3
1344333091612057600,0,3,0,0,3
1320832489989038080,3,0,0,0,3
104887943,0,3,0,0,3
329237447,0,3,0,0,3
4070941694,0,3,0,0,3
104805411,0,3,0,0,3
104215821,1,2,0,0,3
980779734,1,0,0,2,3
104773715,0,3,0,0,3
344750791,1,0,2,0,3
866004967,0,3,0,0,3
104484563,0,1,0,2,3
1344724006386200576,0,3,0,0,3
715995971436617728,0,3,0,0,3
2410094957,0,0,1,2,3
4068930263,1,2,0,0,3
134075812,0,3,0,0,3
1344878979493236736,0,3,0,0,3
852609565,3,0,0,0,3
715952780679233536,0,3,0,0,3
2410522884,0,3,0,0,3
103487182,0,3,0,0,3
328285437,0,3,0,0,3
3150308066,0,3,0,0,3
1318274608412250112,0,3,0,0,3
102647999,0,3,0,0,3
1498314336,1,2,0,0,3
1318495309442449408,0,3,0,0,3
102623084,0,3,0,0,3
1128790860580233216,0,3,0,0,3
1038300126983479296,0,3,0,0,3
851219149573500928,0,3,0,0,3
1145410330933256192,0,3,0,0,3
3048554083,0,3,0,0,3
1213773076749406208,1,2,0,0,3
1128629235873140736,1,0,1,1,3
2366473429,0,3,0,0,3
136982411,0,3,0,0,3
327240184,0,3,0,0,3
3159320343,0,0,2,1,3
14409630,0,3,0,0,3
1145620281882361856,0,3,0,0,3
102430225,3,0,0,0,3
1128539235068211200,0,3,0,0,3
3046624071,1,2,0,0,3
2365946037,0,3,0,0,3
507308235,0,3,0,0,3
4203022213,2,1,0,0,3
1500929299016294400,0,0,0,3,3
1242470864,1,2,0,0,3
771431941,3,0,0,0,3
1317975038780465152,0,3,0,0,3
1145714964117803008,0,3,0,0,3
2628120280,0,3,0,0,3
14636639,0,3,0,0,3
802399009411305472,0,3,0,0,3
1886792400,0,3,0,0,3
103478924,0,3,0,0,3
851438240,0,3,0,0,3
921751640088117248,0,3,0,0,3
1129664071723147264,0,3,0,0,3
715572691886022656,0,3,0,0,3
103321044,0,3,0,0,3
1319337432693821440,3,0,0,0,3
1319236688372137984,0,3,0,0,3
2367859152,0,3,0,0,3
504402615,0,3,0,0,3
1129561710396923904,0,0,3,0,3
2367776352,0,3,0,0,3
3051032096,0,3,0,0,3
730822348241293312,0,3,0,0,3
14311549,1,1,1,0,3
345117833,0,3,0,0,3
4062793595,3,0,0,0,3
1213640892931665920,1,0,2,0,3
977584504608092160,0,3,0,0,3
1206518883772850176,0,3,0,0,3
135887498,0,3,0,0,3
345257901,0,3,0,0,3
1129008528977534976,0,3,0,0,3
1346049285788377088,0,3,0,0,3
102869127,0,0,0,3,3
842445905697636352,0,3,0,0,3
731050037577289728,2,1,0,0,3
136197326,0,3,0,0,3
886020350697504768,0,3,0,0,3
102712927,0,3,0,0,3
1887047923,0,3,0,0,3
1243893187,0,3,0,0,3
105150965,0,3,0,0,3
3061803484,0,3,0,0,3
127523111,1,2,0,0,3
498432627,0,3,0,0,3
129125538,0,3,0,0,3
3139672604,0,3,0,0,3
1131475027373649920,0,3,0,0,3
1254436688,3,0,0,0,3
3139967847,0,3,0,0,3
129217996,2,0,0,1,3
129269243,0,0,0,3,3
864305988,0,2,0,1,3
1323545927198642176,0,3,0,0,3
1341688920384278528,3,0,0,0,3
331653300,0,3,0,0,3
1062325150572597248,0,3,0,0,3
967895167,0,3,0,0,3
1141539319154270208,0,3,0,0,3
107967527,0,3,0,0,3
2202059789,0,3,0,0,3
754299920,1,0,2,0,3
2403394146,0,3,0,0,3
1341955800844136448,1,1,1,0,3
3069117656,0,2,1,0,3
107758813,3,0,0,0,3
3068493570,0,0,0,3,3
1207272716828631040,0,3,0,0,3
1342338739096363008,0,2,0,1,3
1017501634887344128,0,3,0,0,3
717317542222520320,0,3,0,0,3
1252875996,0,3,0,0,3
803252923480346624,0,3,0,0,3
474348289,0,3,0,0,3
2404534911,0,3,0,0,3
755242082,0,3,0,0,3
11759072,1,1,0,1,3
343861983,0,3,0,0,3
128206220,0,3,0,0,3
1212040996495609856,0,3,0,0,3
342836553,2,1,0,0,3
496557454,0,3,0,0,3
333288788,0,2,1,0,3
803721034545430528,0,3,0,0,3
1340030955717709824,0,3,0,0,3
2158595513,1,2,0,0,3
1340196256862384128,0,3,0,0,3
127815606,3,0,0,0,3
2158674797,0,3,0,0,3
1212078369593888768,0,0,0,3,3
3074401109,0,3,0,0,3
128036044,0,3,0,0,3
844483475851939840,0,3,0,0,3
128255614,0,3,0,0,3
4087708312,0,3,0,0,3
979151989,0,0,0,3,3
128427251,0,3,0,0,3
3073250324,0,3,0,0,3
1340716887269847040,0,3,0,0,3
497127030,0,3,0,0,3
1212194217742626816,2,0,1,0,3
2643175987,0,3,0,0,3
1341281451724161024,0,3,0,0,3
1131560457939050496,0,1,0,2,3
1519114497545306112,0,2,0,1,3
1341340792154107904,0,3,0,0,3
1323824437112655872,0,3,0,0,3
4090325506,0,3,0,0,3
1212323090572566528,0,1,0,2,3
3068152430,0,3,0,0,3
803222007517212672,0,3,0,0,3
4190001892,0,3,0,0,3
896370850093568000,0,3,0,0,3
976460979335761920,0,3,0,0,3
1343541679433900032,0,3,0,0,3
2407352670,0,3,0,0,3
1248307267,0,3,0,0,3
976705139493961728,3,0,0,0,3
1248062988,3,0,0,0,3
329901783,0,3,0,0,3
3062901987,0,3,0,0,3
329823642,1,1,1,0,3
1130468035045801984,0,3,0,0,3
729272458193309696,0,3,0,0,3
3147646831,3,0,0,0,3
3062465383,0,3,0,0,3
106124569,0,0,0,3,3
1142992063534776320,1,1,1,0,3
473081127,0,3,0,0,3
1629712668,0,3,0,0,3
1015306713493274624,0,3,0,0,3
1321416877776818176,1,0,1,1,3
132613317,2,0,0,1,3
1130408077688225792,0,3,0,0,3
1143105379418759168,0,1,1,1,3
500897061,0,3,0,0,3
1343943461553266688,0,3,0,0,3
500940284,0,3,0,0,3
500974868,0,3,0,0,3
3149691727,0,3,0,0,3
976742072999907328,2,1,0,0,3
105234387,0,3,0,0,3
1321177215141371904,0,0,0,3,3
1062718617337323520,0,3,0,0,3
2370725349,0,3,0,0,3
3142270463,1,2,0,0,3
1142253410772611072,0,3,0,0,3
130764078,0,3,0,0,3
3142382442,0,2,1,0,3
3142953832,0,3,0,0,3
107456386,3,0,0,0,3
864674186,1,2,0,0,3
2152684466,0,2,0,1,3
1342685717290475520,2,0,0,1,3
12726792,1,2,0,0,3
12759692,1,1,1,0,3
886238552702337024,1,0,0,2,3
1342796312576716800,0,3,0,0,3
2371750994,2,0,0,1,3
1252355886,0,3,0,0,3
728137269530386432,2,0,0,1,3
3066776317,0,3,0,0,3
1322019578159902720,2,0,1,0,3
1888480538,1,0,2,0,3
1342969869852143616,0,3,0,0,3
1212773702896500736,0,3,0,0,3
2636733756,1,2,0,0,3
1131098138742263808,1,2,0,0,3
1322228849782919168,0,3,0,0,3
1343233271245762560,1,2,0,0,3
106691118,0,3,0,0,3
1212796406664089600,0,3,0,0,3
2371022792,0,1,0,2,3
3065176599,0,3,0,0,3
1206939271761817600,0,3,0,0,3
106379353,1,2,0,0,3
1249729843,0,2,0,1,3
87160373,0,3,0,0,3
1151040180679319552,0,3,0,0,3
810080249388138496,0,3,0,0,3
169375693,3,0,0,0,3
882110607146840064,1,2,0,0,3
3256484373,0,3,0,0,3
1222136047053590528,0,3,0,0,3
304266093,0,3,0,0,3
1538706936,0,3,0,0,3
1609957022,0,3,0,0,3
70996927,0,3,0,0,3
1372101148786749440,0,1,0,2,3
356663265,0,3,0,0,3
837514286,1,2,0,0,3
2949262920,0,3,0,0,3
169399849,0,3,0,0,3
80484785,0,3,0,0,3
3255614773,0,3,0,0,3
1157672150431666176,0,3,0,0,3
2726211508,0,3,0,0,3
2189490411,0,3,0,0,3
78244428,0,3,0,0,3
1296697391320506368,0,3,0,0,3
309630871,0,3,0,0,3
2974909167,2,0,0,1,3
797450772892024832,0,3,0,0,3
2726293937,0,3,0,0,3
538617722,0,3,0,0,3
1157593062434058240,0,3,0,0,3
1110445736708263936,0,3,0,0,3
3257383145,0,3,0,0,3
1296805802339004416,0,3,0,0,3
747770212720779264,1,2,0,0,3
183457271,2,1,0,0,3
835368648692891648,0,0,0,3,3
1297213567402414080,2,0,0,1,3
2166610347,0,3,0,0,3
3923634195,0,3,0,0,3
310593498,2,0,0,1,3
1289370445259603968,0,3,0,0,3
716799636,0,3,0,0,3
753196727922987008,0,3,0,0,3
1160965537062481920,3,0,0,0,3
1222051607363215360,3,0,0,0,3
183200987,0,3,0,0,3
70474919,0,3,0,0,3
1370976347330338816,0,3,0,0,3
3235969678,2,1,0,0,3
984646192385568768,2,0,1,0,3
3236105622,1,2,0,0,3
1070028352583553024,2,0,1,0,3
430710447,0,3,0,0,3
183117594,1,2,0,0,3
4927663546,3,0,0,0,3
694871067421188096,0,3,0,0,3
2974323112,0,3,0,0,3
943537900540571648,0,2,0,1,3
3915789313,0,3,0,0,3
810835331708841984,2,0,0,1,3
170865179,0,3,0,0,3
354498085,0,3,0,0,3
697842197933244416,0,2,1,0,3
1201145649657331712,0,2,0,1,3
2455485116,0,3,0,0,3
898030637780619264,3,0,0,0,3
171009937,0,3,0,0,3
77718403,0,3,0,0,3
1373410377506066432,0,3,0,0,3
1165966387,0,3,0,0,3
710277494,0,3,0,0,3
2455798029,0,3,0,0,3
1908332358,1,0,0,2,3
699514041610403840,0,3,0,0,3
1072701775579369472,0,3,0,0,3
748867439111311360,0,3,0,0,3
1072681619822002176,0,0,0,3,3
1373734712624177152,2,0,0,1,3
2727797238,0,3,0,0,3
2728011676,0,3,0,0,3
2456069304,1,2,0,0,3
2456165676,0,3,0,0,3
716382105,3,0,0,0,3
836368008,3,0,0,0,3
170798896,0,3,0,0,3
893666091741794304,0,3,0,0,3
77725576,0,3,0,0,3
1010487026116976640,0,3,0,0,3
1225340704173514752,0,3,0,0,3
2727287501,1,2,0,0,3
1372399770707234816,0,3,0,0,3
1034665690467250176,0,3,0,0,3
170021045,0,3,0,0,3
857857903969017856,0,3,0,0,3
1182097908,1,0,0,2,3
304458507,0,3,0,0,3
1296363760471465984,0,3,0,0,3
1222254874152271872,0,3,0,0,3
837189500,2,1,0,0,3
2727366809,0,3,0,0,3
1160681838857379840,0,3,0,0,3
539172239,1,2,0,0,3
1296203501605969920,2,1,0,0,3
1372971024078172160,0,3,0,0,3
18671865,0,3,0,0,3
1157899372090339328,0,3,0,0,3
170586518,0,3,0,0,3
1373144915308335104,2,1,0,0,3
354395796,0,3,0,0,3
77730207,0,3,0,0,3
985911542674702336,2,1,0,0,3
537809640,1,0,2,0,3
310669133,0,3,0,0,3
442645210,1,1,0,1,3
1188525889,0,3,0,0,3
942694339204935680,0,3,0,0,3
2980937844,0,3,0,0,3
442569550,0,3,0,0,3
69803761,0,3,0,0,3
2980792045,0,3,0,0,3
704624710919856128,0,1,0,2,3
184681685,0,3,0,0,3
1188294864,0,3,0,0,3
835860392106725376,2,0,1,0,3
1069811725015248896,2,0,0,1,3
353466443,0,3,0,0,3
983975026599890944,0,3,0,0,3
718050044,0,3,0,0,3
17454091,3,0,0,0,3
80011594,1,0,2,0,3
184589422,0,3,0,0,3
17458519,1,2,0,0,3
1019911359155392512,0,3,0,0,3
4338113723,0,3,0,0,3
310951169,0,3,0,0,3
2979836960,3,0,0,0,3
1034896750111285248,0,3,0,0,3
1368555916732362752,0,3,0,0,3
3233575285,1,2,0,0,3
2224599691,1,2,0,0,3
442663977,3,0,0,0,3
2449694474,1,1,0,1,3
4924089267,0,2,1,0,3
1298776026512855040,0,0,3,0,3
69485564,0,3,0,0,3
1298697920804319232,1,0,0,2,3
184960685,0,3,0,0,3
4284606077,0,2,0,1,3
1387072450349912064,2,1,0,0,3
1480637995,3,0,0,0,3
2449870102,0,3,0,0,3
356953101,0,3,0,0,3
1161938311,0,3,0,0,3
1348406875,0,1,2,0,3
797821043079544832,1,2,0,0,3
536250112,0,3,0,0,3
1869092676,0,3,0,0,3
1298653268977958912,1,2,0,0,3
1386889707573940224,0,3,0,0,3
165819809,0,3,0,0,3
746740153314586624,0,3,0,0,3
2981351519,0,0,0,3,3
1611293533,0,3,0,0,3
184717248,0,3,0,0,3
1288757961012195328,3,0,0,0,3
2944213082,0,3,0,0,3
747737119255302144,1,2,0,0,3
184199620,0,3,0,0,3
18796462,0,3,0,0,3
1157268870668914688,1,2,0,0,3
1297758349656592384,0,3,0,0,3
1386275927030702080,3,0,0,0,3
1288901307093450752,0,2,0,1,3
898253786388549632,0,3,0,0,3
167702249,0,3,0,0,3
709384735,0,3,0,0,3
835453589745184768,0,3,0,0,3
79501788,0,3,0,0,3
3234342390,1,2,0,0,3
1494748017488183296,0,2,0,1,3
1161248731066277888,0,3,0,0,3
704530990845321216,0,3,0,0,3
18746974,0,3,0,0,3
1491824543295545344,0,3,0,0,3
310737948,0,3,0,0,3
883617565993390080,0,0,0,3,3
1494694311061233664,1,0,0,2,3
1225653570998919168,3,0,0,0,3
441039865,2,0,1,0,3
1680205122,0,3,0,0,3
1386187199398432768,0,3,0,0,3
881764766,3,0,0,0,3
537206432,1,2,0,0,3
429610224,0,3,0,0,3
356811606,0,3,0,0,3
80009637,0,3,0,0,3
1298104870478794752,0,3,0,0,3
704606653258338304,2,0,1,0,3
536755406,1,2,0,0,3
166960271,2,1,0,0,3
303675637,0,3,0,0,3
984132171576246272,0,3,0,0,3
303680456,0,3,0,0,3
1116311874793091072,0,3,0,0,3
2600534092,0,3,0,0,3
1297985605289177088,0,0,0,3,3
1971692582,0,2,1,0,3
2467315904,0,3,0,0,3
441623088,0,2,1,0,3
1186876249,0,3,0,0,3
167201565,0,3,0,0,3
1221874451429507072,0,3,0,0,3
1116289336004292608,0,3,0,0,3
310837340,0,3,0,0,3
184326746,0,3,0,0,3
904271958010806272,0,2,0,1,3
167321050,0,3,0,0,3
1116263340207222784,0,3,0,0,3
748880434134675456,0,3,0,0,3
2330155079,0,3,0,0,3
171418446,0,3,0,0,3
306885893,0,3,0,0,3
1112269538467430400,3,0,0,0,3
898043391241408512,0,3,0,0,3
3245154117,0,3,0,0,3
75240465,0,3,0,0,3
543450137,0,3,0,0,3
1113549783443148800,0,3,0,0,3
178673948,0,3,0,0,3
176070528,0,3,0,0,3
1606273843,0,3,0,0,3
943136806010261504,0,3,0,0,3
750497690614628352,0,3,0,0,3
2460335661,0,3,0,0,3
176183510,3,0,0,0,3
1113362684894896128,1,0,0,2,3
3248372215,1,2,0,0,3
1113221492723130368,0,3,0,0,3
74925766,0,3,0,0,3
74870747,0,3,0,0,3
917314803558780928,0,3,0,0,3
2959227736,0,3,0,0,3
2955176504,0,3,0,0,3
74848682,0,1,1,1,3
1380747380572659712,3,0,0,0,3
3887670433,3,0,0,0,3
178752044,0,3,0,0,3
1159183515386146816,0,2,1,0,3
305437335,0,0,3,0,3
18114670,0,3,0,0,3
433232965,0,3,0,0,3
1381564385546498048,1,2,0,0,3
1872274471,0,3,0,0,3
1158739206371282944,0,3,0,0,3
1293589219177365504,0,3,0,0,3
1376855129111019520,1,2,0,0,3
3243780353,1,2,0,0,3
75687989,0,3,0,0,3
1158752256818159616,0,3,0,0,3
75678117,0,3,0,0,3
436124417,0,3,0,0,3
898132083616473088,0,3,0,0,3
1477473252,0,0,0,3,3
3248933516,0,3,0,0,3
858990963980619776,0,3,0,0,3
1044666836132945920,0,3,0,0,3
542432144,0,3,0,0,3
2960541903,0,3,0,0,3
1337925805,0,3,0,0,3
1606373370,0,3,0,0,3
955679204,2,0,0,1,3
175749806,0,3,0,0,3
1113197954133893120,0,3,0,0,3
176475666,1,0,1,1,3
436534875,0,3,0,0,3
2957261107,1,2,0,0,3
1292321640492093440,1,0,2,0,3
2461941150,1,2,0,0,3
1492794350354722816,0,3,0,0,3
177207175,0,3,0,0,3
1339041056,0,3,0,0,3
434783871,1,2,0,0,3
2955641158,2,1,0,0,3
74618009,0,3,0,0,3
1379638107062984704,0,3,0,0,3
1380098252394086400,1,2,0,0,3
74128348,0,3,0,0,3
544735156,0,3,0,0,3
1292014654219149312,0,3,0,0,3
74413704,0,3,0,0,3
833644706122850304,0,3,0,0,3
177513556,0,3,0,0,3
1339619508,3,0,0,0,3
1112653178930118656,0,3,0,0,3
1492756731872493568,0,3,0,0,3
1004993048,0,3,0,0,3
1969331618,0,3,0,0,3
434221970,0,3,0,0,3
1071595981995569152,2,1,0,0,3
955588465,0,3,0,0,3
2604389720,0,3,0,0,3
1034516621338071040,0,3,0,0,3
1492862660643532800,0,3,0,0,3
1291618408186822656,1,2,0,0,3
1338964092,2,0,0,1,3
1605692672,0,3,0,0,3
546023812,0,3,0,0,3
4310910918,1,0,2,0,3
834062292,0,3,0,0,3
712317693,0,3,0,0,3
305770761,0,1,0,2,3
1538416598,0,3,0,0,3
1113061701534998528,0,3,0,0,3
885267666,0,2,0,1,3
1034497961064116224,2,0,1,0,3
74743956,0,3,0,0,3
1010967386210689024,0,3,0,0,3
74738759,0,3,0,0,3
178272080,0,3,0,0,3
176928370,0,3,0,0,3
356028566,0,3,0,0,3
178087380,0,3,0,0,3
796820870291329024,0,3,0,0,3
701435447394701312,0,3,0,0,3
1057174626441150464,0,3,0,0,3
1292372760006668288,0,3,0,0,3
1376836306198728704,0,3,0,0,3
2602602986,1,0,0,2,3
431496560,1,1,1,0,3
1111042363965800448,0,2,1,0,3
703595195393118208,0,3,0,0,3
76972579,0,3,0,0,3
2968291499,0,3,0,0,3
1374607603226050560,0,3,0,0,3
2951629926,3,0,0,0,3
1178692112,0,3,0,0,3
2728854815,0,3,0,0,3
2334431636,0,3,0,0,3
432022126,0,0,2,1,3
540289349,1,2,0,0,3
964033775398244352,0,3,0,0,3
832258640,0,3,0,0,3
17794234,0,3,0,0,3
76752633,0,0,0,3,3
883303021995855872,3,0,0,0,3
437867912,2,0,1,0,3
700551609726562304,0,3,0,0,3
1295072996718268416,0,3,0,0,3
752227266227089408,1,0,0,2,3
836271002,0,3,0,0,3
1011518542909526016,0,1,2,0,3
2223721432,0,3,0,0,3
1111205154550923264,0,2,1,0,3
548154146,0,0,1,2,3
2969469369,0,3,0,0,3
928225786238259200,0,3,0,0,3
2457208792,0,3,0,0,3
72040420,2,0,1,0,3
984853929245716480,0,2,1,0,3
1202176416470593536,0,0,0,3,3
438474964,1,1,1,0,3
1001914387,0,3,0,0,3
539900316,2,1,0,0,3
171461831,0,3,0,0,3
438395332,0,3,0,0,3
883404403,0,3,0,0,3
77249176,2,0,1,0,3
308736679,2,1,0,0,3
962868619880353792,0,3,0,0,3
716168048,0,3,0,0,3
2457023834,0,3,0,0,3
77213490,0,3,0,0,3
1344683796,2,0,0,1,3
171809568,0,3,0,0,3
540113771,0,3,0,0,3
1295437350546415616,0,3,0,0,3
72153970,1,2,0,0,3
703629186330550272,0,3,0,0,3
72228580,0,3,0,0,3
171977969,0,3,0,0,3
1674201300,0,3,0,0,3
180038757,3,0,0,0,3
3892498461,1,2,0,0,3
179576118,0,3,0,0,3
883161278520336384,3,0,0,0,3
2333851604,3,0,0,0,3
18012401,0,3,0,0,3
73012623,0,3,0,0,3
883927338,3,0,0,0,3
749927782533173248,0,3,0,0,3
1044555599172775936,0,3,0,0,3
943086014981062656,0,3,0,0,3
750000891634257920,0,3,0,0,3
1376252904026279936,0,3,0,0,3
1072039473469407232,0,3,0,0,3
917030515110055936,3,0,0,0,3
541594949,0,3,0,0,3
714577724,1,2,0,0,3
1492358833632690176,0,3,0,0,3
1336536864,0,3,0,0,3
541635829,1,0,2,0,3
2459968897,0,3,0,0,3
307840404,1,0,0,2,3
2962819213,0,3,0,0,3
1158646367591555072,2,0,1,0,3
778660669,1,2,0,0,3
1871621394,0,3,0,0,3
1872927894,0,3,0,0,3
1677256266,1,2,0,0,3
1114390664215711744,0,3,0,0,3
3897081616,0,3,0,0,3
1114346807985876992,0,3,0,0,3
2729921193,1,2,0,0,3
943051823874703360,0,3,0,0,3
437447861,0,1,2,0,3
437277389,0,3,0,0,3
1294641731145797632,0,3,0,0,3
2966065595,0,3,0,0,3
72530397,3,0,0,0,3
1177038846,0,3,0,0,3
1290680978638168064,0,3,0,0,3
173465160,0,3,0,0,3
17922056,0,3,0,0,3
858286202473938944,0,3,0,0,3
917459007685591040,0,3,0,0,3
749680367490174976,0,3,0,0,3
2965691917,1,2,0,0,3
1381957044828274688,0,3,0,0,3
917019658607300608,1,2,0,0,3
2965145313,0,3,0,0,3
76239079,0,3,0,0,3
179848055,0,3,0,0,3
2953036437,0,0,3,0,3
2953089291,0,3,0,0,3
708773624,0,3,0,0,3
3247021018,0,3,0,0,3
936438035734040576,0,3,0,0,3
1364154277975912448,0,3,0,0,3
1154319956399595520,0,3,0,0,3
1073220374387613696,3,0,0,0,3
313462239,2,0,0,1,3
1363927139104522240,0,3,0,0,3
1200574517333987328,0,3,0,0,3
427757005,0,3,0,0,3
1161952345623863296,0,3,0,0,3
965261665561399296,3,0,0,0,3
836571102725963776,3,0,0,0,3
1388874498850574336,0,3,0,0,3
2988728559,0,3,0,0,3
798821470004621312,0,3,0,0,3
1680469021,0,3,0,0,3
3838009457,0,3,0,0,3
2988525155,1,2,0,0,3
841344992,0,3,0,0,3
1069201826229174272,0,0,1,2,3
82924690,2,1,0,0,3
302351163,0,3,0,0,3
85542908,0,3,0,0,3
83341510,1,2,0,0,3
3227935608,0,3,0,0,3
1301171396735713280,0,3,0,0,3
188785440,0,3,0,0,3
187417567,0,3,0,0,3
1389060098723565568,1,2,0,0,3
881845674832166912,3,0,0,0,3
448088309,0,3,0,0,3
775543082,0,2,0,1,3
754970371623940096,1,2,0,0,3
2445687589,0,0,0,3,3
960007982,0,3,0,0,3
809675862996041728,0,3,0,0,3
83461540,2,0,0,1,3
532160512,0,3,0,0,3
745089546648334336,0,3,0,0,3
1496790579539333120,1,2,0,0,3
2611035672,0,3,0,0,3
2937960846,0,3,0,0,3
798160864415272960,0,3,0,0,3
1227155995635277824,0,3,0,0,3
1482925104,0,1,0,2,3
721135223,0,3,0,0,3
1226869686081507328,0,3,0,0,3
1360198914574606336,1,2,0,0,3
961851001249579008,0,3,0,0,3
4916972174,1,1,0,1,3
3229183860,0,3,0,0,3
1119977807902384128,0,3,0,0,3
1490743380393230336,1,2,0,0,3
2468770452,1,0,2,0,3
809752925799071744,0,3,0,0,3
836496391396442112,0,3,0,0,3
2343538670,3,0,0,0,3
1157414611,0,3,0,0,3
878579874,0,3,0,0,3
1013004894486265856,0,3,0,0,3
3229478224,0,3,0,0,3
1019287346246815744,0,3,0,0,3
2996312703,1,2,0,0,3
745541990050234368,0,3,0,0,3
19003196,0,2,1,0,3
3948876141,0,2,0,1,3
743344171432304640,1,1,0,1,3
836512550938374144,0,3,0,0,3
1300632666920742912,2,1,0,0,3
1329711194,0,3,0,0,3
1300768963253723136,0,3,0,0,3
1364175330307620864,1,2,0,0,3
1109146250945818624,0,3,0,0,3
1069243679515111424,0,3,0,0,3
1303403654355931136,0,3,0,0,3
162086649,0,3,0,0,3
1300785490170392576,3,0,0,0,3
157836576,3,0,0,0,3
720886809,0,1,0,2,3
894030777133875200,0,3,0,0,3
860525752286105600,2,0,0,1,3
2213985733,0,3,0,0,3
2441263770,0,3,0,0,3
1300753651133104128,1,0,2,0,3
162209354,0,3,0,0,3
1496233094613016576,0,0,0,3,3
1155905083625766912,0,3,0,0,3
189063251,0,3,0,0,3
936849149370273792,0,3,0,0,3
2169699606,3,0,0,0,3
1327552070,0,3,0,0,3
1472297294,0,3,0,0,3
1220046271970455552,0,3,0,0,3
1484828630,0,3,0,0,3
84853658,1,0,2,0,3
1361943636208943104,0,2,0,1,3
1496719276895608832,2,1,0,0,3
188624478,0,3,0,0,3
531043448,3,0,0,0,3
1361524923957583872,0,3,0,0,3
160073868,3,0,0,0,3
314201877,0,0,0,3,3
1068823469222178816,1,0,2,0,3
1158293492,0,3,0,0,3
1119135467339784192,1,0,1,1,3
1490914509921337344,0,3,0,0,3
2444369721,1,0,1,1,3
705991165477138432,2,1,0,0,3
2939028508,0,3,0,0,3
1068983725462036480,0,1,0,2,3
723560160,0,3,0,0,3
1073268842959233024,0,3,0,0,3
3269807359,0,2,0,1,3
1009665856081743872,0,3,0,0,3
982863072699273216,0,3,0,0,3
67546596,1,2,0,0,3
1302251427029569536,3,0,0,0,3
3224369420,0,0,1,2,3
1389307330378887168,0,3,0,0,3
1670902266,0,3,0,0,3
1286748038497673216,0,3,0,0,3
19157075,0,0,0,3,3
19152738,0,3,0,0,3
2992765876,0,3,0,0,3
1974530989,0,3,0,0,3
2991920835,0,0,3,0,3
159580010,0,3,0,0,3
84682864,1,1,0,1,3
1119240050242478080,0,3,0,0,3
1302167542903996416,0,3,0,0,3
2225918693,0,3,0,0,3
67514074,0,3,0,0,3
2443371329,2,1,0,0,3
897858213776728064,0,3,0,0,3
3226095613,0,3,0,0,3
996499550,0,3,0,0,3
743498751814275072,0,3,0,0,3
84055030,1,1,0,1,3
705780794665639936,0,3,0,0,3
552659269,1,1,0,1,3
959958804,0,3,0,0,3
1286980333217480704,0,3,0,0,3
1363129797136711680,0,3,0,0,3
160899503,0,3,0,0,3
744512044725116928,0,3,0,0,3
83547018,0,3,0,0,3
2341135275,0,3,0,0,3
1220204013582372864,1,2,0,0,3
1012756547104108544,1,2,0,0,3
3227164945,0,3,0,0,3
2324991210,0,3,0,0,3
1198811108,0,3,0,0,3
67887578,0,3,0,0,3
836753621282926592,0,3,0,0,3
302469063,0,3,0,0,3
1877426498,1,1,1,0,3
2939576787,0,3,0,0,3
1363062009831514112,0,3,0,0,3
1035260999622905856,0,0,3,0,3
1154542937252028416,0,2,1,0,3
160594212,0,3,0,0,3
160510281,1,1,1,0,3
1362969320138006528,0,3,0,0,3
158912944,0,3,0,0,3
1226896064705249280,1,2,0,0,3
447720402,2,0,0,1,3
302631559,0,3,0,0,3
1286546108886536192,3,0,0,0,3
706487982790991872,2,0,0,1,3
3958453883,0,3,0,0,3
1118556783033954304,0,2,1,0,3
447795611,2,1,0,0,3
1496769044564910080,0,3,0,0,3
2738858095,0,3,0,0,3
1613570400,0,3,0,0,3
1363036117763817472,2,1,0,0,3
427329617,2,0,0,1,3
160748407,0,3,0,0,3
3844365074,0,3,0,0,3
1202908273671884800,1,1,0,1,3
1157667553,0,3,0,0,3
67246782,0,3,0,0,3
353077420,0,3,0,0,3
81580320,0,2,1,0,3
2737393043,0,3,0,0,3
1226130956777476096,0,3,0,0,3
86669563,0,3,0,0,3
1366493454256271360,0,3,0,0,3
428673588,0,3,0,0,3
1221268227101089792,1,2,0,0,3
81527614,0,3,0,0,3
185473471,0,3,0,0,3
303153745,0,3,0,0,3
311774606,0,3,0,0,3
982279330926440448,0,3,0,0,3
917772193718706176,1,2,0,0,3
1010209503344721920,1,2,0,0,3
1299388246833737728,0,3,0,0,3
2997709781,0,3,0,0,3
831897716745764864,0,3,0,0,3
443658491,2,0,1,0,3
2739425608,1,2,0,0,3
1349110944,0,3,0,0,3
303241149,2,1,0,0,3
4920654193,0,3,0,0,3
2941593817,0,3,0,0,3
357200043,0,3,0,0,3
893576351202103296,0,3,0,0,3
86394930,1,2,0,0,3
1109535423892725760,0,3,0,0,3
1288084518864216064,0,3,0,0,3
746104323113877504,0,3,0,0,3
1288131991456669696,0,3,0,0,3
1490656431984775168,2,1,0,0,3
311889009,0,3,0,0,3
2941926506,0,3,0,0,3
3230308533,2,1,0,0,3
68787520,0,3,0,0,3
753885254335795200,0,3,0,0,3
1359776322864766976,0,3,0,0,3
797882491289866240,3,0,0,0,3
86554003,0,3,0,0,3
1490591941192749056,0,2,1,0,3
553150054,0,3,0,0,3
2942990102,0,3,0,0,3
16569663,2,1,0,0,3
1048582818,0,3,0,0,3
428782267,0,3,0,0,3
1367233772106608640,1,0,2,0,3
1303977239134965760,0,3,0,0,3
443075960,0,3,0,0,3
1668364219,2,1,0,0,3
746685019687620608,0,1,2,0,3
2982155085,0,3,0,0,3
1011903151786659840,0,1,1,1,3
2166592992,0,3,0,0,3
1496921382390697984,0,1,0,2,3
1298932274247933952,0,3,0,0,3
3260283721,0,3,0,0,3
1160960684,1,0,0,2,3
18880373,1,0,0,2,3
889796047,0,3,0,0,3
443004805,0,3,0,0,3
1387548210588274688,0,3,0,0,3
1387525916088221696,0,3,0,0,3
1155281269,0,3,0,0,3
1495407160041390080,0,3,0,0,3
1299291628088291328,0,3,0,0,3
4910353531,0,3,0,0,3
860979429899722752,0,3,0,0,3
2982842021,0,3,0,0,3
1221307474247995392,0,3,0,0,3
3219218677,0,3,0,0,3
746613292592939008,0,3,0,0,3
2716446892,0,3,0,0,3
2217282949,0,3,0,0,3
185392797,0,3,0,0,3
1481557297,0,3,0,0,3
1367131581262004224,0,3,0,0,3
926702512748597248,0,3,0,0,3
1156563418834505728,0,3,0,0,3
443194577,3,0,0,0,3
2737012596,0,3,0,0,3
832333838948958208,0,2,0,1,3
1120337561703145472,0,2,1,0,3
1367019294664581120,0,3,0,0,3
165088789,0,3,0,0,3
1365659278862811136,1,2,0,0,3
164239689,0,3,0,0,3
357236728,0,3,0,0,3
1201305853,0,3,0,0,3
954374540,0,3,0,0,3
4343768172,0,3,0,0,3
916458334592610304,0,3,0,0,3
82020242,1,1,0,1,3
350887220,0,3,0,0,3
4269972192,0,3,0,0,3
1300349374833160192,0,1,0,2,3
163634745,0,3,0,0,3
2984825059,0,3,0,0,3
1491457829890584576,0,3,0,0,3
2996617897,3,0,0,0,3
1219537099751211008,0,3,0,0,3
3945316993,0,3,0,0,3
552905020,0,3,0,0,3
1202877838845710336,1,2,0,0,3
426391625,0,3,0,0,3
2937270441,1,0,2,0,3
1287798190331183104,1,1,0,1,3
86315533,0,3,0,0,3
1349233322,1,0,1,1,3
186458697,0,3,0,0,3
888595295164026880,0,3,0,0,3
753934297837568000,0,3,0,0,3
1303718822612889600,1,2,0,0,3
1287713525461168128,0,3,0,0,3
428426609,2,0,1,0,3
2468609575,3,0,0,0,3
743054102700101632,0,3,0,0,3
1496856291876257792,0,3,0,0,3
743234494568751104,0,3,0,0,3
1299933072612192256,0,3,0,0,3
528337935,0,3,0,0,3
1193247055,0,3,0,0,3
1612647073,0,3,0,0,3
860404380520022016,0,3,0,0,3
1045684445221715968,1,2,0,0,3
426396888,0,3,0,0,3
1495703870739456000,3,0,0,0,3
1045953394295418880,1,2,0,0,3
1202850430503526400,0,0,2,1,3
1495817638970335232,0,3,0,0,3
1287915993033998336,0,3,0,0,3
1672116080,1,0,0,2,3
1389804095368843264,3,0,0,0,3
1897429872,0,2,0,0,2
1191709784136916992,0,2,0,0,2
1198860226583236608,0,2,0,0,2
1074906571895906304,0,2,0,0,2
355823463,0,2,0,0,2
1054365654797746176,2,0,0,0,2
882379742179143680,1,1,0,0,2
1206980925474496512,0,2,0,0,2
359912555,0,0,0,2,2
612917133,0,1,0,1,2
806226210355298304,0,0,0,2,2
954155820,0,2,0,0,2
1917881162,0,2,0,0,2
1082144864257626112,2,0,0,0,2
711469850,0,2,0,0,2
2593470319,0,0,2,0,2
1081795943488401408,0,2,0,0,2
1201407912826089472,0,2,0,0,2
816003406854766592,0,2,0,0,2
1084295676358479872,1,1,0,0,2
1062403434236858368,0,2,0,0,2
817330865529376768,0,2,0,0,2
360219338,0,2,0,0,2
712317428,0,2,0,0,2
781036272,2,0,0,0,2
1017557003135221760,0,2,0,0,2
1059294636605345792,2,0,0,0,2
2650220232,1,1,0,0,2
2226636191,0,2,0,0,2
1082153263808593920,0,2,0,0,2
889413804861337600,0,2,0,0,2
1207456019724603392,0,2,0,0,2
343302812,2,0,0,0,2
2190207191,0,2,0,0,2
782745049,0,2,0,0,2
887640491344449536,0,2,0,0,2
1200139835551420416,0,2,0,0,2
811301470322749440,1,1,0,0,2
1917579673,0,2,0,0,2
1206965307438485504,1,1,0,0,2
1016830930135277568,0,2,0,0,2
1894953235,0,2,0,0,2
374528679,0,2,0,0,2
357696028,0,2,0,0,2
343603724,0,0,0,2,2
619434648,0,2,0,0,2
1081858483425824768,0,2,0,0,2
752776542,0,2,0,0,2
816297127936688128,0,2,0,0,2
1075008991879680000,1,1,0,0,2
767325530,0,2,0,0,2
701833248,0,2,0,0,2
2256791580,0,2,0,0,2
360225931,0,2,0,0,2
765935240,0,1,0,1,2
1198838421768286208,0,2,0,0,2
359945717,0,2,0,0,2
2197579928,0,0,0,2,2
886308947975712768,0,2,0,0,2
1017441002867470336,1,1,0,0,2
2650389169,0,2,0,0,2
812106486583279616,0,2,0,0,2
2603172149,0,2,0,0,2
806372372710301696,0,2,0,0,2
810733824569184256,2,0,0,0,2
2230138535,0,2,0,0,2
1020052367943839744,0,2,0,0,2
1911133698,0,2,0,0,2
1020380156194631680,0,2,0,0,2
1209095473082118144,0,2,0,0,2
355977634,2,0,0,0,2
2230233640,0,2,0,0,2
371831447,0,2,0,0,2
360330752,0,2,0,0,2
619266204,0,2,0,0,2
817274882601943040,0,2,0,0,2
1200335451791515648,0,2,0,0,2
2639247055,0,2,0,0,2
768196190,0,2,0,0,2
1073550414493245440,0,2,0,0,2
754820179,0,2,0,0,2
355960456,0,1,1,0,2
770511326,0,2,0,0,2
1062041449737392128,1,0,0,1,2
2230165357,0,2,0,0,2
1071997109740691456,0,2,0,0,2
2568900823,0,2,0,0,2
712396182,0,2,0,0,2
712048550,0,2,0,0,2
811223584509227008,0,2,0,0,2
1198982758841888768,2,0,0,0,2
766290254,1,1,0,0,2
2650802731,0,2,0,0,2
881607283377020928,0,2,0,0,2
619746373,0,2,0,0,2
1056191004456484864,0,2,0,0,2
2602840370,0,2,0,0,2
2569003304,0,2,0,0,2
754961780,2,0,0,0,2
886252132361535488,0,2,0,0,2
967762536,0,2,0,0,2
1082139984189104128,0,2,0,0,2
810719870870556672,0,2,0,0,2
2222794196,0,2,0,0,2
967598677,0,2,0,0,2
2569134537,0,2,0,0,2
810806012114399232,0,2,0,0,2
876859248646529024,0,2,0,0,2
752781128,0,2,0,0,2
1208457068698591232,0,2,0,0,2
372355146,0,2,0,0,2
2650082971,0,2,0,0,2
2252987431,1,1,0,0,2
1208066942809980928,0,2,0,0,2
356730665,0,2,0,0,2
616260000,0,2,0,0,2
2199019862,0,0,1,1,2
1208070003544723456,0,2,0,0,2
2225205308,2,0,0,0,2
2597103145,0,0,2,0,2
1190491636104478720,2,0,0,0,2
1074395421362012160,0,2,0,0,2
372861006,0,2,0,0,2
2255250848,0,0,0,2,2
1074124700534505472,0,1,1,0,2
1191014779889938432,1,1,0,0,2
970255340,0,2,0,0,2
2199047907,0,2,0,0,2
616256646,0,2,0,0,2
887947727400706048,0,2,0,0,2
1208158251155636224,0,2,0,0,2
1060496121728913408,0,2,0,0,2
2183267638,0,2,0,0,2
757832497,0,2,0,0,2
1190498624087773184,0,2,0,0,2
1200697489789247488,0,2,0,0,2
356728123,0,2,0,0,2
1208015684619259904,2,0,0,0,2
2198924037,0,2,0,0,2
881165073959460864,0,2,0,0,2
782089272,1,1,0,0,2
703157772,1,1,0,0,2
2597603816,0,2,0,0,2
1023249662835417088,1,0,1,0,2
793245691,0,2,0,0,2
1191259045342003200,0,2,0,0,2
356662923,0,2,0,0,2
1073991572927074304,0,2,0,0,2
763374631,0,2,0,0,2
1207877239351566336,0,2,0,0,2
1058478214647967744,0,2,0,0,2
768899816,0,2,0,0,2
616737371,0,2,0,0,2
616728065,0,2,0,0,2
341989162,0,0,1,1,2
373832399,0,2,0,0,2
2597566166,0,2,0,0,2
614136351,0,2,0,0,2
1023421378840719360,1,0,1,0,2
2255348214,0,2,0,0,2
1019884346575020032,2,0,0,0,2
757303874,0,2,0,0,2
1201030758762254336,0,2,0,0,2
709774983,0,2,0,0,2
1208289770545139712,2,0,0,0,2
358891407,0,2,0,0,2
615055885,0,2,0,0,2
816878195257540608,0,2,0,0,2
1056287736771108864,0,2,0,0,2
761011484,2,0,0,0,2
703854816,0,2,0,0,2
888013925400358912,0,2,0,0,2
1200748331238133760,2,0,0,0,2
1200838470090010624,0,2,0,0,2
805708781200048128,0,2,0,0,2
769680223,0,2,0,0,2
615222298,0,1,1,0,2
759561476,0,2,0,0,2
1060769176233656320,0,2,0,0,2
816960319197159424,0,1,1,0,2
1200825622945091584,0,2,0,0,2
1083253096879398912,0,2,0,0,2
760052005,0,2,0,0,2
340528261,0,2,0,0,2
373361660,0,2,0,0,2
1060587855674818560,0,2,0,0,2
2200200035,0,2,0,0,2
816976382550884352,0,2,0,0,2
882050953158901760,2,0,0,0,2
1208444484733804544,0,0,0,2,2
903986525557456896,0,2,0,0,2
1200745873950433280,0,2,0,0,2
1190565942440480768,0,2,0,0,2
939041318,0,2,0,0,2
704743271,0,2,0,0,2
2228511442,0,2,0,0,2
2647043791,0,2,0,0,2
1208619120117325824,1,1,0,0,2
1200734691801870336,1,1,0,0,2
1054500746681565184,0,2,0,0,2
1074340012433526784,0,2,0,0,2
2183300143,0,2,0,0,2
340882923,0,2,0,0,2
2647665233,0,2,0,0,2
811616325357408256,2,0,0,0,2
758987904,0,2,0,0,2
2648093700,0,2,0,0,2
1208381256809033728,0,2,0,0,2
1060877444041850880,0,2,0,0,2
793696958,0,2,0,0,2
1083266360606687232,0,2,0,0,2
2566923754,0,2,0,0,2
340286235,0,2,0,0,2
2647234009,0,2,0,0,2
1207869511803777024,0,2,0,0,2
2198723234,0,2,0,0,2
343181396,0,2,0,0,2
1190319327465132032,0,1,0,1,2
711032226,0,2,0,0,2
1208931887496015872,0,2,0,0,2
811163784521904128,1,1,0,0,2
2223740202,0,2,0,0,2
1023202729013993472,0,2,0,0,2
968507312,0,2,0,0,2
705753968,0,2,0,0,2
342814056,0,2,0,0,2
805958489017229312,0,2,0,0,2
1908713016,2,0,0,0,2
358134683,0,2,0,0,2
1191554743082127360,1,0,0,1,2
755602537,0,2,0,0,2
342785356,2,0,0,0,2
770298546,0,2,0,0,2
1053575138556428288,0,2,0,0,2
1059049769061048320,0,2,0,0,2
705591606,0,2,0,0,2
805438591211929600,0,1,1,0,2
358145106,0,2,0,0,2
359590878,0,2,0,0,2
356376987,0,2,0,0,2
1082375578450309120,0,0,0,2,2
618299598,2,0,0,0,2
372287221,1,0,0,1,2
357410376,0,2,0,0,2
2184584821,0,2,0,0,2
770356860,1,0,0,1,2
2568488135,0,2,0,0,2
2223705713,0,2,0,0,2
1073461570133356544,2,0,0,0,2
876815457508098048,2,0,0,0,2
1208932047957266432,0,2,0,0,2
2644161424,0,2,0,0,2
1897228670,0,2,0,0,2
2256655336,0,2,0,0,2
2644673956,0,2,0,0,2
2251020533,0,2,0,0,2
702753654,0,2,0,0,2
711118075,2,0,0,0,2
2594070674,0,2,0,0,2
1072354917040443392,0,2,0,0,2
342919252,0,2,0,0,2
702645841,0,2,0,0,2
2568483688,0,2,0,0,2
2565292249,2,0,0,0,2
342906424,0,2,0,0,2
2598309559,0,2,0,0,2
1082371703181844480,2,0,0,0,2
1207648913190113280,0,2,0,0,2
710626495,0,2,0,0,2
342718423,0,2,0,0,2
2225460328,0,2,0,0,2
2183928023,0,2,0,0,2
339808674,0,2,0,0,2
2252899982,0,2,0,0,2
1016904703295148032,0,2,0,0,2
617273732,0,2,0,0,2
890573692685701120,0,2,0,0,2
2645950062,0,2,0,0,2
708192837,1,1,0,0,2
705236540,0,2,0,0,2
876481874310217728,0,2,0,0,2
710253597,1,0,0,1,2
1191345923017736192,0,2,0,0,2
2227923436,0,2,0,0,2
613866114,0,0,1,1,2
617139821,0,2,0,0,2
1061816829331542016,1,1,0,0,2
704887862,0,0,2,0,2
1061704057180499968,0,0,0,2,2
1056878380447080448,2,0,0,0,2
1073982761386549248,0,2,0,0,2
881139731505041408,0,2,0,0,2
372563164,1,1,0,0,2
1059001682716250112,0,2,0,0,2
768389395,0,2,0,0,2
2594710470,2,0,0,0,2
342697927,0,2,0,0,2
710468718,0,0,1,1,2
2201772028,0,2,0,0,2
890471898479443968,0,2,0,0,2
876057412729528320,0,0,0,2,2
2251708234,0,2,0,0,2
2182893977,0,2,0,0,2
1061838868150857728,0,2,0,0,2
2256145098,0,2,0,0,2
805942710314139648,0,2,0,0,2
705547624,0,2,0,0,2
890504125594644480,0,2,0,0,2
705244273,0,2,0,0,2
1918874623,0,2,0,0,2
342652142,0,2,0,0,2
905087191885467648,0,2,0,0,2
1910217822,0,2,0,0,2
1207660560290111488,0,2,0,0,2
887901050782367744,0,2,0,0,2
2565780055,0,2,0,0,2
1918012698,2,0,0,0,2
764455892,0,2,0,0,2
1199195923521380352,0,2,0,0,2
350681130,0,0,1,1,2
943981873,0,2,0,0,2
344283925,0,2,0,0,2
352898318,0,1,1,0,2
1066762852034363392,0,2,0,0,2
1079257933492367360,0,2,0,0,2
962621118,2,0,0,0,2
904467176492552192,0,2,0,0,2
809880868567261184,0,2,0,0,2
2210973109,1,1,0,0,2
962432341,0,2,0,0,2
348592422,0,2,0,0,2
774367938,0,2,0,0,2
366930139,0,2,0,0,2
2587375410,0,2,0,0,2
1077328956779622400,1,1,0,0,2
352881594,0,2,0,0,2
1069567130054651904,0,2,0,0,2
2236193151,0,2,0,0,2
2609607054,0,2,0,0,2
2241152851,1,0,1,0,2
1194478472695091200,0,2,0,0,2
1020888933226254336,0,2,0,0,2
885204568300298240,0,2,0,0,2
813423703732142080,2,0,0,0,2
719557646,0,2,0,0,2
879381162111758336,0,0,0,2,2
2192930132,1,0,0,1,2
1018321108280496128,0,2,0,0,2
1055383950527549440,0,2,0,0,2
1020936637562306560,1,1,0,0,2
367032816,0,2,0,0,2
719594810,0,2,0,0,2
367004294,0,2,0,0,2
2241783605,0,2,0,0,2
627250201,1,1,0,0,2
1204855064864710656,0,2,0,0,2
633639606,0,1,1,0,2
2210068683,0,2,0,0,2
366177406,0,2,0,0,2
2615476385,0,2,0,0,2
1204749940360126464,0,2,0,0,2
627909477,0,2,0,0,2
1194768798949068800,2,0,0,0,2
1069442031511093248,0,2,0,0,2
627964787,0,2,0,0,2
1202891778669654016,0,0,0,2,2
814770191930458112,0,2,0,0,2
774452047,0,1,1,0,2
720253033,0,2,0,0,2
1057542122516041728,0,2,0,0,2
720736377,0,2,0,0,2
366069901,0,2,0,0,2
775951897,0,2,0,0,2
1194697727290023936,2,0,0,0,2
366620105,2,0,0,0,2
1018388673451253760,0,2,0,0,2
1194594348010065920,1,1,0,0,2
366737722,0,2,0,0,2
348943217,0,2,0,0,2
1202857435536474112,2,0,0,0,2
1079213978381967360,0,2,0,0,2
808430881132134400,0,2,0,0,2
1079209394175234048,1,1,0,0,2
809843790374518784,0,2,0,0,2
888781014419591168,0,2,0,0,2
1079166449892163584,0,2,0,0,2
352402883,0,2,0,0,2
1079121589369741312,0,2,0,0,2
776469445,2,0,0,0,2
1018478450657488896,1,1,0,0,2
1078943646458789888,1,0,0,1,2
773531983,0,2,0,0,2
367061054,0,2,0,0,2
1194835022693511168,0,2,0,0,2
1055759513813344256,0,1,0,1,2
1205554875892789248,0,2,0,0,2
1076675443661520896,0,1,0,1,2
717995622,1,0,1,0,2
1197262436006543360,0,2,0,0,2
2576983520,0,0,0,2,2
2620323673,1,1,0,0,2
1905572664,0,2,0,0,2
1205573847682093056,0,2,0,0,2
1079413167426543616,0,0,1,1,2
879545393209458688,0,2,0,0,2
367333207,0,2,0,0,2
736042963,0,2,0,0,2
634217744,0,2,0,0,2
347893221,2,0,0,0,2
347717304,0,2,0,0,2
626094936,0,2,0,0,2
2208942829,1,0,0,1,2
1197502507318173696,0,0,0,2,2
815088609254666240,0,2,0,0,2
963390487,0,2,0,0,2
1018044329351213056,2,0,0,0,2
1194114043088384000,0,2,0,0,2
1079495873376239616,0,2,0,0,2
2185622173,1,0,1,0,2
877877383247925248,0,2,0,0,2
353720892,2,0,0,0,2
362319357,0,1,0,1,2
1205591189837230080,0,2,0,0,2
717903511,0,2,0,0,2
347328167,0,2,0,0,2
1020815459590057984,1,1,0,0,2
879682800995225600,0,2,0,0,2
362497667,0,2,0,0,2
2218464199,0,2,0,0,2
362708588,0,2,0,0,2
885226949492314112,0,2,0,0,2
885296427374661632,0,1,1,0,2
2617638774,0,2,0,0,2
633983867,0,2,0,0,2
348405289,0,2,0,0,2
1194288452214218752,2,0,0,0,2
1057985327451815936,0,2,0,0,2
2217760456,0,2,0,0,2
1900615632,0,2,0,0,2
2209616816,2,0,0,0,2
353225220,0,2,0,0,2
1194302146868469760,0,2,0,0,2
776934624,0,2,0,0,2
626852944,2,0,0,0,2
2588151718,0,2,0,0,2
2609246604,0,2,0,0,2
362610622,0,2,0,0,2
347993283,1,0,1,0,2
1022101929244020736,1,1,0,0,2
1069792627388702720,0,2,0,0,2
785971374,0,2,0,0,2
2208977443,0,2,0,0,2
883679121431244800,0,2,0,0,2
777457796,1,1,0,0,2
1057304164840001536,0,2,0,0,2
718890309,0,0,1,1,2
878035006433746944,0,2,0,0,2
734578093,0,2,0,0,2
734409428,0,2,0,0,2
963014904,0,2,0,0,2
348095904,1,0,1,0,2
808025195432714240,0,2,0,0,2
2588277474,0,2,0,0,2
349158227,0,2,0,0,2
366043349,0,2,0,0,2
1062665231858573312,1,0,1,0,2
1204031278158372864,0,2,0,0,2
947592698,1,0,0,1,2
1018746918426501120,2,0,0,0,2
365055733,0,2,0,0,2
2214343028,0,2,0,0,2
2611959476,0,2,0,0,2
1021597736271892480,0,2,0,0,2
727705062,0,2,0,0,2
2613915463,0,2,0,0,2
2239211237,0,2,0,0,2
1077948878371082240,0,2,0,0,2
630993115,0,2,0,0,2
1195721651008233472,0,0,2,0,2
960957402,0,2,0,0,2
960329305,0,2,0,0,2
814361665483538432,0,2,0,0,2
1204120557521793024,0,2,0,0,2
1078296356949774336,1,1,0,0,2
1068858977889345536,0,2,0,0,2
1055514972325928960,0,0,1,1,2
363751141,0,2,0,0,2
2212215336,0,2,0,0,2
1203391424580014080,0,1,0,1,2
728780780,1,0,1,0,2
349835985,0,2,0,0,2
813693898807767040,0,2,0,0,2
728613830,0,2,0,0,2
722609726,0,2,0,0,2
2613997178,0,1,1,0,2
1203545759129444352,0,2,0,0,2
1068700248208490496,0,0,2,0,2
1203547938250735616,2,0,0,0,2
365347359,0,2,0,0,2
775444140,1,0,1,0,2
1068479543332220928,0,2,0,0,2
1078463228538179584,0,2,0,0,2
1196132267409715200,0,2,0,0,2
631809408,0,2,0,0,2
725237958,0,2,0,0,2
1904246564,0,2,0,0,2
1078231479715577856,0,2,0,0,2
889937894202363904,0,2,0,0,2
2238866050,0,2,0,0,2
1203784160848105472,0,2,0,0,2
364240361,0,2,0,0,2
1021434260199223296,0,2,0,0,2
632025736,0,2,0,0,2
1196055471595163648,0,2,0,0,2
725639270,0,2,0,0,2
631907637,1,0,1,0,2
725967836,0,2,0,0,2
878898023023202304,0,2,0,0,2
2239089469,0,2,0,0,2
1904564778,0,2,0,0,2
726489810,0,2,0,0,2
1067990135822680064,0,1,0,1,2
1067995648857788416,0,2,0,0,2
884503735698849792,0,1,0,1,2
2192387018,0,1,0,1,2
1021311006725885952,0,2,0,0,2
631358726,0,2,0,0,2
364784902,0,2,0,0,2
724867974,2,0,0,0,2
1018991985707896832,2,0,0,0,2
364756891,0,2,0,0,2
775484887,0,2,0,0,2
2583754621,1,1,0,0,2
960646676,0,2,0,0,2
726124207,2,0,0,0,2
904660991727865856,0,2,0,0,2
365470925,0,2,0,0,2
2215169180,1,1,0,0,2
1069171669699313664,0,2,0,0,2
1078722260133920768,0,2,0,0,2
721488829,0,2,0,0,2
2237298750,0,2,0,0,2
730701086,1,1,0,0,2
633099604,0,2,0,0,2
2586801671,0,2,0,0,2
365847145,1,1,0,0,2
1196683298094886912,2,0,0,0,2
629158829,0,2,0,0,2
349511544,0,2,0,0,2
878409041554415616,0,2,0,0,2
351654348,0,2,0,0,2
1204453567400218624,0,2,0,0,2
629254937,0,1,0,1,2
1077528324375748608,0,2,0,0,2
1203012242008002560,2,0,0,0,2
786432002,0,2,0,0,2
2240640201,0,2,0,0,2
1204648861966491648,2,0,0,0,2
1200314584197808128,0,2,0,0,2
2580523563,0,2,0,0,2
1021848742083866624,0,2,0,0,2
774637238,0,2,0,0,2
365994352,2,0,0,0,2
1204637674662854656,2,0,0,0,2
1069184691796873216,1,0,0,1,2
808583531316252672,0,1,1,0,2
1067203999483482112,0,2,0,0,2
352052230,0,2,0,0,2
633530728,1,1,0,0,2
1902187028,0,2,0,0,2
633285344,0,2,0,0,2
363514952,1,1,0,0,2
721551403,2,0,0,0,2
363711961,1,1,0,0,2
884429954880065536,0,2,0,0,2
2611259297,0,2,0,0,2
365578585,0,2,0,0,2
351571403,2,0,0,0,2
1021083986859315200,0,2,0,0,2
365571087,2,0,0,0,2
1069048346965434368,0,2,0,0,2
1067637376422416384,0,2,0,0,2
365590590,0,2,0,0,2
728940672,0,2,0,0,2
365528020,1,1,0,0,2
1057557281984909312,0,2,0,0,2
1203352723065843712,0,2,0,0,2
630260217,0,2,0,0,2
1195272781350539264,0,2,0,0,2
1018607938552909824,0,2,0,0,2
1196513107130142720,0,2,0,0,2
961595041,0,1,1,0,2
961554175,2,0,0,0,2
629282465,0,2,0,0,2
2212084177,0,2,0,0,2
1195162031642439680,0,0,1,1,2
1067410617940758528,0,2,0,0,2
730333543,0,2,0,0,2
1204442223842070528,0,2,0,0,2
1019190753107595264,1,1,0,0,2
630031932,0,2,0,0,2
729702644,0,2,0,0,2
814411394263171072,2,0,0,0,2
1904945940,0,2,0,0,2
2582743436,0,2,0,0,2
1078577597255245824,0,1,0,1,2
1196556288433381376,1,0,0,1,2
717653546,0,2,0,0,2
2207852354,0,2,0,0,2
2207601225,0,2,0,0,2
1022772849554030592,0,2,0,0,2
1019613324357627904,0,2,0,0,2
1075509751646019584,0,2,0,0,2
1063541226929119232,1,1,0,0,2
771215072,0,2,0,0,2
1056125931599712256,0,2,0,0,2
361079907,2,0,0,0,2
1206530346793275392,0,2,0,0,2
355417621,0,2,0,0,2
1192837756885622784,0,2,0,0,2
942562310,0,2,0,0,2
344966804,0,2,0,0,2
2204423875,0,2,0,0,2
1063661937957978112,0,2,0,0,2
355345057,0,2,0,0,2
360918976,0,2,0,0,2
2246712857,0,2,0,0,2
1192883923333910528,0,2,0,0,2
810513487487111168,0,2,0,0,2
1063458949477785600,0,1,0,1,2
713988007,0,1,0,1,2
783483109,0,2,0,0,2
1075418687832776704,0,2,0,0,2
1192760482211540992,0,2,0,0,2
2591300761,1,1,0,0,2
344908938,0,2,0,0,2
812725716089470976,1,1,0,0,2
360815424,1,0,1,0,2
2247481356,0,2,0,0,2
810498130366136320,1,1,0,0,2
714429277,1,0,0,1,2
1192814057935519744,0,2,0,0,2
370246776,0,2,0,0,2
1075524713244446720,0,2,0,0,2
807261034935357440,0,2,0,0,2
2184798773,0,2,0,0,2
2574184782,0,2,0,0,2
1193071154631598080,0,2,0,0,2
1022481783512870912,0,2,0,0,2
790310569,0,2,0,0,2
2204600564,0,2,0,0,2
345392961,0,2,0,0,2
771298494,0,2,0,0,2
964975520,2,0,0,0,2
1907184847,0,2,0,0,2
1196065943467810816,0,2,0,0,2
355106483,1,1,0,0,2
2221054212,0,2,0,0,2
355054922,0,2,0,0,2
778544857,0,2,0,0,2
1057232385538957312,0,2,0,0,2
746644717,0,2,0,0,2
746829505,0,2,0,0,2
877506491204468736,1,0,0,1,2
361243018,0,2,0,0,2
370005096,2,0,0,0,2
747234931,0,2,0,0,2
1063707414732648448,0,2,0,0,2
1198298898025988096,2,0,0,0,2
1070798797150801920,0,2,0,0,2
1206512964452442112,0,2,0,0,2
903207318501957632,0,2,0,0,2
1070794553869901824,0,2,0,0,2
622420989,0,2,0,0,2
714951464,0,2,0,0,2
355292809,0,0,1,1,2
345370566,0,2,0,0,2
815561512412540928,0,2,0,0,2
2231654599,2,0,0,0,2
877493452266754048,0,2,0,0,2
713655803,0,2,0,0,2
883621686960152576,0,2,0,0,2
1201515361612554240,1,1,0,0,2
1075152974790434816,0,2,0,0,2
791403565,0,2,0,0,2
1063059712386592768,0,2,0,0,2
344561515,0,2,0,0,2
750597762,0,0,2,0,2
355610882,0,2,0,0,2
966188172,0,2,0,0,2
2571104467,0,2,0,0,2
2635131919,1,1,0,0,2
620641711,0,2,0,0,2
1071331813086375936,1,1,0,0,2
2604425466,0,1,1,0,2
1201532885599162368,0,2,0,0,2
2248543294,0,2,0,0,2
1017703551152349184,2,0,0,0,2
2203607144,0,2,0,0,2
1206655142277210112,0,2,0,0,2
619981336,0,2,0,0,2
751744652,0,2,0,0,2
1022806808379961344,0,2,0,0,2
344339602,0,2,0,0,2
1206915162067759104,1,1,0,0,2
1206907516984029184,0,2,0,0,2
2571051615,1,1,0,0,2
2203324766,0,2,0,0,2
2222218918,0,2,0,0,2
1062787364681072640,0,2,0,0,2
1192266592878383104,0,2,0,0,2
2250071052,2,0,0,0,2
700841898,0,2,0,0,2
2203524484,0,2,0,0,2
2250035412,0,2,0,0,2
620740451,1,1,0,0,2
620760655,1,0,0,1,2
815814484765741056,0,2,0,0,2
1206626856222355456,0,2,0,0,2
807099251981328384,0,2,0,0,2
370617029,0,2,0,0,2
2571654355,0,2,0,0,2
370601116,0,2,0,0,2
700138736,0,2,0,0,2
712941771,1,1,0,0,2
2631867461,0,2,0,0,2
877122138163081216,0,2,0,0,2
815868733419753472,1,1,0,0,2
815837263993180160,0,2,0,0,2
877379403877040128,0,2,0,0,2
1201606213286481920,0,2,0,0,2
2221834271,1,0,1,0,2
2190354610,0,2,0,0,2
1063378938125266944,2,0,0,0,2
1081311465557000192,0,1,1,0,2
371105155,0,2,0,0,2
1192380496195379200,0,2,0,0,2
620822257,0,2,0,0,2
2634969753,0,2,0,0,2
700443648,0,2,0,0,2
1063106139242618880,0,2,0,0,2
620978612,0,2,0,0,2
1063121061200314368,1,1,0,0,2
1201552568276701184,2,0,0,0,2
2591804282,2,0,0,0,2
1192384735437307904,0,2,0,0,2
1020513030738595840,2,0,0,0,2
620981394,0,1,0,1,2
2248395358,0,2,0,0,2
1897944618,0,2,0,0,2
965883012,1,1,0,0,2
883291856028790784,0,2,0,0,2
743917339,0,2,0,0,2
1070512958680125440,0,2,0,0,2
1079718409754107904,0,2,0,0,2
1197752160496181248,0,2,0,0,2
813301802691162112,0,2,0,0,2
1197700687443976192,0,2,0,0,2
368307918,0,2,0,0,2
716639172,0,2,0,0,2
1064908236237824000,0,2,0,0,2
716680134,0,1,0,1,2
1079769831413596160,0,2,0,0,2
1202259350435201024,0,2,0,0,2
885663543609106432,0,2,0,0,2
634887387,0,2,0,0,2
1899442356,0,2,0,0,2
362010064,0,2,0,0,2
1205953613815799808,0,2,0,0,2
361912471,0,0,0,2,2
2244673342,0,2,0,0,2
346696446,2,0,0,0,2
740155501,0,2,0,0,2
903388078152327168,0,2,0,0,2
771677413,0,2,0,0,2
1064575300611309568,0,1,0,1,2
964426136,0,0,2,0,2
1079867378283044864,0,2,0,0,2
716617261,0,2,0,0,2
964260822,0,2,0,0,2
2589443876,0,2,0,0,2
361858314,0,2,0,0,2
2233536302,0,2,0,0,2
738874867,0,2,0,0,2
2233837096,0,2,0,0,2
771868884,0,2,0,0,2
880035032546648064,0,2,0,0,2
2193364118,0,2,0,0,2
877783418272088064,1,0,1,0,2
1070500311641612288,0,2,0,0,2
1069912864268312576,0,2,0,0,2
1193978799970537472,0,2,0,0,2
903451788237389824,1,1,0,0,2
353962723,2,0,0,0,2
2243646256,0,2,0,0,2
1205818187364913152,0,1,1,0,2
785305537,0,0,1,1,2
963622274,0,0,1,1,2
1076510017493159936,0,2,0,0,2
903872322582532096,0,2,0,0,2
625425124,0,2,0,0,2
737076433,0,2,0,0,2
2576523402,0,2,0,0,2
347165761,2,0,0,0,2
2588811684,0,2,0,0,2
353981507,0,2,0,0,2
634759472,0,1,1,0,2
2207039339,1,1,0,0,2
624846456,0,1,0,1,2
1197653393335963648,0,2,0,0,2
354178246,0,2,0,0,2
1065173251498917888,0,2,0,0,2
346966982,2,0,0,0,2
362142397,0,2,0,0,2
1022238957894021120,0,2,0,0,2
354173919,0,2,0,0,2
716929922,0,2,0,0,2
634848423,0,2,0,0,2
2621324157,1,1,0,0,2
1065268205227311104,0,2,0,0,2
737548231,0,2,0,0,2
634813330,0,2,0,0,2
945182550,0,2,0,0,2
1202238058608971776,0,2,0,0,2
810114319853748224,0,2,0,0,2
813259164537360384,2,0,0,0,2
368980730,0,2,0,0,2
1022438068110819328,0,0,2,0,2
742617786,0,2,0,0,2
622999733,0,2,0,0,2
883330518552461312,0,2,0,0,2
623137190,1,0,1,0,2
1080332640753012736,0,2,0,0,2
361392271,1,0,0,1,2
742811888,0,2,0,0,2
1206293333406101504,1,1,0,0,2
778291842,0,2,0,0,2
2590363336,0,2,0,0,2
1064371561396953088,0,2,0,0,2
1193580056192438272,0,2,0,0,2
1064400489230422016,0,2,0,0,2
622942563,0,0,0,2,2
2246152364,0,2,0,0,2
1064562564544323584,0,1,0,1,2
743275561,1,1,0,0,2
345738292,0,2,0,0,2
369432787,0,1,0,1,2
964623727,0,2,0,0,2
2605826035,0,2,0,0,2
1193233683689431040,0,2,0,0,2
903899988383719424,2,0,0,0,2
1206312571193552896,0,2,0,0,2
354884801,0,2,0,0,2
361308374,0,2,0,0,2
1193293701155569664,0,2,0,0,2
361373548,0,2,0,0,2
1080383928328835072,1,1,0,0,2
1070383199367385088,0,2,0,0,2
636186261,0,1,1,0,2
361448624,1,0,0,1,2
2625769556,0,2,0,0,2
741447367,0,2,0,0,2
1198007113848688640,0,2,0,0,2
785180418,0,2,0,0,2
1054765577967943680,0,2,0,0,2
951258433,1,0,0,1,2
623935867,0,2,0,0,2
1064526594377682944,0,2,0,0,2
361706332,0,2,0,0,2
368563616,0,2,0,0,2
623285283,0,2,0,0,2
1206088334382161920,0,2,0,0,2
883397053400756224,0,2,0,0,2
944474942,0,1,0,1,2
368514781,0,2,0,0,2
957068192,0,2,0,0,2
2589819031,0,1,1,0,2
951291606,0,2,0,0,2
815441401047486464,1,1,0,0,2
2574495587,0,2,0,0,2
635856800,0,2,0,0,2
885808563721039872,0,2,0,0,2
1202188046717861888,0,2,0,0,2
771605412,0,2,0,0,2
1198139588172111872,1,1,0,0,2
877598919752110080,0,2,0,0,2
346141978,0,2,0,0,2
2625025163,0,2,0,0,2
2246101073,1,0,1,0,2
1080331188223410176,0,2,0,0,2
2205335576,0,2,0,0,2
1055856339241578496,1,1,0,0,2
368957961,1,1,0,0,2
354686307,0,2,0,0,2
707391757,0,2,0,0,2
1135842741513048064,0,2,0,0,2
1084383617487458304,0,2,0,0,2
532105506,0,1,1,0,2
446144526,0,2,0,0,2
2445871502,0,2,0,0,2
878268410,0,2,0,0,2
446229657,0,2,0,0,2
446394784,0,2,0,0,2
2166019913,0,2,0,0,2
1118581125306253312,0,2,0,0,2
426599008,0,2,0,0,2
1155090154723434496,0,0,0,2,2
1118715578674552832,0,2,0,0,2
836841453112406016,0,1,0,1,2
531690635,0,2,0,0,2
878014657,0,2,0,0,2
531636535,0,2,0,0,2
878308741,0,2,0,0,2
1118215272177868800,1,0,1,0,2
1155517954810945536,0,0,0,2,2
1973613492,0,2,0,0,2
445801735,0,2,0,0,2
1118019853737181184,0,2,0,0,2
1972914800,1,0,0,1,2
856609358607785984,0,2,0,0,2
445439845,0,2,0,0,2
532740430,2,0,0,0,2
1117994972207128576,0,2,0,0,2
2343814458,1,0,0,1,2
878445866,0,2,0,0,2
1155895344489586688,0,2,0,0,2
532936292,2,0,0,0,2
532994917,0,2,0,0,2
2447175673,0,2,0,0,2
1974247855,1,1,0,0,2
840247890,0,2,0,0,2
1043860690166059008,0,2,0,0,2
2346536729,0,2,0,0,2
449044444,0,2,0,0,2
2347699803,0,2,0,0,2
1154289230006358016,0,2,0,0,2
1119845201990815744,0,2,0,0,2
448594502,2,0,0,0,2
448402028,0,2,0,0,2
448124330,1,1,0,0,2
855692937719685120,0,2,0,0,2
529166733,0,0,0,2,2
448090537,0,2,0,0,2
448042447,0,2,0,0,2
841314025,0,2,0,0,2
855745304510869504,0,2,0,0,2
529308647,1,1,0,0,2
447836776,2,0,0,0,2
840326004,0,2,0,0,2
529449769,0,2,0,0,2
855908077014482944,0,2,0,0,2
841297669,0,2,0,0,2
447716798,0,2,0,0,2
1119277266306043904,1,1,0,0,2
447581025,0,2,0,0,2
529625116,1,1,0,0,2
1154686786527879168,0,2,0,0,2
447425040,0,2,0,0,2
529964802,0,2,0,0,2
447291187,0,2,0,0,2
1119233848682983424,0,2,0,0,2
2165904140,2,0,0,0,2
2345713307,0,2,0,0,2
445117130,0,2,0,0,2
533256411,0,2,0,0,2
533261414,0,2,0,0,2
536433625,0,2,0,0,2
1156554738143571968,2,0,0,0,2
835909716970729472,0,1,1,0,2
835888098588274688,0,2,0,0,2
535687116,0,2,0,0,2
1156671498452701184,0,2,0,0,2
1116701026311184384,1,1,0,0,2
442976929,0,2,0,0,2
536202862,0,2,0,0,2
442745792,0,2,0,0,2
442737041,0,2,0,0,2
442691734,0,2,0,0,2
2340777160,1,1,0,0,2
857388190780542976,2,0,0,0,2
1116363785499856896,0,2,0,0,2
2340202291,0,2,0,0,2
443622788,1,1,0,0,2
1156775287129927680,0,2,0,0,2
2339747697,0,2,0,0,2
442202595,2,0,0,0,2
536733783,0,2,0,0,2
442153452,0,2,0,0,2
2339178909,0,2,0,0,2
897919034066423808,0,2,0,0,2
442083142,0,2,0,0,2
1156894072604364800,0,2,0,0,2
880962697,2,0,0,0,2
881204526,0,2,0,0,2
536925740,0,2,0,0,2
1157197179741769728,0,2,0,0,2
441619292,0,2,0,0,2
835912765638311936,0,2,0,0,2
535328432,1,1,0,0,2
839725369,0,2,0,0,2
1972322612,0,2,0,0,2
533544872,0,2,0,0,2
2447471248,2,0,0,0,2
836462730286608384,0,1,0,1,2
836385765886078976,0,2,0,0,2
1117671432736137216,0,2,0,0,2
444663785,2,0,0,0,2
856889264658841600,0,2,0,0,2
1117570063828041728,0,2,0,0,2
1117566107039219712,0,2,0,0,2
533699758,2,0,0,0,2
444436956,0,2,0,0,2
444361942,0,2,0,0,2
533810216,0,2,0,0,2
1117512969535938560,1,1,0,0,2
836212010253758464,0,2,0,0,2
856927691399995392,2,0,0,0,2
897883786330882048,0,2,0,0,2
443918267,0,2,0,0,2
1117444474139897856,0,2,0,0,2
2342792126,0,2,0,0,2
2342633049,0,2,0,0,2
443910842,0,2,0,0,2
534216882,0,2,0,0,2
1971906372,0,0,0,2,2
1117338975193055232,0,2,0,0,2
534541041,0,2,0,0,2
839628266,0,2,0,0,2
1117189097209176064,0,2,0,0,2
1156514261864108032,0,2,0,0,2
534694047,0,2,0,0,2
449077766,0,2,0,0,2
2347821925,0,2,0,0,2
449119247,0,1,0,1,2
2352148289,0,2,0,0,2
454868492,0,2,0,0,2
1151572952892227584,0,2,0,0,2
1036157087267483648,0,2,0,0,2
454602731,0,2,0,0,2
2352403521,0,2,0,0,2
523078223,1,1,0,0,2
2352343873,0,2,0,0,2
854374326811770880,2,0,0,0,2
897471712115163136,0,2,0,0,2
1036029413396242432,0,2,0,0,2
838791921761939456,0,1,1,0,2
523221062,0,2,0,0,2
1151731125200416768,0,2,0,0,2
894149263026003968,0,2,0,0,2
1043489704161759232,0,2,0,0,2
454938033,0,2,0,0,2
2164123819,0,2,0,0,2
1121972281104900096,0,2,0,0,2
2351840858,0,2,0,0,2
2351520912,0,2,0,0,2
453759584,0,2,0,0,2
843461574,0,2,0,0,2
2433822654,2,0,0,0,2
524330987,1,1,0,0,2
453074041,0,2,0,0,2
1121608051369209856,0,2,0,0,2
2350688272,0,2,0,0,2
1121427424728608768,0,2,0,0,2
838641519254962176,2,0,0,0,2
452561321,0,2,0,0,2
454894610,0,2,0,0,2
2352454811,0,2,0,0,2
525046615,0,2,0,0,2
455741604,0,2,0,0,2
1150417753318338560,0,2,0,0,2
1150494965249634304,0,2,0,0,2
1978842072,0,2,0,0,2
1123215049881837568,1,1,0,0,2
521014267,0,2,0,0,2
456568053,2,0,0,0,2
1150703350238896128,0,2,0,0,2
456451054,0,2,0,0,2
2430058106,0,2,0,0,2
1036303409597620224,0,2,0,0,2
522098484,0,2,0,0,2
1151095547807145984,2,0,0,0,2
839060626395705344,0,2,0,0,2
2431004375,0,2,0,0,2
1122842646895124480,0,2,0,0,2
522997943,0,2,0,0,2
1122812647332773888,0,2,0,0,2
1151245714598584320,0,2,0,0,2
522397245,0,2,0,0,2
2353128657,2,0,0,0,2
897463788865298432,0,2,0,0,2
522458544,0,2,0,0,2
522650151,0,2,0,0,2
2431874822,1,1,0,0,2
1043445277397594112,0,2,0,0,2
1122691161263673344,0,2,0,0,2
455245216,0,2,0,0,2
1151511811415584768,0,1,1,0,2
854289942457044992,0,2,0,0,2
1122544654661165056,0,2,0,0,2
452521711,0,2,0,0,2
838559901362302976,0,0,1,1,2
1154275243629801472,2,0,0,0,2
1154067599174410240,0,2,0,0,2
450570437,0,1,1,0,2
2438636265,1,1,0,0,2
1153621866617217024,0,2,0,0,2
450551503,1,1,0,0,2
2438690521,1,1,0,0,2
526929374,0,2,0,0,2
877202630,0,2,0,0,2
837492441150328832,0,2,0,0,2
527254567,0,2,0,0,2
450241139,1,0,1,0,2
1120520573656821760,2,0,0,0,2
855392460926836736,0,2,0,0,2
841657837,0,2,0,0,2
1120358839105261568,2,0,0,0,2
450029812,0,2,0,0,2
450705879,1,1,0,0,2
855448460673372160,2,0,0,0,2
1043712647894450176,0,2,0,0,2
2347953198,0,2,0,0,2
527739782,0,2,0,0,2
2440527757,0,2,0,0,2
897801517356527616,2,0,0,0,2
527927876,0,2,0,0,2
449574447,0,2,0,0,2
2440995092,0,2,0,0,2
2347897453,0,2,0,0,2
1154254686926434304,0,2,0,0,2
2441127084,0,2,0,0,2
1120038574693466112,0,2,0,0,2
528187589,0,0,0,2,2
841787306,0,2,0,0,2
837681602130034688,0,2,0,0,2
1121358153579413504,1,1,0,0,2
451438798,0,2,0,0,2
452122077,0,2,0,0,2
452059692,0,2,0,0,2
452038725,0,1,1,0,2
838434046350852096,0,2,0,0,2
525397082,0,2,0,0,2
1977709428,1,0,0,1,2
1043558820398739456,0,2,0,0,2
894088092432293888,1,1,0,0,2
838259110600638464,2,0,0,0,2
1121252603319291904,0,2,0,0,2
451574181,0,2,0,0,2
1121119872019095552,0,2,0,0,2
525856397,0,2,0,0,2
1121057791525965824,0,2,0,0,2
838086877467066368,0,2,0,0,2
897751675452239872,0,2,0,0,2
1120985765448753152,2,0,0,0,2
838052511110074368,0,2,0,0,2
526020270,0,0,1,1,2
1120979372519907328,0,2,0,0,2
526124021,0,2,0,0,2
838029470246268928,1,0,1,0,2
1977313004,2,0,0,0,2
451059583,2,0,0,0,2
2349586409,0,2,0,0,2
1120813441017532416,0,2,0,0,2
2349134612,0,2,0,0,2
876413246,0,2,0,0,2
450877904,2,0,0,0,2
837898983959838720,0,2,0,0,2
537133093,0,2,0,0,2
441578852,0,2,0,0,2
2339044078,1,1,0,0,2
1110563590761865216,0,2,0,0,2
432262164,0,2,0,0,2
832886436810653696,0,2,0,0,2
431750043,0,2,0,0,2
548449165,2,0,0,0,2
2465266614,0,2,0,0,2
548551915,1,1,0,0,2
832831044554485760,0,2,0,0,2
548589312,0,2,0,0,2
548643972,1,0,0,1,2
1045262213500493824,2,0,0,0,2
431381794,0,2,0,0,2
1110642026960297984,0,2,0,0,2
893709997716242432,2,0,0,0,2
549205947,0,2,0,0,2
2329141010,1,1,0,0,2
432524220,0,1,0,1,2
431172304,0,2,0,0,2
1110518257159561216,0,2,0,0,2
832804145828610048,1,1,0,0,2
1160804056786489344,0,2,0,0,2
2466021139,1,1,0,0,2
859693835877855232,0,2,0,0,2
430955461,0,2,0,0,2
2328823460,0,2,0,0,2
1160927815317032960,1,1,0,0,2
549472336,0,2,0,0,2
1966588514,0,2,0,0,2
549475397,0,2,0,0,2
889431559,2,0,0,0,2
1110189978804465664,0,2,0,0,2
1160462660464521216,1,0,1,0,2
2464724068,0,2,0,0,2
832627233818759168,0,2,0,0,2
2463901442,0,2,0,0,2
434119942,1,1,0,0,2
434117965,0,2,0,0,2
433999030,0,2,0,0,2
2332405798,1,0,1,0,2
2462807462,0,2,0,0,2
433677418,0,2,0,0,2
1159744270636593152,2,0,0,0,2
2332189922,0,2,0,0,2
545801629,0,1,1,0,2
833383027401224192,0,2,0,0,2
546526833,0,2,0,0,2
1968818293,1,1,0,0,2
1159978466172899328,0,2,0,0,2
1112230635198771200,2,0,0,0,2
1160124246468616192,0,2,0,0,2
1111228082600505344,0,0,0,2,2
433341969,0,2,0,0,2
2331742582,0,2,0,0,2
1044992244351217664,1,1,0,0,2
832728312,0,2,0,0,2
547112918,0,2,0,0,2
1034158436999684096,0,2,0,0,2
432994402,0,2,0,0,2
1111748329552203776,0,2,0,0,2
547317369,0,2,0,0,2
887750888,0,2,0,0,2
1111629810747559936,0,2,0,0,2
859263812389621760,0,2,0,0,2
832598270,0,0,0,2,2
2330565012,0,2,0,0,2
1045541176420458496,2,0,0,0,2
889494770,0,2,0,0,2
434177591,0,2,0,0,2
1162019291744460800,0,2,0,0,2
551303014,0,2,0,0,2
428462430,0,1,0,1,2
551340822,0,2,0,0,2
860505667416858624,0,2,0,0,2
428394930,0,2,0,0,2
551410053,0,2,0,0,2
1109228615630311424,0,2,0,0,2
551589191,2,0,0,0,2
890496229,0,2,0,0,2
551771155,1,0,0,1,2
551811504,0,2,0,0,2
890890478,0,2,0,0,2
427465590,0,2,0,0,2
427408181,0,2,0,0,2
1162023479190925312,0,2,0,0,2
1109484639431901184,0,2,0,0,2
427305459,0,2,0,0,2
829957088,0,2,0,0,2
2469609210,0,2,0,0,2
552134315,2,0,0,0,2
1046028518738612224,0,2,0,0,2
891112034,0,2,0,0,2
891344917,2,0,0,0,2
1162203143381254144,0,2,0,0,2
1108943009196855296,2,0,0,0,2
1033501126220554240,1,1,0,0,2
1108942647324901376,0,2,0,0,2
427188575,0,2,0,0,2
426837412,0,2,0,0,2
831946716400197632,0,2,0,0,2
860489291683643392,0,2,0,0,2
832251869665820672,0,2,0,0,2
1110150862125629440,0,2,0,0,2
1109798103295549440,0,2,0,0,2
859787337500434432,0,2,0,0,2
859860541145309184,0,2,0,0,2
429905298,2,0,0,0,2
1965794510,0,2,0,0,2
1161367313775562752,2,0,0,0,2
1161407887345893376,0,2,0,0,2
1110078470086901760,0,0,0,2,2
550072991,0,2,0,0,2
550073846,0,2,0,0,2
2169529654,0,2,0,0,2
1045575004547469312,2,0,0,0,2
1161524519355518976,0,2,0,0,2
860031740546617344,0,2,0,0,2
429189805,0,2,0,0,2
2467381346,0,2,0,0,2
550965156,0,2,0,0,2
2328004631,0,2,0,0,2
550316189,2,0,0,0,2
1109765948888629248,2,0,0,0,2
2327652417,0,2,0,0,2
550397558,0,2,0,0,2
860069753439780864,1,1,0,0,2
2467826292,0,2,0,0,2
1109548776539082752,0,2,0,0,2
830813492,0,2,0,0,2
550863477,0,2,0,0,2
1033714173924929536,0,2,0,0,2
2468113308,2,0,0,0,2
1161674889348050944,1,0,0,1,2
2468157280,0,1,0,1,2
2332827829,0,2,0,0,2
1112637912796024832,2,0,0,0,2
835479309590626304,0,1,0,1,2
439077939,0,2,0,0,2
2336602860,1,0,0,1,2
1034673192332353536,0,2,0,0,2
439554032,0,1,0,1,2
2166695126,1,1,0,0,2
2166753073,0,1,1,0,2
439485003,0,2,0,0,2
539268454,0,2,0,0,2
834671191721967616,0,2,0,0,2
439354620,0,2,0,0,2
858050331829260288,0,2,0,0,2
1157952766863650816,2,0,0,0,2
539808608,0,2,0,0,2
1115052446571814912,0,2,0,0,2
539849874,0,2,0,0,2
438796821,0,2,0,0,2
882653234,0,2,0,0,2
438708550,0,2,0,0,2
1158080962435211264,0,2,0,0,2
539880793,0,2,0,0,2
883650810,0,2,0,0,2
2456669354,0,2,0,0,2
834329165021249536,0,2,0,0,2
1114840181033570304,0,2,0,0,2
883745335,0,2,0,0,2
438210522,0,2,0,0,2
2334454626,0,2,0,0,2
1158220845451337728,2,0,0,0,2
437911103,0,2,0,0,2
1114623555872919552,0,2,0,0,2
540547939,0,2,0,0,2
1971106440,0,2,0,0,2
439902946,0,2,0,0,2
2457691291,2,0,0,0,2
835198192987709440,0,2,0,0,2
1116254714444812288,0,2,0,0,2
537493666,0,2,0,0,2
1116217294386892800,0,2,0,0,2
1157338413873487872,2,0,0,0,2
2338379399,0,2,0,0,2
441042248,0,2,0,0,2
441026608,1,0,0,1,2
537650211,1,1,0,0,2
838430995,0,2,0,0,2
440789951,0,1,1,0,2
537935901,2,0,0,0,2
835297534415372288,0,2,0,0,2
1034755404570525696,2,0,0,0,2
837689977,0,2,0,0,2
835173413664735232,1,0,1,0,2
2452256710,0,2,0,0,2
537989351,0,2,0,0,2
1157565909675978752,0,1,0,1,2
1157569775658291200,0,2,0,0,2
538093202,0,2,0,0,2
2337828524,0,2,0,0,2
1044375049694842880,0,2,0,0,2
440395380,0,2,0,0,2
837600883,2,0,0,0,2
538317013,1,1,0,0,2
1044388000820596736,0,2,0,0,2
837532338,0,2,0,0,2
2451901238,0,0,2,0,2
897923024388751360,0,2,0,0,2
1034713747951050752,0,2,0,0,2
437849802,2,0,0,0,2
1114558198390849536,0,2,0,0,2
858771165921382400,0,2,0,0,2
435344079,0,2,0,0,2
436094659,0,2,0,0,2
1044613049984765952,0,2,0,0,2
1113846934291263488,0,2,0,0,2
542897249,1,1,0,0,2
543181996,0,2,0,0,2
1113734850161381376,1,0,1,0,2
1158813137379954688,0,2,0,0,2
2333335311,2,0,0,0,2
884236339,0,2,0,0,2
2333216655,0,2,0,0,2
435719481,2,0,0,0,2
435473092,2,0,0,0,2
2460650465,0,2,0,0,2
2460839558,0,2,0,0,2
2461874998,0,2,0,0,2
1158741271210426368,0,2,0,0,2
2461879997,0,2,0,0,2
1159436985142059008,0,2,0,0,2
1159439056947830784,1,1,0,0,2
434849313,0,2,0,0,2
1159466439469862912,0,2,0,0,2
1159472395675033600,0,2,0,0,2
434792857,0,2,0,0,2
544485649,2,0,0,0,2
1112919043940409344,1,1,0,0,2
1112907502771896320,2,0,0,0,2
858766791685832704,0,2,0,0,2
1112701094851997696,1,1,0,0,2
434351222,0,2,0,0,2
434346093,0,2,0,0,2
542018861,1,0,1,0,2
1158689541756203008,1,0,0,1,2
1044516354303225856,0,2,0,0,2
541407858,1,0,0,1,2
540838479,0,2,0,0,2
540862005,0,2,0,0,2
2457697795,2,0,0,0,2
1158356870291058688,0,2,0,0,2
1158384058709266432,0,2,0,0,2
437489726,2,0,0,0,2
2458174809,0,2,0,0,2
541137771,2,0,0,0,2
2167171394,0,2,0,0,2
1158424896600330240,0,2,0,0,2
834166287102312448,0,2,0,0,2
2458976628,0,2,0,0,2
437050979,0,2,0,0,2
1158463641403850752,0,0,1,1,2
1044544947708473344,0,2,0,0,2
436488433,0,2,0,0,2
436989977,0,2,0,0,2
883803072,0,2,0,0,2
834075291823792128,0,2,0,0,2
1034605350912184320,0,2,0,0,2
2333672735,0,2,0,0,2
1970482206,0,2,0,0,2
436814433,0,2,0,0,2
541636191,0,2,0,0,2
1114157748671995904,0,2,0,0,2
1044591575718916096,0,2,0,0,2
2333638607,0,2,0,0,2
541878477,0,0,0,2,2
1158671484723875840,2,0,0,0,2
2460028357,0,2,0,0,2
2429136708,0,2,0,0,2
520771211,0,1,1,0,2
520713471,1,0,0,1,2
1131771355148554240,0,2,0,0,2
1132153027245236224,0,0,2,0,2
1038979358919204864,2,0,0,0,2
1132047554923900928,0,2,0,0,2
476320437,1,1,0,0,2
1140956465630334976,1,1,0,0,2
895156705629270016,0,2,0,0,2
1140994376459542528,0,2,0,0,2
849732133031727104,0,2,0,0,2
476136307,0,2,0,0,2
2373778260,0,2,0,0,2
2153116108,0,2,0,0,2
863907703,1,1,0,0,2
864077052,0,2,0,0,2
1131794234695020544,2,0,0,0,2
2153037038,0,2,0,0,2
2402057102,0,0,0,2,2
864227480,0,2,0,0,2
497561002,0,2,0,0,2
1141224189577162752,1,0,1,0,2
2373437576,0,2,0,0,2
1038753066084970496,0,2,0,0,2
497765883,0,2,0,0,2
475614018,0,0,0,2,2
497776666,0,2,0,0,2
854098704,0,2,0,0,2
864286033,0,2,0,0,2
475564441,1,0,0,1,2
1131489193882861568,2,0,0,0,2
1141283272154128384,0,2,0,0,2
1141316898107400192,1,1,0,0,2
863343878,1,0,0,1,2
476669529,0,2,0,0,2
850017957295960064,0,2,0,0,2
2158260054,0,2,0,0,2
1139761044224536576,0,2,0,0,2
1132656370602446848,0,2,0,0,2
1132648939952443392,0,2,0,0,2
1132637919389323264,0,2,0,0,2
495202725,2,0,0,0,2
495272913,0,1,0,1,2
2375414868,0,2,0,0,2
1139838812404760576,0,2,0,0,2
1139859169446629376,0,2,0,0,2
495353585,0,2,0,0,2
478447998,0,2,0,0,2
855355375,0,2,0,0,2
1132501406202548224,2,0,0,0,2
478186903,0,2,0,0,2
2158286982,0,2,0,0,2
2401989976,0,2,0,0,2
863151457,0,2,0,0,2
1140319043750170624,1,1,0,0,2
1132217733838323712,1,1,0,0,2
1140352483321110528,0,2,0,0,2
2400134058,0,2,0,0,2
2153450886,0,1,0,1,2
495971977,0,2,0,0,2
1140502717481115648,0,2,0,0,2
2400851976,0,2,0,0,2
477042158,0,2,0,0,2
1140647027249840128,0,2,0,0,2
496157178,0,2,0,0,2
1140655442323841024,2,0,0,0,2
2158484268,0,2,0,0,2
2403082631,1,1,0,0,2
864370206,0,2,0,0,2
494609110,0,2,0,0,2
2407501769,0,2,0,0,2
1041032816899710976,0,2,0,0,2
1130742716063731712,0,2,0,0,2
2370755050,0,2,0,0,2
2407261358,0,2,0,0,2
473071947,0,2,0,0,2
1142730504854278144,0,2,0,0,2
2152373995,0,2,0,0,2
1130691973797441536,0,0,1,1,2
500632463,2,0,0,0,2
472734186,0,2,0,0,2
850379487019757568,0,2,0,0,2
472589390,0,2,0,0,2
843335093968146432,0,2,0,0,2
2159231396,0,2,0,0,2
1142953746604941312,0,2,0,0,2
850297366460727296,0,2,0,0,2
500739772,0,2,0,0,2
500753198,0,2,0,0,2
2370396552,0,2,0,0,2
1143182481006501888,0,2,0,0,2
896411057849335808,0,2,0,0,2
865909723,0,2,0,0,2
2369933002,0,2,0,0,2
1038432874280628224,1,0,0,1,2
853187185,0,2,0,0,2
1143386917620207616,0,2,0,0,2
471779083,1,1,0,0,2
501381054,1,0,0,1,2
501432095,0,2,0,0,2
501491773,0,2,0,0,2
2370881816,0,2,0,0,2
1142397805182541824,1,1,0,0,2
1141408049610940416,0,2,0,0,2
1141908419311390720,0,2,0,0,2
1141485508620693504,0,2,0,0,2
1041001060876386304,0,2,0,0,2
498475788,0,2,0,0,2
2152953156,0,2,0,0,2
498611410,0,2,0,0,2
1131340678661902336,2,0,0,0,2
843845848685592576,2,0,0,0,2
1131329436131954688,0,1,0,1,2
498796913,0,2,0,0,2
850205172299055104,0,2,0,0,2
1131257059192713216,2,0,0,0,2
499094647,1,1,0,0,2
2404811206,0,2,0,0,2
338850470,1,0,1,0,2
896110256958431232,0,0,2,0,2
1142364620138717184,0,2,0,0,2
1141926827801190400,0,2,0,0,2
853596133,0,2,0,0,2
473855122,0,2,0,0,2
896145685946486784,0,2,0,0,2
499514663,0,2,0,0,2
473793876,0,2,0,0,2
1131116683001602048,0,0,0,2,2
473728339,0,2,0,0,2
473695999,1,1,0,0,2
499742283,0,1,1,0,2
2371509290,0,0,1,1,2
473627914,0,2,0,0,2
1041015495548461056,0,0,0,2,2
1131064378516631552,0,2,0,0,2
494872259,0,2,0,0,2
2154114193,0,2,0,0,2
1143664058912165888,0,2,0,0,2
489349234,0,2,0,0,2
846316865832042496,0,2,0,0,2
1039764411475550208,0,2,0,0,2
2384056843,0,2,0,0,2
2388881970,2,0,0,0,2
1135348263496892416,0,2,0,0,2
488989387,1,0,1,0,2
857665315,0,2,0,0,2
489146943,0,2,0,0,2
489175346,0,2,0,0,2
483874769,0,2,0,0,2
2389073448,0,2,0,0,2
489313716,0,0,0,2,2
860438600,0,2,0,0,2
483465220,0,2,0,0,2
2383398410,0,2,0,0,2
2388160516,2,0,0,0,2
489509235,0,2,0,0,2
2389570449,0,2,0,0,2
2389572100,0,2,0,0,2
483170010,0,2,0,0,2
1135113820903485440,0,2,0,0,2
1039755538404442112,0,2,0,0,2
2156073731,0,2,0,0,2
847619854941118464,0,1,1,0,2
857071848,2,0,0,0,2
490159926,0,2,0,0,2
895411505063010304,0,1,0,1,2
1134786885807685632,0,2,0,0,2
482993584,0,2,0,0,2
2382229472,0,2,0,0,2
2384307876,0,0,2,0,2
857932952,0,2,0,0,2
1137460356115075072,0,2,0,0,2
2155217664,0,2,0,0,2
1135889659702022144,0,2,0,0,2
2386489839,1,1,0,0,2
846819471624953856,0,2,0,0,2
859239236,0,2,0,0,2
487602848,0,2,0,0,2
2386793827,0,2,0,0,2
1136409651287928832,0,2,0,0,2
859512726,0,2,0,0,2
2387016294,0,2,0,0,2
1135692600445427712,0,2,0,0,2
859558621,0,2,0,0,2
487666584,0,2,0,0,2
485778320,0,2,0,0,2
487672674,0,2,0,0,2
846419458449199104,0,2,0,0,2
847058291834437632,1,1,0,0,2
1136647719509024768,0,2,0,0,2
485613650,0,2,0,0,2
1039814189135618048,0,2,0,0,2
485569930,1,0,0,1,2
846384268549001216,0,2,0,0,2
487757725,0,2,0,0,2
1136685957753856000,0,2,0,0,2
895616076980944896,0,2,0,0,2
860031710,0,2,0,0,2
487997344,0,2,0,0,2
1135643137576120320,0,2,0,0,2
1135623604211724288,0,2,0,0,2
488178998,0,2,0,0,2
2155728819,0,2,0,0,2
2382135426,2,0,0,0,2
2381704559,0,2,0,0,2
2376448542,2,0,0,0,2
1139141118128529408,2,0,0,0,2
2393544174,2,0,0,0,2
845376539315204096,0,1,0,1,2
861360536,0,2,0,0,2
2394094625,0,2,0,0,2
1133590856848379904,2,0,0,0,2
2394348654,0,2,0,0,2
2394684582,0,2,0,0,2
1040642451411804160,0,2,0,0,2
861502782,0,2,0,0,2
848591028110209024,0,2,0,0,2
1138777682248982528,0,2,0,0,2
479865933,0,2,0,0,2
848628372611760128,0,2,0,0,2
2395640462,2,0,0,0,2
1133273398543572992,0,2,0,0,2
1138385571405950976,2,0,0,0,2
2377601870,2,0,0,0,2
861900228,0,2,0,0,2
848675346350313472,0,2,0,0,2
493714995,2,0,0,0,2
493815342,0,1,1,0,2
479325947,0,2,0,0,2
1132949807620771840,0,2,0,0,2
848941872903061504,0,2,0,0,2
493987001,0,2,0,0,2
845001167918841856,0,2,0,0,2
848994443692736512,0,2,0,0,2
494261402,0,2,0,0,2
849178163662008320,0,2,0,0,2
2376881202,0,2,0,0,2
2393537526,1,0,0,1,2
1133624766659608576,1,1,0,0,2
1137594146900860928,0,2,0,0,2
1138024042005377024,1,1,0,0,2
856828796,0,1,0,1,2
2380557388,0,2,0,0,2
482722358,0,2,0,0,2
491196032,0,2,0,0,2
845849031439933440,1,1,0,0,2
860692770,0,2,0,0,2
856449547,2,0,0,0,2
2391522499,2,0,0,0,2
482078038,0,2,0,0,2
491868446,0,2,0,0,2
491896579,0,2,0,0,2
2391588949,0,2,0,0,2
1134081651468898304,2,0,0,0,2
492071527,0,2,0,0,2
895271641235636224,1,1,0,0,2
845594521509421056,0,2,0,0,2
492260594,0,2,0,0,2
1138064483853643776,0,2,0,0,2
1133835319034417152,0,2,0,0,2
1133797906895560704,0,2,0,0,2
1039502332453683200,0,2,0,0,2
2392442874,0,2,0,0,2
492634646,0,2,0,0,2
1138213523559931904,0,2,0,0,2
1133704222929772544,0,2,0,0,2
1138228587318906880,1,1,0,0,2
492892224,0,2,0,0,2
1138340723860889600,1,0,1,0,2
1133656803848445952,0,2,0,0,2
848504630325768192,1,0,0,1,2
2409287088,1,1,0,0,2
2409313740,0,0,0,2,2
844967300,1,1,0,0,2
2359237766,1,0,1,0,2
852438553581633536,0,2,0,0,2
1125591378656923648,0,2,0,0,2
462170893,0,2,0,0,2
1148141759832186880,0,2,0,0,2
1125586611801030656,1,1,0,0,2
1037572866638786560,1,0,0,1,2
870646334,0,2,0,0,2
1037441490757316608,0,2,0,0,2
514531293,1,1,0,0,2
1125388641503784960,0,2,0,0,2
894496642220544000,2,0,0,0,2
1148379784835162112,0,2,0,0,2
461674837,0,2,0,0,2
2421923463,0,2,0,0,2
1042681987272769536,1,1,0,0,2
1125775446077997056,0,2,0,0,2
1042685863380099072,0,2,0,0,2
2359145786,0,2,0,0,2
840799846860746752,0,2,0,0,2
461149491,1,1,0,0,2
461104275,0,2,0,0,2
871116008,0,2,0,0,2
515778628,0,2,0,0,2
2423273365,0,2,0,0,2
2423437014,0,2,0,0,2
460873515,0,2,0,0,2
515931875,0,2,0,0,2
853176034451238912,2,0,0,0,2
2423548144,0,2,0,0,2
840316141696405504,0,2,0,0,2
847712832,0,0,2,0,2
852421562414370816,0,2,0,0,2
846547718,0,2,0,0,2
463185225,0,0,1,1,2
463891298,0,2,0,0,2
463767782,0,0,0,2,2
511757178,0,2,0,0,2
463706120,1,1,0,0,2
511777241,0,2,0,0,2
2362263726,2,0,0,0,2
512045599,0,2,0,0,2
463690371,0,2,0,0,2
852169376405090304,2,0,0,0,2
1147461807591829504,2,0,0,0,2
2420004272,0,2,0,0,2
1126451846342762496,0,2,0,0,2
1126423063921405952,0,2,0,0,2
463255536,0,2,0,0,2
1147525614699597824,2,0,0,0,2
841042803312467968,0,2,0,0,2
1147525679711264768,0,2,0,0,2
462870568,0,2,0,0,2
2161194579,0,2,0,0,2
848815154,0,2,0,0,2
1126188690366181376,0,2,0,0,2
2361264798,0,2,0,0,2
1147630972785049600,0,2,0,0,2
2420301068,0,2,0,0,2
2420408951,0,2,0,0,2
2161282327,0,2,0,0,2
1147858132229427200,0,2,0,0,2
2361149385,0,0,0,2,2
1042299069798985728,0,2,0,0,2
2361011803,0,2,0,0,2
516228043,0,2,0,0,2
1148931242496163840,1,0,0,1,2
1126774734702538752,2,0,0,0,2
457339350,0,2,0,0,2
2426761696,0,2,0,0,2
1123997820179054592,0,2,0,0,2
458146319,0,2,0,0,2
2355933775,0,2,0,0,2
2426781572,0,2,0,0,2
1979654786,0,2,0,0,2
873012055,0,2,0,0,2
519350666,0,2,0,0,2
894403600750858240,1,1,0,0,2
519378175,0,2,0,0,2
1043238551813545984,0,2,0,0,2
457698542,0,2,0,0,2
1150067050850770944,0,2,0,0,2
1150142626496225280,0,2,0,0,2
853919781606567936,0,2,0,0,2
518560657,1,1,0,0,2
2354828575,0,2,0,0,2
2427727129,0,2,0,0,2
1036599136206942208,0,2,0,0,2
520193952,0,2,0,0,2
854019501352001536,0,2,0,0,2
897368987906060288,0,2,0,0,2
1123612013572259840,0,2,0,0,2
2354588964,0,2,0,0,2
1123484722720583680,2,0,0,0,2
1150345987254292480,0,2,0,0,2
520551755,0,0,0,2,2
456913979,2,0,0,0,2
1123278192289038336,0,2,0,0,2
1123252687624122368,0,2,0,0,2
2426742387,1,1,0,0,2
1036895942115577856,1,1,0,0,2
516772508,0,2,0,0,2
2424992436,0,0,0,2,2
1124747956656041984,1,1,0,0,2
2423897512,0,2,0,0,2
2161776112,0,2,0,0,2
517285829,0,2,0,0,2
459654629,0,2,0,0,2
2424291889,0,2,0,0,2
459533696,1,0,0,1,2
1149304873130844160,0,2,0,0,2
517422360,0,2,0,0,2
459380805,0,2,0,0,2
853465906814439424,2,0,0,0,2
517582034,0,2,0,0,2
2424980741,0,2,0,0,2
459324215,0,2,0,0,2
459275958,0,2,0,0,2
2147499236,1,1,0,0,2
459229732,2,0,0,0,2
1037013226221973504,0,2,0,0,2
459195953,0,2,0,0,2
853513463447953408,0,2,0,0,2
2356837350,0,2,0,0,2
1149492140927377408,0,2,0,0,2
458958737,0,2,0,0,2
518259565,0,2,0,0,2
458792938,0,2,0,0,2
1124175854089588736,2,0,0,0,2
518431742,1,1,0,0,2
458683336,0,2,0,0,2
518450228,0,2,0,0,2
1124134742536986624,0,2,0,0,2
841462690778357760,0,2,0,0,2
1126825680531087360,0,2,0,0,2
2409351953,0,2,0,0,2
1145269326460739584,0,2,0,0,2
504667913,0,2,0,0,2
2412777378,0,2,0,0,2
1129447129917923328,0,0,0,2,2
851074149510520832,1,1,0,0,2
1129276769184419840,0,2,0,0,2
505329541,2,0,0,0,2
469062067,0,2,0,0,2
1128974524295385088,0,0,2,0,2
1145165617902735360,0,2,0,0,2
867268872,0,2,0,0,2
867438908,0,2,0,0,2
505834981,2,0,0,0,2
1128934077002846208,0,2,0,0,2
1145219521252417536,0,2,0,0,2
2160353000,0,2,0,0,2
1145015483600478208,0,2,0,0,2
468522409,0,2,0,0,2
1128793896488595456,0,2,0,0,2
1145364153432866816,0,2,0,0,2
851238877,0,2,0,0,2
1128629668234584064,0,2,0,0,2
2413265806,1,1,0,0,2
468186503,0,2,0,0,2
1145539552662061056,2,0,0,0,2
1145592393984434176,0,2,0,0,2
2365985504,0,2,0,0,2
2365942602,1,1,0,0,2
1128225555885842432,0,2,0,0,2
2160611911,0,2,0,0,2
1128150775161450496,1,1,0,0,2
2151276653,0,2,0,0,2
850982005906878464,0,2,0,0,2
2365483502,0,2,0,0,2
502148861,0,2,0,0,2
1130146695713394688,1,1,0,0,2
501583124,0,2,0,0,2
2159517912,1,0,1,0,2
2369290868,0,2,0,0,2
1143858127730860032,1,1,0,0,2
2369200996,1,0,0,1,2
1038413900113485824,1,1,0,0,2
502018244,0,2,0,0,2
1144029914510893056,0,2,0,0,2
1144096457240252416,0,1,0,1,2
470613021,0,2,0,0,2
842950525364699136,0,2,0,0,2
894974068809768960,0,2,0,0,2
866581542,0,0,2,0,2
470401651,0,2,0,0,2
504471239,0,2,0,0,2
1129756864902815744,1,1,0,0,2
866654942,1,0,1,0,2
1144304554898579456,0,2,0,0,2
2368011746,0,2,0,0,2
1144435161611685888,0,2,0,0,2
1144635587216969728,0,2,0,0,2
1129668804085198848,0,2,0,0,2
469751445,0,2,0,0,2
469607027,0,2,0,0,2
842702900560322560,2,0,0,0,2
2412397586,0,2,0,0,2
2367990911,0,2,0,0,2
2367860101,0,2,0,0,2
867028441,0,2,0,0,2
507846462,0,2,0,0,2
1128089888430219264,0,2,0,0,2
852038550702792704,1,0,1,0,2
510349369,2,0,0,0,2
509774617,0,2,0,0,2
851651487449194496,0,2,0,0,2
849465199,0,0,1,1,2
841676694599622656,0,2,0,0,2
2363683576,0,2,0,0,2
465631711,0,2,0,0,2
1041911806954856448,0,2,0,0,2
1146508701424971776,0,2,0,0,2
465468443,2,0,0,0,2
2363354855,0,2,0,0,2
2417259292,2,0,0,0,2
465387793,0,2,0,0,2
868792956,0,2,0,0,2
2161176670,0,2,0,0,2
1146775864073498624,0,2,0,0,2
465878411,0,2,0,0,2
2149357540,1,1,0,0,2
464855487,0,2,0,0,2
2418025080,0,2,0,0,2
510352313,0,2,0,0,2
510417738,0,2,0,0,2
510582037,1,0,0,1,2
1146950175555870720,0,2,0,0,2
464478015,0,2,0,0,2
841582570445897728,1,1,0,0,2
841574369977540608,0,2,0,0,2
1147027908474658816,0,2,0,0,2
464293690,0,2,0,0,2
1126871767002128384,0,2,0,0,2
852035655605510144,0,2,0,0,2
841754437148397568,0,2,0,0,2
465921722,0,2,0,0,2
1145740259310919680,0,2,0,0,2
849759356,0,2,0,0,2
467684598,0,2,0,0,2
851470470163705856,0,2,0,0,2
2365251060,0,2,0,0,2
508343379,0,2,0,0,2
508368492,2,0,0,0,2
1128077757961920512,0,2,0,0,2
851475683087970304,0,2,0,0,2
842162962538217472,0,2,0,0,2
467361179,0,2,0,0,2
850568222,0,2,0,0,2
1038102820334051328,1,0,0,1,2
850135171,0,2,0,0,2
2161037089,1,1,0,0,2
1127610370883907584,0,2,0,0,2
509073133,0,2,0,0,2
896844988700667904,0,2,0,0,2
2364189544,0,2,0,0,2
851553558843367424,0,2,0,0,2
841970996924059648,2,0,0,0,2
2415670229,0,2,0,0,2
466992330,0,2,0,0,2
2415777066,1,1,0,0,2
849542202,2,0,0,0,2
466593916,0,2,0,0,2
466568901,0,2,0,0,2
841937205308334080,0,2,0,0,2
466491846,1,1,0,0,2
466368179,0,2,0,0,2
466340592,0,2,0,0,2
466238105,2,0,0,0,2
552790359,1,1,0,0,2
1162372339431952384,0,2,0,0,2
1190056809538572288,2,0,0,0,2
389785377,0,2,0,0,2
1092528132844896256,0,2,0,0,2
1027087629748121600,0,2,0,0,2
1180945649254031360,0,0,0,2,2
389648599,0,2,0,0,2
591657809,0,2,0,0,2
1027124664861118464,0,2,0,0,2
389941674,2,0,0,0,2
2169910896,0,2,0,0,2
591587107,2,0,0,0,2
901076525528829952,0,2,0,0,2
389996032,0,1,1,0,2
2177765156,0,2,0,0,2
390231195,0,2,0,0,2
591402429,2,0,0,0,2
389524488,0,2,0,0,2
870925849842900992,0,2,0,0,2
822503168026308608,1,1,0,0,2
871036164467290112,0,0,0,2,2
1092344760012959744,0,0,0,2,2
389510317,0,2,0,0,2
808835558,0,2,0,0,2
2279188364,0,2,0,0,2
592644769,0,2,0,0,2
1181321797406515200,0,2,0,0,2
389381775,0,2,0,0,2
592702491,0,2,0,0,2
822464212060536832,1,1,0,0,2
389278503,2,0,0,0,2
592780280,1,1,0,0,2
1051120971522945024,0,1,1,0,2
871507665092059136,0,2,0,0,2
2532946616,0,2,0,0,2
390423165,0,2,0,0,2
822698825135570944,0,2,0,0,2
2530687837,1,1,0,0,2
1179544140545220608,0,2,0,0,2
1179602195181785088,1,0,0,1,2
822838852083712000,0,2,0,0,2
918558986,0,2,0,0,2
810664981,0,2,0,0,2
2530097384,0,0,1,1,2
810301470,0,2,0,0,2
391544773,0,2,0,0,2
1179870877032370176,0,2,0,0,2
391336404,0,2,0,0,2
2530426376,2,0,0,0,2
391278919,1,1,0,0,2
391271143,2,0,0,0,2
870434199290994688,0,2,0,0,2
918675516,0,2,0,0,2
1180579511353692160,1,1,0,0,2
391245194,0,2,0,0,2
391167104,0,2,0,0,2
900915965625368576,2,0,0,0,2
810144614,0,2,0,0,2
1935086006,0,2,0,0,2
590776410,0,2,0,0,2
590818686,0,2,0,0,2
870698185429098496,0,2,0,0,2
891860299837579264,1,1,0,0,2
590954704,0,2,0,0,2
1180394812886966272,0,1,1,0,2
1180529905202802688,0,2,0,0,2
390685825,2,0,0,0,2
1092759647650484224,1,1,0,0,2
1091946036141142016,0,2,0,0,2
920600269,1,1,0,0,2
1091897302766288896,0,2,0,0,2
1090678345308749824,0,2,0,0,2
871837673140441088,0,2,0,0,2
387330840,0,2,0,0,2
1182286621858643968,0,2,0,0,2
595294466,0,2,0,0,2
1090962071821406208,0,2,0,0,2
1182323856830124032,0,2,0,0,2
595351222,0,2,0,0,2
595362856,0,2,0,0,2
1090902163994394624,0,2,0,0,2
2538589270,0,2,0,0,2
2538656434,0,2,0,0,2
821756533113425920,0,2,0,0,2
1026508759185670144,0,2,0,0,2
2276334952,0,2,0,0,2
595530958,0,1,1,0,2
1091037038407806976,0,2,0,0,2
386990695,1,1,0,0,2
1090660176351424512,0,2,0,0,2
871953259925307392,2,0,0,0,2
921995689,2,0,0,0,2
595698907,0,2,0,0,2
821521296060248064,0,2,0,0,2
595717226,0,2,0,0,2
1182655617770631168,0,0,0,2,2
1182677715704401920,0,2,0,0,2
2539480417,1,1,0,0,2
2539808478,0,0,0,2,2
1182709952575660032,0,2,0,0,2
2539905868,0,2,0,0,2
806977141,0,1,1,0,2
871817700791775232,1,1,0,0,2
1182249769504108544,0,2,0,0,2
388941348,0,2,0,0,2
1026815389198573568,0,2,0,0,2
2535603859,0,2,0,0,2
891603310041497600,0,2,0,0,2
1091707987469709312,0,2,0,0,2
2278941050,0,2,0,0,2
593578409,0,2,0,0,2
1181583826184597504,0,2,0,0,2
2535920108,0,2,0,0,2
388762962,1,1,0,0,2
807923168,0,1,0,1,2
2536323081,0,2,0,0,2
593597497,0,2,0,0,2
593759887,0,2,0,0,2
1181831973632913408,0,2,0,0,2
1091397684030726144,1,1,0,0,2
871750078834323456,0,2,0,0,2
2538264847,0,2,0,0,2
1091335011188363264,2,0,0,0,2
1181976146230964224,0,2,0,0,2
388194284,0,1,1,0,2
594490204,0,0,1,1,2
1091289875213701120,0,2,0,0,2
2537775316,0,2,0,0,2
2537940435,0,2,0,0,2
1091053992828911616,0,2,0,0,2
387749485,0,2,0,0,2
921007538,0,0,2,0,2
2537996623,1,1,0,0,2
891552525387796480,0,2,0,0,2
1182181472012132352,0,2,0,0,2
921530880,1,1,0,0,2
391920857,0,2,0,0,2
590206569,0,2,0,0,2
391985368,0,2,0,0,2
2520833916,0,2,0,0,2
396620326,0,2,0,0,2
396544587,0,2,0,0,2
2288224578,2,0,0,0,2
813675932,0,2,0,0,2
1176806863872114688,0,2,0,0,2
2518646195,1,0,0,1,2
1176861899545120768,0,2,0,0,2
584870335,0,2,0,0,2
2287898174,1,0,0,1,2
2287827636,2,0,0,0,2
1028812967301791744,0,2,0,0,2
395863181,0,2,0,0,2
1095360576501383168,0,2,0,0,2
813179593,0,2,0,0,2
914182460,2,0,0,0,2
2288557992,0,2,0,0,2
2521243466,0,2,0,0,2
914254440,0,2,0,0,2
1095238527804162048,0,2,0,0,2
869470636829048832,2,0,0,0,2
2176748647,0,2,0,0,2
1095105823838269440,0,2,0,0,2
1028371558564339712,2,0,0,0,2
395344983,0,2,0,0,2
1177583459230834688,1,1,0,0,2
395271452,1,1,0,0,2
586392096,0,2,0,0,2
869650492435054592,2,0,0,0,2
1028307588234928128,0,2,0,0,2
1094918343650410496,1,1,0,0,2
2176502963,0,2,0,0,2
1095753910793498624,0,2,0,0,2
2522568300,0,2,0,0,2
912637411,0,2,0,0,2
2175572795,0,2,0,0,2
582139491,0,0,1,1,2
868496924504055808,0,2,0,0,2
2175682025,1,0,0,1,2
868716327351066624,2,0,0,0,2
1176066269168095232,2,0,0,0,2
900348470929895424,0,2,0,0,2
582476950,0,2,0,0,2
397963803,0,2,0,0,2
582525517,0,2,0,0,2
1029429725045903360,0,2,0,0,2
1096424603952533504,0,0,2,0,2
582652851,0,2,0,0,2
397430245,0,2,0,0,2
1096379070986809344,0,0,1,1,2
396800499,1,1,0,0,2
1096353753249267712,0,2,0,0,2
2517115508,0,2,0,0,2
868827560217587712,1,1,0,0,2
1176312273226350592,0,2,0,0,2
583245442,0,2,0,0,2
868829638243627008,1,0,1,0,2
2289748982,2,0,0,0,2
583705637,0,0,0,2,2
1943806136,0,2,0,0,2
397110912,0,2,0,0,2
583808530,1,0,0,1,2
868994236607324160,0,2,0,0,2
397066908,0,2,0,0,2
2518184124,0,0,2,0,2
1177622361153167360,0,0,0,2,2
2286471475,0,2,0,0,2
1936162309,0,2,0,0,2
589171466,1,1,0,0,2
1178400217676148736,0,2,0,0,2
2284071247,0,2,0,0,2
393041796,0,2,0,0,2
870265092071460864,0,2,0,0,2
588703918,0,2,0,0,2
2526671652,0,2,0,0,2
588987505,2,0,0,0,2
823430059302195200,0,2,0,0,2
589031651,0,2,0,0,2
823403337299021824,0,2,0,0,2
1093772379094990848,0,2,0,0,2
823265675556884480,0,2,0,0,2
392779702,0,2,0,0,2
392649826,0,2,0,0,2
900735594183131136,0,2,0,0,2
393301357,0,2,0,0,2
589325722,0,2,0,0,2
589374602,0,2,0,0,2
1179098204052307968,2,0,0,0,2
392408043,0,2,0,0,2
2528321399,0,2,0,0,2
823069713584586752,0,2,0,0,2
589531145,0,2,0,0,2
1179209439087333376,0,2,0,0,2
1179267520487968768,2,0,0,0,2
918440696,1,1,0,0,2
822879860049657856,0,0,1,1,2
590078679,1,1,0,0,2
1050566926831951872,1,0,0,1,2
392070197,0,2,0,0,2
588235765,0,2,0,0,2
588192560,0,2,0,0,2
394870420,0,2,0,0,2
869915276313341952,0,2,0,0,2
2522735215,0,2,0,0,2
2286365685,2,0,0,0,2
1177886392791134208,1,1,0,0,2
1028263085235208192,0,2,0,0,2
1094693086490488832,2,0,0,0,2
1177942398082531328,0,2,0,0,2
2524202314,0,2,0,0,2
586817042,1,0,0,1,2
586826418,0,2,0,0,2
2285822340,1,0,1,0,2
812481685,0,2,0,0,2
394329646,0,2,0,0,2
2285478440,0,2,0,0,2
394060207,0,2,0,0,2
1094549297524293632,0,2,0,0,2
2284722270,0,2,0,0,2
394046651,1,1,0,0,2
812421632,1,1,0,0,2
2176955273,0,2,0,0,2
1028070267417812992,0,2,0,0,2
393988605,0,2,0,0,2
1178071145238728704,0,2,0,0,2
1178161163009347584,0,2,0,0,2
2525212288,0,2,0,0,2
587706022,0,2,0,0,2
393745532,1,1,0,0,2
1939518254,0,2,0,0,2
823464905621770240,0,2,0,0,2
393605148,0,2,0,0,2
588074830,0,2,0,0,2
596203585,0,2,0,0,2
2275901779,0,0,2,0,2
821326544228466688,1,1,0,0,2
378293481,0,2,0,0,2
1186849872223363072,0,2,0,0,2
605764344,0,2,0,0,2
378721774,0,2,0,0,2
2265031725,0,2,0,0,2
801398016,0,2,0,0,2
378641339,2,0,0,0,2
2556597078,0,2,0,0,2
378547864,0,2,0,0,2
606271072,0,2,0,0,2
1024586125594316800,0,2,0,0,2
1086703679112204288,0,2,0,0,2
874315255655964672,0,2,0,0,2
1186995869050114048,0,2,0,0,2
1052470097485414400,0,2,0,0,2
378251280,0,2,0,0,2
2556250105,0,1,1,0,2
1086639655691390976,0,2,0,0,2
800723348,1,1,0,0,2
606567090,0,2,0,0,2
2263398982,1,1,0,0,2
874533900051140608,0,2,0,0,2
1052511144945086464,0,2,0,0,2
2263102161,0,2,0,0,2
818838215771783168,0,2,0,0,2
2262988507,0,2,0,0,2
2262770630,0,2,0,0,2
377897280,1,1,0,0,2
1086168831029141504,0,1,0,1,2
1052657011991699456,0,2,0,0,2
608037041,0,2,0,0,2
1186817191578079232,0,2,0,0,2
2265746353,0,1,0,1,2
1187721297758953472,2,0,0,0,2
604189685,2,0,0,0,2
1186118152612208640,0,2,0,0,2
380226565,2,0,0,0,2
2267723629,2,0,0,0,2
1186206331939819520,0,2,0,0,2
873475578111852544,0,2,0,0,2
603805835,0,0,0,2,2
902422293770588160,0,2,0,0,2
2554358197,2,0,0,0,2
931477381,0,2,0,0,2
379849298,0,2,0,0,2
2267361039,0,1,1,0,2
802342002,0,2,0,0,2
1087314959623745536,0,2,0,0,2
604026401,0,2,0,0,2
604282110,1,0,1,0,2
873926261546070016,0,2,0,0,2
2554738410,0,1,0,1,2
931603903,2,0,0,0,2
1024795596371066880,0,2,0,0,2
2555051318,0,2,0,0,2
802295330,0,2,0,0,2
2555230924,0,2,0,0,2
379301995,0,2,0,0,2
891248213209915392,0,0,0,2,2
604575662,1,0,0,1,2
891218862754156544,1,1,0,0,2
801660452,0,2,0,0,2
1024791301257142272,0,2,0,0,2
1024773885449842688,2,0,0,0,2
604785131,0,2,0,0,2
1086041691277193216,0,2,0,0,2
377642036,2,0,0,0,2
1186097270221148160,0,2,0,0,2
1189460503028027392,0,2,0,0,2
376119767,0,2,0,0,2
1085378281396875264,0,1,1,0,2
875611563431874560,0,2,0,0,2
1024146338903031808,1,0,1,0,2
376081637,1,1,0,0,2
875678048221360128,0,2,0,0,2
610904248,0,2,0,0,2
2259151076,1,1,0,0,2
2259116760,0,2,0,0,2
2561819793,0,1,0,1,2
2561943826,2,0,0,0,2
375995557,0,2,0,0,2
375882218,1,0,1,0,2
611384516,0,2,0,0,2
1084748549055746048,2,0,0,0,2
1922524478,0,2,0,0,2
1084741356264804352,0,2,0,0,2
375530327,1,0,0,1,2
1922190679,1,0,0,1,2
1084648898331852800,0,2,0,0,2
375478326,0,2,0,0,2
375462983,2,0,0,0,2
1189649327561592832,0,2,0,0,2
890719280207196160,0,2,0,0,2
1189707749916954624,2,0,0,0,2
375225061,0,2,0,0,2
2256895632,0,2,0,0,2
1189958336059527168,0,0,0,2,2
937019420,0,0,1,1,2
937421238,0,2,0,0,2
1189106251965390848,0,0,0,2,2
796724744,0,2,0,0,2
608408052,2,0,0,0,2
1085836561600503808,0,2,0,0,2
1187809406223695872,0,2,0,0,2
608538326,2,0,0,0,2
377510483,2,0,0,0,2
377430097,0,2,0,0,2
377388030,0,2,0,0,2
934040287,0,2,0,0,2
2559943844,2,0,0,0,2
2262096681,0,2,0,0,2
874879454983720960,0,0,0,2,2
608886135,1,1,0,0,2
609022746,1,1,0,0,2
1188434351685541888,0,2,0,0,2
799705982,2,0,0,0,2
2560658347,0,2,0,0,2
1085824769721655296,0,2,0,0,2
1188815232145219584,1,1,0,0,2
376705489,0,2,0,0,2
1085813778736922624,0,2,0,0,2
376659300,0,2,0,0,2
2560742870,0,0,0,2,2
875110811949301760,0,2,0,0,2
1085643447447490560,0,2,0,0,2
1188619575165886464,2,0,0,0,2
376472551,0,2,0,0,2
798453012,0,2,0,0,2
1052934062518620160,0,2,0,0,2
1188725789853962240,0,2,0,0,2
934858074,0,2,0,0,2
818480935016534016,0,2,0,0,2
2561489272,0,2,0,0,2
931295125,0,2,0,0,2
1186012824176398336,0,2,0,0,2
386499629,2,0,0,0,2
820529770496593920,0,2,0,0,2
1183599397478682624,0,2,0,0,2
924964746,0,0,2,0,2
820675574007873536,2,0,0,0,2
1183667411616010240,0,2,0,0,2
598510548,0,2,0,0,2
1183742874824970240,1,1,0,0,2
2273007428,0,2,0,0,2
598564308,1,1,0,0,2
1183746337055088640,0,2,0,0,2
901473759940534272,0,2,0,0,2
1183787296467894272,0,2,0,0,2
820598942144614400,0,2,0,0,2
1183836180145721344,0,2,0,0,2
925401996,0,2,0,0,2
599254695,0,0,0,2,2
385242953,0,2,0,0,2
2544718447,0,2,0,0,2
599309336,0,2,0,0,2
599309550,0,2,0,0,2
925934341,0,2,0,0,2
1025803356651118592,0,2,0,0,2
2545470695,0,2,0,0,2
1051799481056972800,0,2,0,0,2
2545922261,0,2,0,0,2
1089118535949975552,0,2,0,0,2
820290392268668928,0,2,0,0,2
383757070,0,2,0,0,2
1184488447391625216,0,2,0,0,2
383706815,0,2,0,0,2
383611184,0,2,0,0,2
924747451,1,1,0,0,2
2179948113,0,2,0,0,2
383282399,0,2,0,0,2
597492011,0,2,0,0,2
872036742328500224,0,2,0,0,2
1026352181014941696,0,2,0,0,2
2275271626,0,2,0,0,2
386424840,0,2,0,0,2
2179512213,0,2,0,0,2
1051589415301251072,0,2,0,0,2
386392661,2,0,0,0,2
2540749496,0,2,0,0,2
1090219473032921088,0,2,0,0,2
901376862122893312,1,0,1,0,2
386144464,0,2,0,0,2
386124292,0,2,0,0,2
821203276913901568,1,1,0,0,2
806334157,0,2,0,0,2
1090004219975876608,0,2,0,0,2
1183469661725310976,0,2,0,0,2
1026138292817784832,0,2,0,0,2
821010707496009728,0,2,0,0,2
821008267174379520,0,2,0,0,2
385828582,2,0,0,0,2
597651670,0,2,0,0,2
1089749970025152512,1,1,0,0,2
924409160,0,2,0,0,2
924446725,0,2,0,0,2
385462342,0,2,0,0,2
2541489899,0,2,0,0,2
2273973565,0,0,2,0,2
1930558374,0,2,0,0,2
598157121,0,2,0,0,2
1026117274443210752,0,0,1,1,2
820206284792336384,0,0,0,2,2
872819940033777664,0,2,0,0,2
603531844,1,1,0,0,2
1185869017237598208,1,1,0,0,2
1088016983126290432,0,2,0,0,2
1185672061198438400,0,2,0,0,2
2550216900,0,2,0,0,2
1087964926025580544,0,2,0,0,2
381621895,0,2,0,0,2
819735688920768512,0,2,0,0,2
381491678,0,2,0,0,2
381463270,1,0,0,1,2
2268873213,0,2,0,0,2
602730123,0,2,0,0,2
381419034,0,2,0,0,2
1087719024388120576,0,2,0,0,2
1025196460672004096,0,2,0,0,2
1925926369,0,2,0,0,2
1924962948,0,2,0,0,2
928307995,0,2,0,0,2
381238954,0,2,0,0,2
602827004,1,1,0,0,2
819593447598333952,2,0,0,0,2
602863857,2,0,0,0,2
2552273633,1,1,0,0,2
602961516,2,0,0,0,2
1924694552,0,2,0,0,2
603067892,0,2,0,0,2
930513001,1,1,0,0,2
873399432791953408,1,1,0,0,2
1924497570,0,2,0,0,2
2552587548,0,2,0,0,2
891362625178681344,0,2,0,0,2
603454455,0,2,0,0,2
804092749,0,2,0,0,2
601834378,0,2,0,0,2
872844815939112960,0,2,0,0,2
601057795,0,2,0,0,2
600100515,2,0,0,0,2
383207588,0,2,0,0,2
820089057807978496,0,2,0,0,2
1088748639349100544,0,2,0,0,2
1088725091645616128,0,0,1,1,2
2180014561,2,0,0,0,2
383107299,0,2,0,0,2
1051848704569700352,0,2,0,0,2
600947822,0,2,0,0,2
383023823,0,2,0,0,2
927912349,0,2,0,0,2
1185074996777046016,2,0,0,0,2
873081689580253184,2,0,0,0,2
819971933076856832,0,2,0,0,2
819948387084726272,0,2,0,0,2
1088118878201360384,1,1,0,0,2
1926960727,1,1,0,0,2
1185208006415278080,0,1,0,1,2
928285136,0,2,0,0,2
382311817,0,2,0,0,2
1185349090797858816,0,1,1,0,2
1088336886144225280,0,2,0,0,2
2548496568,0,2,0,0,2
2549133361,0,2,0,0,2
873134472723546112,1,0,0,1,2
2270257788,0,2,0,0,2
2270111810,0,2,0,0,2
2549348929,0,2,0,0,2
1088153468056072192,0,2,0,0,2
1185513491077226496,0,2,0,0,2
2291530314,2,0,0,0,2
1096567999539093504,0,2,0,0,2
1096601042538643456,1,0,0,1,2
1167062317420302336,0,2,0,0,2
829677355165691904,0,2,0,0,2
1104625812467273728,1,1,0,0,2
1166689233970614272,0,2,0,0,2
1104615639992414208,0,2,0,0,2
829667532038606848,0,2,0,0,2
863947629981519872,0,2,0,0,2
2172038993,0,2,0,0,2
417822803,1,1,0,0,2
1167020022839091200,0,2,0,0,2
2483886429,0,2,0,0,2
824518945,0,2,0,0,2
864080912849481728,0,2,0,0,2
1167021931687817216,0,2,0,0,2
562732504,0,2,0,0,2
2314447997,0,2,0,0,2
418595232,0,2,0,0,2
1032199479640961024,1,0,1,0,2
1104316797413662720,1,1,0,0,2
864105713412472832,0,2,0,0,2
2313668359,0,2,0,0,2
563077966,0,2,0,0,2
2484700888,0,2,0,0,2
563149431,0,2,0,0,2
2484986277,0,2,0,0,2
2313247805,0,2,0,0,2
1032146236026044416,0,2,0,0,2
2313149677,2,0,0,0,2
416784280,0,2,0,0,2
1103706765558984704,0,2,0,0,2
1167411055858839552,0,2,0,0,2
1104692541981642752,1,0,0,1,2
561995208,0,0,0,2,2
2485542739,1,0,0,1,2
1105049595560771584,0,2,0,0,2
1165386857192071168,2,0,0,0,2
1165424404714704896,1,1,0,0,2
863327314414718976,0,2,0,0,2
2316907202,0,2,0,0,2
824983201,0,2,0,0,2
1047374421999190016,0,1,0,1,2
1165552907078524928,0,0,0,2,2
1960159939,2,0,0,0,2
560609578,0,2,0,0,2
2316583434,0,0,0,2,2
1105114174244507648,0,2,0,0,2
560675673,0,2,0,0,2
863415929316757504,0,2,0,0,2
1165577398986956800,0,2,0,0,2
1165611432567889920,0,2,0,0,2
561846922,0,2,0,0,2
1165656950824153088,0,2,0,0,2
2315961337,0,2,0,0,2
898913215362600960,0,2,0,0,2
1032434657940463616,1,1,0,0,2
1165906287990722560,0,2,0,0,2
1104955270243934208,0,2,0,0,2
1104930284489732096,0,2,0,0,2
1032421453747113984,0,2,0,0,2
1166281446354407424,0,2,0,0,2
561226175,1,1,0,0,2
1166358896983891968,1,1,0,0,2
829948048960786432,1,0,0,1,2
2315470860,0,2,0,0,2
863768207764725760,1,1,0,0,2
1047506496811094016,0,2,0,0,2
1958394764,0,2,0,0,2
1032555559118151680,0,2,0,0,2
903002575,2,0,0,0,2
414419233,0,2,0,0,2
2491361480,1,0,1,0,2
1168649140865241088,0,2,0,0,2
2491542836,0,0,0,2,2
1102445884195946496,0,2,0,0,2
414108131,0,2,0,0,2
2310303431,0,2,0,0,2
565581077,0,2,0,0,2
565707112,0,2,0,0,2
565716079,1,1,0,0,2
1168852381942996992,2,0,0,0,2
565799319,0,2,0,0,2
565970798,0,2,0,0,2
1031538884604243968,0,2,0,0,2
566224744,0,2,0,0,2
1047519323269545984,0,2,0,0,2
413590881,2,0,0,0,2
566428916,0,2,0,0,2
2492791872,0,2,0,0,2
413243773,0,2,0,0,2
1169025602717933568,0,2,0,0,2
566451027,0,2,0,0,2
413144376,1,1,0,0,2
413114211,0,2,0,0,2
903226201,0,2,0,0,2
1169123935256031232,0,2,0,0,2
1102176579734642688,2,0,0,0,2
566739958,0,2,0,0,2
828287685085179904,2,0,0,0,2
2493623372,0,2,0,0,2
565309929,2,0,0,0,2
864742512082259968,0,2,0,0,2
563663867,0,2,0,0,2
901688935,0,2,0,0,2
823982539,0,2,0,0,2
416321589,0,2,0,0,2
416290958,0,2,0,0,2
864260210331754496,0,2,0,0,2
1167555386821480448,0,0,2,0,2
864294704921403392,1,1,0,0,2
1167567916566548480,1,0,1,0,2
2485831940,0,0,0,2,2
2485909958,0,2,0,0,2
1103303171433263104,0,2,0,0,2
1103220829872099328,0,2,0,0,2
2311788349,0,2,0,0,2
901307394,0,2,0,0,2
1167895182924271616,2,0,0,0,2
1167989359263604736,1,1,0,0,2
414485912,0,2,0,0,2
1102921650851373056,0,2,0,0,2
1168059142596190208,0,2,0,0,2
415021686,0,2,0,0,2
564937247,0,2,0,0,2
2489385758,0,2,0,0,2
1102821739749363712,2,0,0,0,2
1102790127313661952,0,2,0,0,2
414807688,0,2,0,0,2
1168254628389015552,1,1,0,0,2
1957898342,0,2,0,0,2
899127965346168832,0,2,0,0,2
2311020200,0,2,0,0,2
828673676866383872,0,2,0,0,2
1168411705078099968,2,0,0,0,2
1105301102608764928,0,2,0,0,2
420237420,0,2,0,0,2
864996774825426944,0,2,0,0,2
2322492800,0,2,0,0,2
1163345155065171968,0,2,0,0,2
1163394262404177920,1,1,0,0,2
424859182,0,2,0,0,2
1108054203384115200,0,0,0,2,2
2473105433,0,1,1,0,2
1163430178996903936,0,2,0,0,2
861569252029067264,1,0,1,0,2
831319556635385856,0,2,0,0,2
1163493811592544256,1,0,1,0,2
861587122834288640,0,2,0,0,2
2322646400,0,2,0,0,2
2322519642,0,2,0,0,2
554938898,0,2,0,0,2
2322514568,0,2,0,0,2
1163523436339224576,0,2,0,0,2
828541104,0,2,0,0,2
831188068761796608,2,0,0,0,2
424084046,0,0,0,2,2
424047059,0,2,0,0,2
894659348,0,2,0,0,2
2322479655,0,2,0,0,2
2474284572,0,2,0,0,2
2322152671,1,0,1,0,2
555302942,0,2,0,0,2
1046643636346265600,0,2,0,0,2
2321967820,1,1,0,0,2
861911624453681152,0,2,0,0,2
831129010902016000,2,0,0,0,2
831091837775527936,0,2,0,0,2
1107305772642435072,0,2,0,0,2
893691019,0,2,0,0,2
425081409,0,2,0,0,2
423514732,0,2,0,0,2
861288012486934528,0,2,0,0,2
1108498349982994432,0,2,0,0,2
2470479708,0,2,0,0,2
1964774448,0,2,0,0,2
2324171570,0,2,0,0,2
1162516638081650688,0,2,0,0,2
552958812,0,2,0,0,2
426262515,1,0,0,1,2
1108465804528504832,0,2,0,0,2
553056081,0,2,0,0,2
1108402467572572160,2,0,0,0,2
2471162522,0,2,0,0,2
893467525220093952,0,2,0,0,2
1033412224734253056,0,2,0,0,2
2471431628,2,0,0,0,2
1162679696045334528,0,2,0,0,2
831492799245742080,0,2,0,0,2
1108379680632131584,0,2,0,0,2
861385956854726656,0,2,0,0,2
1162704181721018368,0,2,0,0,2
1162762778362490880,0,2,0,0,2
553697692,0,2,0,0,2
553730797,0,2,0,0,2
425640015,0,2,0,0,2
892726897,0,2,0,0,2
828612553,0,2,0,0,2
1163014814030974976,0,2,0,0,2
2323544388,0,2,0,0,2
1108152627534221312,0,1,0,1,2
893571986,0,2,0,0,2
1163200486234718208,1,1,0,0,2
1033246093046247424,2,0,0,0,2
423429995,0,2,0,0,2
560086917,0,2,0,0,2
863312994041815040,0,2,0,0,2
421428639,0,2,0,0,2
1047195083085414400,0,2,0,0,2
421388173,1,1,0,0,2
1165070556393287680,0,2,0,0,2
893213856704720896,0,2,0,0,2
830479996439392256,0,2,0,0,2
1105868735812796416,0,2,0,0,2
1165182853019295744,0,1,0,1,2
1105860244544999424,0,2,0,0,2
1105801574528348160,0,2,0,0,2
1047355522901594112,0,2,0,0,2
2478740814,0,2,0,0,2
2317883041,0,2,0,0,2
559366154,0,2,0,0,2
420862132,0,2,0,0,2
1106132560655077376,1,0,1,0,2
420850899,1,1,0,0,2
2317402226,1,0,0,1,2
897439262,0,2,0,0,2
863313044604059648,0,2,0,0,2
1105410255201230848,0,2,0,0,2
1105394223442845696,0,2,0,0,2
1105369790301040640,0,2,0,0,2
420589875,0,2,0,0,2
1105363277918490624,2,0,0,0,2
420541403,0,2,0,0,2
1960502118,2,0,0,0,2
863324404952043520,0,2,0,0,2
420384268,0,2,0,0,2
1165307053415387136,0,1,0,1,2
421470944,0,2,0,0,2
898821241284558848,0,2,0,0,2
1033245139358154752,0,2,0,0,2
422452100,0,2,0,0,2
2476118811,1,0,1,0,2
2476383025,0,2,0,0,2
2476454455,0,2,0,0,2
1164207180008108032,0,0,2,0,2
862127778954706944,0,2,0,0,2
1033081634998951936,0,2,0,0,2
556684465,0,2,0,0,2
1164410372180156416,0,2,0,0,2
2320127743,0,2,0,0,2
556830985,0,2,0,0,2
1106927792099418112,0,2,0,0,2
556860953,0,2,0,0,2
1961621070,0,1,1,0,2
862528780891500544,0,2,0,0,2
422401928,0,2,0,0,2
558319107,0,2,0,0,2
1032934411761672192,0,2,0,0,2
862537170422079488,1,1,0,0,2
422177633,0,2,0,0,2
830645044059193344,0,2,0,0,2
826144033,0,2,0,0,2
557379867,0,2,0,0,2
862614947167174656,0,2,0,0,2
1106416324157292544,0,0,0,2,2
893332687481647104,0,2,0,0,2
1106267738010517504,0,2,0,0,2
421901165,0,2,0,0,2
557940446,0,2,0,0,2
896733192,0,2,0,0,2
825904458,1,1,0,0,2
1102171548755152896,0,2,0,0,2
1102155961467322368,0,0,1,1,2
2513855172,1,1,0,0,2
2508015318,0,2,0,0,2
825945322635419648,1,1,0,0,2
908525905,2,0,0,0,2
908645209,2,0,0,0,2
908673595,0,2,0,0,2
402954222,0,2,0,0,2
2507524923,0,2,0,0,2
576162066,0,2,0,0,2
1173484394352381952,0,2,0,0,2
402811979,1,1,0,0,2
867097801859227648,0,2,0,0,2
2297720286,0,2,0,0,2
1099067827573743616,0,2,0,0,2
576263202,0,2,0,0,2
908846821,0,2,0,0,2
900245837686734848,0,1,1,0,2
2298502525,2,0,0,0,2
1048639663358050304,0,2,0,0,2
825678947115470848,0,2,0,0,2
909352141,0,2,0,0,2
2508751320,0,2,0,0,2
2508944062,0,1,0,1,2
825603953173860352,0,2,0,0,2
402024978,0,2,0,0,2
2297357828,0,2,0,0,2
576870117,0,2,0,0,2
1048765178009927680,0,2,0,0,2
401928200,0,2,0,0,2
577006202,0,2,0,0,2
1173915132239519744,0,2,0,0,2
825404128729956352,0,2,0,0,2
403363828,0,2,0,0,2
1048610858585153536,2,0,0,0,2
867413056346783744,2,0,0,0,2
907638492,0,0,2,0,2
574328381,0,2,0,0,2
1172676312017846272,0,2,0,0,2
574335090,0,1,1,0,2
907172467,1,0,1,0,2
404755853,1,1,0,0,2
826342988896993280,0,2,0,0,2
404601976,2,0,0,0,2
1030359667640344576,0,2,0,0,2
574374274,0,2,0,0,2
1172744519613177856,2,0,0,0,2
1100046375079809024,0,2,0,0,2
2299713622,0,2,0,0,2
1947734402,0,2,0,0,2
899928504174874624,0,2,0,0,2
1172879390021234688,0,2,0,0,2
1099419877226528768,0,2,0,0,2
1099972871311499264,0,2,0,0,2
1099971805811560448,1,1,0,0,2
574835371,0,2,0,0,2
575015377,0,2,0,0,2
892809079952998400,1,1,0,0,2
866967756289265664,0,2,0,0,2
818351438,0,2,0,0,2
575297079,2,0,0,0,2
826058295060398080,0,2,0,0,2
403634902,1,1,0,0,2
1099727858308501504,2,0,0,0,2
1173117403649019904,0,2,0,0,2
892703320137191424,0,1,1,0,2
575648685,1,1,0,0,2
1098613866500632576,0,2,0,0,2
825349432149409792,0,2,0,0,2
2504740039,2,0,0,0,2
399581321,0,2,0,0,2
867741943404670976,0,2,0,0,2
1097500320350040064,0,0,0,2,2
580021259,0,2,0,0,2
2512291729,0,2,0,0,2
2294650958,0,2,0,0,2
1097205863377448960,0,2,0,0,2
2512327647,0,2,0,0,2
868089552631738368,2,0,0,0,2
2512824441,1,1,0,0,2
1097124895509671936,0,2,0,0,2
400008247,0,2,0,0,2
1097071157612855296,1,1,0,0,2
1175522352282648576,0,2,0,0,2
2512856729,0,2,0,0,2
1175618525789970432,0,2,0,0,2
824768822238466048,0,2,0,0,2
2293949666,0,2,0,0,2
580965349,0,2,0,0,2
399350656,0,2,0,0,2
2293292816,1,1,0,0,2
1096699474531868672,1,0,1,0,2
399287609,0,2,0,0,2
2513397590,0,2,0,0,2
868365732236623872,1,0,0,1,2
868368934608809984,0,2,0,0,2
2292986189,0,2,0,0,2
911049380,0,2,0,0,2
868384664897105920,0,2,0,0,2
581798082,0,2,0,0,2
398931951,0,2,0,0,2
2295514968,0,2,0,0,2
579523957,1,0,1,0,2
1173995794845691904,2,0,0,0,2
2174883053,2,0,0,0,2
577226021,0,2,0,0,2
1098526239181070336,2,0,0,0,2
2296546845,0,2,0,0,2
577715025,0,2,0,0,2
867425779411537920,0,2,0,0,2
1174264241043496960,0,2,0,0,2
825229782367555584,0,2,0,0,2
1098215894679879680,0,2,0,0,2
2510990164,0,2,0,0,2
1098207936978014208,2,0,0,0,2
578125964,0,2,0,0,2
401318665,2,0,0,0,2
1174299161723846656,0,2,0,0,2
825185422603083776,0,2,0,0,2
825093693803749376,2,0,0,0,2
400367091,0,2,0,0,2
1098189041315438592,1,1,0,0,2
401015705,0,2,0,0,2
2511284990,0,2,0,0,2
1098180671686823936,0,2,0,0,2
910112166,0,2,0,0,2
2296277460,0,0,1,1,2
578494066,0,2,0,0,2
1945095770,0,2,0,0,2
2295876258,2,0,0,0,2
578962728,0,2,0,0,2
1048968615142330368,0,2,0,0,2
910331444,0,2,0,0,2
867661083451904000,0,0,1,1,2
2512218183,0,2,0,0,2
2300039771,0,2,0,0,2
2300058518,1,1,0,0,2
822823202,0,2,0,0,2
2303538931,0,2,0,0,2
822088208,0,1,1,0,2
1101188217028702208,0,2,0,0,2
2495470235,0,2,0,0,2
1101166348363800576,0,2,0,0,2
2495569627,0,2,0,0,2
2305249428,0,2,0,0,2
821509981,0,2,0,0,2
827945671718268928,0,1,0,1,2
1169942684078759936,0,2,0,0,2
827942758409134080,0,2,0,0,2
1170014684533145600,0,2,0,0,2
1170065413079625728,0,2,0,0,2
569991966,0,2,0,0,2
410147949,0,2,0,0,2
2303514812,0,2,0,0,2
1101429364191834112,1,1,0,0,2
827857899401539584,0,0,0,2,2
409884949,1,1,0,0,2
1100953584017932288,0,2,0,0,2
1170212552707465216,2,0,0,0,2
866099823832858624,0,2,0,0,2
409782748,0,2,0,0,2
1170222571633037312,0,1,0,1,2
570465284,0,2,0,0,2
409731864,0,2,0,0,2
1100866883270529024,0,2,0,0,2
570605546,0,2,0,0,2
1170321200666611712,0,2,0,0,2
1100860319105208320,0,2,0,0,2
1170402800909660160,0,2,0,0,2
410842864,0,2,0,0,2
899297297628057600,0,2,0,0,2
570704674,0,2,0,0,2
1101711316509691904,0,2,0,0,2
1102042230066417664,0,2,0,0,2
1102041671695515648,0,2,0,0,2
2308523157,0,2,0,0,2
1169185705521754112,0,2,0,0,2
822753624,0,2,0,0,2
2308082295,0,2,0,0,2
899264623735562240,0,2,0,0,2
412296550,0,2,0,0,2
1101776466763763712,0,2,0,0,2
567705357,0,2,0,0,2
1101763048061263872,2,0,0,0,2
1169222345862594560,0,2,0,0,2
2307880661,0,2,0,0,2
567961199,1,0,0,1,2
411672378,0,2,0,0,2
1169589145070637056,0,1,1,0,2
568067226,0,2,0,0,2
903641881,0,2,0,0,2
865199261918662656,0,2,0,0,2
1169508304114061312,0,2,0,0,2
2494776662,0,2,0,0,2
568181270,0,2,0,0,2
411379338,0,0,0,2,2
1101528839858147328,0,0,1,1,2
865234528784314368,0,2,0,0,2
822132590,0,2,0,0,2
2306612902,0,2,0,0,2
2306340081,0,2,0,0,2
828094127015337984,0,2,0,0,2
1169576219542740992,0,2,0,0,2
827770303832940544,0,2,0,0,2
2303097804,0,2,0,0,2
574193170,0,2,0,0,2
1948985102,0,2,0,0,2
826988616589021184,2,0,0,0,2
2501462364,0,2,0,0,2
2502045193,0,2,0,0,2
1171490926398586880,0,1,1,0,2
1171571613785034752,0,2,0,0,2
1171641363085107200,0,2,0,0,2
819176581,0,1,0,1,2
1171655142334226432,1,1,0,0,2
2300800376,0,2,0,0,2
826749054109487104,0,2,0,0,2
405675397,0,2,0,0,2
573380680,0,2,0,0,2
866670045237305344,1,0,0,1,2
573636808,0,2,0,0,2
1171780706000936960,0,1,1,0,2
572509496,2,0,0,0,2
1171835716764098560,0,2,0,0,2
1171919448699101184,0,2,0,0,2
1171951345949130752,0,2,0,0,2
2502513787,0,2,0,0,2
826644970106867712,0,2,0,0,2
899655330476564480,0,2,0,0,2
405143038,0,0,0,2,2
405131498,0,2,0,0,2
2300522616,0,2,0,0,2
826522836185530368,0,2,0,0,2
573906893,2,0,0,0,2
2504216027,1,1,0,0,2
573942201,0,2,0,0,2
1030493296089591808,0,2,0,0,2
572592173,0,2,0,0,2
2301392263,0,2,0,0,2
1100801030646685696,0,2,0,0,2
2173977198,0,2,0,0,2
570763732,0,2,0,0,2
2497997270,0,2,0,0,2
2498291852,0,2,0,0,2
408686208,1,1,0,0,2
827685156077060096,0,2,0,0,2
408368572,0,2,0,0,2
570859668,0,2,0,0,2
571115237,1,1,0,0,2
827674568848396288,0,2,0,0,2
827615417577271296,0,2,0,0,2
1170797712700321792,0,2,0,0,2
571584260,0,2,0,0,2
1170909674268348416,0,2,0,0,2
827494077117644800,0,1,0,1,2
2499408814,0,2,0,0,2
406609209,0,2,0,0,2
1171013495384657920,0,2,0,0,2
2301905315,0,1,1,0,2
1951601112,0,2,0,0,2
571851042,0,1,1,0,2
2499710582,0,2,0,0,2
827386779816693760,1,0,0,1,2
1048216526225100800,0,2,0,0,2
905126540,0,2,0,0,2
819194600,0,2,0,0,2
406819338,0,1,0,1,2
2301675037,0,2,0,0,2
2301660618,0,2,0,0,2
1100551024992022528,0,2,0,0,2
1171312506649755648,1,0,0,1,2
866868707238326272,2,0,0,0,2
795970690855956480,0,2,0,0,2
1209249979744817152,0,2,0,0,2
81296132,0,2,0,0,2
1367560812043382784,0,2,0,0,2
3232492459,0,2,0,0,2
1367437530644250624,2,0,0,0,2
80840832,1,0,0,1,2
80841702,0,2,0,0,2
3231974736,2,0,0,0,2
705137056528404480,0,2,0,0,2
81064164,0,2,0,0,2
3231782157,1,1,0,0,2
81251120,0,2,0,0,2
1331564407,0,2,0,0,2
1367841892600217600,0,2,0,0,2
1366586863230746624,0,2,0,0,2
81538107,2,0,0,0,2
964704328559812608,1,1,0,0,2
3230682440,0,2,0,0,2
705297793339035648,0,2,0,0,2
1330901161,2,0,0,0,2
1365755736240910336,2,0,0,0,2
1330388334,0,2,0,0,2
3230065184,2,0,0,0,2
1365346475476013056,0,2,0,0,2
1367591713599082496,1,1,0,0,2
1367853587553021952,0,2,0,0,2
82058244,0,2,0,0,2
79912419,1,0,0,1,2
1369724532680974336,0,2,0,0,2
79417889,0,2,0,0,2
1610925913,0,2,0,0,2
79682039,0,2,0,0,2
3233925233,1,0,1,0,2
1369387490205966336,0,2,0,0,2
1369300408871583744,0,2,0,0,2
1369203336998699008,0,2,0,0,2
1369178304952078336,0,0,0,2,2
3233840826,1,0,1,0,2
79944799,0,2,0,0,2
3232495902,0,2,0,0,2
79976594,0,2,0,0,2
1368805920193589248,0,2,0,0,2
1368689203907731456,0,2,0,0,2
1368686214912630784,0,2,0,0,2
704665010828607488,0,2,0,0,2
3233573674,0,0,2,0,2
704665705715798016,0,2,0,0,2
80284702,0,0,2,0,2
704742569725440000,2,0,0,0,2
704939166023479296,0,2,0,0,2
82004213,0,2,0,0,2
1365077826685165568,0,2,0,0,2
1361325279004811264,0,2,0,0,2
84313362,0,1,1,0,2
1363047196925517824,0,2,0,0,2
705818966141239296,0,2,0,0,2
1362760339687809024,0,2,0,0,2
705835780426604544,0,2,0,0,2
705858445166170112,0,2,0,0,2
84049913,0,2,0,0,2
84057548,0,2,0,0,2
1362367384913330176,0,2,0,0,2
1328832480,0,2,0,0,2
3226024956,0,2,0,0,2
706008808951259136,0,2,0,0,2
83674382,0,2,0,0,2
3225789433,0,0,1,1,2
926842127505555456,0,2,0,0,2
965120903943106560,2,0,0,0,2
1362043156485783552,0,2,0,0,2
1361978435829178368,1,1,0,0,2
84509823,0,2,0,0,2
706173704728920064,2,0,0,0,2
84532613,0,2,0,0,2
965162396812808192,0,2,0,0,2
84776076,0,0,2,0,2
83705507,0,2,0,0,2
83482072,0,2,0,0,2
3229737038,0,2,0,0,2
3229112695,1,1,0,0,2
82198012,0,2,0,0,2
705376673953222656,0,2,0,0,2
1364903012532178944,0,2,0,0,2
964789631660195840,0,2,0,0,2
1364691963715276800,0,2,0,0,2
82375507,0,2,0,0,2
705471811115360256,0,2,0,0,2
1364621804946526208,0,1,0,1,2
1364566276362932224,0,2,0,0,2
3229427342,0,2,0,0,2
3228805124,1,1,0,0,2
1363423669960118272,0,2,0,0,2
82585713,0,2,0,0,2
1364237408145969152,1,1,0,0,2
1612653150,0,2,0,0,2
82793717,0,2,0,0,2
3228208312,0,2,0,0,2
82932826,0,2,0,0,2
83082103,0,0,2,0,2
1363926532188610560,1,1,0,0,2
83256071,0,2,0,0,2
1363492728445702144,0,2,0,0,2
1369783807931412480,2,0,0,0,2
1369869152211509248,0,2,0,0,2
1370033889117409280,0,2,0,0,2
703032033644257280,2,0,0,0,2
76067735,0,2,0,0,2
1376236613592735744,0,0,2,0,2
3241737535,0,2,0,0,2
702959722626830336,0,2,0,0,2
76248429,0,2,0,0,2
3241501164,1,1,0,0,2
1375902216117235712,0,2,0,0,2
1375886729568129024,2,0,0,0,2
1375854638721720320,0,2,0,0,2
1375537981591719936,0,1,0,1,2
1375318157716512768,0,2,0,0,2
1376377036579684352,2,0,0,0,2
76590996,0,2,0,0,2
3241094393,0,2,0,0,2
76652581,1,0,1,0,2
76679287,0,2,0,0,2
963984343893815296,0,2,0,0,2
703213504828989440,0,2,0,0,2
703232296099385344,0,2,0,0,2
76742643,0,2,0,0,2
1335538968,0,2,0,0,2
703456900243963904,0,2,0,0,2
1607983273,1,0,0,1,2
702858377630765056,1,1,0,0,2
704520143343390720,0,0,2,0,2
3244141867,0,2,0,0,2
1378412647654203392,0,1,0,1,2
927825280709914624,0,2,0,0,2
3245018556,0,2,0,0,2
701889242792914944,0,2,0,0,2
75430058,0,2,0,0,2
1377925265301467136,0,2,0,0,2
75521105,0,2,0,0,2
1377853283788800000,0,0,0,2,2
75578746,0,2,0,0,2
702080216563376128,0,2,0,0,2
3244118114,0,2,0,0,2
3242918955,0,2,0,0,2
963785063363219456,0,1,0,1,2
75676153,2,0,0,0,2
1376920082723397632,0,2,0,0,2
702304395023806464,1,0,0,1,2
702446190386913280,0,2,0,0,2
1376815674660683776,0,2,0,0,2
702733498877091840,0,2,0,0,2
1376517477790842880,0,2,0,0,2
75965362,2,0,0,0,2
1607823350,0,2,0,0,2
76892585,1,1,0,0,2
3240471392,0,2,0,0,2
77069220,0,2,0,0,2
1371468588796805120,0,2,0,0,2
3237880218,0,2,0,0,2
3237784802,1,0,1,0,2
78254739,0,0,2,0,2
704269963998195712,0,2,0,0,2
78346022,0,1,0,1,2
1333478191,0,0,2,0,2
1371563990225022976,0,2,0,0,2
78554747,0,2,0,0,2
78566492,1,0,0,1,2
1371484303000018944,0,2,0,0,2
78713167,0,2,0,0,2
1374416147508994048,0,2,0,0,2
3236198922,0,2,0,0,2
78739450,0,2,0,0,2
78790147,0,0,1,1,2
3235865408,0,2,0,0,2
927455649490964480,0,2,0,0,2
1370670202845822976,0,2,0,0,2
3235257871,0,2,0,0,2
1370424170773876736,0,2,0,0,2
1370311148856299520,0,2,0,0,2
3235230751,0,1,1,0,2
3237930984,1,1,0,0,2
1372302284957184000,0,2,0,0,2
1372471264376360960,0,0,0,2,2
1372513756396335104,0,0,0,2,2
3240104907,0,2,0,0,2
3239517059,0,2,0,0,2
1608669456,0,2,0,0,2
1374132209871912960,2,0,0,0,2
1334751630,0,2,0,0,2
77448185,2,0,0,0,2
1334596688,1,1,0,0,2
3239002378,0,1,0,1,2
77479921,0,2,0,0,2
1609114472,0,2,0,0,2
927506489513611264,2,0,0,0,2
703909300771622912,0,2,0,0,2
1609796053,0,2,0,0,2
1372902332757774336,0,2,0,0,2
1372866161746997248,1,1,0,0,2
704015847094784000,1,1,0,0,2
77973889,1,1,0,0,2
1372693170270666752,0,0,0,2,2
1372614101332078592,2,0,0,0,2
77986283,0,2,0,0,2
1372565779225382912,0,2,0,0,2
3224168702,0,2,0,0,2
1361302841026035712,0,2,0,0,2
1350457485350592512,0,2,0,0,2
3191421652,0,2,0,0,2
93607917,0,2,0,0,2
1353995335513870336,0,2,0,0,2
3191713122,1,1,0,0,2
1353990300331552768,0,2,0,0,2
93872975,0,2,0,0,2
966612699621806080,0,2,0,0,2
1353916382212218880,0,0,0,2,2
94024072,0,1,0,1,2
94030271,0,2,0,0,2
710245966113165312,0,2,0,0,2
1353834145626148864,2,0,0,0,2
3191801521,0,2,0,0,2
1319079216,0,2,0,0,2
94193598,0,2,0,0,2
94201838,0,2,0,0,2
94293106,0,2,0,0,2
1353686718646341632,0,2,0,0,2
1353563289482047488,0,2,0,0,2
1353547237184466944,0,2,0,0,2
1353542166228905984,1,0,1,0,2
966718138980225024,0,2,0,0,2
94561541,1,1,0,0,2
93504885,0,2,0,0,2
3191821890,2,0,0,0,2
1353350782180085760,0,0,1,1,2
92305455,0,2,0,0,2
1355444494863372288,1,1,0,0,2
91804756,0,2,0,0,2
92032498,0,2,0,0,2
3194589969,0,2,0,0,2
1354791116160327680,0,2,0,0,2
3194395741,0,2,0,0,2
1354755165556011008,0,2,0,0,2
92166751,0,2,0,0,2
92211478,2,0,0,0,2
92260294,0,0,0,2,2
966414358833180672,0,2,0,0,2
3191958167,1,0,1,0,2
92472116,0,2,0,0,2
92602090,0,2,0,0,2
710175745730068480,0,2,0,0,2
92903533,0,2,0,0,2
1354116211253141504,1,1,0,0,2
92975960,0,2,0,0,2
92999280,2,0,0,0,2
93035292,1,1,0,0,2
93044427,0,2,0,0,2
93142555,0,2,0,0,2
1353358307507933184,0,2,0,0,2
94725954,0,2,0,0,2
1327718143,0,2,0,0,2
3184299522,0,2,0,0,2
3185767945,1,1,0,0,2
1351993606849114112,0,2,0,0,2
1351992227199856640,0,2,0,0,2
3185481168,0,2,0,0,2
1620363414,0,2,0,0,2
1351836292695339008,0,2,0,0,2
966964254069919744,0,2,0,0,2
3184619617,2,0,0,0,2
1351732444299456512,0,2,0,0,2
1620560431,0,2,0,0,2
1351576282492936192,0,2,0,0,2
1352162415014719488,1,1,0,0,2
1620598903,0,2,0,0,2
1620628812,0,0,0,2,2
711386585502261248,0,2,0,0,2
97006770,0,2,0,0,2
97037616,0,2,0,0,2
925977362302455808,0,2,0,0,2
3182045930,0,2,0,0,2
1350799029110714368,2,0,0,0,2
925976911100108800,2,0,0,0,2
711871919260217344,0,2,0,0,2
3185949890,1,1,0,0,2
1317060644,1,0,1,0,2
1353276969979424768,1,1,0,0,2
710592465191841792,0,2,0,0,2
3189858666,0,2,0,0,2
1353162437554556928,0,0,1,1,2
966734924261810176,0,2,0,0,2
94799541,0,2,0,0,2
1619773213,0,2,0,0,2
94973754,0,2,0,0,2
1352890412743053312,0,2,0,0,2
1352883826821881856,0,2,0,0,2
1352865192879792128,0,2,0,0,2
95052610,0,2,0,0,2
95298042,0,2,0,0,2
3186308226,1,1,0,0,2
1317969085,0,2,0,0,2
1352672348013535232,0,2,0,0,2
710694663972212736,0,2,0,0,2
1317940495,0,2,0,0,2
95407913,0,2,0,0,2
95559013,2,0,0,0,2
95618688,0,2,0,0,2
1352492250035593216,0,2,0,0,2
1352442675857940480,0,2,0,0,2
95649818,1,1,0,0,2
709273288619393024,0,2,0,0,2
1355484083275640832,0,2,0,0,2
91627522,0,2,0,0,2
1358424184263614464,2,0,0,0,2
1359391219147800576,0,2,0,0,2
965615500758745088,0,2,0,0,2
707465914615250944,0,2,0,0,2
707510499953549312,0,2,0,0,2
3215961051,0,1,0,1,2
87535320,0,2,0,0,2
707516837156802560,0,2,0,0,2
87710683,0,1,0,1,2
87760374,1,1,0,0,2
1358562149598117888,0,2,0,0,2
1358405638020231168,0,2,0,0,2
86841018,0,0,2,0,2
88116058,0,2,0,0,2
3212013329,0,2,0,0,2
1358239454943711232,1,1,0,0,2
88296327,0,2,0,0,2
707674138362511360,2,0,0,0,2
1324561650,0,2,0,0,2
88397036,0,2,0,0,2
926585760425406464,1,0,1,0,2
88435914,0,2,0,0,2
1324079822,0,2,0,0,2
707292708675653632,0,2,0,0,2
3219063571,0,2,0,0,2
91615098,2,0,0,0,2
1360841707001159680,0,1,0,1,2
84959335,0,2,0,0,2
3223610215,0,2,0,0,2
85061358,1,1,0,0,2
85122161,0,1,1,0,2
85243332,1,0,1,0,2
706495547163676672,0,2,0,0,2
706518419852537856,0,2,0,0,2
1360916317788921856,0,2,0,0,2
85332527,0,2,0,0,2
85387319,1,1,0,0,2
1360527856099422208,0,2,0,0,2
1359560232800817152,0,2,0,0,2
1360333717198180352,0,2,0,0,2
1614827450,0,2,0,0,2
86004635,0,2,0,0,2
3220397821,0,2,0,0,2
1614976040,0,2,0,0,2
86280935,0,2,0,0,2
1359850062340255744,1,1,0,0,2
1359844132017958912,1,1,0,0,2
86373402,1,1,0,0,2
1359816851069501440,0,0,0,2,2
3207704602,0,2,0,0,2
1357865749126254592,0,2,0,0,2
707838440197349376,0,2,0,0,2
926373334027259904,0,2,0,0,2
90160373,0,2,0,0,2
1323146101,0,0,0,2,2
1356579023913185280,0,2,0,0,2
966010049251430400,1,1,0,0,2
90607993,0,2,0,0,2
90711416,0,2,0,0,2
1617818378,0,2,0,0,2
1322469492,0,2,0,0,2
90985345,1,0,1,0,2
966294844049121280,0,2,0,0,2
91275795,1,1,0,0,2
88635690,0,2,0,0,2
3196044211,1,0,0,1,2
1617963218,2,0,0,0,2
1355813541777817600,0,0,2,0,2
966338360557043712,0,2,0,0,2
91506061,0,2,0,0,2
91512239,0,2,0,0,2
1355563665777426432,2,0,0,0,2
1320838519,2,0,0,0,2
3195241537,1,0,1,0,2
91591908,2,0,0,0,2
1356867613939404800,0,2,0,0,2
1356869364130205696,2,0,0,0,2
89965797,0,2,0,0,2
89932468,0,2,0,0,2
1357758344841334784,0,2,0,0,2
88701731,0,2,0,0,2
707839540380180480,1,1,0,0,2
1357749240450011136,0,2,0,0,2
1357668791434563584,0,0,0,2,2
3203975255,0,2,0,0,2
89142678,0,2,0,0,2
707971976263032832,0,2,0,0,2
89154205,1,0,0,1,2
89233291,0,2,0,0,2
1357359215132643328,0,2,0,0,2
708161179093315584,2,0,0,0,2
708203974155837440,2,0,0,0,2
89456022,0,0,0,2,2
3201126845,0,2,0,0,2
89496754,0,2,0,0,2
89679765,0,2,0,0,2
3199021159,2,0,0,0,2
89761831,0,2,0,0,2
1616984160,0,2,0,0,2
1356982514095685632,0,2,0,0,2
701783761097195520,2,0,0,0,2
75216978,0,2,0,0,2
75198812,0,2,0,0,2
61897267,0,2,0,0,2
1396171720562601984,0,2,0,0,2
61661216,0,2,0,0,2
4886178938,0,2,0,0,2
4886680834,0,2,0,0,2
61737228,1,1,0,0,2
959491570172071936,0,2,0,0,2
61808321,0,2,0,0,2
61859409,0,2,0,0,2
1395693378617106432,0,2,0,0,2
959497241093464064,0,1,0,1,2
61913539,0,2,0,0,2
959482722380124160,0,2,0,0,2
4887639045,0,2,0,0,2
62017034,0,2,0,0,2
3290204804,2,0,0,0,2
1595431500,0,0,0,2,2
1395047755093995520,0,2,0,0,2
1394987694162432000,0,2,0,0,2
62261859,0,2,0,0,2
1394915644508938240,0,2,0,0,2
62404274,0,2,0,0,2
3289856105,0,2,0,0,2
3291240946,2,0,0,0,2
61561276,0,2,0,0,2
3289817260,0,2,0,0,2
4883307291,0,2,0,0,2
1397600128450633728,0,2,0,0,2
3293796279,2,0,0,0,2
3293730065,0,2,0,0,2
60653225,0,2,0,0,2
60830036,0,2,0,0,2
1361447641,2,0,0,0,2
4881953963,0,2,0,0,2
959382451423412224,0,2,0,0,2
60945991,0,2,0,0,2
959452405178957824,0,2,0,0,2
61052085,1,1,0,0,2
61541315,0,2,0,0,2
1396795352972505088,0,2,0,0,2
3292510876,0,2,0,0,2
1594972069,0,2,0,0,2
61180850,0,2,0,0,2
61190093,0,2,0,0,2
1360581206,1,0,1,0,2
1396726422111064064,0,2,0,0,2
1396712486825431040,0,2,0,0,2
4885618131,0,2,0,0,2
1396344113495166976,0,2,0,0,2
1394854676026347520,0,0,0,2,2
62538554,0,2,0,0,2
3245417541,0,2,0,0,2
3281929639,0,2,0,0,2
1357431937,0,2,0,0,2
64039682,0,2,0,0,2
1392863950560141312,2,0,0,0,2
1356957043,0,2,0,0,2
1356896318,0,2,0,0,2
1356811640,0,1,0,1,2
1392554462011559936,2,0,0,0,2
64377390,0,2,0,0,2
1598851068,0,2,0,0,2
3283300861,1,1,0,0,2
928941709400125440,0,2,0,0,2
3285079272,1,1,0,0,2
64658974,0,2,0,0,2
4898347372,0,2,0,0,2
4898436568,0,2,0,0,2
64744912,2,0,0,0,2
1392152490909437952,2,0,0,0,2
1392149448004816896,2,0,0,0,2
960763469724340224,2,0,0,0,2
64975890,1,1,0,0,2
64998253,0,0,2,0,2
4899214533,0,2,0,0,2
960189338859524096,0,2,0,0,2
1393485411645853696,2,0,0,0,2
62596346,0,2,0,0,2
63198594,0,1,0,1,2
4891952030,0,2,0,0,2
1394660352076369920,2,0,0,0,2
62765213,0,2,0,0,2
62828269,0,2,0,0,2
1394413853673345024,0,2,0,0,2
1394383673689001984,0,2,0,0,2
3289072098,1,0,0,1,2
1394302122171289600,0,2,0,0,2
63125168,0,2,0,0,2
3288841923,0,2,0,0,2
63200840,0,2,0,0,2
63699278,0,1,1,0,2
1358972346,0,2,0,0,2
3288364302,0,2,0,0,2
63317972,2,0,0,0,2
4893362397,0,2,0,0,2
3287185327,2,0,0,0,2
3287184386,1,1,0,0,2
1393636389313409024,0,2,0,0,2
1597077799,0,2,0,0,2
63660694,1,0,0,1,2
1597220010,0,2,0,0,2
3293841893,0,2,0,0,2
60491535,0,2,0,0,2
1397666832044068864,1,0,1,0,2
1403925687208120320,0,2,0,0,2
56886532,0,2,0,0,2
3298583057,0,2,0,0,2
56964184,0,2,0,0,2
1404543145577271296,0,2,0,0,2
56999447,0,2,0,0,2
1404510515762581504,0,2,0,0,2
4870954187,0,2,0,0,2
1366941631,0,2,0,0,2
1366914456,0,2,0,0,2
57126357,0,2,0,0,2
929829523016871936,0,2,0,0,2
1404978186278952960,0,2,0,0,2
3297724886,0,1,0,1,2
1403718304213225472,0,2,0,0,2
958711827369664512,0,2,0,0,2
57291556,2,0,0,0,2
929804322598281216,0,2,0,0,2
57351586,0,2,0,0,2
57419921,0,2,0,0,2
57426567,1,1,0,0,2
1403182124199411712,0,2,0,0,2
1403003082150088704,0,2,0,0,2
1404933060877979648,0,2,0,0,2
56677858,2,0,0,0,2
60369231,0,2,0,0,2
3300222131,0,2,0,0,2
958164531561218048,0,2,0,0,2
3300790079,0,2,0,0,2
3300679585,0,2,0,0,2
1406965120098394112,0,2,0,0,2
55811884,0,2,0,0,2
930001557973647360,1,1,0,0,2
55864870,1,1,0,0,2
3300340886,2,0,0,0,2
55976957,0,2,0,0,2
55982203,0,2,0,0,2
1406147728137199616,0,2,0,0,2
56672909,0,2,0,0,2
56076684,0,2,0,0,2
56235675,0,2,0,0,2
56473208,0,2,0,0,2
1405475283654807552,0,0,2,0,2
1591270142,0,2,0,0,2
958508539839959040,0,2,0,0,2
4869904209,1,1,0,0,2
56628593,0,2,0,0,2
1368152558,0,2,0,0,2
56632054,1,0,1,0,2
1402913049535713280,0,0,0,2,2
57721830,0,2,0,0,2
3297442206,1,1,0,0,2
1399272999631552512,0,2,0,0,2
1399761083649437696,0,2,0,0,2
1399748652491587584,1,1,0,0,2
3295268841,1,0,0,1,2
1363083624,1,0,0,1,2
1363066044,0,0,0,2,2
59454151,2,0,0,0,2
1399580491695726592,1,1,0,0,2
3295103893,0,2,0,0,2
59665548,0,2,0,0,2
1399280495347879936,0,2,0,0,2
3295050134,0,2,0,0,2
3297389167,0,2,0,0,2
3294945871,0,2,0,0,2
1398955989576060928,1,1,0,0,2
929603815246123008,0,2,0,0,2
60070209,0,2,0,0,2
1398693601203347456,0,1,1,0,2
4879851387,0,2,0,0,2
60209451,0,2,0,0,2
3294464877,0,2,0,0,2
1397966413537611776,2,0,0,0,2
60256725,2,0,0,0,2
959110029721956352,0,2,0,0,2
1400038651971653632,0,2,0,0,2
58947703,0,2,0,0,2
58855595,0,2,0,0,2
57992091,0,2,0,0,2
58039883,0,2,0,0,2
1365097790,0,2,0,0,2
58186298,0,2,0,0,2
1401473291483860992,0,2,0,0,2
1401350799222095872,1,1,0,0,2
58281990,0,2,0,0,2
1592561767,0,2,0,0,2
3296969972,2,0,0,0,2
58391929,0,2,0,0,2
58394273,0,2,0,0,2
3296741889,1,0,0,1,2
1400646286899044352,0,2,0,0,2
58719619,0,2,0,0,2
1400487667238854656,0,2,0,0,2
1364813635,0,2,0,0,2
1364654154,0,2,0,0,2
58788474,0,2,0,0,2
4874490561,0,2,0,0,2
3296216887,0,1,1,0,2
1364314154,0,2,0,0,2
1392089916948066304,0,0,1,1,2
1392072170243645440,0,2,0,0,2
1392070602127659008,0,2,0,0,2
1382614401644179456,0,2,0,0,2
1384097008311443456,0,2,0,0,2
962650200027344896,1,0,0,1,2
1383635850680958976,0,2,0,0,2
3253247341,0,2,0,0,2
1345147392,0,2,0,0,2
71941709,0,2,0,0,2
962862031610241024,0,2,0,0,2
3251485658,0,2,0,0,2
1382639402539753472,0,2,0,0,2
72259444,0,2,0,0,2
72316060,1,1,0,0,2
928277269000355840,0,2,0,0,2
1382596903414734848,0,2,0,0,2
700507551775862784,0,2,0,0,2
1344523994,1,1,0,0,2
962947723518529536,0,2,0,0,2
72605563,0,2,0,0,2
3250173696,2,0,0,0,2
1344009853,0,2,0,0,2
1381927214627758080,0,2,0,0,2
72922172,0,2,0,0,2
72964567,0,2,0,0,2
71674240,0,2,0,0,2
1345548763,0,2,0,0,2
1386582707883454464,0,0,2,0,2
695397915120906240,1,1,0,0,2
1602853494,1,1,0,0,2
4925307185,1,1,0,0,2
70214638,1,1,0,0,2
1603099266,0,2,0,0,2
3259211191,0,2,0,0,2
70374984,0,2,0,0,2
962206443242971136,0,2,0,0,2
3257574752,0,2,0,0,2
70860853,0,2,0,0,2
1346980866,0,2,0,0,2
3256204332,0,2,0,0,2
1384478971861995520,0,2,0,0,2
3255870421,2,0,0,0,2
1385314659855568896,0,0,0,2,2
1385153170826010624,2,0,0,0,2
3255443731,2,0,0,0,2
1385074370775683072,0,2,0,0,2
3255283909,0,2,0,0,2
696590308256120832,0,2,0,0,2
962549766101131264,0,2,0,0,2
71233818,0,1,0,1,2
3254785590,0,2,0,0,2
1381917689287876608,0,2,0,0,2
1381906868063367168,2,0,0,0,2
73046116,0,2,0,0,2
1379487521382391808,0,2,0,0,2
74164099,0,2,0,0,2
74172933,0,2,0,0,2
1339790534,0,0,2,0,2
1379844326222655488,0,1,0,1,2
1379773024493203456,0,2,0,0,2
74397539,0,2,0,0,2
927896250757894144,0,2,0,0,2
1339207645,0,2,0,0,2
701398992131907584,2,0,0,0,2
74669085,0,2,0,0,2
74715952,0,2,0,0,2
73082274,0,2,0,0,2
74788429,1,1,0,0,2
74818354,0,2,0,0,2
701456975952011264,0,0,0,2,2
701462928327839744,0,2,0,0,2
74971909,0,2,0,0,2
927861246044659712,0,2,0,0,2
701530139465748480,2,0,0,0,2
1606062805,0,2,0,0,2
75065306,0,2,0,0,2
1378600596689813504,0,2,0,0,2
1380116081159892992,0,2,0,0,2
1380230129880682496,0,2,0,0,2
1380235938496966656,0,2,0,0,2
74043102,1,1,0,0,2
73087405,1,0,1,0,2
73129331,2,0,0,0,2
1604268012,0,2,0,0,2
73184511,0,2,0,0,2
1381657413166583808,1,1,0,0,2
700780553507880960,0,2,0,0,2
73384748,1,1,0,0,2
700814433195417600,0,2,0,0,2
73498797,0,2,0,0,2
73563870,0,2,0,0,2
1342620859,0,2,0,0,2
3248270940,0,2,0,0,2
3248110248,0,2,0,0,2
1380903885951234048,0,2,0,0,2
73738411,0,2,0,0,2
1380778768546025472,2,0,0,0,2
701042909970214912,0,2,0,0,2
73936131,0,0,0,2,2
3247607322,0,2,0,0,2
1340409241,1,1,0,0,2
74025708,0,2,0,0,2
69928950,0,2,0,0,2
69862177,0,2,0,0,2
3280523064,1,1,0,0,2
66728112,0,2,0,0,2
4908987526,0,2,0,0,2
961223177706774528,0,2,0,0,2
4909352434,0,2,0,0,2
66235789,2,0,0,0,2
66289256,0,2,0,0,2
66341603,0,2,0,0,2
1601159310,0,2,0,0,2
961289436683104256,1,1,0,0,2
1390478549757296640,0,2,0,0,2
1390215724048822272,0,2,0,0,2
961584277426200576,0,2,0,0,2
66072561,2,0,0,0,2
3271267932,2,0,0,0,2
66834237,0,2,0,0,2
1389948069731516416,0,2,0,0,2
4910909814,0,0,0,2,2
1389896363077369856,0,2,0,0,2
1351416764,1,1,0,0,2
66993403,0,2,0,0,2
928707416937578496,0,2,0,0,2
67176089,1,1,0,0,2
3270833912,1,0,0,1,2
3275199626,1,1,0,0,2
961012019163000832,0,2,0,0,2
1386723396029882368,0,2,0,0,2
1391739257367142400,0,2,0,0,2
65109051,0,2,0,0,2
65169560,0,2,0,0,2
65187097,0,2,0,0,2
65221652,0,2,0,0,2
65278009,0,2,0,0,2
65298278,0,0,0,2,2
1354909358,1,1,0,0,2
1391799486079438848,1,0,0,1,2
65373103,0,2,0,0,2
1391784435578667008,1,0,1,0,2
1391669530427015168,0,2,0,0,2
65664015,0,0,0,2,2
65483749,2,0,0,0,2
4904009210,0,2,0,0,2
4904120638,2,0,0,0,2
65551984,0,2,0,0,2
65553408,1,1,0,0,2
1391602158571819008,1,1,0,0,2
1600599523,0,2,0,0,2
65609330,2,0,0,0,2
3277828218,0,2,0,0,2
1391397520144699392,1,1,0,0,2
67260558,0,2,0,0,2
4911963642,0,2,0,0,2
3270486380,2,0,0,0,2
68978679,0,2,0,0,2
961881526718918656,1,1,0,0,2
1349467232,0,2,0,0,2
961883474905899008,0,2,0,0,2
3261790809,2,0,0,0,2
3261511237,0,2,0,0,2
68720387,0,2,0,0,2
4920041097,1,1,0,0,2
4920163193,0,2,0,0,2
1388034363842080768,1,1,0,0,2
1349037978,0,2,0,0,2
1387855757119459328,0,2,0,0,2
1389528800929665024,0,2,0,0,2
1387825833251905536,0,2,0,0,2
1387740360701399040,0,2,0,0,2
1387641838765490176,0,2,0,0,2
69293734,0,2,0,0,2
4924079663,0,2,0,0,2
3260234860,0,2,0,0,2
1602792654,0,2,0,0,2
3259766678,0,2,0,0,2
1386760666992709632,0,2,0,0,2
1386746125407854592,0,1,0,1,2
68416293,2,0,0,0,2
4917385835,0,2,0,0,2
1388553071979122688,0,2,0,0,2
4917157460,2,0,0,0,2
3269916540,0,2,0,0,2
1389486121072144384,0,2,0,0,2
67509406,0,2,0,0,2
1601548039,0,2,0,0,2
4913328567,0,2,0,0,2
1351231176,0,2,0,0,2
3268338126,1,0,1,0,2
3268015003,1,1,0,0,2
3267381625,1,1,0,0,2
67775715,1,0,1,0,2
1601835037,0,2,0,0,2
67855670,0,0,0,2,2
1389058077257699328,0,2,0,0,2
3266565264,0,2,0,0,2
1388912145711108096,0,2,0,0,2
1388865848656285696,0,2,0,0,2
68120686,1,1,0,0,2
3266486256,0,2,0,0,2
928560287237619712,0,2,0,0,2
961835304716922880,0,2,0,0,2
68317599,0,2,0,0,2
967348608872968192,0,2,0,0,2
97731555,0,2,0,0,2
978668199771295744,0,2,0,0,2
1324994598742102016,0,2,0,0,2
3081663981,0,2,0,0,2
3081588712,0,2,0,0,2
3081397249,2,0,0,0,2
1325279899150512128,1,0,1,0,2
125781817,1,1,0,0,2
1325251331255365632,0,2,0,0,2
1325210363290267648,0,2,0,0,2
3080848382,0,2,0,0,2
126083012,0,2,0,0,2
126261545,1,1,0,0,2
1324966727743131648,1,1,0,0,2
125400853,1,1,0,0,2
1324950623524179968,0,2,0,0,2
126319621,0,2,0,0,2
1257264380,0,2,0,0,2
1324870450023784448,0,1,0,1,2
1257245570,2,0,0,0,2
726200901891940352,1,1,0,0,2
3079382745,0,2,0,0,2
1324814540073324544,0,2,0,0,2
975781213305683968,0,2,0,0,2
1256345629,0,2,0,0,2
3081802001,0,2,0,0,2
1325514756048908288,0,2,0,0,2
1255803114,0,2,0,0,2
1258593637,0,2,0,0,2
124113597,0,2,0,0,2
124126197,1,0,1,0,2
124196063,0,2,0,0,2
124252785,0,1,0,1,2
1645344630,0,0,0,2,2
124365247,2,0,0,0,2
1326120536422932480,2,0,0,0,2
975463378511638528,0,2,0,0,2
725587752335474688,1,1,0,0,2
1325925390905434112,0,2,0,0,2
1325794994863697920,1,1,0,0,2
3082018247,0,2,0,0,2
124694439,0,2,0,0,2
124789611,2,0,0,0,2
3082960955,0,2,0,0,2
3082717198,0,2,0,0,2
1325741149206810624,2,0,0,0,2
125053452,0,2,0,0,2
125088088,0,2,0,0,2
125088901,2,0,0,0,2
1325640164673265664,0,1,0,1,2
125261332,0,1,0,1,2
126756071,0,2,0,0,2
126813246,2,0,0,0,2
1254042577,0,2,0,0,2
727260470525222912,0,2,0,0,2
1254760429,0,2,0,0,2
128484661,2,0,0,0,2
3073098420,2,0,0,0,2
128690061,0,2,0,0,2
128690365,0,2,0,0,2
1323884281521795072,0,2,0,0,2
3072879286,0,2,0,0,2
1323868810491822080,0,1,1,0,2
3072862803,0,1,0,1,2
128852209,0,2,0,0,2
1323756287004446720,0,2,0,0,2
128285925,0,2,0,0,2
1323719967884324864,0,2,0,0,2
3072344450,0,2,0,0,2
1254498770,0,2,0,0,2
3072084421,0,2,0,0,2
3072077327,0,2,0,0,2
129166542,0,2,0,0,2
1323612684483440640,0,2,0,0,2
1647605240,2,0,0,0,2
976113020136034304,0,2,0,0,2
1323523481762410496,0,2,0,0,2
128342965,0,2,0,0,2
3073865941,0,2,0,0,2
726464676750454784,0,2,0,0,2
1324398536205750272,0,2,0,0,2
126910020,0,2,0,0,2
975899071280857088,2,0,0,0,2
3077314242,0,2,0,0,2
1324597977156116480,2,0,0,0,2
1324591038749577216,0,2,0,0,2
3076706573,0,2,0,0,2
3076532106,0,2,0,0,2
975949046064889856,0,2,0,0,2
127172156,0,2,0,0,2
1324467654036389888,2,0,0,0,2
975980931965116416,0,2,0,0,2
727059403216658432,1,1,0,0,2
127484192,0,2,0,0,2
127507139,0,2,0,0,2
127553214,1,1,0,0,2
127565407,0,2,0,0,2
1324335744530501632,0,2,0,0,2
3075851307,0,2,0,0,2
3075622740,2,0,0,0,2
727015631703388160,0,2,0,0,2
1324121533049004032,0,2,0,0,2
128039857,0,2,0,0,2
124100120,0,2,0,0,2
3085959774,0,2,0,0,2
1259225322,0,2,0,0,2
119866395,0,2,0,0,2
3100856019,0,2,0,0,2
119514245,0,2,0,0,2
3100283920,0,2,0,0,2
1264648027,1,0,1,0,2
119667644,0,2,0,0,2
119684432,0,2,0,0,2
119696635,0,2,0,0,2
119709235,0,2,0,0,2
1642376238,0,2,0,0,2
723724298972729344,2,0,0,0,2
119986431,0,2,0,0,2
119328096,0,2,0,0,2
1329774148646817792,0,2,0,0,2
3098790466,0,2,0,0,2
3098382898,0,0,0,2,2
120405204,0,2,0,0,2
120489874,1,1,0,0,2
1329522148893974528,0,2,0,0,2
1263834888,0,2,0,0,2
723897898124058624,0,1,1,0,2
3098000969,0,2,0,0,2
3097279708,0,1,0,1,2
1330547528203382784,1,1,0,0,2
973875200948350976,1,1,0,0,2
1326632518637023232,2,0,0,0,2
722793928081174528,0,2,0,0,2
117767974,1,1,0,0,2
722501320058531840,0,2,0,0,2
722560529349361664,1,0,0,1,2
117985774,0,2,0,0,2
722625686549241856,0,0,0,2,2
118082484,0,2,0,0,2
1639801410,0,0,0,2,2
118103789,2,0,0,0,2
118107139,0,2,0,0,2
1331835176947765248,0,2,0,0,2
722860526787772416,0,2,0,0,2
1265611285,0,2,0,0,2
1331564798195036160,0,0,2,0,2
1331326336074272768,0,2,0,0,2
1641288128,2,0,0,0,2
118613799,0,2,0,0,2
1267151814,0,2,0,0,2
1331105561128042496,0,2,0,0,2
118669873,0,2,0,0,2
1642160586,1,1,0,0,2
1330881958235099136,0,2,0,0,2
1266503754,0,2,0,0,2
121090662,0,2,0,0,2
922954519042056192,0,2,0,0,2
724107109470756864,1,1,0,0,2
1260247532,0,2,0,0,2
122937542,0,2,0,0,2
1643760607,0,2,0,0,2
3091531360,0,2,0,0,2
922745873385377792,1,1,0,0,2
1327545160369115136,0,2,0,0,2
1260518365,0,2,0,0,2
123073669,0,2,0,0,2
725005310532960256,0,2,0,0,2
1327531594236764160,0,2,0,0,2
3090355848,1,1,0,0,2
1327334309557137408,0,2,0,0,2
121356214,0,2,0,0,2
1259990546,0,2,0,0,2
975162496003788800,0,1,1,0,2
725223321244188672,1,1,0,0,2
3088506052,0,2,0,0,2
725271818219696128,0,2,0,0,2
3087434967,2,0,0,0,2
922571412992229376,2,0,0,0,2
1326877033075535872,1,0,1,0,2
3086881833,0,2,0,0,2
725318571715366912,0,2,0,0,2
974517614671142912,0,2,0,0,2
1327753769170259968,0,2,0,0,2
122761006,0,2,0,0,2
1261300080,0,2,0,0,2
121494889,0,0,1,1,2
121547368,0,2,0,0,2
1328742752457273344,1,0,0,1,2
1328565915546394624,0,2,0,0,2
121757231,1,1,0,0,2
1643347249,0,2,0,0,2
1328377263432331264,0,2,0,0,2
3094574274,0,2,0,0,2
121986915,0,2,0,0,2
122029547,0,2,0,0,2
1262391883,0,2,0,0,2
122114443,0,2,0,0,2
1643476466,0,2,0,0,2
1261743776,0,2,0,0,2
1328040808856113152,0,2,0,0,2
922808089279156224,0,2,0,0,2
122402588,1,0,0,1,2
3092599422,0,2,0,0,2
1327928915978018816,0,2,0,0,2
724660166663139328,0,2,0,0,2
122647962,1,1,0,0,2
1254354031,0,2,0,0,2
3071554460,0,2,0,0,2
97765312,2,0,0,0,2
977842557341372416,1,1,0,0,2
3047485897,0,2,0,0,2
977827581109026816,0,2,0,0,2
1318249199566159872,1,0,1,0,2
1318199172454121472,0,1,1,0,2
3046922383,0,2,0,0,2
731463931970113536,0,2,0,0,2
731490083690319872,0,2,0,0,2
1318016397352468480,1,0,1,0,2
137444093,0,2,0,0,2
3045149437,0,2,0,0,2
1317872799978082304,0,2,0,0,2
977816053186260992,0,1,1,0,2
137511158,0,2,0,0,2
1242228853,0,2,0,0,2
137699771,0,2,0,0,2
137740737,0,2,0,0,2
731732953693343744,0,2,0,0,2
3044692146,0,2,0,0,2
1317508825826643968,2,0,0,0,2
1242010477,0,0,1,1,2
921655254407577600,0,2,0,0,2
138003857,0,2,0,0,2
977817333241610240,0,2,0,0,2
136877210,0,2,0,0,2
138037438,0,2,0,0,2
3049932417,0,2,0,0,2
3052703979,0,2,0,0,2
1319338285026570240,0,2,0,0,2
1319025866198994944,0,2,0,0,2
730613638118162432,0,1,1,0,2
1244609569,0,2,0,0,2
135744803,0,2,0,0,2
1318813507039731712,0,2,0,0,2
135906974,2,0,0,0,2
135945835,0,2,0,0,2
730995794816438272,0,2,0,0,2
136198923,0,2,0,0,2
1318473813047214080,0,0,1,1,2
1318634172051644416,0,2,0,0,2
731054089312833536,0,2,0,0,2
1318606193477087232,0,2,0,0,2
977620803171762176,0,2,0,0,2
731168207927705600,0,0,0,2,2
3048856239,0,2,0,0,2
136635976,0,2,0,0,2
1318479094762381312,2,0,0,0,2
136666777,0,0,0,2,2
3048654094,0,2,0,0,2
1241646199,0,2,0,0,2
1240500834,1,0,0,1,2
1253982194,0,2,0,0,2
140348798,1,1,0,0,2
1316355193169207296,1,1,0,0,2
1316341950195400704,0,2,0,0,2
732623078698668032,0,2,0,0,2
139754609,0,2,0,0,2
139900972,0,2,0,0,2
140126841,0,2,0,0,2
140139022,0,2,0,0,2
1316044960353808384,0,2,0,0,2
1655326610,0,2,0,0,2
140346467,1,1,0,0,2
140351722,0,2,0,0,2
1316613759717134336,0,2,0,0,2
140357253,0,2,0,0,2
140359476,0,2,0,0,2
140366916,0,2,0,0,2
140370171,0,0,1,1,2
140448107,0,2,0,0,2
1315879803334070272,1,1,0,0,2
1315866204515393536,0,2,0,0,2
3038946111,0,2,0,0,2
140550685,0,1,0,1,2
140713309,0,2,0,0,2
3040729649,0,2,0,0,2
139390342,0,2,0,0,2
3043018705,0,2,0,0,2
3042177804,0,2,0,0,2
138211367,0,2,0,0,2
1317055856089784320,0,2,0,0,2
1317044281199284224,0,2,0,0,2
138330586,0,2,0,0,2
3042773702,2,0,0,0,2
138430209,0,2,0,0,2
978327161328238592,0,2,0,0,2
138517010,0,0,2,0,2
138555849,0,2,0,0,2
3042239639,0,2,0,0,2
1316843425791123456,0,2,0,0,2
1316632691601702912,0,2,0,0,2
1654513231,1,1,0,0,2
1316800318349467648,0,2,0,0,2
1316759412518907904,0,1,1,0,2
138820999,0,2,0,0,2
1316695656480886784,0,0,0,2,2
139028339,0,2,0,0,2
139075703,0,2,0,0,2
3041496220,0,0,0,2,2
732477511968264192,0,2,0,0,2
139183692,0,2,0,0,2
1244907751,0,2,0,0,2
730332160637313024,0,2,0,0,2
135088714,0,2,0,0,2
728841123679096832,2,0,0,0,2
131219151,0,2,0,0,2
1250909738,0,2,0,0,2
1250355750,0,2,0,0,2
1649439421,0,2,0,0,2
131439169,0,2,0,0,2
976429650846146560,0,2,0,0,2
976453234003980288,0,2,0,0,2
131779688,0,2,0,0,2
976453494843592704,0,1,0,1,2
131791552,0,2,0,0,2
131961671,0,2,0,0,2
131081660,2,0,0,0,2
132054468,0,2,0,0,2
132122585,0,2,0,0,2
132170371,0,2,0,0,2
1321621216986308608,0,2,0,0,2
132210087,0,2,0,0,2
1321558742048165888,0,2,0,0,2
132453228,0,2,0,0,2
3062201871,0,2,0,0,2
1321446350064701440,0,2,0,0,2
729274815677382656,0,2,0,0,2
1322350357381525504,0,2,0,0,2
130920306,0,2,0,0,2
3053231578,0,2,0,0,2
1322961170983170048,0,2,0,0,2
3070837030,0,2,0,0,2
1323311426736455680,0,2,0,0,2
1323296596117745664,0,2,0,0,2
1323271037660860416,0,2,0,0,2
1253203484,0,2,0,0,2
3068631529,0,2,0,0,2
727808319335874560,0,1,0,1,2
1323055683445661696,0,2,0,0,2
130403610,0,2,0,0,2
130404891,0,2,0,0,2
1322960388741234688,0,2,0,0,2
1252731030,0,2,0,0,2
727906213606871040,0,2,0,0,2
3068060556,0,2,0,0,2
1648320404,0,0,2,0,2
130758588,2,0,0,0,2
130765503,0,2,0,0,2
1322871491495518208,0,0,0,2,2
1648449110,0,2,0,0,2
3067510775,0,2,0,0,2
1322740555500134400,0,2,0,0,2
1322593927568896000,0,2,0,0,2
132633577,0,2,0,0,2
729342219870572544,0,2,0,0,2
132673169,0,2,0,0,2
134626111,2,0,0,0,2
134311201,0,2,0,0,2
134340549,1,1,0,0,2
977084623636369408,0,2,0,0,2
3059059231,0,2,0,0,2
3058908581,0,2,0,0,2
3058894378,1,1,0,0,2
1320152491187732480,0,2,0,0,2
1245940428,0,2,0,0,2
3056678956,1,0,0,1,2
134604488,0,2,0,0,2
1319920949089783808,0,2,0,0,2
1247941526,0,2,0,0,2
1651973558,1,0,1,0,2
1245742171,0,2,0,0,2
1319873548761010176,0,2,0,0,2
1652477690,2,0,0,0,2
3053678482,0,2,0,0,2
3053583212,0,2,0,0,2
1319685393458040832,0,2,0,0,2
134965367,0,2,0,0,2
3053564234,0,2,0,0,2
135059561,0,1,1,0,2
729967227827556352,0,1,1,0,2
1320505630583447552,0,2,0,0,2
1320550779388739584,1,0,1,0,2
729903716728508416,2,0,0,0,2
132746982,0,2,0,0,2
1321316826316353536,0,2,0,0,2
1321215231352279040,0,2,0,0,2
132845769,0,2,0,0,2
132994590,2,0,0,0,2
1321169117894774784,1,1,0,0,2
133181912,0,2,0,0,2
1321053350251683840,0,2,0,0,2
133277726,0,0,0,2,2
1320998383075512320,0,2,0,0,2
3061425942,1,1,0,0,2
133669026,0,2,0,0,2
3061183318,1,1,0,0,2
1320782552110669824,0,2,0,0,2
133788844,0,2,0,0,2
1247015148,0,2,0,0,2
3060575715,0,2,0,0,2
1320673137772523520,2,0,0,0,2
133983836,0,2,0,0,2
134044319,0,2,0,0,2
1320630337257369600,0,1,1,0,2
3107580300,0,2,0,0,2
722389054566834176,0,2,0,0,2
1332329516212105216,1,1,0,0,2
1345409753636364288,0,2,0,0,2
1300923398,0,2,0,0,2
103281569,0,2,0,0,2
1345670739920375808,0,2,0,0,2
3156476409,0,2,0,0,2
1345640771341324288,2,0,0,0,2
103337452,1,1,0,0,2
969153919594110976,0,2,0,0,2
1300399932,0,2,0,0,2
715629845024079872,0,2,0,0,2
3154503766,0,2,0,0,2
1345407782841888768,0,2,0,0,2
1345801514909011968,0,2,0,0,2
1345347008446521344,2,0,0,0,2
103850230,0,2,0,0,2
925007182570983424,0,2,0,0,2
103877706,0,2,0,0,2
3153831071,0,2,0,0,2
103953047,0,2,0,0,2
103999463,0,2,0,0,2
1345189785384722432,0,2,0,0,2
1628105288,0,1,1,0,2
715922343172907008,0,2,0,0,2
715509282977017856,0,2,0,0,2
3157727915,0,2,0,0,2
1344797502407651328,0,2,0,0,2
1346291754585133056,1,0,1,0,2
3159374739,0,2,0,0,2
102355134,1,1,0,0,2
1346405463705862144,0,2,0,0,2
102437099,0,2,0,0,2
102478163,0,0,0,2,2
3159087507,0,2,0,0,2
1346340324830892032,0,2,0,0,2
1346326436269977600,0,2,0,0,2
102602904,0,2,0,0,2
1346299566589698048,2,0,0,0,2
1303121448,0,2,0,0,2
103171490,0,2,0,0,2
1346201197091278848,0,2,0,0,2
3158229565,0,2,0,0,2
102955736,1,1,0,0,2
3158229151,0,2,0,0,2
925023695785017344,0,0,2,0,2
3158067277,2,0,0,0,2
103083533,0,2,0,0,2
103132707,0,2,0,0,2
103142826,1,1,0,0,2
103151029,0,0,1,1,2
104294199,1,0,0,1,2
3151975414,0,2,0,0,2
3107853113,0,2,0,0,2
924701599561322496,2,0,0,0,2
106154551,2,0,0,0,2
3147101880,1,0,0,1,2
1630298372,0,2,0,0,2
3146531210,0,2,0,0,2
1343544234033479680,1,1,0,0,2
1343525759038627840,0,2,0,0,2
1343500261982089216,1,0,0,1,2
106418525,0,2,0,0,2
1630855554,1,0,0,1,2
970092835901984768,0,2,0,0,2
3144832924,1,1,0,0,2
3148140673,1,0,0,1,2
1343035871419744256,0,2,0,0,2
106791817,0,2,0,0,2
717048547430916096,0,2,0,0,2
717071970723045376,0,2,0,0,2
1343001970949431296,1,0,1,0,2
1342872378452312064,0,2,0,0,2
107087622,0,2,0,0,2
3143216111,0,1,1,0,2
107303711,2,0,0,0,2
1342591170267013120,0,2,0,0,2
1343861241559670784,1,1,0,0,2
105902628,0,2,0,0,2
716063225624846336,0,2,0,0,2
105098899,0,1,1,0,2
716141050432253952,0,2,0,0,2
1628806626,0,2,0,0,2
3151411830,1,1,0,0,2
1344575509640974336,0,2,0,0,2
1344552875813429248,0,1,0,1,2
3151252218,0,2,0,0,2
1344365743094329344,1,1,0,0,2
104987601,0,2,0,0,2
105052727,1,1,0,0,2
3150520777,0,2,0,0,2
1344164473918140416,0,2,0,0,2
3148175958,0,2,0,0,2
1344160026194272256,0,2,0,0,2
969520662342787072,0,2,0,0,2
1344123519966179328,0,1,0,1,2
105364936,0,0,0,2,2
1629527034,0,2,0,0,2
3149374188,1,1,0,0,2
1629540794,0,2,0,0,2
105753595,0,2,0,0,2
105753919,0,2,0,0,2
105812962,0,2,0,0,2
1346486657445294080,0,2,0,0,2
968776405029998592,0,2,0,0,2
1303878516,0,2,0,0,2
99269724,0,2,0,0,2
1349323784889667584,0,2,0,0,2
1349316305149710336,0,2,0,0,2
1349292252565278720,1,1,0,0,2
3176377521,0,2,0,0,2
99084149,2,0,0,0,2
99086059,0,2,0,0,2
1349211945812054016,0,2,0,0,2
1349123696410071040,0,2,0,0,2
1313529642,0,2,0,0,2
712646748129329152,0,2,0,0,2
1623044233,0,2,0,0,2
98916902,0,2,0,0,2
99332835,0,2,0,0,2
1348883650537000960,0,0,0,2,2
99373477,0,2,0,0,2
1313297438,0,2,0,0,2
99409935,0,2,0,0,2
1623051084,0,2,0,0,2
712846845156978688,0,2,0,0,2
968027840410107904,0,2,0,0,2
99740545,0,2,0,0,2
3171677759,0,2,0,0,2
1349364191543627776,1,1,0,0,2
712344849068986368,0,2,0,0,2
102264907,0,2,0,0,2
98376616,0,2,0,0,2
711922980385918976,0,2,0,0,2
97889206,0,2,0,0,2
1350322266337402880,0,2,0,0,2
98049648,0,2,0,0,2
98121681,0,2,0,0,2
3180031256,0,2,0,0,2
925846064296493056,0,2,0,0,2
98155286,0,1,0,1,2
1349982907411128320,0,2,0,0,2
712179475065122816,0,2,0,0,2
98382896,0,2,0,0,2
712342107554455552,0,2,0,0,2
98401983,2,0,0,0,2
98507440,2,0,0,0,2
967581553076457472,0,2,0,0,2
1349865186220392448,0,2,0,0,2
1349789731031298048,0,1,0,1,2
1314178838,0,2,0,0,2
712240257270308864,1,1,0,0,2
1349583572911468544,0,2,0,0,2
98739523,0,2,0,0,2
925764495917633536,0,2,0,0,2
3171668783,1,1,0,0,2
99939839,0,2,0,0,2
1348557258456670208,2,0,0,0,2
101846636,2,0,0,0,2
1347199276376600576,1,1,0,0,2
1347182752358010880,0,2,0,0,2
714213213156589568,0,2,0,0,2
3163490936,0,2,0,0,2
1305680827,1,1,0,0,2
1347094634426732544,1,1,0,0,2
101723990,0,2,0,0,2
3163073695,0,2,0,0,2
101783198,0,2,0,0,2
714535083919745024,1,1,0,0,2
3162685886,0,2,0,0,2
1348544347847892992,0,2,0,0,2
101927674,0,1,0,1,2
3162471829,0,2,0,0,2
1346913062272450560,0,2,0,0,2
714692716567928832,0,0,0,2,2
3160713703,2,0,0,0,2
3160535143,0,2,0,0,2
714839822213509120,0,2,0,0,2
1346713492674539520,0,0,1,1,2
714897270722826240,2,0,0,0,2
102263206,0,2,0,0,2
3164685068,0,2,0,0,2
968377856177987584,1,0,0,1,2
1347358800425218048,0,2,0,0,2
101200141,0,2,0,0,2
713052989003538432,0,2,0,0,2
3170022066,0,2,0,0,2
1348271845129084928,1,1,0,0,2
3168785548,0,2,0,0,2
100285649,0,2,0,0,2
1348111497269043200,0,2,0,0,2
3168336356,0,2,0,0,2
100469505,0,1,1,0,2
1307938310,0,2,0,0,2
100517876,0,2,0,0,2
100532445,0,2,0,0,2
1347902993186873344,0,2,0,0,2
3167174366,0,1,1,0,2
100700320,0,2,0,0,2
100755899,0,2,0,0,2
3166364161,0,2,0,0,2
100779661,0,2,0,0,2
1347660649103548416,0,2,0,0,2
3166201429,0,2,0,0,2
1347617031588245504,1,1,0,0,2
3165739966,0,2,0,0,2
3142530596,0,2,0,0,2
107622315,0,2,0,0,2
1292159352,0,2,0,0,2
720604107468365824,0,2,0,0,2
1335855592716468224,0,2,0,0,2
3121197242,2,0,0,0,2
1335498300640751616,0,2,0,0,2
720346434998960128,0,2,0,0,2
113965284,0,2,0,0,2
1277803332,2,0,0,0,2
113999734,0,2,0,0,2
1335320496490094592,0,1,1,0,2
1335241750416224256,1,0,0,1,2
1636605638,2,0,0,0,2
972567951059677184,0,2,0,0,2
1335926889777672192,2,0,0,0,2
114332856,0,2,0,0,2
923520176594870272,1,1,0,0,2
923519026084507648,1,0,0,1,2
1275578606,2,0,0,0,2
3119108628,2,0,0,0,2
114445946,0,2,0,0,2
3118791507,1,1,0,0,2
114510363,0,2,0,0,2
1275154423,0,2,0,0,2
1334873286195490816,0,0,1,1,2
113813865,0,2,0,0,2
3121656590,0,2,0,0,2
972148070711529472,1,0,1,0,2
113356908,0,0,0,2,2
972271004813746176,0,2,0,0,2
112963171,2,0,0,0,2
972371554582630400,0,2,0,0,2
112989755,1,1,0,0,2
3125065835,0,2,0,0,2
1336790724248031232,0,2,0,0,2
113086634,1,1,0,0,2
113247657,0,2,0,0,2
1336601376588144640,0,2,0,0,2
720045923246739456,1,0,0,1,2
113396396,0,2,0,0,2
972452967101227008,0,2,0,0,2
1280018124,0,2,0,0,2
3121972043,0,2,0,0,2
1336319110121078784,1,1,0,0,2
1336198538817011712,0,2,0,0,2
1336192298951057408,0,0,0,2,2
113597793,0,2,0,0,2
113603444,0,2,0,0,2
113634895,1,0,0,1,2
113649482,1,1,0,0,2
720160371282178048,0,2,0,0,2
3118534294,0,2,0,0,2
3118484704,1,1,0,0,2
3117945087,0,2,0,0,2
3110996888,2,0,0,0,2
1333515358234431488,1,1,0,0,2
116275212,0,2,0,0,2
1333465328781824000,0,2,0,0,2
721703970503307264,0,2,0,0,2
1271872177,0,2,0,0,2
1638557335,1,0,0,1,2
116522146,0,2,0,0,2
1333353648328413184,0,2,0,0,2
3111010033,0,2,0,0,2
116742974,0,2,0,0,2
117024322,0,2,0,0,2
1274453851,0,2,0,0,2
1332882629838868480,1,0,0,1,2
117215912,0,2,0,0,2
1332857316652195840,2,0,0,0,2
722117494899679232,1,0,1,0,2
117355394,0,2,0,0,2
1639242043,0,2,0,0,2
1332532437155409920,0,2,0,0,2
117509274,0,2,0,0,2
1639663394,0,2,0,0,2
973519283056791552,0,2,0,0,2
3113241713,0,2,0,0,2
1333823921506795520,0,2,0,0,2
115950795,0,2,0,0,2
3113404954,1,1,0,0,2
1334589010669256704,2,0,0,0,2
114927576,0,2,0,0,2
115004513,0,2,0,0,2
923496972786348032,0,2,0,0,2
115060189,0,2,0,0,2
3117160067,0,2,0,0,2
972827422684057600,0,2,0,0,2
115115722,0,0,0,2,2
115204476,0,2,0,0,2
1273247052,0,2,0,0,2
1334284143866355712,0,2,0,0,2
1334258879954210816,0,2,0,0,2
3115232078,0,2,0,0,2
3115142547,0,2,0,0,2
1334186369996922880,0,2,0,0,2
721298889563906048,0,2,0,0,2
3114702137,0,2,0,0,2
721312865983012864,0,2,0,0,2
115621462,0,2,0,0,2
721405663365042176,0,2,0,0,2
972991180823658496,1,0,0,1,2
1337096295840763904,0,0,0,2,2
3125954698,0,2,0,0,2
3141841122,0,2,0,0,2
1340210246581538816,1,0,0,1,2
108684205,0,2,0,0,2
1632936062,0,2,0,0,2
3138570834,1,0,1,0,2
108850383,2,0,0,0,2
1340909869268930560,2,0,0,0,2
3136749011,1,1,0,0,2
109087837,0,0,0,2,2
1340468448720285696,0,2,0,0,2
3135674219,0,2,0,0,2
970719967015415808,0,1,0,1,2
1340202454776987648,0,2,0,0,2
108656518,0,2,0,0,2
1633321206,0,2,0,0,2
1633531836,2,0,0,0,2
109613239,0,2,0,0,2
109728178,2,0,0,0,2
1287578316,0,2,0,0,2
109791172,2,0,0,0,2
1633710211,0,2,0,0,2
1634127883,0,2,0,0,2
1339897708862205952,0,2,0,0,2
1286482890,0,2,0,0,2
924584558514835456,0,2,0,0,2
1341321385789034496,0,2,0,0,2
3126239735,2,0,0,0,2
1342055838287069184,0,2,0,0,2
970280368443142144,0,2,0,0,2
107663335,1,0,0,1,2
1342373087912861696,0,2,0,0,2
107680763,0,2,0,0,2
107685083,0,2,0,0,2
1342306825836834816,0,2,0,0,2
107700292,0,2,0,0,2
1632064710,1,1,0,0,2
1342225943956500480,0,2,0,0,2
1342199762884374528,0,2,0,0,2
1632097280,0,2,0,0,2
717556739764170752,0,2,0,0,2
3140531574,1,1,0,0,2
108005160,2,0,0,0,2
3140325491,0,2,0,0,2
108016619,0,2,0,0,2
108069506,0,2,0,0,2
1341635610122084352,0,2,0,0,2
108286621,0,2,0,0,2
108312938,0,2,0,0,2
1341447301089386496,0,0,0,2,2
1341430127046111232,0,2,0,0,2
1286213155,0,2,0,0,2
3133238866,0,2,0,0,2
3133076385,0,2,0,0,2
3127339846,0,2,0,0,2
111838410,1,0,0,1,2
111873921,1,1,0,0,2
3128143033,0,2,0,0,2
1283768730,0,2,0,0,2
112047615,0,2,0,0,2
112085850,2,0,0,0,2
112191211,0,2,0,0,2
719204585026367488,1,0,0,1,2
112236654,0,2,0,0,2
1283356963,1,1,0,0,2
1337747396235841536,1,0,1,0,2
110380935,0,2,0,0,2
1337735358830669824,2,0,0,0,2
972111205232869376,0,2,0,0,2
112433390,0,2,0,0,2
1337493584312864768,2,0,0,0,2
1337375344941121536,1,1,0,0,2
112515691,0,2,0,0,2
719618625116762112,0,2,0,0,2
112653500,0,2,0,0,2
112669635,0,2,0,0,2
112691744,0,2,0,0,2
719026073527169024,0,2,0,0,2
111600426,0,2,0,0,2
111438456,0,2,0,0,2
718871434093703168,0,2,0,0,2
971330210565009408,0,2,0,0,2
1339437912501436416,0,2,0,0,2
110460168,0,2,0,0,2
110482968,0,2,0,0,2
1285708675,0,1,0,1,2
971409230841438208,0,2,0,0,2
718415444147773440,1,1,0,0,2
718426119951753216,0,2,0,0,2
1339119919066177536,0,2,0,0,2
1339041287551389696,0,2,0,0,2
971698786148986880,0,2,0,0,2
1338940532001828864,1,1,0,0,2
1338923980745412608,0,2,0,0,2
111003622,0,2,0,0,2
1338777342978760704,0,2,0,0,2
111217548,0,2,0,0,2
1635123126,0,2,0,0,2
1338622970722463744,0,2,0,0,2
1284332036,1,1,0,0,2
1283919878,0,2,0,0,2
1338449710982500352,0,2,0,0,2
55692277,1,1,0,0,2
1407214173113786368,0,2,0,0,2
1407261037347356672,2,0,0,0,2
4418116949,0,2,0,0,2
4416209877,0,2,0,0,2
1486904734929752064,0,2,0,0,2
3755304686,0,2,0,0,2
20564483,0,2,0,0,2
3755267970,2,0,0,0,2
20578272,0,2,0,0,2
3752331994,0,2,0,0,2
20619120,0,2,0,0,2
1486592308325670912,0,2,0,0,2
945230690215268352,0,2,0,0,2
20647617,0,2,0,0,2
20493414,0,2,0,0,2
945302455385858048,0,2,0,0,2
20666494,0,2,0,0,2
935903980110016512,2,0,0,0,2
945332667196854272,0,2,0,0,2
3748417892,0,2,0,0,2
1486238100628344832,0,2,0,0,2
945378531403591680,0,2,0,0,2
935843496677781504,0,2,0,0,2
1486065115157843968,0,2,0,0,2
1486038913105883136,0,2,0,0,2
4415221576,0,2,0,0,2
20443761,0,2,0,0,2
20848260,1,1,0,0,2
3776992515,1,0,0,1,2
20118243,0,2,0,0,2
4385484799,0,2,0,0,2
3783722003,0,2,0,0,2
944909516751196160,2,0,0,0,2
20146913,0,2,0,0,2
1488050100488515584,2,0,0,0,2
1542637915,0,2,0,0,2
1487928493333630976,0,2,0,0,2
1487853142662332416,0,2,0,0,2
944963209638961152,0,2,0,0,2
3776541736,0,2,0,0,2
1464295506,1,1,0,0,2
4390070054,0,2,0,0,2
1487769919420870656,0,2,0,0,2
1543023114,0,2,0,0,2
1487740213883506688,2,0,0,0,2
1487732578274938880,0,2,0,0,2
1487721967348162560,0,0,0,2,2
945029960464568320,0,2,0,0,2
945055610218967040,1,1,0,0,2
1464595417,0,2,0,0,2
4399364915,0,2,0,0,2
3739681518,0,2,0,0,2
1485729302557646848,0,2,0,0,2
1483682929461149696,1,0,0,1,2
1459296559,1,1,0,0,2
1484520358405632000,0,2,0,0,2
935807470693470208,0,2,0,0,2
1459474195,0,0,0,2,2
3704123185,0,2,0,0,2
1484231396713320448,2,0,0,0,2
1459378322,0,2,0,0,2
21305650,0,2,0,0,2
21316101,0,2,0,0,2
3700641626,0,2,0,0,2
3700336456,0,2,0,0,2
1484077439173156864,0,2,0,0,2
1459748209,1,0,0,1,2
1458731557,0,2,0,0,2
3697546103,0,2,0,0,2
946045762319904768,1,1,0,0,2
1483889659138740224,2,0,0,0,2
21422783,0,2,0,0,2
946076638420254720,1,1,0,0,2
21428364,0,1,0,1,2
1483832450346549248,1,1,0,0,2
1545792342,0,2,0,0,2
1483728542496342016,0,2,0,0,2
1484740194268229632,0,2,0,0,2
3709788077,0,2,0,0,2
4423659205,2,0,0,0,2
21083746,0,2,0,0,2
20882602,0,2,0,0,2
1544341616,1,1,0,0,2
945707820451794944,0,2,0,0,2
945735632101441536,0,2,0,0,2
3723104114,0,2,0,0,2
21017311,1,1,0,0,2
1485344371214262272,2,0,0,0,2
3722881636,0,2,0,0,2
3720276682,0,2,0,0,2
945759728533045248,0,2,0,0,2
1485155168853319680,0,0,0,2,2
3709877595,1,1,0,0,2
21088417,0,2,0,0,2
1484980528701120512,0,2,0,0,2
21108075,0,2,0,0,2
3718166476,0,2,0,0,2
1460471641,0,2,0,0,2
21135495,0,2,0,0,2
21135522,0,2,0,0,2
1484903846342463488,0,2,0,0,2
1484886376864976896,0,0,1,1,2
1459961330,0,2,0,0,2
1488403513713598464,1,1,0,0,2
1467504068,0,2,0,0,2
20049994,0,2,0,0,2
3848127853,0,2,0,0,2
3858721153,0,2,0,0,2
18831554,1,1,0,0,2
936483571081998336,2,0,0,0,2
1491576843736317952,1,0,1,0,2
18861668,2,0,0,0,2
943748968785199104,0,2,0,0,2
18904766,2,0,0,0,2
1491405886421667840,1,1,0,0,2
18958504,0,2,0,0,2
3850079063,2,0,0,0,2
943891378936958976,0,1,0,1,2
4337205316,2,0,0,0,2
1491071439973326848,0,2,0,0,2
4347936320,0,2,0,0,2
19077019,0,2,0,0,2
1490941749010726912,0,2,0,0,2
3839843914,0,2,0,0,2
1490847979770503168,0,1,0,1,2
1490844835015962624,0,2,0,0,2
4349272216,1,1,0,0,2
1490760885492920320,0,2,0,0,2
1490643643627155456,0,2,0,0,2
3858828557,0,2,0,0,2
3860044874,0,2,0,0,2
1488461809497837568,0,2,0,0,2
1492200993903484928,1,1,0,0,2
18583397,0,2,0,0,2
1492352566771994624,0,2,0,0,2
1475593172,0,2,0,0,2
943419339717345280,0,2,0,0,2
18600301,0,2,0,0,2
1474947690,0,2,0,0,2
18604111,0,2,0,0,2
3870969214,0,2,0,0,2
3870200169,1,1,0,0,2
4325244324,1,0,0,1,2
1474493340,2,0,0,0,2
1491887105223847936,0,2,0,0,2
1538605190,0,2,0,0,2
943507426803728384,0,2,0,0,2
3863752882,0,2,0,0,2
18663077,0,2,0,0,2
3863642608,2,0,0,0,2
1473620790,0,2,0,0,2
3862785492,0,2,0,0,2
4329647598,0,2,0,0,2
18712642,1,1,0,0,2
1491897799268569088,2,0,0,0,2
1471581901,0,2,0,0,2
1471502064,0,2,0,0,2
944062916419993600,1,1,0,0,2
936110643572236288,0,2,0,0,2
1542305389,0,2,0,0,2
4368507974,0,2,0,0,2
3804928095,0,2,0,0,2
19739900,0,2,0,0,2
3804656716,0,2,0,0,2
19757852,2,0,0,0,2
4370244856,1,1,0,0,2
1489151569987780608,0,2,0,0,2
3801511275,0,2,0,0,2
19847251,0,0,2,0,2
1488928458038288384,0,0,2,0,2
1490494777351032832,0,2,0,0,2
1488910986971131904,0,2,0,0,2
1488875565037854720,0,2,0,0,2
4376648537,0,2,0,0,2
4376835839,0,2,0,0,2
1488781112604254208,0,2,0,0,2
3794446095,0,2,0,0,2
1488629135937503232,0,2,0,0,2
20005513,0,2,0,0,2
4379240362,0,2,0,0,2
4382900482,0,2,0,0,2
19693545,1,1,0,0,2
1489537480990674944,0,2,0,0,2
1489582034121019392,0,2,0,0,2
3813606995,0,2,0,0,2
944158376426172416,0,2,0,0,2
19343245,0,2,0,0,2
3827797517,0,2,0,0,2
1490312630015492096,1,1,0,0,2
1490279965841108992,0,2,0,0,2
1470578228,0,0,2,0,2
1490190873140809728,1,1,0,0,2
19447498,0,2,0,0,2
19454788,0,2,0,0,2
19456096,0,2,0,0,2
1490118897906900992,0,0,0,2,2
1490085377163796480,2,0,0,0,2
1541343396,1,1,0,0,2
3822618741,0,2,0,0,2
944449808940412928,0,2,0,0,2
4361651235,0,2,0,0,2
4361857575,0,2,0,0,2
1489683283864608768,0,2,0,0,2
4363929372,2,0,0,0,2
4365430516,0,2,0,0,2
1489645489163501568,0,2,0,0,2
1483710602401005568,0,2,0,0,2
946217223835869184,0,2,0,0,2
958124367816388608,0,2,0,0,2
24839495,0,2,0,0,2
1550094144,0,2,0,0,2
1550855047,0,0,0,2,2
3562773193,0,2,0,0,2
1476786398350872576,0,2,0,0,2
3557130193,0,2,0,0,2
3556278496,0,2,0,0,2
4524851481,1,1,0,0,2
1475875296142192640,0,2,0,0,2
3548525477,0,2,0,0,2
24829880,0,2,0,0,2
3544676597,0,2,0,0,2
1477159845224595456,2,0,0,0,2
24997928,1,0,0,1,2
3539178132,0,2,0,0,2
3538567276,0,2,0,0,2
3535027635,0,2,0,0,2
25041901,1,1,0,0,2
25051173,0,2,0,0,2
25057168,1,0,1,0,2
3533725153,0,2,0,0,2
1475008639421190144,0,2,0,0,2
25210758,0,2,0,0,2
1549926878,0,2,0,0,2
24403055,0,2,0,0,2
3531929175,0,2,0,0,2
1446565903,0,2,0,0,2
3603021318,0,2,0,0,2
23619366,0,2,0,0,2
23712638,1,1,0,0,2
1478676320099971072,0,2,0,0,2
23748576,2,0,0,0,2
23779363,1,1,0,0,2
947486475788177408,2,0,0,0,2
3600399443,0,2,0,0,2
1478418237452787712,1,1,0,0,2
3600379096,1,1,0,0,2
947500204944699392,0,2,0,0,2
3576945315,0,2,0,0,2
3589446677,0,2,0,0,2
1477906084085993472,2,0,0,0,2
1477888255169216512,0,2,0,0,2
24161930,2,0,0,0,2
3581901795,0,2,0,0,2
1477681414745251840,0,2,0,0,2
1549209552,0,0,1,1,2
24261700,0,2,0,0,2
1477417183143673856,1,1,0,0,2
1477375308365975552,0,2,0,0,2
1552587715,0,2,0,0,2
1474844811005886464,0,2,0,0,2
935779637120126976,0,2,0,0,2
26447612,0,2,0,0,2
1554070063,1,1,0,0,2
1472063643294568448,0,1,1,0,2
26058859,0,2,0,0,2
26088764,1,1,0,0,2
26134177,0,2,0,0,2
26281746,0,2,0,0,2
1440480240,2,0,0,0,2
1440309608,2,0,0,0,2
3492546376,0,2,0,0,2
26431083,0,2,0,0,2
26451758,0,1,0,1,2
948601069214601216,0,2,0,0,2
1554980808,0,2,0,0,2
1471444720865796096,2,0,0,0,2
1471438683916099584,0,2,0,0,2
1471376499005542400,0,2,0,0,2
934790884671008768,0,2,0,0,2
26562748,0,2,0,0,2
26616725,1,0,1,0,2
3482548037,0,2,0,0,2
1555663747,2,0,0,0,2
4565879957,0,1,0,1,2
1472174141872562176,0,2,0,0,2
25817610,0,2,0,0,2
4537541940,0,2,0,0,2
1473469633499856896,0,2,0,0,2
1474763401427656704,0,0,2,0,2
3529369636,0,2,0,0,2
4537884082,0,2,0,0,2
1474420417657925632,0,2,0,0,2
1553625925,1,0,1,0,2
1442022392,2,0,0,0,2
1474259581358546944,0,2,0,0,2
1474051876492660736,0,2,0,0,2
3522920601,0,2,0,0,2
3522821362,0,2,0,0,2
1473421301087977472,1,0,1,0,2
25816723,0,2,0,0,2
3521181132,0,2,0,0,2
3519663253,2,0,0,0,2
3515583735,1,1,0,0,2
25661299,1,1,0,0,2
1472963102136324096,0,2,0,0,2
25691038,0,0,0,2,2
3508000277,0,2,0,0,2
25754979,0,2,0,0,2
1472838624332943360,0,0,0,2,2
25796722,0,2,0,0,2
23541116,0,0,0,2,2
23490130,1,1,0,0,2
23436708,1,1,0,0,2
3662710875,0,2,0,0,2
22025158,0,2,0,0,2
1482192369546059776,0,2,0,0,2
22052085,0,2,0,0,2
3670834282,0,2,0,0,2
946396611646693376,1,0,0,1,2
1482039580543143936,0,2,0,0,2
1482033493672710144,0,2,0,0,2
946409383302332416,0,2,0,0,2
1454092566,0,2,0,0,2
3663393012,0,2,0,0,2
22226402,0,2,0,0,2
1482310598499131392,0,2,0,0,2
22232322,0,2,0,0,2
935492125126549504,0,0,0,2,2
4465742120,2,0,0,0,2
3655110615,0,2,0,0,2
1481748429705740288,0,2,0,0,2
1481709755915722752,0,2,0,0,2
1453102652,0,2,0,0,2
1452509766,0,2,0,0,2
3650005332,0,2,0,0,2
3649902014,0,2,0,0,2
22009055,0,2,0,0,2
1482406743514959872,0,2,0,0,2
23419370,0,1,1,0,2
4448733178,0,2,0,0,2
3688876599,0,2,0,0,2
1483346106289471488,0,2,0,0,2
4443022282,0,2,0,0,2
1483285212167651328,1,1,0,0,2
1483273206803107840,0,2,0,0,2
21627049,0,2,0,0,2
1457852508,0,2,0,0,2
21702621,0,1,1,0,2
21714655,0,2,0,0,2
1482934433648832512,0,2,0,0,2
1482751421061677056,1,0,1,0,2
4456843753,0,2,0,0,2
1482657362087673856,0,2,0,0,2
4450828093,0,2,0,0,2
1482632905969045504,0,2,0,0,2
21834961,1,1,0,0,2
1456331970,0,2,0,0,2
1482631625812946944,0,2,0,0,2
1482624074073448448,0,2,0,0,2
4456022056,0,2,0,0,2
1455956190,0,2,0,0,2
4456601476,1,1,0,0,2
1547585768,1,1,0,0,2
22391737,0,2,0,0,2
4469290273,0,2,0,0,2
4491047896,0,2,0,0,2
4484365275,1,0,0,1,2
1480065760382832640,0,2,0,0,2
1449362354,0,2,0,0,2
3626184012,0,2,0,0,2
1480025132424855552,0,2,0,0,2
1479792114590371840,0,2,0,0,2
3623078431,2,0,0,0,2
947170482503200768,0,2,0,0,2
4489431507,0,2,0,0,2
947173454259798016,1,0,1,0,2
1479540453649559552,0,2,0,0,2
22442442,1,0,0,1,2
3616653492,0,2,0,0,2
23183433,0,2,0,0,2
4491790579,0,2,0,0,2
1479397364783800320,0,2,0,0,2
3608634312,0,2,0,0,2
23294336,0,2,0,0,2
1448195142,0,2,0,0,2
1479134541528846336,0,2,0,0,2
1479071154316791808,0,2,0,0,2
23371273,0,2,0,0,2
3627651320,0,0,0,2,2
22898130,0,2,0,0,2
1449626893,2,0,0,0,2
4480872021,0,2,0,0,2
22466396,0,2,0,0,2
22480368,0,2,0,0,2
1481511759123030016,0,2,0,0,2
1450895618,0,2,0,0,2
3647538858,0,2,0,0,2
1481382552929660928,0,2,0,0,2
1450428668,0,2,0,0,2
946978876395106304,1,1,0,0,2
947046346464350208,2,0,0,0,2
1480882939751718912,0,2,0,0,2
22631085,0,1,0,1,2
22658326,0,2,0,0,2
1480840654250983424,0,2,0,0,2
22677899,0,2,0,0,2
22680155,0,2,0,0,2
22688688,1,1,0,0,2
1480789693792854016,0,2,0,0,2
3635222715,0,2,0,0,2
1480538284900061184,0,2,0,0,2
22747984,0,1,1,0,2
22749273,0,2,0,0,2
1492367677427716096,0,0,2,0,2
936540962964344832,1,1,0,0,2
4319618547,1,1,0,0,2
1500878676027654144,2,0,0,0,2
4056813085,0,2,0,0,2
1502582596911382528,0,1,0,1,2
937864552582139904,0,2,0,0,2
4056209999,0,2,0,0,2
1502257540662444032,2,0,0,0,2
4055575932,0,2,0,0,2
1501906738668355584,0,2,0,0,2
4054741160,0,2,0,0,2
1496847175,0,2,0,0,2
1501590429602615296,0,2,0,0,2
1500800354249809920,0,2,0,0,2
14459133,0,2,0,0,2
940777758291935232,0,2,0,0,2
14634830,0,2,0,0,2
940792914673889280,0,1,1,0,2
1527532441,0,2,0,0,2
14644641,2,0,0,0,2
1500385517023764480,0,0,1,1,2
14702119,0,2,0,0,2
4204937001,0,2,0,0,2
4046436802,0,2,0,0,2
4046388531,0,2,0,0,2
1502923910316240896,0,2,0,0,2
1497809706,0,2,0,0,2
1499955792786690048,2,0,0,0,2
14225448,0,2,0,0,2
1513609522254053376,1,1,0,0,2
14051638,0,2,0,0,2
940612028829392896,0,2,0,0,2
1503088254,0,2,0,0,2
1511954083741003776,1,0,0,1,2
4072786517,0,2,0,0,2
14172125,0,2,0,0,2
1510601967206531072,1,0,1,0,2
1509881248856129536,0,2,0,0,2
4193338754,0,2,0,0,2
1501055257,0,2,0,0,2
4200655093,1,1,0,0,2
1526211403,0,2,0,0,2
4065386361,0,2,0,0,2
4195043062,0,2,0,0,2
1505856678297837568,0,1,1,0,2
14303901,0,2,0,0,2
14310701,0,2,0,0,2
937951747410030592,0,2,0,0,2
1504859292251295744,0,2,0,0,2
4062347837,0,2,0,0,2
14398442,0,1,0,1,2
937601215181021184,0,2,0,0,2
4042772774,0,2,0,0,2
1475788963,0,1,1,0,2
4017636567,0,2,0,0,2
1498821233177202688,1,0,1,0,2
1498735750028066816,1,1,0,0,2
4222154833,2,0,0,0,2
15229872,2,0,0,0,2
1498638683989319680,0,0,2,0,2
4019159134,1,1,0,0,2
1498571728066605056,0,2,0,0,2
1498556210122870784,0,2,0,0,2
15363308,2,0,0,0,2
1530148956,0,2,0,0,2
1498383943619727360,2,0,0,0,2
4025455888,0,2,0,0,2
1498346138491133952,1,1,0,0,2
1498292491300257792,0,2,0,0,2
15477558,2,0,0,0,2
1498265768147959808,0,2,0,0,2
1498224163005378560,0,2,0,0,2
1530333793,0,2,0,0,2
1491138384,0,2,0,0,2
1498201473360232448,0,2,0,0,2
15530557,0,2,0,0,2
1490858090,2,0,0,0,2
4023530926,0,2,0,0,2
15129460,0,2,0,0,2
1499757375271862272,0,2,0,0,2
1499146350134497280,0,2,0,0,2
1499694324707213312,0,0,0,2,2
1499540370908061696,0,2,0,0,2
1499473907027484672,0,2,0,0,2
14807056,0,2,0,0,2
1499416144788299776,0,2,0,0,2
1495566594,1,1,0,0,2
4210630174,0,1,0,1,2
4210818493,0,2,0,0,2
1495502808,0,2,0,0,2
1499232923010146304,1,0,0,1,2
937479265334861824,0,2,0,0,2
1498929695903129600,0,2,0,0,2
1499077229376159744,0,2,0,0,2
1499062210982821888,0,1,1,0,2
14949375,2,0,0,0,2
14960142,0,2,0,0,2
14962858,0,2,0,0,2
4032775835,0,2,0,0,2
4032485530,0,2,0,0,2
1493620422,1,1,0,0,2
15060567,0,2,0,0,2
941256492812046336,1,0,1,0,2
14005492,0,2,0,0,2
13971332,0,2,0,0,2
13752982,0,2,0,0,2
939468689199448064,0,2,0,0,2
5548282,2,0,0,0,2
5770992,2,0,0,0,2
5820642,2,0,0,0,2
5880102,0,1,1,0,2
939391957402574848,1,1,0,0,2
4121836762,0,2,0,0,2
4121735293,0,2,0,0,2
4121375553,0,2,0,0,2
1526701636923564032,0,2,0,0,2
4119855640,0,2,0,0,2
6460072,1,1,0,0,2
1515425887,1,1,0,0,2
6471092,0,2,0,0,2
1514393952,0,2,0,0,2
4117351692,0,2,0,0,2
6875652,1,1,0,0,2
1514318172,0,2,0,0,2
4167462443,0,2,0,0,2
939481500650758144,2,0,0,0,2
4167898214,0,2,0,0,2
4169309422,2,0,0,0,2
4107476403,0,2,0,0,2
4125053417,0,2,0,0,2
1530619942403448832,1,0,0,1,2
13641592,2,0,0,0,2
4151773234,1,1,0,0,2
938733206181941248,0,2,0,0,2
4144705385,0,1,1,0,2
1546730331302408192,0,0,0,2,2
622873,1,1,0,0,2
685883,0,2,0,0,2
4143354372,0,2,0,0,2
1519231586,0,2,0,0,2
1519561764,2,0,0,0,2
939127503469334528,0,2,0,0,2
939155783165599744,0,2,0,0,2
1516683194,0,2,0,0,2
4312711,1,0,1,0,2
939170459177828352,2,0,0,0,2
1534988873964703744,0,1,0,1,2
1520308651,0,2,0,0,2
1520327442,1,1,0,0,2
4132812327,0,2,0,0,2
4157594363,0,2,0,0,2
1532174306134097920,0,0,0,2,2
1532015636645154816,0,2,0,0,2
4158556393,1,0,1,0,2
4159511788,0,0,1,1,2
4107283833,0,2,0,0,2
4169710039,0,2,0,0,2
1521936330724638720,2,0,0,0,2
12610772,0,2,0,0,2
11811702,0,2,0,0,2
1524431917,2,0,0,0,2
4183392472,0,2,0,0,2
4083501796,0,2,0,0,2
12154952,0,2,0,0,2
1524486354,0,2,0,0,2
1518839947369021440,0,2,0,0,2
1518839938040709120,0,0,0,2,2
12365412,0,2,0,0,2
940298139243810816,0,0,0,2,2
1518695368883679232,1,0,0,1,2
7950832,0,2,0,0,2
940359490829893632,0,2,0,0,2
4079734634,0,2,0,0,2
938042153699332096,1,1,0,0,2
1516861595393032192,0,2,0,0,2
938031774206234624,0,2,0,0,2
4186660672,0,2,0,0,2
940576567243177984,0,2,0,0,2
4186787057,0,2,0,0,2
4075723839,0,2,0,0,2
1503384888,0,2,0,0,2
1519018974385774592,0,1,0,1,2
11611902,0,2,0,0,2
940125538735210496,0,2,0,0,2
1519318738226536448,2,0,0,0,2
4105748033,0,2,0,0,2
7978862,2,0,0,0,2
1521755204953198592,0,2,0,0,2
1513699508,0,2,0,0,2
1521429786186375168,0,2,0,0,2
1520698304,1,1,0,0,2
4103888727,1,1,0,0,2
4173393737,0,2,0,0,2
1520510881930616832,0,2,0,0,2
9043302,2,0,0,0,2
4174057702,0,2,0,0,2
939669120819318784,0,0,2,0,2
10129252,1,1,0,0,2
10372732,1,0,1,0,2
1519581987039858688,2,0,0,0,2
939940131040980992,1,1,0,0,2
1519487312459350016,0,0,0,2,2
1519461532370931712,1,0,0,1,2
4180103950,0,2,0,0,2
1519381012530094080,1,1,0,0,2
4092125620,0,2,0,0,2
1498178229957705728,0,2,0,0,2
15582239,2,0,0,0,2
1498174921284935680,0,2,0,0,2
1494741589289226240,1,0,1,0,2
942685057269067776,0,2,0,0,2
3929829076,2,0,0,0,2
17446470,1,0,1,0,2
4287597423,0,2,0,0,2
3929277376,1,0,1,0,2
17481972,0,2,0,0,2
4289863216,0,2,0,0,2
17518579,0,2,0,0,2
1494778047152922624,2,0,0,0,2
17537467,0,2,0,0,2
1480279364,1,1,0,0,2
17396161,0,2,0,0,2
1480232072,0,2,0,0,2
17600254,2,0,0,0,2
1494435404250025984,0,2,0,0,2
1479812473,0,2,0,0,2
1494364700465074176,0,2,0,0,2
3918556295,0,2,0,0,2
4295249293,0,2,0,0,2
1494237779420753920,0,2,0,0,2
4297020432,0,2,0,0,2
1494218173024985088,2,0,0,0,2
17401471,0,2,0,0,2
936831907685421056,0,2,0,0,2
17037647,1,0,0,1,2
4273724428,0,2,0,0,2
1482573662,0,2,0,0,2
1482422113,0,2,0,0,2
1496103715912179712,0,2,0,0,2
1496054044015489024,1,0,1,0,2
942477309700984832,0,2,0,0,2
3947256255,0,2,0,0,2
1496033607265107968,2,0,0,0,2
942548761678700544,0,2,0,0,2
1482142958,0,2,0,0,2
1495926891127218176,1,0,0,1,2
1495756458805366784,0,2,0,0,2
1495317118308343808,0,2,0,0,2
1495685036934369280,0,2,0,0,2
1534649808,0,2,0,0,2
4280250913,0,2,0,0,2
17258834,0,2,0,0,2
1495461773318705152,1,0,1,0,2
4280643797,0,2,0,0,2
1495410689426530304,0,2,0,0,2
17329395,2,0,0,0,2
4287115888,0,2,0,0,2
17381334,0,2,0,0,2
1494148060481560576,0,2,0,0,2
17749056,0,2,0,0,2
4299037817,0,2,0,0,2
1492705864507084800,2,0,0,0,2
1493264274235424768,2,0,0,0,2
1493230270258073600,0,2,0,0,2
1493218871817523200,0,2,0,0,2
18149569,0,2,0,0,2
4309908933,0,2,0,0,2
18171063,1,1,0,0,2
18218081,0,2,0,0,2
4311609441,0,2,0,0,2
1492874702292807680,0,2,0,0,2
1477184034,1,1,0,0,2
1492682394998276096,0,2,0,0,2
3909980836,0,2,0,0,2
4315326263,1,1,0,0,2
1492603083637071872,0,2,0,0,2
18385443,0,2,0,0,2
1476656978,0,2,0,0,2
18470499,0,2,0,0,2
1492556907152044032,0,2,0,0,2
1492534875534016512,2,0,0,0,2
943356409114255360,0,2,0,0,2
943360129449316352,0,2,0,0,2
1492473508244631552,0,2,0,0,2
1477916804,0,2,0,0,2
1493283611701030912,0,2,0,0,2
18075767,0,2,0,0,2
1493294208010305536,0,2,0,0,2
3909899115,0,2,0,0,2
17775036,2,0,0,0,2
17782233,1,1,0,0,2
17784904,0,1,0,1,2
1493986599449030656,2,0,0,0,2
17792766,0,2,0,0,2
17804773,0,2,0,0,2
17808673,0,2,0,0,2
17828872,0,2,0,0,2
1536293179,0,2,0,0,2
4303412597,0,2,0,0,2
3902318079,0,2,0,0,2
3901301892,2,0,0,0,2
3901241669,0,2,0,0,2
3900513155,2,0,0,0,2
4307268863,0,2,0,0,2
4307490856,2,0,0,0,2
4307544928,1,1,0,0,2
3893238941,0,2,0,0,2
1493551809608122368,2,0,0,0,2
1493545386006380544,2,0,0,0,2
17039738,0,2,0,0,2
3949118053,0,1,0,1,2
1498024171191820288,0,2,0,0,2
3993362892,0,2,0,0,2
15920704,1,1,0,0,2
4000337594,1,0,1,0,2
15956735,2,0,0,0,2
4242672159,0,2,0,0,2
1497543259551322112,0,2,0,0,2
1497532161678839808,0,2,0,0,2
4242893722,0,2,0,0,2
1488961603,0,2,0,0,2
16032967,2,0,0,0,2
4244468878,0,2,0,0,2
1497480667927568384,0,2,0,0,2
4241801429,0,2,0,0,2
1497465177230348288,0,2,0,0,2
3989099278,0,0,0,2,2
1497365100726042624,0,2,0,0,2
1497328643516899328,2,0,0,0,2
1497280599706460160,2,0,0,0,2
4248471437,1,1,0,0,2
4250539875,0,2,0,0,2
16286244,2,0,0,0,2
3982336485,2,0,0,0,2
1497200701373620224,1,0,1,0,2
4000525811,0,2,0,0,2
1497642790787944448,0,2,0,0,2
942456646206349312,0,2,0,0,2
1497827075788472320,0,2,0,0,2
4011820694,1,1,0,0,2
4011270631,0,2,0,0,2
1497979314322939904,1,1,0,0,2
15679112,0,2,0,0,2
4236209181,0,2,0,0,2
15694971,1,0,1,0,2
937007607126155264,0,2,0,0,2
15717192,0,2,0,0,2
1497853909200556032,0,2,0,0,2
1497844910598283264,0,2,0,0,2
1497823015211782144,0,2,0,0,2
4001937034,0,2,0,0,2
1497820623107624960,2,0,0,0,2
1497777671467847680,0,2,0,0,2
1497755706035826688,0,2,0,0,2
15802905,0,2,0,0,2
941699051849994240,0,2,0,0,2
15823935,0,2,0,0,2
4237051817,0,2,0,0,2
1531554512,0,2,0,0,2
1490401032,0,2,0,0,2
15863347,0,2,0,0,2
3979810455,0,2,0,0,2
16343935,0,2,0,0,2
16348726,0,1,0,1,2
1484191015,0,2,0,0,2
16694610,0,2,0,0,2
16715269,0,2,0,0,2
1485101707,0,2,0,0,2
1496749135814434816,0,1,1,0,2
16738396,0,2,0,0,2
1496747730139435008,2,0,0,0,2
1496745207403974656,0,2,0,0,2
16789008,0,2,0,0,2
1496708114279800832,1,1,0,0,2
1484470213,0,2,0,0,2
1533979561,0,2,0,0,2
936939467633389568,0,2,0,0,2
3957949635,0,2,0,0,2
1483352923,0,2,0,0,2
1496499721598349312,1,0,1,0,2
16980324,0,2,0,0,2
3954010943,0,2,0,0,2
17002737,0,2,0,0,2
1496376851853238272,0,2,0,0,2
3952728313,0,2,0,0,2
1496350579798409216,2,0,0,0,2
3951932146,0,2,0,0,2
1496777559413071872,0,2,0,0,2
1496780177610706944,0,2,0,0,2
16649251,0,2,0,0,2
3964754482,0,2,0,0,2
941922370930929664,0,2,0,0,2
16428036,0,2,0,0,2
16438613,0,2,0,0,2
4255516393,0,2,0,0,2
16441325,0,2,0,0,2
3973525815,0,2,0,0,2
1496997487093366784,0,2,0,0,2
942096046909476864,0,2,0,0,2
942109767165767680,0,2,0,0,2
1496945298970755072,0,2,0,0,2
942146144750243840,0,2,0,0,2
16533779,0,2,0,0,2
4258786649,1,1,0,0,2
3970255997,0,2,0,0,2
1496886126250020864,0,2,0,0,2
16590736,0,2,0,0,2
3969532295,0,2,0,0,2
942273285718462464,0,2,0,0,2
3965638633,0,2,0,0,2
16635357,0,2,0,0,2
1496808605613441024,0,2,0,0,2
4566327556,2,0,0,0,2
948987204407193600,0,2,0,0,2
26745373,1,1,0,0,2
1428942709054713856,2,0,0,0,2
1430202618572386304,0,2,0,0,2
1430091826787078144,2,0,0,0,2
1430010667889827840,0,2,0,0,2
1578539822,0,2,0,0,2
1429685754360442880,1,0,1,0,2
45608788,0,2,0,0,2
1429608599739895808,1,1,0,0,2
1394680322,0,2,0,0,2
3332268173,0,2,0,0,2
45817039,0,2,0,0,2
4802851995,1,1,0,0,2
1430214525278695424,0,2,0,0,2
45830906,0,2,0,0,2
1428803363408277504,1,0,1,0,2
1394234227,0,2,0,0,2
45967198,0,2,0,0,2
3330880793,2,0,0,0,2
46111642,2,0,0,0,2
3330528852,0,2,0,0,2
46149426,0,2,0,0,2
3329612308,0,2,0,0,2
1428269340139433984,0,2,0,0,2
45435723,0,2,0,0,2
1395261925,0,2,0,0,2
46290559,0,2,0,0,2
1430936798897659904,0,2,0,0,2
1431203991346565120,0,2,0,0,2
4792028236,0,2,0,0,2
44584244,0,2,0,0,2
4792308514,0,2,0,0,2
3338726991,2,0,0,0,2
1431026148633284608,0,2,0,0,2
4792519037,0,2,0,0,2
44639842,0,2,0,0,2
3337892283,0,2,0,0,2
44680341,0,2,0,0,2
1430862692898594816,0,2,0,0,2
4794644186,0,2,0,0,2
3337568847,0,2,0,0,2
44834232,0,2,0,0,2
4793047084,0,2,0,0,2
45000407,0,2,0,0,2
3337084030,0,2,0,0,2
3336966525,0,2,0,0,2
4793353421,0,2,0,0,2
1395613524,0,2,0,0,2
45239771,0,2,0,0,2
1430476712890888192,0,2,0,0,2
1428260027412926464,0,2,0,0,2
4805886083,0,2,0,0,2
40338686,0,2,0,0,2
1389029610,0,2,0,0,2
47368721,0,2,0,0,2
931382826439655424,0,2,0,0,2
47405728,0,2,0,0,2
1426557505975504896,0,2,0,0,2
47419120,1,1,0,0,2
47423739,1,0,1,0,2
47435872,0,2,0,0,2
47472163,2,0,0,0,2
1426506066368532480,1,1,0,0,2
1426272369639837696,1,1,0,0,2
1426100054117404672,0,2,0,0,2
4818143933,0,2,0,0,2
955310742877564928,0,2,0,0,2
47650197,0,2,0,0,2
47653726,0,2,0,0,2
1426068360106811392,1,0,0,1,2
47702881,0,0,0,2,2
1425895588990697472,0,1,1,0,2
955422014562603008,0,0,0,2,2
1425737378593918976,0,2,0,0,2
4819095142,0,1,1,0,2
1425508975441760256,0,2,0,0,2
47319667,0,2,0,0,2
47301829,0,0,0,2,2
3327912297,0,2,0,0,2
46775436,2,0,0,0,2
931558438873726976,0,0,0,2,2
46487844,1,1,0,0,2
46496181,0,2,0,0,2
46503479,0,2,0,0,2
1391732262,0,2,0,0,2
1579830428,0,2,0,0,2
1427567246314983424,0,2,0,0,2
3326878001,2,0,0,0,2
46671412,0,2,0,0,2
1427438089941618688,0,2,0,0,2
1427375190636441600,0,0,0,2,2
1426893167853514752,0,2,0,0,2
46837333,0,0,0,2,2
1391192431,0,2,0,0,2
46869996,0,2,0,0,2
46882827,0,2,0,0,2
3325015923,0,2,0,0,2
3324829646,2,0,0,0,2
1580796806,0,2,0,0,2
1389578521,0,2,0,0,2
3323775246,0,2,0,0,2
3322782067,1,1,0,0,2
1396003530,0,2,0,0,2
3339859744,0,2,0,0,2
4790113761,2,0,0,0,2
1436639797209042944,0,2,0,0,2
41404142,0,2,0,0,2
1437172878278021120,0,2,0,0,2
41443956,0,0,2,0,2
41576334,0,2,0,0,2
1436962582506704896,0,2,0,0,2
953444678724214784,0,2,0,0,2
41716199,0,1,0,1,2
41828703,0,2,0,0,2
4764280980,1,1,0,0,2
41850935,1,1,0,0,2
1436621377277251584,0,2,0,0,2
1573739468,0,2,0,0,2
4765875314,1,1,0,0,2
3351103197,0,2,0,0,2
1574915011,0,2,0,0,2
3350260367,2,0,0,0,2
42141479,0,2,0,0,2
42168969,0,2,0,0,2
1436034776318812160,0,2,0,0,2
42215896,1,1,0,0,2
1399194204,1,1,0,0,2
3349400207,0,0,0,2,2
4758568336,0,1,0,1,2
3355450373,0,2,0,0,2
3339919967,0,2,0,0,2
3359376700,0,2,0,0,2
40470027,0,2,0,0,2
1404291386,0,2,0,0,2
3361382713,1,1,0,0,2
40529132,0,2,0,0,2
952990627742003200,0,2,0,0,2
1439162088493142016,0,2,0,0,2
952994314153594880,1,0,1,0,2
40601630,0,2,0,0,2
3359816000,0,2,0,0,2
40718595,0,2,0,0,2
40769714,0,2,0,0,2
1402083824,0,2,0,0,2
953052829953884160,0,2,0,0,2
1403085170,0,2,0,0,2
40886943,0,2,0,0,2
1438286861265367040,0,0,2,0,2
1438207370157441024,0,2,0,0,2
41089758,0,2,0,0,2
1402516160,0,2,0,0,2
1437996172145164288,0,0,0,2,2
41146054,0,2,0,0,2
1573708573,1,1,0,0,2
1575325609,0,2,0,0,2
1435830650821431296,0,2,0,0,2
3347513260,0,2,0,0,2
3343196494,2,0,0,0,2
43312399,1,0,0,1,2
4777224753,0,2,0,0,2
43329795,0,2,0,0,2
1577052721,1,1,0,0,2
43490035,2,0,0,0,2
3344018993,0,2,0,0,2
3343976705,0,2,0,0,2
954394825901596672,0,2,0,0,2
3343692912,0,2,0,0,2
1432883953355132928,0,0,1,1,2
1432680237708546048,1,0,1,0,2
1575375541,0,2,0,0,2
1432513139464081408,0,1,0,1,2
43909545,0,2,0,0,2
44085606,0,2,0,0,2
44114466,0,2,0,0,2
3342167843,0,2,0,0,2
44165363,0,2,0,0,2
1431784586544095232,1,1,0,0,2
1431705697658433536,0,2,0,0,2
1396406984,0,2,0,0,2
44461671,1,0,0,1,2
43212672,0,2,0,0,2
3345673300,0,2,0,0,2
1434385491273519104,0,0,0,2,2
3345679565,0,2,0,0,2
42387555,0,2,0,0,2
4770409963,0,2,0,0,2
3347199549,0,2,0,0,2
932068755856936960,1,1,0,0,2
42618271,0,2,0,0,2
3346354985,0,2,0,0,2
1435097882986782720,0,2,0,0,2
932048685566955520,0,2,0,0,2
42685874,0,2,0,0,2
954146422537953280,0,2,0,0,2
42787639,0,2,0,0,2
1434834245604806656,0,2,0,0,2
42805562,1,0,0,1,2
42841145,0,2,0,0,2
4774335633,0,2,0,0,2
42847757,0,2,0,0,2
1434799589148745728,0,2,0,0,2
1434740734070964224,0,2,0,0,2
42976640,0,2,0,0,2
3345725843,0,2,0,0,2
4774539388,0,2,0,0,2
47904386,0,2,0,0,2
1425421276953382912,0,2,0,0,2
1425397878034419712,1,0,0,1,2
1413582334134259712,0,2,0,0,2
52079138,1,1,0,0,2
52098306,1,0,1,0,2
1414133928454148096,0,2,0,0,2
4849105026,1,0,0,1,2
957277654578814976,1,0,0,1,2
52250044,0,2,0,0,2
1413777487897808896,1,1,0,0,2
52337911,0,2,0,0,2
52345273,0,2,0,0,2
1376011021,0,2,0,0,2
52442787,0,2,0,0,2
1414440529962717184,2,0,0,0,2
1413424309805060096,0,2,0,0,2
1413259191595278336,0,2,0,0,2
3305649568,0,2,0,0,2
4853505269,0,1,0,1,2
52768455,0,2,0,0,2
52887521,1,0,0,1,2
1412878161985998848,0,2,0,0,2
53003701,0,2,0,0,2
3305106217,0,2,0,0,2
53015553,0,2,0,0,2
51917005,0,2,0,0,2
1414466981105831936,0,0,0,2,2
1585904383,1,0,0,1,2
1415604450807488512,0,2,0,0,2
4842405982,2,0,0,0,2
1586344920,1,0,0,1,2
51197722,0,2,0,0,2
4843081899,0,2,0,0,2
1416054688949145600,2,0,0,0,2
1416007812673466368,1,0,0,1,2
1415927899585138688,0,2,0,0,2
51301878,1,1,0,0,2
3308672783,0,2,0,0,2
51415963,0,2,0,0,2
3308340296,0,2,0,0,2
930767110720147456,0,2,0,0,2
4844284508,1,0,0,1,2
51680123,0,2,0,0,2
930855299665334272,2,0,0,0,2
3307803688,0,2,0,0,2
1415026482288553984,0,1,0,1,2
1414905824498135040,1,1,0,0,2
51752365,0,2,0,0,2
1377005215,1,0,0,1,2
1414760941309382656,0,2,0,0,2
51839330,0,2,0,0,2
1412479729127415808,0,2,0,0,2
957628103152553984,0,2,0,0,2
53153646,0,2,0,0,2
54854562,0,2,0,0,2
957938893160148992,1,1,0,0,2
54515435,0,2,0,0,2
1409629943747825664,0,2,0,0,2
930053580077252608,0,2,0,0,2
1371725376,0,2,0,0,2
1409479429227630592,0,1,1,0,2
3302088785,0,2,0,0,2
1409015387425939456,0,2,0,0,2
958033081813864448,0,2,0,0,2
3301851219,0,2,0,0,2
54855812,1,1,0,0,2
53158294,0,2,0,0,2
54927454,1,0,0,1,2
3301727562,0,2,0,0,2
1408628962218151936,0,2,0,0,2
1590097332,0,2,0,0,2
55245281,1,0,1,0,2
4863851482,0,1,0,1,2
55389338,0,0,0,2,2
55488463,0,2,0,0,2
55551182,0,2,0,0,2
3301265789,0,2,0,0,2
54451006,0,2,0,0,2
54310289,0,2,0,0,2
957831788293836800,0,2,0,0,2
1589296218,0,2,0,0,2
53296006,1,0,0,1,2
53314990,2,0,0,0,2
957648706714722304,0,2,0,0,2
1411567432590794752,0,2,0,0,2
957714121310355456,2,0,0,0,2
1411446372285382656,1,1,0,0,2
53650356,0,2,0,0,2
53730785,0,0,0,2,2
1589059459,0,2,0,0,2
53858050,0,2,0,0,2
53875510,1,1,0,0,2
53886610,0,2,0,0,2
1410522276643049472,1,0,0,1,2
1373042797,0,2,0,0,2
3303668659,0,2,0,0,2
53970033,0,2,0,0,2
53977215,2,0,0,0,2
3303511654,0,2,0,0,2
1410308699709743104,0,2,0,0,2
1410299649102069760,0,2,0,0,2
4857179132,0,2,0,0,2
4842265467,0,2,0,0,2
956896680833638400,0,2,0,0,2
1387060718,2,0,0,0,2
3315632037,0,2,0,0,2
48443814,0,2,0,0,2
3317038394,0,2,0,0,2
1423000128869208064,0,0,0,2,2
3316279985,0,2,0,0,2
48813321,0,2,0,0,2
48815914,2,0,0,0,2
3315912644,1,1,0,0,2
956159615166812160,0,1,0,1,2
48957019,2,0,0,0,2
1421926074859020288,0,2,0,0,2
4829545919,0,2,0,0,2
48394143,0,2,0,0,2
4829664712,0,2,0,0,2
49078623,0,2,0,0,2
4830584368,0,2,0,0,2
49156409,1,1,0,0,2
1421304949745459200,0,2,0,0,2
1421299043561476096,0,2,0,0,2
49201190,0,2,0,0,2
956322297870278656,0,2,0,0,2
3314302387,0,2,0,0,2
1420785884811743232,1,1,0,0,2
3317323402,0,1,0,1,2
3317529025,2,0,0,0,2
1378554852,0,2,0,0,2
4822073618,0,2,0,0,2
1386963115,0,2,0,0,2
1425178285982588928,1,1,0,0,2
48022536,0,2,0,0,2
48032877,0,2,0,0,2
1425110848880594944,0,2,0,0,2
1425078623258697728,0,2,0,0,2
48071635,0,2,0,0,2
1424813235325128704,0,2,0,0,2
48126768,0,2,0,0,2
1424616322600734720,0,2,0,0,2
955827866163269632,0,2,0,0,2
1423640666005925888,0,2,0,0,2
4823388221,0,2,0,0,2
48298579,1,1,0,0,2
1581669979,0,2,0,0,2
4824917175,0,2,0,0,2
48320257,0,2,0,0,2
48321395,1,1,0,0,2
1385590958,1,0,0,1,2
3317900413,1,1,0,0,2
1385290944,1,0,1,0,2
48351177,0,2,0,0,2
4833269817,0,2,0,0,2
4833849027,0,0,2,0,2
49427517,0,2,0,0,2
50649068,0,2,0,0,2
50262004,2,0,0,0,2
1417680771360333824,1,1,0,0,2
4837773581,0,2,0,0,2
1417559554821349376,0,2,0,0,2
4837906036,2,0,0,0,2
1417069180302491648,0,2,0,0,2
3311695823,0,2,0,0,2
3311680114,0,2,0,0,2
3311282674,0,2,0,0,2
1416791365900410880,0,2,0,0,2
3310956065,0,2,0,0,2
956492536163553280,1,1,0,0,2
50683759,0,2,0,0,2
50691301,0,2,0,0,2
1585443884,0,2,0,0,2
50795383,2,0,0,0,2
956877143035793408,0,2,0,0,2
3309856294,2,0,0,0,2
51006340,0,2,0,0,2
51016965,0,2,0,0,2
51022703,0,2,0,0,2
3309819600,1,1,0,0,2
1417849059205730304,0,2,0,0,2
50254699,1,1,0,0,2
3312355684,0,2,0,0,2
50234486,0,1,1,0,2
1420290161586282496,0,2,0,0,2
49569242,0,2,0,0,2
49577527,0,2,0,0,2
3313633062,1,0,0,1,2
1419683952525287424,0,1,0,1,2
4834967849,2,0,0,0,2
49654286,0,2,0,0,2
956587267312832512,0,2,0,0,2
1419583507811258368,0,0,0,2,2
1419314254587449344,1,1,0,0,2
1584336518,0,2,0,0,2
49759174,0,2,0,0,2
1419291926369538048,2,0,0,0,2
49783346,0,2,0,0,2
3312972837,0,2,0,0,2
49863285,2,0,0,0,2
1418740726599389184,0,2,0,0,2
1418468356403777536,0,2,0,0,2
50005040,0,2,0,0,2
3312559945,2,0,0,0,2
1418200698332667904,2,0,0,0,2
3363029830,0,2,0,0,2
1440081067390615552,0,2,0,0,2
3469038634,1,1,0,0,2
1460631054813831168,0,0,1,1,2
1428184699,0,2,0,0,2
1461281779151781888,0,2,0,0,2
30472862,0,2,0,0,2
1461178907080933376,0,1,0,1,2
950226184809467904,0,2,0,0,2
3415155005,1,1,0,0,2
1461016068387143680,0,2,0,0,2
1460834685358067712,0,2,0,0,2
1460745274461241344,0,2,0,0,2
4654247636,0,2,0,0,2
1460340624587059200,0,2,0,0,2
3417167529,0,2,0,0,2
31087194,0,2,0,0,2
4654658064,0,2,0,0,2
1426166485,0,2,0,0,2
3410756824,0,2,0,0,2
4655960675,0,2,0,0,2
31166117,0,2,0,0,2
1459906885751083008,0,2,0,0,2
1459822540155613184,0,2,0,0,2
3410029923,0,2,0,0,2
3409634873,0,0,2,0,2
1428459367,0,2,0,0,2
1461774993725997056,0,1,0,1,2
31375369,1,1,0,0,2
29993833,0,2,0,0,2
1559432262,1,1,0,0,2
3424463359,0,2,0,0,2
29487053,0,2,0,0,2
4636338923,1,1,0,0,2
1462694069428051968,1,1,0,0,2
29592756,2,0,0,0,2
29686487,0,2,0,0,2
3423938298,2,0,0,0,2
1462394384138313728,0,2,0,0,2
29815531,0,2,0,0,2
30009487,0,2,0,0,2
4645311915,0,2,0,0,2
3421660815,0,2,0,0,2
30044637,0,2,0,0,2
30077339,0,2,0,0,2
30165114,0,2,0,0,2
3421555995,0,0,0,2,2
30184765,0,1,0,1,2
30203926,0,2,0,0,2
3421185513,0,2,0,0,2
3420290915,0,2,0,0,2
934228272598024192,1,0,0,1,2
3409147324,0,2,0,0,2
1425443156,0,2,0,0,2
40280373,0,2,0,0,2
1457883326266568704,0,2,0,0,2
3405463577,0,2,0,0,2
1458146080743321600,1,0,0,1,2
1425130328,0,2,0,0,2
32517371,0,2,0,0,2
32544370,1,1,0,0,2
1458061943625945088,1,0,0,1,2
4670326837,2,0,0,0,2
3404639717,0,2,0,0,2
1457976387902459904,0,2,0,0,2
1457893146541506560,1,1,0,0,2
32671919,0,1,1,0,2
4667023213,2,0,0,0,2
32674474,0,2,0,0,2
950766252770889728,0,2,0,0,2
32789279,0,2,0,0,2
1457633750674780160,2,0,0,0,2
1457628922204594176,0,2,0,0,2
1424840197,2,0,0,0,2
950769226356150272,0,2,0,0,2
3401759614,0,2,0,0,2
32950484,0,2,0,0,2
933815128864239616,0,2,0,0,2
32481861,0,2,0,0,2
1458289005540384768,0,2,0,0,2
31496965,0,2,0,0,2
3407673472,1,1,0,0,2
1459314888497676288,0,2,0,0,2
1425362959,0,2,0,0,2
31727719,0,0,1,1,2
3408249370,0,2,0,0,2
31935840,0,2,0,0,2
1425345446,0,2,0,0,2
32146797,0,2,0,0,2
1458879554102038528,0,2,0,0,2
3407949585,0,2,0,0,2
32189808,0,2,0,0,2
32280889,0,2,0,0,2
3405607240,0,2,0,0,2
4663909067,0,2,0,0,2
933878332868804608,0,2,0,0,2
1458696512918097920,0,2,0,0,2
3406844134,0,2,0,0,2
32332637,0,2,0,0,2
32388784,0,2,0,0,2
32404613,0,2,0,0,2
32421337,0,2,0,0,2
950668827884310528,0,2,0,0,2
3405911607,0,2,0,0,2
29415992,0,2,0,0,2
29412015,2,0,0,0,2
29403871,0,1,0,1,2
1557284174,0,2,0,0,2
3439525175,0,2,0,0,2
4593018380,0,2,0,0,2
1468614109516214272,2,0,0,0,2
1435644168,0,2,0,0,2
27590402,0,2,0,0,2
1468296647004520448,0,2,0,0,2
1468132887731916800,2,0,0,0,2
1468094505005899776,0,2,0,0,2
1467818093078589440,2,0,0,0,2
1434926424,0,2,0,0,2
27847441,0,1,1,0,2
4591356563,0,2,0,0,2
27861747,0,2,0,0,2
3436417443,0,2,0,0,2
1467219940209950720,2,0,0,0,2
1467122540418007040,0,2,0,0,2
1467081161721585664,0,2,0,0,2
949562884954050560,0,2,0,0,2
1467008606029582336,0,2,0,0,2
4607204592,0,2,0,0,2
28089569,0,2,0,0,2
1466704445471739904,0,2,0,0,2
27463759,0,2,0,0,2
949323617195700224,0,2,0,0,2
1463171000149807104,0,1,1,0,2
27099985,0,2,0,0,2
26751213,0,2,0,0,2
3467491336,1,1,0,0,2
4568671157,0,2,0,0,2
1470661404155736064,0,2,0,0,2
3458686042,0,0,0,2,2
1556168569,0,2,0,0,2
3457241777,0,2,0,0,2
4574475083,1,0,0,1,2
1437349212,0,2,0,0,2
1470290957589520384,0,2,0,0,2
1469730187805790208,2,0,0,0,2
1468780801932226560,0,2,0,0,2
1436803190,1,1,0,0,2
1469635972488966144,0,2,0,0,2
1469622270054354944,0,2,0,0,2
27272730,1,1,0,0,2
27309226,0,2,0,0,2
27318560,1,1,0,0,2
1469329814070824960,0,2,0,0,2
4589251881,0,2,0,0,2
3440108473,0,0,1,1,2
949233812973674496,0,2,0,0,2
28097613,0,2,0,0,2
949650425589809152,0,2,0,0,2
1466521394267791360,2,0,0,0,2
3431239329,0,2,0,0,2
4622248102,0,2,0,0,2
4623072433,0,2,0,0,2
1464784207050387456,0,1,1,0,2
28805232,0,2,0,0,2
28822847,0,2,0,0,2
1558322876,1,1,0,0,2
1464518735734185984,0,2,0,0,2
3431480841,0,2,0,0,2
28873954,1,1,0,0,2
4631299574,0,2,0,0,2
29025050,1,1,0,0,2
1466471679278956544,1,1,0,0,2
3431098684,1,1,0,0,2
29051261,0,2,0,0,2
3429811519,2,0,0,0,2
1464107754520465408,2,0,0,0,2
4631914842,0,2,0,0,2
4632181699,0,2,0,0,2
1463874014196158464,0,2,0,0,2
949871410377191424,0,2,0,0,2
3427961044,1,1,0,0,2
4634333482,0,2,0,0,2
4620858263,0,2,0,0,2
1465268275240071168,0,1,1,0,2
28629425,0,2,0,0,2
1465270410715430912,0,2,0,0,2
28194996,0,2,0,0,2
1558181821,0,2,0,0,2
28235832,0,0,1,1,2
1466222467588898816,0,1,0,1,2
28283874,1,0,1,0,2
1466198420352344064,0,2,0,0,2
1466164372812746752,0,2,0,0,2
1466145637519527936,1,1,0,0,2
1432838558,0,2,0,0,2
1466061461344731136,1,1,0,0,2
28416537,0,2,0,0,2
4612743022,0,2,0,0,2
1466050723699998720,0,2,0,0,2
1466029131850784768,0,2,0,0,2
4613077632,1,0,0,1,2
28523024,0,2,0,0,2
1432499354,0,2,0,0,2
28560301,1,1,0,0,2
28562445,0,2,0,0,2
4617430279,0,2,0,0,2
28607373,0,2,0,0,2
33056164,0,2,0,0,2
1457230641045643264,2,0,0,0,2
4682291179,0,2,0,0,2
1444964217333825536,0,2,0,0,2
1445768907780886528,0,2,0,0,2
38036375,1,0,1,0,2
38046203,0,2,0,0,2
1412914850,0,2,0,0,2
4723304478,1,0,1,0,2
1445305796997226496,0,2,0,0,2
952202533157576704,2,0,0,0,2
1445251686646394880,0,2,0,0,2
1445240485195489280,0,2,0,0,2
3373876617,0,2,0,0,2
4728267391,1,1,0,0,2
1412931320,0,2,0,0,2
1444940699640733696,1,1,0,0,2
1444904883925094400,0,2,0,0,2
38281063,0,2,0,0,2
3373749443,0,2,0,0,2
38301822,1,0,0,1,2
38377861,1,1,0,0,2
38411796,0,2,0,0,2
38424924,0,2,0,0,2
4730519908,0,2,0,0,2
1444072189582532608,2,0,0,0,2
1445839971965972480,0,2,0,0,2
1413582656,0,1,0,1,2
1447975110137327616,0,2,0,0,2
3378962668,0,2,0,0,2
37007402,0,2,0,0,2
3380584852,2,0,0,0,2
37090589,0,2,0,0,2
3380335812,2,0,0,0,2
37119394,0,2,0,0,2
952175285167935488,0,2,0,0,2
952178618741993472,0,2,0,0,2
3379391831,0,2,0,0,2
37381618,0,2,0,0,2
1447095366780952576,0,2,0,0,2
37470070,0,2,0,0,2
3377167511,0,2,0,0,2
3378897015,0,2,0,0,2
1414714770,0,0,2,0,2
3378761199,0,2,0,0,2
4716230311,0,2,0,0,2
1414237890,1,0,1,0,2
4716951378,1,0,0,1,2
1446405116525961216,0,2,0,0,2
1446376979339431936,1,1,0,0,2
37714294,0,2,0,0,2
1446311448511193088,0,2,0,0,2
38612968,0,2,0,0,2
1443921605294497792,0,2,0,0,2
1570159688,0,2,0,0,2
39954366,0,2,0,0,2
39604027,0,2,0,0,2
1407198990,0,1,0,1,2
1441650541495402496,1,0,0,1,2
1571044027,0,2,0,0,2
39709526,0,2,0,0,2
3365714151,0,2,0,0,2
1406871109,1,1,0,0,2
1441273073202696192,0,2,0,0,2
932995427900813312,0,2,0,0,2
1441083527051632640,0,2,0,0,2
3365140443,0,2,0,0,2
38665903,0,2,0,0,2
39969029,0,2,0,0,2
40003065,0,2,0,0,2
4745022561,1,1,0,0,2
40026089,0,2,0,0,2
1440917220096348160,0,2,0,0,2
1440758066987692032,2,0,0,0,2
40144582,0,2,0,0,2
1405380894,2,0,0,0,2
3363817006,0,2,0,0,2
952851439247765504,0,2,0,0,2
4741634700,0,2,0,0,2
1441838229028630528,0,2,0,0,2
39541976,1,1,0,0,2
952591850543689728,0,2,0,0,2
1411159339,0,2,0,0,2
38909470,0,2,0,0,2
3370554959,1,1,0,0,2
38934958,0,2,0,0,2
3369969646,0,2,0,0,2
3369761339,0,2,0,0,2
1442946642693525504,0,2,0,0,2
3369696021,0,2,0,0,2
39044562,0,2,0,0,2
39058378,0,2,0,0,2
39072364,0,2,0,0,2
952509984532656128,1,0,0,1,2
1442567471215509504,0,2,0,0,2
39253803,0,2,0,0,2
39285085,0,2,0,0,2
39303612,1,1,0,0,2
1442540789406396416,1,1,0,0,2
1442503988121800704,0,2,0,0,2
39320447,0,2,0,0,2
3367805304,1,1,0,0,2
1570988533,0,2,0,0,2
1447879957926092800,0,2,0,0,2
1569707556,1,1,0,0,2
4682774060,0,2,0,0,2
1455145457244590080,1,0,0,1,2
4689980401,0,2,0,0,2
4690243328,2,0,0,0,2
4690253076,1,1,0,0,2
3396782902,0,2,0,0,2
1455496558426738688,0,2,0,0,2
34180269,2,0,0,0,2
951337388671946752,0,2,0,0,2
1455410767277301760,0,2,0,0,2
34228009,0,2,0,0,2
4693151060,0,0,0,2,2
34266989,0,2,0,0,2
33891546,0,2,0,0,2
1455041194472484864,0,2,0,0,2
3395278798,0,2,0,0,2
34310945,0,2,0,0,2
1454835222076329984,0,2,0,0,2
1454796772648407040,0,2,0,0,2
34356185,0,2,0,0,2
34393808,2,0,0,0,2
951376058569371648,0,2,0,0,2
1454725504502624256,1,0,0,1,2
34554431,0,2,0,0,2
1455812838770057216,0,2,0,0,2
3397656093,0,2,0,0,2
36810063,2,0,0,0,2
4688353364,2,0,0,0,2
3401206874,1,1,0,0,2
1457031862187028480,0,2,0,0,2
4685707616,0,2,0,0,2
33164489,0,2,0,0,2
1456867037192409088,0,2,0,0,2
3400241829,0,0,1,1,2
950876277489233920,2,0,0,0,2
33222406,0,0,1,1,2
4686738030,0,2,0,0,2
4688201143,0,2,0,0,2
1456276019363475456,2,0,0,0,2
33868697,0,2,0,0,2
33420129,0,2,0,0,2
3398775035,0,2,0,0,2
33538427,0,2,0,0,2
1564136730,0,2,0,0,2
3398510849,0,2,0,0,2
33689575,0,2,0,0,2
3398381428,0,2,0,0,2
33824562,1,0,0,1,2
33866614,0,2,0,0,2
951103702579937280,0,2,0,0,2
1454402003296210944,0,2,0,0,2
3394898979,0,2,0,0,2
34596198,1,0,0,1,2
1449115508628807680,1,1,0,0,2
36028398,0,2,0,0,2
36083855,2,0,0,0,2
1415790834,0,2,0,0,2
36197816,1,1,0,0,2
3384195586,0,2,0,0,2
36271552,2,0,0,0,2
4708965014,2,0,0,0,2
1449301360315404288,0,2,0,0,2
1449280006207643648,0,2,0,0,2
36383937,0,2,0,0,2
3383076081,0,1,0,1,2
4694417744,0,2,0,0,2
4709379023,0,2,0,0,2
1448924032808726528,0,2,0,0,2
1448739236920791040,0,2,0,0,2
3382695867,0,2,0,0,2
1569191089,0,2,0,0,2
4709665512,0,2,0,0,2
1448493039891017728,0,1,0,1,2
36691351,0,2,0,0,2
36697842,1,0,1,0,2
4711148614,0,1,0,1,2
3386395696,0,2,0,0,2
3387261575,0,2,0,0,2
35860880,0,2,0,0,2
1450789906389913600,0,2,0,0,2
1453922072565108736,2,0,0,0,2
34697179,0,2,0,0,2
1453777605640036352,1,0,1,0,2
1453606805519495168,0,2,0,0,2
1566251418,0,1,0,1,2
3393531569,0,2,0,0,2
933696799642214400,0,2,0,0,2
4697246484,0,0,0,2,2
4697419530,2,0,0,0,2
1452920549898964992,0,2,0,0,2
35044456,2,0,0,0,2
1419742603,2,0,0,0,2
3391581772,1,0,1,0,2
3391574645,2,0,0,0,2
3391566801,2,0,0,0,2
1452302097035132928,0,1,0,1,2
35434910,0,2,0,0,2
1452089491938635776,0,2,0,0,2
951566729695686656,0,2,0,0,2
1451202801946746880,0,2,0,0,2
3389604502,0,2,0,0,2
1235796846,0,2,0,0,2
127603707,0,2,0,0,2
1095161672,0,2,0,0,2
258475158,0,2,0,0,2
257921477,0,2,0,0,2
257923933,0,2,0,0,2
780202385067024384,0,2,0,0,2
1249935964409147392,0,2,0,0,2
258352025,0,2,0,0,2
258375865,0,2,0,0,2
258390253,0,2,0,0,2
1249815490278625280,0,2,0,0,2
1249766457426079744,0,2,0,0,2
910699065091948544,0,2,0,0,2
1061700198,1,0,0,1,2
1001108858633322496,0,2,0,0,2
1249597042516807680,0,1,0,1,2
1249560010893352960,0,2,0,0,2
258959484,0,2,0,0,2
259088428,2,0,0,0,2
1249504655370891264,0,2,0,0,2
1249435040578031616,0,2,0,0,2
259264989,1,1,0,0,2
1249418739100999680,0,2,0,0,2
780631761797517312,2,0,0,0,2
1249385311521521664,0,2,0,0,2
257906367,1,0,1,0,2
1063014128,0,2,0,0,2
257857123,0,2,0,0,2
257850068,1,1,0,0,2
1063655526,0,2,0,0,2
1250817793542352896,0,2,0,0,2
256373233,0,2,0,0,2
779710914618544128,0,2,0,0,2
256601177,1,1,0,0,2
1250666133851713536,2,0,0,0,2
1000412979651923968,0,0,1,1,2
256968909,0,2,0,0,2
779931210319597568,1,1,0,0,2
257084079,1,1,0,0,2
779956182224076800,0,2,0,0,2
257151862,0,2,0,0,2
779960163977596928,0,2,0,0,2
1250253028579520512,0,1,0,1,2
1250158520051302400,0,2,0,0,2
1000443699820560384,0,2,0,0,2
1250136450911236096,0,2,0,0,2
1250106145211133952,2,0,0,0,2
779998592715067392,0,2,0,0,2
910795340948885504,0,2,0,0,2
257683530,0,2,0,0,2
780717289200943104,0,0,2,0,2
259666001,1,0,0,1,2
1000347213145563136,0,2,0,0,2
262738676,0,2,0,0,2
782132110131924992,0,2,0,0,2
1248063122675511296,0,2,0,0,2
1248005328916099072,0,2,0,0,2
1247975935254515712,0,2,0,0,2
262266685,0,2,0,0,2
1001989161065353216,0,2,0,0,2
1247924416346021888,2,0,0,0,2
1247918820691451904,1,0,0,1,2
2805096200,0,1,1,0,2
782245561655238656,1,1,0,0,2
262773145,0,2,0,0,2
1001150894015004672,0,1,1,0,2
2804700173,0,1,0,1,2
1247719448108085248,0,2,0,0,2
782269317102444544,0,2,0,0,2
1247632037437231104,1,1,0,0,2
1728987414,0,2,0,0,2
1055513430,0,2,0,0,2
1247498812215582720,1,1,0,0,2
2803696517,0,2,0,0,2
263315667,0,0,2,0,2
263406194,0,2,0,0,2
2806331934,1,1,0,0,2
1248217636070215680,0,2,0,0,2
1001841875551113216,0,2,0,0,2
261786049,0,2,0,0,2
259806722,0,2,0,0,2
781103802816626688,0,2,0,0,2
781129082876620800,0,2,0,0,2
781317220613885952,1,1,0,0,2
1249004339617726464,0,2,0,0,2
260208583,1,1,0,0,2
1248996515483435008,0,2,0,0,2
2810607491,0,2,0,0,2
260316020,1,0,1,0,2
260356266,0,2,0,0,2
1248946823701639168,1,1,0,0,2
260478244,0,2,0,0,2
1059280297,0,2,0,0,2
2809006239,0,2,0,0,2
1248498416058920960,0,2,0,0,2
781663843722362880,0,2,0,0,2
1058338177,0,2,0,0,2
1057945303,0,2,0,0,2
1001813051060842496,0,2,0,0,2
1057410452,0,2,0,0,2
781948661248958464,0,2,0,0,2
256105681,2,0,0,0,2
1250890239490568192,0,2,0,0,2
1247257595624058880,0,0,0,2,2
1252688751966466048,0,2,0,0,2
252078412,0,2,0,0,2
252114578,1,0,0,1,2
1717173325,1,1,0,0,2
1252850835937058816,1,1,0,0,2
252139762,0,2,0,0,2
2831602543,0,0,0,2,2
252209020,0,2,0,0,2
1252786391106359296,1,0,0,1,2
1252784527946035200,1,1,0,0,2
1252719401771679744,2,0,0,0,2
1718062165,0,2,0,0,2
2829785529,0,2,0,0,2
2831342505,0,2,0,0,2
252520118,0,2,0,0,2
2831324290,0,0,2,0,2
252636775,1,1,0,0,2
1070834641,0,2,0,0,2
1252570948085129216,0,2,0,0,2
252786063,0,2,0,0,2
2830617183,0,2,0,0,2
252953862,0,2,0,0,2
252959232,0,0,0,2,2
252016342,0,2,0,0,2
2831738192,2,0,0,0,2
1252910409297858560,0,2,0,0,2
251818933,0,2,0,0,2
1074242293,0,2,0,0,2
1715288959,0,1,1,0,2
1715414071,0,2,0,0,2
998412396887707648,0,2,0,0,2
911530605103374336,0,2,0,0,2
1253351931910606848,0,2,0,0,2
777421248057880576,0,2,0,0,2
1253330593921695744,0,2,0,0,2
251136448,1,1,0,0,2
251237359,1,0,0,1,2
911521465698279424,0,2,0,0,2
1715788291,0,2,0,0,2
1253278457544531968,0,2,0,0,2
251268932,0,2,0,0,2
998587246373634048,0,2,0,0,2
251542906,0,2,0,0,2
1253033268125011968,0,2,0,0,2
998602165756276736,0,2,0,0,2
1071867942,0,2,0,0,2
251731335,1,1,0,0,2
911280399032229888,0,2,0,0,2
2830299164,0,2,0,0,2
1252357075797266432,0,2,0,0,2
256030718,0,2,0,0,2
2822797093,0,2,0,0,2
910953190392320000,0,2,0,0,2
2824018208,2,0,0,0,2
254864247,0,2,0,0,2
999972772293107712,0,2,0,0,2
1251406040198975488,0,2,0,0,2
255082169,0,0,2,0,2
1066259821,0,1,1,0,2
2823133454,0,2,0,0,2
2822907243,1,1,0,0,2
1721714312,1,1,0,0,2
255554199,0,0,0,2,2
1252340653499047936,0,2,0,0,2
255583467,0,2,0,0,2
2822578197,2,0,0,0,2
779210246938124288,0,2,0,0,2
2822139971,0,2,0,0,2
1251054181521084416,2,0,0,0,2
255822028,0,2,0,0,2
779373885179453440,0,2,0,0,2
255967872,2,0,0,0,2
1250934456359272448,0,0,0,2,2
779403949975625728,1,1,0,0,2
910985906076753920,0,2,0,0,2
911057639005548544,0,2,0,0,2
254740543,0,0,2,0,2
1721130294,0,2,0,0,2
1252291163471654912,0,2,0,0,2
999147889338220544,0,2,0,0,2
253498519,1,0,0,1,2
2828464319,0,2,0,0,2
2828265590,0,2,0,0,2
911147415260008448,0,2,0,0,2
253770322,0,0,1,1,2
1068208171,0,2,0,0,2
1251872269103779840,2,0,0,0,2
1720718389,1,1,0,0,2
253923857,1,0,0,1,2
2826931852,0,2,0,0,2
254294455,0,2,0,0,2
1251752192417071104,0,2,0,0,2
1251623635191808000,0,2,0,0,2
2826086804,2,0,0,0,2
254461877,0,2,0,0,2
254473516,1,1,0,0,2
2824851401,0,2,0,0,2
778589018757931008,0,1,1,0,2
254563418,0,2,0,0,2
2802416107,0,2,0,0,2
1247168996165722112,0,2,0,0,2
2834059631,0,2,0,0,2
2787155991,1,1,0,0,2
1003681338975834112,0,2,0,0,2
1045365006,2,0,0,0,2
785504777660751872,0,2,0,0,2
272838173,0,2,0,0,2
1243834753826140160,0,2,0,0,2
1003699852092551168,0,2,0,0,2
1045146589,0,1,0,1,2
272909967,0,0,2,0,2
272912601,0,2,0,0,2
2787401280,2,0,0,0,2
1243640841727590400,1,0,0,1,2
2785580569,0,2,0,0,2
1243579606906490880,0,0,2,0,2
1044631296,0,2,0,0,2
1243567719485558784,1,1,0,0,2
1243489421321617408,0,0,0,2,2
273323590,0,1,1,0,2
273339355,0,2,0,0,2
785623786804477952,0,2,0,0,2
785754444457734144,0,2,0,0,2
1243389371547447296,1,1,0,0,2
786082590205902848,1,0,0,1,2
1243983632244641792,1,1,0,0,2
1045547496,0,2,0,0,2
272573967,0,2,0,0,2
272503721,0,2,0,0,2
1048214598,0,2,0,0,2
1740454531,0,2,0,0,2
270586147,0,2,0,0,2
1244356884632440832,2,0,0,0,2
1741065020,0,2,0,0,2
785131571279896576,0,2,0,0,2
785158661110951936,0,2,0,0,2
2789567600,1,1,0,0,2
2789367973,0,2,0,0,2
1047132330,2,0,0,0,2
2789128573,0,2,0,0,2
271526585,2,0,0,0,2
2789087095,0,2,0,0,2
271743799,0,2,0,0,2
271819395,0,2,0,0,2
2788788260,1,0,0,1,2
1244124522611011584,1,0,1,0,2
2788345931,1,1,0,0,2
1003606244874182656,0,2,0,0,2
2788296134,0,2,0,0,2
272423422,0,2,0,0,2
273832718,0,2,0,0,2
1004023215235256320,2,0,0,0,2
909845596139335680,0,0,0,2,2
1241723367872397312,0,2,0,0,2
277037872,0,2,0,0,2
1242068248226652160,0,2,0,0,2
2781281855,0,2,0,0,2
1241969407951171584,0,0,2,0,2
277226852,0,0,0,2,2
2781152517,0,2,0,0,2
787195899294261248,0,2,0,0,2
909366472576815104,2,0,0,0,2
2780971784,1,1,0,0,2
277617377,0,2,0,0,2
1831744928,0,2,0,0,2
1243100096520024064,0,2,0,0,2
2780540981,2,0,0,0,2
278004125,0,2,0,0,2
1241630189102206976,0,2,0,0,2
1039514863,0,1,0,1,2
787372816270258176,0,2,0,0,2
1039513892,0,2,0,0,2
787439419011674112,1,1,0,0,2
278420326,0,2,0,0,2
278455137,0,2,0,0,2
1241412185949007872,2,0,0,0,2
1242205225383006208,0,2,0,0,2
276727319,0,2,0,0,2
1242249975268020224,0,2,0,0,2
1242295344794234880,0,2,0,0,2
2785077424,0,2,0,0,2
1042347673,1,1,0,0,2
1242895834288660480,0,2,0,0,2
1004104110717788160,0,0,0,2,2
274660905,0,2,0,0,2
1242815214543941632,2,0,0,0,2
1242763418530013184,0,0,0,2,2
274922912,0,2,0,0,2
2783611431,0,2,0,0,2
275228879,0,2,0,0,2
275498007,0,0,2,0,2
1242567591165480960,1,1,0,0,2
275662572,0,2,0,0,2
275955591,0,2,0,0,2
1242497226187964416,0,2,0,0,2
276016978,1,1,0,0,2
1242453844929286144,1,1,0,0,2
276158936,0,2,0,0,2
276178942,1,1,0,0,2
1004390134622507008,2,0,0,0,2
1040414852,0,2,0,0,2
2791052198,0,2,0,0,2
784800748219555840,0,0,0,2,2
1247154501758283776,0,2,0,0,2
265963799,1,1,0,0,2
783513305830846464,0,2,0,0,2
1246371196473503744,0,2,0,0,2
1246305213398450176,0,2,0,0,2
265328525,0,2,0,0,2
265338025,2,0,0,0,2
265450460,0,2,0,0,2
1246153007382720512,0,2,0,0,2
265676869,2,0,0,0,2
909980244798464000,1,0,1,0,2
2798863589,0,2,0,0,2
1246087204650311680,0,2,0,0,2
783856461193641984,0,2,0,0,2
265976761,0,1,0,1,2
265987405,0,2,0,0,2
2797670928,0,2,0,0,2
1002547781578493952,0,2,0,0,2
266288746,1,1,0,0,2
266352262,0,2,0,0,2
783756104383725568,0,2,0,0,2
1051760114,0,2,0,0,2
266438608,0,2,0,0,2
1245878924397162496,0,2,0,0,2
264954642,1,0,0,1,2
264807341,0,2,0,0,2
1246489292584529920,1,1,0,0,2
264731683,0,2,0,0,2
1247120698818072576,0,1,0,1,2
1002224937090912256,0,2,0,0,2
1002246713615179776,0,2,0,0,2
1729816471,0,2,0,0,2
1054647138,2,0,0,0,2
1246917232107630592,1,1,0,0,2
264138532,1,1,0,0,2
1054299612,1,1,0,0,2
1246846806475943936,2,0,0,0,2
1246834500794904576,2,0,0,0,2
1246817673159327744,0,0,0,2,2
1246815179934961664,0,2,0,0,2
1002279611256987648,0,2,0,0,2
1730425278,0,2,0,0,2
2800750079,0,2,0,0,2
1246781545458827264,0,2,0,0,2
1731550555,0,2,0,0,2
910017901943431168,0,2,0,0,2
1246551660035313664,1,1,0,0,2
1052681628,0,2,0,0,2
1246504927670624256,2,0,0,0,2
1245836280417726464,0,2,0,0,2
267048017,0,2,0,0,2
270144827,0,2,0,0,2
1245021117405896704,0,2,0,0,2
2794405275,2,0,0,0,2
784217543833690112,0,2,0,0,2
1245214872721293312,0,2,0,0,2
1245207041230155776,0,2,0,0,2
2794298976,0,2,0,0,2
268846839,0,2,0,0,2
1049760602,0,2,0,0,2
269043889,0,2,0,0,2
1049621443,0,2,0,0,2
269195863,0,2,0,0,2
1244975359310864384,0,2,0,0,2
267066867,0,2,0,0,2
2793615313,0,2,0,0,2
2793483047,0,2,0,0,2
1244889351957315584,0,2,0,0,2
269371209,2,0,0,0,2
1049093306,0,2,0,0,2
269674328,0,2,0,0,2
2792361295,0,2,0,0,2
269721327,0,2,0,0,2
1244752771657674752,0,1,0,1,2
269783540,0,2,0,0,2
268675403,1,1,0,0,2
1245232554069893120,0,2,0,0,2
1245255401031053312,0,2,0,0,2
1245309637227839488,0,2,0,0,2
267221846,0,2,0,0,2
2797090548,2,0,0,0,2
267272694,0,2,0,0,2
267602505,0,2,0,0,2
1733598534,0,2,0,0,2
1245688494355361792,0,2,0,0,2
2796427605,0,2,0,0,2
2796418845,0,2,0,0,2
267772916,0,0,0,2,2
1245635282235314176,0,1,0,1,2
1050788029,0,2,0,0,2
1245581693047558144,0,2,0,0,2
2796345170,0,2,0,0,2
784001849514950656,0,2,0,0,2
1734347725,0,2,0,0,2
2795713705,0,2,0,0,2
784063318411603968,0,2,0,0,2
1734756686,0,2,0,0,2
268423416,0,2,0,0,2
268423609,0,2,0,0,2
268430680,0,2,0,0,2
2833936432,0,1,1,0,2
911532050691379200,0,2,0,0,2
1267747345837387776,0,2,0,0,2
994459192365846528,0,2,0,0,2
2872095533,0,2,0,0,2
1102786850,0,2,0,0,2
770160611267313664,0,2,0,0,2
233598714,0,2,0,0,2
770180261296365568,0,2,0,0,2
2871297168,0,2,0,0,2
912991937250119680,0,1,1,0,2
233846650,2,0,0,0,2
1263283832964464640,0,2,0,0,2
912971605055115264,0,2,0,0,2
1263201321634672640,0,2,0,0,2
234751453,2,0,0,0,2
1263128428909223936,0,2,0,0,2
1263110392898674688,0,2,0,0,2
1263103773137870848,0,2,0,0,2
234338459,0,2,0,0,2
1100748288,1,1,0,0,2
1263002797756362752,0,2,0,0,2
234484575,0,2,0,0,2
1262936662537109504,0,2,0,0,2
1262889420706856960,0,2,0,0,2
234686357,0,2,0,0,2
1102829888,0,2,0,0,2
1263456185568473088,0,2,0,0,2
769894246740594688,0,2,0,0,2
1263525325864161280,0,2,0,0,2
1264048123535454208,0,2,0,0,2
232233125,0,2,0,0,2
232240452,0,2,0,0,2
1263860395833344000,0,0,2,0,2
1263783241770774528,0,2,0,0,2
994202205291937792,0,2,0,0,2
1263717137467822080,0,0,1,1,2
2873312535,0,2,0,0,2
232792371,0,2,0,0,2
232826358,0,2,0,0,2
232839909,1,1,0,0,2
1263709512684441600,0,2,0,0,2
769620316519862272,2,0,0,0,2
1703961390,0,2,0,0,2
233019856,0,2,0,0,2
233027652,0,2,0,0,2
769760582283071488,0,2,0,0,2
2872976578,0,2,0,0,2
769807041791533056,0,1,1,0,2
233148757,0,1,1,0,2
233164948,0,2,0,0,2
1262848101750050816,0,2,0,0,2
770753022444077056,0,1,1,0,2
767356916,0,2,0,0,2
1097900803,0,2,0,0,2
2865865925,0,2,0,0,2
1098713666,0,2,0,0,2
1261690009754767360,0,2,0,0,2
1261564127970856960,2,0,0,0,2
2865428245,0,2,0,0,2
1098702818,0,2,0,0,2
237309813,0,2,0,0,2
237356136,0,2,0,0,2
995098635061915648,0,2,0,0,2
1098311948,1,0,0,1,2
2865179571,0,2,0,0,2
1262729763451527168,0,2,0,0,2
237642561,0,2,0,0,2
2864892457,0,2,0,0,2
1705689696,0,2,0,0,2
237992857,0,2,0,0,2
238149680,0,2,0,0,2
912691360926445568,0,2,0,0,2
2864177763,0,2,0,0,2
771970225210322944,0,2,0,0,2
2863744486,2,0,0,0,2
771999630175461376,2,0,0,0,2
1261940761265876992,0,2,0,0,2
2865984030,1,1,0,0,2
771356773361917952,0,1,0,1,2
236508711,0,2,0,0,2
235078462,0,2,0,0,2
1262659734752169984,1,1,0,0,2
1100157506,0,2,0,0,2
770990694748004352,0,2,0,0,2
235185931,0,2,0,0,2
235245313,0,2,0,0,2
235357157,1,1,0,0,2
1262365142039384064,0,2,0,0,2
771106491336122368,0,2,0,0,2
235636751,1,1,0,0,2
771261538686541824,0,2,0,0,2
235672911,2,0,0,0,2
235713807,0,2,0,0,2
235830420,0,2,0,0,2
2866313453,0,2,0,0,2
236181217,0,2,0,0,2
236318812,0,1,0,1,2
1262023386210983936,0,2,0,0,2
236412458,0,2,0,0,2
236419828,0,0,0,2,2
1261995531242311680,0,2,0,0,2
2873763315,0,2,0,0,2
1703596009,1,1,0,0,2
238494975,0,2,0,0,2
1699861896,1,0,0,1,2
1266920567380127744,0,2,0,0,2
226310487,0,2,0,0,2
1699769436,0,2,0,0,2
767957605180252160,0,2,0,0,2
1266697335616221184,0,2,0,0,2
2882504082,0,2,0,0,2
1266672770546630656,2,0,0,0,2
1109924664,0,2,0,0,2
2881808024,1,1,0,0,2
226994152,0,2,0,0,2
913477934253465600,0,2,0,0,2
1265943276932169728,2,0,0,0,2
1109205427,0,2,0,0,2
1266384652559843328,0,2,0,0,2
1266377767832236032,0,2,0,0,2
227499062,0,2,0,0,2
227511357,0,2,0,0,2
768380225902129152,0,1,1,0,2
227615419,2,0,0,0,2
1107912259,0,2,0,0,2
1266272531897442304,0,2,0,0,2
1266095167376932864,0,2,0,0,2
2883420156,2,0,0,0,2
226266893,0,2,0,0,2
2884113957,0,2,0,0,2
226074098,0,2,0,0,2
766986580229775360,0,2,0,0,2
1267683655427796992,0,2,0,0,2
992315093928103936,0,2,0,0,2
224564319,1,1,0,0,2
2886106866,0,0,0,2,2
224756187,0,2,0,0,2
1698743167,1,0,0,1,2
224876358,0,2,0,0,2
992342456699162624,0,2,0,0,2
1111138886,0,2,0,0,2
225359694,0,2,0,0,2
225397356,0,2,0,0,2
225438673,0,2,0,0,2
1267341921942306816,1,0,1,0,2
1267221289405747200,0,2,0,0,2
992611593228664832,0,2,0,0,2
225771323,0,2,0,0,2
1267162761601179648,1,1,0,0,2
1267147296480858112,0,2,0,0,2
1267122231148249088,1,0,0,1,2
767347959159742464,2,0,0,0,2
2880442944,0,0,0,2,2
2880009243,0,2,0,0,2
1103940366,0,2,0,0,2
2874898612,0,2,0,0,2
1264867688813297664,1,0,0,1,2
769181718137937920,1,1,0,0,2
230242603,0,2,0,0,2
230243509,0,2,0,0,2
230371227,0,2,0,0,2
230396283,0,2,0,0,2
1264665856908365824,0,2,0,0,2
769276503809032192,0,2,0,0,2
2874964981,2,0,0,0,2
1264412268843929600,1,0,1,0,2
231012468,0,2,0,0,2
768413954955771904,2,0,0,0,2
2874588048,0,2,0,0,2
1264314013665513472,0,2,0,0,2
231179182,0,2,0,0,2
2874092192,0,2,0,0,2
231480361,0,2,0,0,2
1264237148062048256,0,2,0,0,2
1264201631400374272,0,1,1,0,2
231818559,0,2,0,0,2
1104229770,0,2,0,0,2
231876029,0,2,0,0,2
768982188436000768,0,2,0,0,2
2877014742,0,2,0,0,2
229777037,0,2,0,0,2
2877761738,0,2,0,0,2
768447331649916928,0,2,0,0,2
228291151,1,1,0,0,2
1265826854188929024,0,2,0,0,2
1265722472453857280,2,0,0,0,2
993326684131811328,0,2,0,0,2
1265556943894196224,1,1,0,0,2
1265544234234503168,0,2,0,0,2
1265530543040598016,0,2,0,0,2
1265530198558203904,0,2,0,0,2
1265438405720227840,0,2,0,0,2
1265437851061190656,0,2,0,0,2
2878658775,1,1,0,0,2
768721966241030144,0,2,0,0,2
229054690,0,2,0,0,2
1265242076297465856,0,2,0,0,2
229177582,0,2,0,0,2
2877822448,0,2,0,0,2
229355567,0,2,0,0,2
229362718,2,0,0,0,2
1265237484671242240,0,2,0,0,2
2877804431,0,2,0,0,2
238477182,1,1,0,0,2
772073515461869568,0,2,0,0,2
998226177063030784,1,1,0,0,2
246749282,0,2,0,0,2
1081910052,0,2,0,0,2
1256219356553515008,0,1,1,0,2
1256197297634979840,0,2,0,0,2
1256186366246912000,0,2,0,0,2
2844296561,0,2,0,0,2
246555444,1,0,0,1,2
2844227092,0,2,0,0,2
246578623,1,0,0,1,2
1081164588,2,0,0,0,2
246667561,0,2,0,0,2
1255898287996932096,0,2,0,0,2
247216929,0,2,0,0,2
775388341084758016,0,0,2,0,2
997551779641470976,0,2,0,0,2
2843211018,0,2,0,0,2
247025119,0,2,0,0,2
775600899947425792,0,2,0,0,2
247088469,0,2,0,0,2
247153833,2,0,0,0,2
911775858045599744,0,2,0,0,2
2842490193,0,2,0,0,2
2842455229,0,2,0,0,2
1256259077551742976,2,0,0,0,2
775220859682381824,0,2,0,0,2
775180763683627008,0,1,0,1,2
246018602,0,2,0,0,2
244713549,0,0,2,0,2
1085979823,0,2,0,0,2
774578662763073536,0,2,0,0,2
1712144400,0,2,0,0,2
2848226275,0,2,0,0,2
244932670,0,2,0,0,2
2848117404,0,2,0,0,2
1256992603373010944,0,2,0,0,2
244992048,0,2,0,0,2
1256939414841851904,0,2,0,0,2
774630821600890880,0,2,0,0,2
1256863659667619840,0,2,0,0,2
245305752,0,2,0,0,2
1084520400,0,2,0,0,2
245417964,0,2,0,0,2
774880364598816768,1,1,0,0,2
245480863,2,0,0,0,2
1256644369077219328,1,1,0,0,2
1083130801,0,2,0,0,2
774991495648514048,0,2,0,0,2
2845103236,0,2,0,0,2
247216104,0,2,0,0,2
775634466727485440,0,2,0,0,2
1257290297245040640,0,2,0,0,2
2835830851,1,1,0,0,2
1254478998031269888,0,2,0,0,2
2838130393,0,2,0,0,2
1076684418,0,2,0,0,2
249295148,0,2,0,0,2
2837926990,2,0,0,0,2
1254378855181299712,0,2,0,0,2
249494188,0,2,0,0,2
776554838813470720,1,1,0,0,2
2836467196,0,2,0,0,2
1076413538,0,2,0,0,2
250012241,0,1,0,1,2
775641572389953536,0,0,0,2,2
998176022162849792,0,2,0,0,2
776774174647971840,2,0,0,0,2
776779489103613952,0,2,0,0,2
776834038233501696,0,2,0,0,2
2835125360,0,2,0,0,2
1075583947,1,1,0,0,2
2834853891,0,2,0,0,2
1253859781003153408,0,2,0,0,2
250222621,0,0,2,0,2
250477961,0,2,0,0,2
776150328047759360,0,2,0,0,2
776115374953684992,0,2,0,0,2
1254566834042548224,0,2,0,0,2
1254648147688583168,0,2,0,0,2
247449691,0,2,0,0,2
775715244723277824,0,2,0,0,2
1078999172,2,0,0,0,2
1255379298858434560,2,0,0,0,2
247639395,1,1,0,0,2
2841113815,0,2,0,0,2
1255227858869510144,0,2,0,0,2
247749454,0,2,0,0,2
1255206720269402112,0,2,0,0,2
247779761,0,2,0,0,2
1254936970192728064,1,0,0,1,2
248008848,1,1,0,0,2
248037971,0,2,0,0,2
1254845396800745472,0,2,0,0,2
775958975531536384,0,2,0,0,2
248314139,0,0,2,0,2
775963126776799232,1,1,0,0,2
248350853,0,2,0,0,2
775973256327233536,0,2,0,0,2
248470558,1,1,0,0,2
248480514,0,2,0,0,2
997135451105488896,0,2,0,0,2
244549819,0,2,0,0,2
772076593707683840,1,0,1,0,2
995808384661278720,0,2,0,0,2
240599552,0,1,1,0,2
240612597,0,2,0,0,2
1259774271854952448,0,2,0,0,2
1707854503,0,2,0,0,2
240686672,0,2,0,0,2
240733132,0,2,0,0,2
2859165243,0,1,1,0,2
2858939330,0,2,0,0,2
1259654202680320000,0,2,0,0,2
240791489,0,2,0,0,2
240919285,0,2,0,0,2
241863868,1,1,0,0,2
1259536379979067392,0,2,0,0,2
241017790,0,2,0,0,2
772938597137801216,0,2,0,0,2
1259438776595734528,0,0,2,0,2
1259358504986558464,2,0,0,0,2
996058579017838592,0,2,0,0,2
2856175547,0,2,0,0,2
1259194136726573056,0,2,0,0,2
241694489,0,2,0,0,2
1259160603463204864,2,0,0,0,2
1094335994,0,2,0,0,2
772430092291153920,0,2,0,0,2
733612969796472832,2,0,0,0,2
2860542634,0,2,0,0,2
238731792,1,0,1,0,2
1706233866,0,2,0,0,2
1260883207983108096,0,2,0,0,2
238811953,2,0,0,0,2
1260829732607791104,0,2,0,0,2
2862877235,2,0,0,0,2
912680136725499904,1,0,0,1,2
2862504920,0,2,0,0,2
239024759,0,2,0,0,2
239067644,0,2,0,0,2
1260616460847570944,0,2,0,0,2
1260556460439810048,0,2,0,0,2
239392935,0,2,0,0,2
2861394267,0,0,0,2,2
1095694472,0,2,0,0,2
239774360,0,2,0,0,2
239928090,0,0,2,0,2
240037632,0,2,0,0,2
1095636931,0,2,0,0,2
772379782738800640,0,2,0,0,2
240261051,0,0,1,1,2
241831471,0,2,0,0,2
241964958,0,2,0,0,2
1257332207020118016,0,2,0,0,2
2849857343,0,2,0,0,2
996623066003161088,1,0,0,1,2
773662398473535488,0,2,0,0,2
2850279139,0,2,0,0,2
2850206974,0,1,0,1,2
243622009,0,2,0,0,2
243637874,0,2,0,0,2
243660923,0,2,0,0,2
1711088028,0,2,0,0,2
243728937,0,2,0,0,2
243766193,1,0,0,1,2
243993376,0,2,0,0,2
912584461648310272,0,2,0,0,2
244034416,0,2,0,0,2
244086641,0,2,0,0,2
996816256593514496,2,0,0,0,2
1257718038780088320,0,2,0,0,2
1257711486702583808,0,0,0,2,2
244368056,0,2,0,0,2
1086340088,1,1,0,0,2
244415800,0,2,0,0,2
2849061006,0,2,0,0,2
1257353465577312256,0,2,0,0,2
2850933570,0,2,0,0,2
2851155231,0,2,0,0,2
243277786,2,0,0,0,2
2851543613,0,2,0,0,2
773295895265812480,0,2,0,0,2
1259018001325711360,0,2,0,0,2
1259014854226014208,0,2,0,0,2
1258981261051408384,2,0,0,0,2
2854589263,1,1,0,0,2
1258801167808823296,2,0,0,0,2
1258800658590969856,2,0,0,0,2
912391422917042176,1,1,0,0,2
1258741632263950336,0,2,0,0,2
242644025,2,0,0,0,2
1258698839638212608,0,1,0,1,2
2852344789,0,2,0,0,2
242800514,0,2,0,0,2
242885875,0,2,0,0,2
1258454512915951616,0,2,0,0,2
242928817,0,2,0,0,2
1258401252523769856,0,2,0,0,2
243010874,0,2,0,0,2
243054130,0,2,0,0,2
773598288645857280,0,2,0,0,2
2851609655,0,2,0,0,2
278507565,0,2,0,0,2
2779480247,1,1,0,0,2
1241362599901528064,0,2,0,0,2
1218467807555289088,2,0,0,0,2
316492583,0,2,0,0,2
2714837289,0,2,0,0,2
316579915,0,2,0,0,2
2714702428,2,0,0,0,2
1218637677949485056,0,2,0,0,2
2714446859,0,2,0,0,2
316862663,0,2,0,0,2
316942254,0,2,0,0,2
316981458,0,2,0,0,2
2714150103,0,2,0,0,2
317290922,1,1,0,0,2
318061902,0,2,0,0,2
799221111187718144,0,2,0,0,2
799243782545883136,0,2,0,0,2
993419294,0,0,0,2,2
1013204428386721792,0,2,0,0,2
1218220601166520320,1,1,0,0,2
993183206,0,2,0,0,2
317799620,0,2,0,0,2
2712701678,0,2,0,0,2
317867850,0,2,0,0,2
799475995434549248,0,2,0,0,2
2714877791,0,2,0,0,2
2714900780,1,0,1,0,2
2714958579,0,2,0,0,2
316238982,2,0,0,0,2
995683820,0,2,0,0,2
995513514,1,1,0,0,2
314669283,0,2,0,0,2
1012750715419287552,0,2,0,0,2
1219712834382135296,0,0,0,2,2
1219693921023987712,0,2,0,0,2
906249348165632000,0,2,0,0,2
315007364,0,2,0,0,2
995021599,0,2,0,0,2
315178860,0,2,0,0,2
1219633347426758656,0,2,0,0,2
1219557378431029248,0,2,0,0,2
1219540222586818560,0,2,0,0,2
315390967,0,2,0,0,2
1219537290055188480,1,1,0,0,2
1219520872748216320,1,1,0,0,2
2716567923,0,2,0,0,2
799093183498113024,0,2,0,0,2
2716393801,1,1,0,0,2
993807518,1,1,0,0,2
1218874090708029440,0,2,0,0,2
799508887468703744,0,2,0,0,2
2711693856,0,2,0,0,2
1012516685641740288,0,2,0,0,2
988458350,0,2,0,0,2
1215934859052535808,1,1,0,0,2
1215812490400911360,0,2,0,0,2
988811664,0,2,0,0,2
2700673315,0,2,0,0,2
800420755062210560,0,2,0,0,2
800425200336543744,0,2,0,0,2
1013712898328334336,0,1,1,0,2
2699600532,0,2,0,0,2
2699005478,0,2,0,0,2
321254947,0,2,0,0,2
1013764151100035072,0,2,0,0,2
1217386348820041728,0,2,0,0,2
321360475,0,2,0,0,2
321437001,0,2,0,0,2
988185817,1,1,0,0,2
1215399908787621888,0,2,0,0,2
1013783918275977216,0,2,0,0,2
1215328212856606720,0,2,0,0,2
800930412516298752,0,2,0,0,2
321608925,0,2,0,0,2
801061435954655232,0,2,0,0,2
321998691,0,2,0,0,2
1880114912,0,2,0,0,2
990595316,0,2,0,0,2
1216213723406307328,0,2,0,0,2
800062055361417216,0,2,0,0,2
2710623760,1,1,0,0,2
1217173590078042112,0,2,0,0,2
1879293818,0,2,0,0,2
1216734034585358336,2,0,0,0,2
799747129250107392,0,2,0,0,2
2707377797,0,2,0,0,2
991467397,0,2,0,0,2
319127159,2,0,0,0,2
1216650101294338048,0,2,0,0,2
319147282,1,1,0,0,2
1216607394496745472,0,2,0,0,2
319341907,0,0,1,1,2
2706354980,0,2,0,0,2
1216433763963559936,0,2,0,0,2
319481338,0,2,0,0,2
319512191,0,1,0,1,2
1879798590,0,2,0,0,2
799989608243138560,0,2,0,0,2
1216357037681999872,0,2,0,0,2
2705698292,0,0,0,2,2
1216302521918066688,0,1,0,1,2
2718711173,0,2,0,0,2
313911026,2,0,0,0,2
322135631,1,1,0,0,2
2728364632,1,1,0,0,2
1223058093908676608,0,2,0,0,2
1223029832323403776,0,2,0,0,2
2729773861,1,0,0,1,2
308414825,0,2,0,0,2
308419576,0,2,0,0,2
2729142679,1,1,0,0,2
308608636,0,2,0,0,2
308626340,0,2,0,0,2
308710245,0,2,0,0,2
1222750915742093312,1,1,0,0,2
1222688371933351936,0,2,0,0,2
1001065988,0,2,0,0,2
906602412898693120,0,2,0,0,2
906578705417490432,1,1,0,0,2
1222504116695511040,0,2,0,0,2
308967242,0,1,0,1,2
309020381,0,2,0,0,2
309220855,0,2,0,0,2
1222226869677768704,0,0,2,0,2
1011668616247377920,1,1,0,0,2
309848330,0,2,0,0,2
310122024,0,2,0,0,2
2729948822,0,2,0,0,2
2730600502,0,2,0,0,2
1873212073,1,1,0,0,2
2730796742,0,2,0,0,2
1010875395669942272,0,2,0,0,2
1010898724313235456,0,2,0,0,2
1224427129783320576,0,2,0,0,2
1224293883485605888,1,1,0,0,2
1005185244,0,2,0,0,2
1224282754252247040,0,2,0,0,2
306370880,1,1,0,0,2
306470307,1,1,0,0,2
1004373271,0,2,0,0,2
306643256,0,2,0,0,2
1871848686,0,2,0,0,2
1003945908,0,2,0,0,2
796993863793655808,0,2,0,0,2
1223880042381340672,2,0,0,0,2
2731629316,1,0,0,1,2
797014491024281600,0,2,0,0,2
906605920171417600,1,1,0,0,2
307370665,0,2,0,0,2
307436508,0,2,0,0,2
797146640784248832,0,2,0,0,2
307738716,1,0,0,1,2
1001277056,0,2,0,0,2
310439145,1,1,0,0,2
1220072174574129152,0,2,0,0,2
1875110450,0,2,0,0,2
2723220393,0,2,0,0,2
797906720538456064,0,2,0,0,2
999655680,0,2,0,0,2
1221088940880531456,0,2,0,0,2
312166942,0,0,0,2,2
999280766,0,2,0,0,2
312327609,0,2,0,0,2
312466919,0,2,0,0,2
312476144,0,2,0,0,2
312619339,0,2,0,0,2
312792226,0,2,0,0,2
310535567,0,2,0,0,2
2721646099,0,2,0,0,2
1220688622367588352,0,2,0,0,2
2721246826,0,2,0,0,2
313311468,1,1,0,0,2
1220561387585523712,1,1,0,0,2
2720775395,0,1,0,1,2
313449542,0,2,0,0,2
1876421282,0,2,0,0,2
997171812,0,2,0,0,2
996942318,0,0,2,0,2
1221146660731965440,0,2,0,0,2
1221208014922964992,0,2,0,0,2
797881709152833536,0,2,0,0,2
1221287711161622528,0,1,1,0,2
2725361949,0,2,0,0,2
1221971310802194432,0,2,0,0,2
310724233,1,1,0,0,2
310751155,0,2,0,0,2
1221929719219871744,0,2,0,0,2
797699259638382592,0,2,0,0,2
797751635653038080,0,2,0,0,2
1011864644959571968,1,1,0,0,2
310938935,0,2,0,0,2
797785050490294272,0,2,0,0,2
1221714794979438592,1,1,0,0,2
1011872368766148608,0,2,0,0,2
2724936543,0,2,0,0,2
2724880349,0,1,1,0,2
797806566367903744,1,0,0,1,2
311374173,0,2,0,0,2
311382708,0,2,0,0,2
2724044073,1,0,1,0,2
1221382902044295168,0,2,0,0,2
1221356580878389248,0,2,0,0,2
1221345910900260864,1,1,0,0,2
322095351,0,0,2,0,2
986714738,0,2,0,0,2
1241353535465324544,1,1,0,0,2
1891061130,1,0,1,0,2
333915606,2,0,0,0,2
2665817858,0,2,0,0,2
333928030,0,2,0,0,2
334051970,0,2,0,0,2
978319092,0,2,0,0,2
334246880,0,2,0,0,2
334261183,0,2,0,0,2
334423683,0,2,0,0,2
334574673,0,2,0,0,2
334578305,0,2,0,0,2
334689096,0,2,0,0,2
2661864984,2,0,0,0,2
1891542768,2,0,0,0,2
334696051,0,2,0,0,2
977540850,0,2,0,0,2
804200253473705984,1,1,0,0,2
1211535105933496320,1,1,0,0,2
334948123,0,2,0,0,2
1211435409521049600,1,0,1,0,2
2663215282,0,2,0,0,2
977138190,0,2,0,0,2
335194774,0,2,0,0,2
333882193,0,0,1,1,2
2666649781,0,2,0,0,2
333802413,0,2,0,0,2
333693460,2,0,0,0,2
1212403044752584704,0,2,0,0,2
331757950,1,1,0,0,2
803579506070056960,0,2,0,0,2
332328982,0,2,0,0,2
1212289899589582848,1,0,1,0,2
1889534246,0,2,0,0,2
1015683182060945408,0,2,0,0,2
2670060276,0,0,0,2,2
332852460,0,2,0,0,2
2669492127,0,2,0,0,2
2669352938,0,2,0,0,2
979038300,0,2,0,0,2
1212105887390679040,0,2,0,0,2
2668687728,0,2,0,0,2
333360494,0,2,0,0,2
1890081306,1,1,0,0,2
978626180,0,2,0,0,2
333432982,0,2,0,0,2
1212012209301118976,1,1,0,0,2
1211987337195839488,0,2,0,0,2
333595638,0,2,0,0,2
1015918388428918784,0,2,0,0,2
335257928,0,2,0,0,2
331480884,0,2,0,0,2
972736968,0,2,0,0,2
2655816937,2,0,0,0,2
1210161877998866432,0,2,0,0,2
2655634572,0,2,0,0,2
2655377238,0,2,0,0,2
804765166437068800,1,1,0,0,2
337602715,1,0,0,1,2
1209844028545437696,2,0,0,0,2
972829326,0,2,0,0,2
2654115788,0,2,0,0,2
1209687096694173696,0,2,0,0,2
972483564,0,2,0,0,2
2661836502,0,2,0,0,2
1209567518672576512,0,2,0,0,2
805003359388389376,1,0,1,0,2
2652993068,0,2,0,0,2
338004749,1,1,0,0,2
338118668,0,2,0,0,2
338153973,0,2,0,0,2
1209454159201632256,0,2,0,0,2
1209440919746949120,1,1,0,0,2
338315801,0,2,0,0,2
2651580396,0,2,0,0,2
1016364116393562112,0,2,0,0,2
336936601,0,2,0,0,2
2656965931,2,0,0,0,2
2657230276,1,1,0,0,2
1015930974948003840,0,2,0,0,2
905192411432964096,0,2,0,0,2
335318854,0,2,0,0,2
1211143097905598464,1,1,0,0,2
976225218,0,2,0,0,2
1893136567,0,2,0,0,2
975119521,0,2,0,0,2
905186811680616448,0,2,0,0,2
1210882874750029824,1,1,0,0,2
1210877987815477248,0,2,0,0,2
336011569,0,2,0,0,2
1210812009425432576,0,2,0,0,2
804415296085770240,0,2,0,0,2
336150610,0,2,0,0,2
1210705887091781632,0,2,0,0,2
804420978658770944,1,1,0,0,2
336427708,0,2,0,0,2
336459388,0,2,0,0,2
2658840061,1,0,1,0,2
1210541495842983936,0,2,0,0,2
804525059620700160,0,2,0,0,2
331562400,0,2,0,0,2
1212458730685517824,1,0,0,1,2
1215243976917291008,0,2,0,0,2
1213981773614288896,0,2,0,0,2
2691329351,0,2,0,0,2
984152839,0,2,0,0,2
324892417,2,0,0,0,2
801640721396678656,0,2,0,0,2
1214240543800090624,2,0,0,0,2
1214234855153602560,0,2,0,0,2
2689861225,0,2,0,0,2
325540857,1,1,0,0,2
983681036,2,0,0,0,2
1014598228237586432,0,2,0,0,2
1014810320890679296,0,2,0,0,2
327243977,0,2,0,0,2
801877950819958784,0,2,0,0,2
326244104,0,0,2,0,2
1213890118047547392,0,2,0,0,2
1014832297252655104,2,0,0,0,2
326553468,0,2,0,0,2
1213861334703464448,0,2,0,0,2
326883874,0,2,0,0,2
326901658,1,1,0,0,2
1886313704,0,2,0,0,2
327112070,0,2,0,0,2
1214502875994435584,0,2,0,0,2
2691391672,0,2,0,0,2
801476435277971456,0,2,0,0,2
1214617357269815296,0,2,0,0,2
322225068,1,1,0,0,2
2696255059,1,1,0,0,2
1215231893727256576,0,1,0,1,2
1215216297027481600,0,2,0,0,2
1013987880241250304,2,0,0,0,2
1215204300864937984,0,2,0,0,2
986361108,1,1,0,0,2
323083587,0,2,0,0,2
801314237649977344,1,0,1,0,2
323427157,0,2,0,0,2
905968687827562496,0,2,0,0,2
323643527,1,1,0,0,2
323649128,0,2,0,0,2
1214834292611862528,0,2,0,0,2
1214804401811902464,0,2,0,0,2
1014463713720627200,0,2,0,0,2
1014490215078092800,2,0,0,0,2
2692380764,1,1,0,0,2
324049005,2,0,0,0,2
905832727341039616,0,0,0,2,2
801447205378859008,0,2,0,0,2
2683978681,0,2,0,0,2
1213763892263804928,0,2,0,0,2
2673328754,2,0,0,0,2
2676506516,1,1,0,0,2
2679903918,0,2,0,0,2
2679303348,1,1,0,0,2
2679036570,2,0,0,0,2
802909913710264320,0,2,0,0,2
802911333159235584,0,2,0,0,2
1212934077961011200,0,2,0,0,2
1888100275,0,2,0,0,2
330228818,0,2,0,0,2
1212844360200359936,0,2,0,0,2
980440435,1,1,0,0,2
330348706,0,2,0,0,2
327299860,1,1,0,0,2
330465007,1,0,0,1,2
1212780600228118528,0,2,0,0,2
1212778624740282368,0,2,0,0,2
1212756458619564032,0,2,0,0,2
1212669571041124352,1,0,1,0,2
330859655,0,2,0,0,2
331061427,0,2,0,0,2
980046139,2,0,0,0,2
2674753069,0,2,0,0,2
1889277732,0,2,0,0,2
329491213,0,2,0,0,2
1213135287364120576,0,2,0,0,2
329456555,0,0,0,2,2
2680062516,0,2,0,0,2
2683540813,0,2,0,0,2
802459067289661440,0,2,0,0,2
1213625387193749504,0,2,0,0,2
802536747779366912,2,0,0,0,2
327843329,0,2,0,0,2
1015106291495309312,0,2,0,0,2
327891162,0,2,0,0,2
1213494059559350272,0,2,0,0,2
327960822,0,2,0,0,2
802689211635814400,0,2,0,0,2
328325395,0,2,0,0,2
328338911,0,2,0,0,2
328393217,0,2,0,0,2
2681503465,0,2,0,0,2
1213264791403290624,0,2,0,0,2
328859386,0,2,0,0,2
1213200957355388928,0,2,0,0,2
1213196105912995840,0,2,0,0,2
1213193293439229952,0,2,0,0,2
1213179786643697664,1,0,0,1,2
2680268848,0,2,0,0,2
305715428,1,1,0,0,2
305555362,0,2,0,0,2
1224612260397690880,0,2,0,0,2
1235967516427448320,0,2,0,0,2
287424432,0,2,0,0,2
287555166,0,0,1,1,2
287732448,0,2,0,0,2
1236280324004298752,0,2,0,0,2
1236228485884100608,2,0,0,0,2
1236210791063400448,0,2,0,0,2
1236096314238103552,0,2,0,0,2
1006868726480867328,0,2,0,0,2
908354832330665984,0,2,0,0,2
791418321971318784,0,2,0,0,2
1235955860716883968,0,2,0,0,2
1235670904379564032,0,2,0,0,2
288341428,1,0,0,1,2
288343217,0,2,0,0,2
791492356025442304,1,0,1,0,2
791510733938798592,0,2,0,0,2
288720260,0,0,0,2,2
1856465972,0,2,0,0,2
1235855475184263168,0,2,0,0,2
791661052266029056,0,2,0,0,2
1026369271,0,2,0,0,2
1235699081059631104,0,2,0,0,2
287338703,0,2,0,0,2
1236517825570836480,1,0,1,0,2
908393270602076160,0,1,0,1,2
791024027276115968,0,2,0,0,2
1853928650,0,2,0,0,2
790664945662844928,0,2,0,0,2
1237133081452187648,2,0,0,0,2
2762830900,0,2,0,0,2
2762751175,0,2,0,0,2
790677632161415168,0,2,0,0,2
1237031702804885504,1,1,0,0,2
2762411578,0,2,0,0,2
286387486,0,2,0,0,2
286424432,0,2,0,0,2
286455082,1,0,0,1,2
2762385563,1,0,0,1,2
2762271082,1,1,0,0,2
1006558382294228992,0,2,0,0,2
2762098790,0,2,0,0,2
1236703924142440448,2,0,0,0,2
1236635596493410304,0,2,0,0,2
908579320695681024,2,0,0,0,2
1854105618,1,1,0,0,2
287028880,0,2,0,0,2
1027340514,0,2,0,0,2
908266980276191232,0,2,0,0,2
289308588,2,0,0,0,2
790624990567604224,1,0,0,1,2
2754877375,2,0,0,0,2
291546163,0,2,0,0,2
291589629,0,2,0,0,2
1022913458,0,2,0,0,2
2755131689,0,2,0,0,2
291717668,0,2,0,0,2
1234400158600908800,2,0,0,0,2
291785581,0,2,0,0,2
291808796,0,2,0,0,2
291852263,0,2,0,0,2
1022717256,0,2,0,0,2
907583773960757248,0,2,0,0,2
1025961667,0,2,0,0,2
292247912,0,2,0,0,2
2754613564,0,2,0,0,2
2754433686,0,2,0,0,2
292409381,0,2,0,0,2
1022316763,1,0,1,0,2
1233800133789265920,0,2,0,0,2
2753626726,0,2,0,0,2
292447949,0,2,0,0,2
292613742,0,1,0,1,2
292822750,2,0,0,0,2
291496884,0,2,0,0,2
1234506365571387392,0,2,0,0,2
291069429,0,2,0,0,2
2756229297,2,0,0,0,2
1235484848988368896,0,0,0,2,2
1235478672884355072,0,2,0,0,2
2758407969,0,2,0,0,2
791799391182999552,0,2,0,0,2
791801737778692096,0,2,0,0,2
791830348866973696,0,2,0,0,2
908223959233163264,0,2,0,0,2
289785505,0,2,0,0,2
1007258028347928576,2,0,0,0,2
1235222051734073344,0,2,0,0,2
289897331,0,2,0,0,2
791879620521975808,0,2,0,0,2
908215012191113216,0,2,0,0,2
1235140499381551104,0,2,0,0,2
289992125,1,0,0,1,2
1235131784464961536,2,0,0,0,2
290301833,0,2,0,0,2
791951357024489472,0,2,0,0,2
907985964127186944,0,2,0,0,2
1234828303778877440,0,2,0,0,2
1007434928882114560,1,1,0,0,2
1237269982255304704,0,2,0,0,2
285807105,0,2,0,0,2
2733677764,0,2,0,0,2
280609806,0,2,0,0,2
909287285459472384,0,2,0,0,2
1037070872,0,2,0,0,2
1240492463539621888,0,2,0,0,2
280414048,0,2,0,0,2
1036978278,0,2,0,0,2
1240441915725828096,0,2,0,0,2
2775909654,0,2,0,0,2
280492173,0,2,0,0,2
1240346650083831808,0,0,0,2,2
1005373040488734720,0,2,0,0,2
280730503,0,2,0,0,2
1005465452116676608,0,2,0,0,2
280858423,1,1,0,0,2
2775054089,2,0,0,0,2
2774978283,0,2,0,0,2
788826640214323200,0,2,0,0,2
2774382493,0,2,0,0,2
1239966136491483136,0,1,0,1,2
281148368,2,0,0,0,2
1035788941,0,2,0,0,2
281532180,0,2,0,0,2
281658767,0,2,0,0,2
1240613099423567872,1,1,0,0,2
280007491,0,0,0,2,2
1845267631,1,0,1,0,2
2777113181,0,2,0,0,2
1832502638,0,2,0,0,2
1004563263034621952,1,1,0,0,2
2779186753,0,2,0,0,2
787635617752506368,0,2,0,0,2
1241185057336786944,0,0,0,2,2
1241073006253715456,1,1,0,0,2
1241067658709172224,0,2,0,0,2
278958662,0,2,0,0,2
1039161516,0,2,0,0,2
1240994910658072576,0,2,0,0,2
279175663,0,2,0,0,2
1834626078,2,0,0,0,2
787916024360337408,1,1,0,0,2
1004910718360010752,1,1,0,0,2
279450147,0,2,0,0,2
279458428,0,2,0,0,2
2777484226,0,2,0,0,2
788223651682328576,0,2,0,0,2
1240746136413052928,0,2,0,0,2
279758387,0,2,0,0,2
1843940551,2,0,0,0,2
788864973715804160,0,2,0,0,2
1239816710523441152,0,2,0,0,2
285660031,1,1,0,0,2
908647201252851712,2,0,0,0,2
1238344047258984448,1,1,0,0,2
1238340497934082048,1,1,0,0,2
283968369,0,1,0,1,2
790091559349825536,0,2,0,0,2
284158112,0,2,0,0,2
2766437240,0,2,0,0,2
1851512814,0,2,0,0,2
790198912497831936,2,0,0,0,2
1237798297252712448,0,2,0,0,2
908709315627888640,0,0,0,2,2
1030343677,1,1,0,0,2
1239719867495804928,1,1,0,0,2
1029676686,0,2,0,0,2
285026739,0,2,0,0,2
285095344,0,2,0,0,2
1006449003779719168,1,0,0,1,2
1237477043006308352,0,2,0,0,2
1237467453183217664,0,2,0,0,2
1853028702,0,2,0,0,2
285372767,0,2,0,0,2
285499578,0,2,0,0,2
1006534427621683200,1,1,0,0,2
789917215172755456,0,2,0,0,2
1238462636108505088,0,2,0,0,2
283702225,1,1,0,0,2
2768072843,0,2,0,0,2
1005725779479711744,0,2,0,0,2
2772679709,1,0,0,1,2
1239464433572884480,0,2,0,0,2
2772472330,0,2,0,0,2
1033968224,0,2,0,0,2
282489876,0,2,0,0,2
1239302096224243712,0,2,0,0,2
1239266755672821760,0,2,0,0,2
1033240776,0,2,0,0,2
1032929719,0,2,0,0,2
282993947,0,2,0,0,2
789440554807521280,0,2,0,0,2
283056691,0,2,0,0,2
1032153282,0,2,0,0,2
283179898,0,2,0,0,2
789521957645582336,1,0,1,0,2
1032072318,0,2,0,0,2
1238775276030607360,0,2,0,0,2
283416650,0,2,0,0,2
1031845153,0,2,0,0,2
1238652357887442944,2,0,0,0,2
792881328890851328,1,1,0,0,2
792985820307329024,0,2,0,0,2
1233432561361281024,2,0,0,0,2
2740861762,0,2,0,0,2
2741564604,1,1,0,0,2
2741265317,0,2,0,0,2
1228061963193929728,0,2,0,0,2
300644196,0,2,0,0,2
1228048522026659840,0,2,0,0,2
300717177,0,2,0,0,2
1866943310,0,2,0,0,2
300970096,0,2,0,0,2
1011870391,0,2,0,0,2
795624602508480512,0,2,0,0,2
301287268,0,2,0,0,2
2739395681,0,2,0,0,2
1227940610629177344,0,2,0,0,2
1011431766,2,0,0,0,2
795936907813408768,0,2,0,0,2
1227825314023251968,0,2,0,0,2
1009458788208869376,0,2,0,0,2
1867602823,0,2,0,0,2
2739866889,0,2,0,0,2
1227507704857382912,2,0,0,0,2
301894814,1,1,0,0,2
1009499337330749440,0,2,0,0,2
795459221458481152,0,2,0,0,2
1009376491904360448,1,1,0,0,2
1866588008,0,2,0,0,2
300424785,1,1,0,0,2
1864778318,0,2,0,0,2
2742830184,0,2,0,0,2
2742788475,0,2,0,0,2
298946143,0,2,0,0,2
1014034260,0,2,0,0,2
299040857,2,0,0,0,2
906947698514956288,0,2,0,0,2
299242198,2,0,0,0,2
299518755,0,2,0,0,2
299557473,0,2,0,0,2
1228891888494596096,1,1,0,0,2
2742436007,0,2,0,0,2
1228688374736867328,1,0,0,1,2
2742370230,2,0,0,0,2
299811004,1,1,0,0,2
1866510403,0,2,0,0,2
300102563,1,1,0,0,2
300164181,1,0,0,1,2
1228549988256346112,1,1,0,0,2
795257792290586624,0,2,0,0,2
300419873,1,1,0,0,2
2739692243,0,2,0,0,2
302017113,0,2,0,0,2
292907555,1,1,0,0,2
2734769527,1,0,0,1,2
796419365415645184,0,2,0,0,2
1225434070601142272,0,2,0,0,2
1225426405040652288,0,2,0,0,2
1007420174,0,2,0,0,2
1010482162754359296,0,2,0,0,2
304305829,0,2,0,0,2
304346565,0,2,0,0,2
304346846,0,0,0,2,2
304403563,0,2,0,0,2
1225299881863966720,2,0,0,0,2
1225187242378919936,0,2,0,0,2
1009531741315502080,0,2,0,0,2
906754260112691200,0,2,0,0,2
1225129146696765440,2,0,0,0,2
796635410613104640,0,2,0,0,2
304934250,0,2,0,0,2
305251258,0,2,0,0,2
305265706,0,2,0,0,2
1224757885109854208,1,1,0,0,2
305394773,0,2,0,0,2
1010822161928540160,0,2,0,0,2
1871662777,0,2,0,0,2
303729424,0,2,0,0,2
1225826125865082880,2,0,0,0,2
1225866373852782592,0,1,0,1,2
796322659311255552,0,2,0,0,2
302098430,2,0,0,0,2
1227309158057336832,0,2,0,0,2
1010807990,0,2,0,0,2
302495772,0,2,0,0,2
1227065329056198656,0,2,0,0,2
1226956088680935424,0,2,0,0,2
302620787,0,2,0,0,2
2738944001,0,2,0,0,2
2738784802,0,2,0,0,2
1009790139592269824,0,2,0,0,2
906850836998787072,0,2,0,0,2
796174800829890560,1,1,0,0,2
1226503955145842688,1,1,0,0,2
796275781303488512,0,2,0,0,2
2737782208,0,2,0,0,2
1226387894656544768,0,2,0,0,2
796305730945122304,0,2,0,0,2
303149443,0,2,0,0,2
1226113806998224896,0,2,0,0,2
2736984105,0,2,0,0,2
2736963946,0,2,0,0,2
1229261322333782016,0,2,0,0,2
794883158445621248,0,2,0,0,2
794880125728866304,0,2,0,0,2
295025465,0,2,0,0,2
1007928976805855232,0,2,0,0,2
294377836,1,1,0,0,2
294386480,2,0,0,0,2
294452476,0,2,0,0,2
294456746,0,2,0,0,2
2750947647,0,2,0,0,2
294541294,1,0,1,0,2
294782954,0,2,0,0,2
1232379273257738240,0,2,0,0,2
294931471,0,2,0,0,2
1232312078100156416,0,2,0,0,2
2744299913,0,2,0,0,2
295032336,1,1,0,0,2
1232285266880192512,0,2,0,0,2
2750472090,0,2,0,0,2
295260943,1,0,1,0,2
295349218,0,2,0,0,2
1232026465111289856,0,2,0,0,2
2749919953,0,2,0,0,2
295540893,0,2,0,0,2
1231880555311976448,0,2,0,0,2
1231826468507750400,0,2,0,0,2
2751245081,0,2,0,0,2
294370902,0,2,0,0,2
1232585988758745088,0,2,0,0,2
907506806728953856,0,2,0,0,2
1233375756862009344,0,2,0,0,2
2753099757,1,1,0,0,2
1022156058,0,2,0,0,2
1233317359051563008,2,0,0,0,2
293013685,0,2,0,0,2
793096099561177088,0,2,0,0,2
1860393073,0,2,0,0,2
793154980828024832,0,2,0,0,2
1021819339,0,2,0,0,2
1233028786603556864,0,2,0,0,2
1021648242,0,2,0,0,2
293790639,0,2,0,0,2
1232860641242705920,1,0,1,0,2
293962960,0,1,0,1,2
2751705450,0,2,0,0,2
1232715955618402304,1,1,0,0,2
1232691842380128256,0,2,0,0,2
294075288,0,2,0,0,2
294109771,0,2,0,0,2
294266049,0,2,0,0,2
793377481982181376,0,2,0,0,2
1231760251289911296,2,0,0,0,2
793637455341715456,0,2,0,0,2
295717171,0,2,0,0,2
1230515476603842560,0,2,0,0,2
1230381900293865472,0,2,0,0,2
2746252067,0,2,0,0,2
2746240046,1,1,0,0,2
297298424,0,2,0,0,2
1008498123247845376,0,2,0,0,2
2746223653,0,2,0,0,2
297770842,0,2,0,0,2
297851969,0,2,0,0,2
1008592802974875648,0,2,0,0,2
2745453644,1,1,0,0,2
2745345948,0,2,0,0,2
297992129,0,2,0,0,2
1015578116,0,2,0,0,2
2745149015,0,0,1,1,2
2744933393,0,2,0,0,2
1015359992,0,2,0,0,2
794822738129129472,1,1,0,0,2
298355213,0,2,0,0,2
1008682617372278784,0,2,0,0,2
298451969,0,2,0,0,2
298504500,0,2,0,0,2
1230489719626223616,0,2,0,0,2
1017102211,0,2,0,0,2
1231651843664683008,1,1,0,0,2
1017196783,0,2,0,0,2
295764382,0,2,0,0,2
295806714,0,2,0,0,2
1231579891901988864,1,1,0,0,2
1231575965324718080,1,1,0,0,2
1008149019007307776,0,2,0,0,2
1231466234031616000,1,0,0,1,2
295868476,0,2,0,0,2
295897464,0,2,0,0,2
1018167444,0,2,0,0,2
1231165984947539968,0,2,0,0,2
1008351942714593280,0,2,0,0,2
296125826,2,0,0,0,2
296152939,0,2,0,0,2
1230885445610999808,0,2,0,0,2
296234910,0,2,0,0,2
296276433,0,2,0,0,2
296369870,0,2,0,0,2
794139579754381312,1,1,0,0,2
296382406,1,1,0,0,2
1008439671871897600,0,2,0,0,2
1863288516,0,2,0,0,2
766981160278843392,0,2,0,0,2
769540611632431104,2,0,0,0,2
180405385,0,2,0,0,2
187189706,0,2,0,0,2
1305062735567351808,0,2,0,0,2
986363597646385152,0,2,0,0,2
1305071402412912640,0,2,0,0,2
2940384366,0,0,2,0,2
186889582,0,2,0,0,2
1287157114507538432,0,2,0,0,2
187177329,0,0,0,2,2
1159581594,1,1,0,0,2
2939828990,2,0,0,0,2
189979093,0,2,0,0,2
1287060684828741632,0,2,0,0,2
3002361460,0,2,0,0,2
1680654486,0,2,0,0,2
1305247327628783616,0,2,0,0,2
154064699,0,2,0,0,2
981648345650233344,0,2,0,0,2
1305461549553733632,1,1,0,0,2
1209433171,2,0,0,0,2
754178404027539456,2,0,0,0,2
186764020,0,2,0,0,2
1305060565837139968,0,2,0,0,2
154387290,0,2,0,0,2
2941769109,0,2,0,0,2
185850792,2,0,0,0,2
154814375,0,2,0,0,2
2941767905,0,2,0,0,2
1304799091155705856,0,2,0,0,2
1288016417359503360,0,2,0,0,2
186241998,0,2,0,0,2
1287625976470413312,0,2,0,0,2
154697628,0,2,0,0,2
1287570427079020544,1,0,0,1,2
742198200648531968,0,2,0,0,2
986300920307863552,0,2,0,0,2
1287356467524145152,0,2,0,0,2
3001168448,2,0,0,0,2
1304879838323527680,0,2,0,0,2
1287351502768451584,2,0,0,0,2
154541008,1,1,0,0,2
187381709,0,2,0,0,2
2939577281,0,2,0,0,2
1305547051560611840,0,2,0,0,2
153477472,0,2,0,0,2
754992078682107904,2,0,0,0,2
1286281354552864768,2,0,0,0,2
3004282632,0,2,0,0,2
189189845,0,2,0,0,2
2937262183,0,2,0,0,2
189221903,0,2,0,0,2
189272895,0,2,0,0,2
986847481014218752,0,2,0,0,2
1286082486636695552,0,2,0,0,2
189439356,0,2,0,0,2
189466022,0,2,0,0,2
153315016,1,1,0,0,2
919534059726036992,0,2,0,0,2
1285989492357320704,0,2,0,0,2
1285961898240823296,0,2,0,0,2
755345225078476800,0,2,0,0,2
189832672,0,2,0,0,2
189005524,0,1,1,0,2
1286562194486751232,0,2,0,0,2
187567327,1,1,0,0,2
741483937499873280,0,2,0,0,2
187682673,0,2,0,0,2
741974067163598848,2,0,0,0,2
1158564314,0,2,0,0,2
986570829046665216,0,2,0,0,2
153703333,0,2,0,0,2
187872097,0,0,0,2,2
187896248,0,2,0,0,2
188043254,0,2,0,0,2
188095958,0,2,0,0,2
153702897,0,2,0,0,2
1681423154,0,2,0,0,2
188309751,0,2,0,0,2
188316210,0,2,0,0,2
919520481593630720,0,2,0,0,2
741848058447683584,0,2,0,0,2
1286590680387604480,0,2,0,0,2
986612661671645184,0,2,0,0,2
1207948890,0,2,0,0,2
1288240498365276160,0,2,0,0,2
1207636100,0,2,0,0,2
742732369497587712,0,2,0,0,2
156323148,1,1,0,0,2
1289766869688229888,0,2,0,0,2
985810540965527552,0,2,0,0,2
1289733024897212416,0,2,0,0,2
1304132395235377152,0,2,0,0,2
156050368,0,2,0,0,2
2949092680,0,2,0,0,2
985853854234431488,0,2,0,0,2
1164642571,0,2,0,0,2
1304305478319484928,0,2,0,0,2
155909187,1,0,0,1,2
1289514354354851840,0,2,0,0,2
1304311013924167680,0,2,0,0,2
742529432900931584,0,2,0,0,2
2999148097,1,1,0,0,2
155562849,0,2,0,0,2
183172449,0,2,0,0,2
752866136073523200,1,0,0,1,2
156552878,2,0,0,0,2
183265297,0,2,0,0,2
182348800,0,2,0,0,2
156876843,0,2,0,0,2
156766521,2,0,0,0,2
181365084,0,2,0,0,2
156727309,1,0,0,1,2
1165973503,2,0,0,0,2
1303875848290795520,1,1,0,0,2
2950988910,0,2,0,0,2
1202455327,0,2,0,0,2
1303893413046005760,0,2,0,0,2
982253767922860032,0,2,0,0,2
2950970554,1,1,0,0,2
752707774413303808,0,2,0,0,2
985744255128948736,2,0,0,0,2
181768648,0,2,0,0,2
2997866579,0,2,0,0,2
985748757747728384,0,2,0,0,2
181960091,0,2,0,0,2
183181182,0,1,1,0,2
183306644,0,1,0,1,2
1666654892,2,0,0,0,2
184536484,1,0,1,0,2
2999457987,0,2,0,0,2
1288696634482647040,0,2,0,0,2
1205739318,0,2,0,0,2
184870746,0,2,0,0,2
1161903090,0,2,0,0,2
155218188,0,2,0,0,2
185184529,0,2,0,0,2
742418651295457280,1,0,0,1,2
1288358002471428096,0,2,0,0,2
1288345767141421056,0,2,0,0,2
753689689425444864,0,2,0,0,2
3000509880,0,2,0,0,2
155119841,0,2,0,0,2
919111025038938112,0,2,0,0,2
185555270,0,2,0,0,2
986240819211489280,0,2,0,0,2
154995199,0,2,0,0,2
184678546,0,2,0,0,2
1288783638776119296,0,2,0,0,2
916682758281240576,1,1,0,0,2
1288836474188623872,0,2,0,0,2
183566262,0,2,0,0,2
1304433404205694976,0,2,0,0,2
986114785812107264,0,2,0,0,2
753506273333809152,0,2,0,0,2
183786438,2,0,0,0,2
2945751412,0,2,0,0,2
183928181,0,2,0,0,2
1304441226746302464,0,0,2,0,2
1680397800,0,2,0,0,2
184112080,0,2,0,0,2
1288877087617626112,0,2,0,0,2
2945081343,1,0,1,0,2
1304482243956690944,0,2,0,0,2
184299977,0,2,0,0,2
184340732,0,2,0,0,2
2945068790,0,2,0,0,2
753547850823376896,0,0,1,1,2
189858416,0,2,0,0,2
2936098081,0,2,0,0,2
1668871802,0,2,0,0,2
1283244412022267904,1,1,0,0,2
756974016439529472,0,2,0,0,2
150277980,0,0,0,2,2
150223953,0,2,0,0,2
1307862315665035264,0,2,0,0,2
1150283376,0,2,0,0,2
757042052886433792,0,2,0,0,2
150197920,1,1,0,0,2
1307885683013345280,0,1,0,1,2
916026101549367296,1,1,0,0,2
2935789351,0,2,0,0,2
1282991124857028608,0,1,1,0,2
1149952243,0,2,0,0,2
1308111389584748544,2,0,0,0,2
757233724320645120,1,1,0,0,2
195325951,0,2,0,0,2
1282770424519176192,0,2,0,0,2
195377658,0,2,0,0,2
2927860063,1,1,0,0,2
3010417968,0,2,0,0,2
194569251,0,2,0,0,2
2930175889,0,2,0,0,2
1307716008426135552,0,2,0,0,2
150881317,2,0,0,0,2
194131253,0,2,0,0,2
194210858,0,2,0,0,2
1307028992688418816,0,2,0,0,2
3009266221,2,0,0,0,2
1283417556275978240,1,1,0,0,2
1307223056155373568,0,2,0,0,2
150761760,0,2,0,0,2
740435390117642240,0,2,0,0,2
3009617401,1,1,0,0,2
150632621,1,1,0,0,2
1307355820183695360,0,2,0,0,2
3009929742,2,0,0,0,2
3010286342,1,1,0,0,2
3010317684,1,1,0,0,2
150400237,0,2,0,0,2
756952697375453184,0,2,0,0,2
195412076,0,2,0,0,2
195422975,0,2,0,0,2
2927458027,0,2,0,0,2
3012151466,0,2,0,0,2
2925107062,0,2,0,0,2
149502552,0,2,0,0,2
987906080129912832,0,2,0,0,2
1685283966,0,2,0,0,2
196737451,0,2,0,0,2
196870745,0,2,0,0,2
1685858916,0,2,0,0,2
196974789,0,2,0,0,2
757912239659708416,0,2,0,0,2
1308690224843812864,2,0,0,0,2
149030881,0,2,0,0,2
3012625990,0,2,0,0,2
149024511,0,2,0,0,2
197020684,0,2,0,0,2
1281868144584257536,2,0,0,0,2
197409496,0,2,0,0,2
1281856246577070080,0,2,0,0,2
149563261,0,2,0,0,2
1282040650612068352,0,1,0,1,2
1149403472,0,2,0,0,2
981082850781954048,1,0,0,1,2
195656311,1,1,0,0,2
916017143875031040,0,2,0,0,2
1148808553,1,0,0,1,2
195728543,0,2,0,0,2
1282400713813954560,0,2,0,0,2
981122390758391808,0,2,0,0,2
2925946914,0,2,0,0,2
740088997909811200,2,0,0,0,2
2925857606,2,0,0,0,2
2925777646,1,1,0,0,2
196251669,0,2,0,0,2
1282243264620290048,0,2,0,0,2
196489169,0,2,0,0,2
1282152240384335872,1,1,0,0,2
196507529,2,0,0,0,2
1282063085021409280,0,2,0,0,2
3011880510,0,0,0,2,2
981221481609879552,1,0,1,0,2
1307015197396267008,0,1,1,0,2
1283438573182570496,0,2,0,0,2
191460408,0,2,0,0,2
1152745590,0,2,0,0,2
1306302489898213376,0,1,0,1,2
191501180,0,2,0,0,2
191522610,0,2,0,0,2
756322424334016512,0,2,0,0,2
152728674,0,0,2,0,2
152701779,0,2,0,0,2
756345072690532352,1,1,0,0,2
741128547742449664,0,2,0,0,2
1285116139341860864,0,1,0,1,2
1285092541587771392,2,0,0,0,2
191735122,0,2,0,0,2
1214284580,0,2,0,0,2
191755534,0,2,0,0,2
987245859640430592,0,2,0,0,2
1306399738598748160,0,2,0,0,2
1285055953981681664,2,0,0,0,2
3005652427,2,0,0,0,2
191409583,0,2,0,0,2
987261735076802560,1,1,0,0,2
1285341110223634432,0,2,0,0,2
190406136,1,0,0,1,2
1285640273788370944,0,2,0,0,2
2935748351,0,2,0,0,2
1285597507809169408,0,2,0,0,2
1154265278,0,2,0,0,2
190649427,1,1,0,0,2
755834458587136000,0,0,1,1,2
2934790392,1,1,0,0,2
190988523,0,2,0,0,2
3004962415,0,2,0,0,2
1285412858470166528,0,2,0,0,2
191018601,0,2,0,0,2
1683106057,0,2,0,0,2
1211474257,0,2,0,0,2
191112958,0,2,0,0,2
191158795,0,2,0,0,2
1285374180981043200,0,2,0,0,2
756372886353485824,1,1,0,0,2
1306563728926674944,0,2,0,0,2
1664453658,1,1,0,0,2
193070710,0,2,0,0,2
916163822267879424,0,1,1,0,2
1283710458139234304,0,0,0,2,2
740766649717018624,0,2,0,0,2
3007708710,0,0,1,1,2
193252944,0,2,0,0,2
756859179394936832,0,2,0,0,2
193587776,0,2,0,0,2
1150519351,0,2,0,0,2
1283548441457508352,0,2,0,0,2
1283524259365613568,0,2,0,0,2
193880586,0,2,0,0,2
193888204,0,2,0,0,2
756908579026636800,0,2,0,0,2
1283453128231145472,1,0,1,0,2
194087234,1,1,0,0,2
3007982415,0,2,0,0,2
151117957,0,2,0,0,2
193193263,0,2,0,0,2
1283806572448305152,0,1,1,0,2
1152174812,0,2,0,0,2
919804628514066432,0,2,0,0,2
152275734,1,1,0,0,2
1284951325483184128,0,2,0,0,2
152259723,1,0,1,0,2
152230763,1,1,0,0,2
1284905872431493120,0,2,0,0,2
152181438,0,2,0,0,2
756489585446756352,0,2,0,0,2
152107570,0,2,0,0,2
152034412,0,2,0,0,2
1284450175336022016,0,2,0,0,2
192391748,1,0,0,1,2
987286845833621504,0,2,0,0,2
916308961032310784,1,1,0,0,2
3007240016,0,2,0,0,2
1284350792695083008,0,2,0,0,2
1151335200,0,2,0,0,2
1151263100,1,1,0,0,2
181210263,0,1,0,1,2
156907607,0,2,0,0,2
3012629990,0,2,0,0,2
2987158829,0,2,0,0,2
983578420985540608,1,0,0,1,2
983554465818177536,0,2,0,0,2
1181121174,1,1,0,0,2
1296165090102841344,0,2,0,0,2
170666501,0,2,0,0,2
1180328400,0,2,0,0,2
170852399,0,2,0,0,2
1300502174728814592,0,2,0,0,2
170963321,0,2,0,0,2
749558042102947840,0,2,0,0,2
1296051864929218560,0,2,0,0,2
162740948,0,2,0,0,2
170971386,1,1,0,0,2
162732973,0,2,0,0,2
748839766121148416,0,2,0,0,2
162718915,1,0,0,1,2
1300633057305608192,0,2,0,0,2
1295955393076760576,2,0,0,0,2
1193780617,0,2,0,0,2
983633076420071424,1,0,1,0,2
1300289134557196288,1,1,0,0,2
748420263189045248,0,2,0,0,2
169118414,0,2,0,0,2
917744342286110720,1,1,0,0,2
2974914144,1,1,0,0,2
169429164,0,2,0,0,2
1192767230,0,2,0,0,2
1296695754686332928,0,2,0,0,2
1296672397848797184,2,0,0,0,2
169554562,0,1,0,1,2
2974756255,0,2,0,0,2
1193019914,0,0,1,1,2
169862115,0,2,0,0,2
2974229181,0,2,0,0,2
1296473869595947008,1,1,0,0,2
169931937,0,2,0,0,2
984763074677694464,0,2,0,0,2
163374629,2,0,0,0,2
1296408112488833024,0,2,0,0,2
162344507,1,0,0,1,2
1295908831805861888,0,2,0,0,2
1295906203546132480,0,2,0,0,2
2968681072,0,2,0,0,2
1295247624606384128,2,0,0,0,2
1295231456026013696,0,2,0,0,2
2967619211,2,0,0,0,2
749243504900145152,0,2,0,0,2
1300971147173920768,2,0,0,0,2
983390886892580864,0,2,0,0,2
172630108,0,2,0,0,2
984992748359970816,0,2,0,0,2
1295092502077218816,0,2,0,0,2
161674056,0,2,0,0,2
985018043586707456,0,2,0,0,2
172969854,0,2,0,0,2
749524041585819648,0,2,0,0,2
161649422,0,2,0,0,2
173114103,0,2,0,0,2
749556271557316608,0,2,0,0,2
161649239,0,2,0,0,2
749139983525613568,0,2,0,0,2
984905734310842368,0,2,0,0,2
1295888335769083904,0,2,0,0,2
1295424090258329600,0,2,0,0,2
1295814355917746176,1,1,0,0,2
1671988705,0,2,0,0,2
2988181169,0,2,0,0,2
1295791195910574080,0,2,0,0,2
984866096439353344,1,0,1,0,2
745351426117869568,0,2,0,0,2
171448189,0,2,0,0,2
171461799,0,2,0,0,2
171470729,0,2,0,0,2
983422517812629504,0,2,0,0,2
2970460743,0,2,0,0,2
984888714622054400,0,2,0,0,2
984899057930862592,0,2,0,0,2
171654055,0,2,0,0,2
2969711866,0,2,0,0,2
1300907685479698432,0,2,0,0,2
2969673880,0,2,0,0,2
2975814810,1,0,1,0,2
2975826580,2,0,0,0,2
1192316876,1,1,0,0,2
164750364,0,2,0,0,2
1299336413784096768,0,2,0,0,2
164417762,0,2,0,0,2
166097729,0,2,0,0,2
746777498877321216,0,2,0,0,2
983906086867668992,0,2,0,0,2
2983607230,0,2,0,0,2
166348894,0,2,0,0,2
1298397871213969408,2,0,0,0,2
166500776,0,2,0,0,2
1298320567083311104,1,1,0,0,2
747021696402526208,0,2,0,0,2
2980272874,0,2,0,0,2
166702774,0,0,0,2,2
1299561141031464960,2,0,0,0,2
2980151938,0,2,0,0,2
166784096,0,2,0,0,2
1298198858086797312,2,0,0,0,2
1298682386197229568,0,2,0,0,2
165711444,0,2,0,0,2
1187277944,0,2,0,0,2
165690516,0,2,0,0,2
1299087773601861632,0,2,0,0,2
1299052898178027520,0,2,0,0,2
1299043445017735168,0,2,0,0,2
1299017112489525248,0,2,0,0,2
164901858,0,2,0,0,2
1299007360208236544,0,2,0,0,2
1299131581542531072,0,2,0,0,2
746641310853955584,0,2,0,0,2
165173427,0,2,0,0,2
917765509764009984,0,2,0,0,2
165349010,0,2,0,0,2
1298911186092605440,2,0,0,0,2
165473091,0,1,1,0,2
2981933152,0,2,0,0,2
165641975,1,1,0,0,2
165646058,0,1,0,1,2
165676066,0,2,0,0,2
1673296868,0,2,0,0,2
1298118513849184256,0,2,0,0,2
1297098212138840064,1,0,0,1,2
984403455996583936,1,0,0,1,2
2978168505,0,2,0,0,2
1185795433,0,0,0,2,2
168394093,0,2,0,0,2
163809794,0,2,0,0,2
1299937344854859776,2,0,0,0,2
984456210077376512,0,2,0,0,2
1297233715832266752,0,2,0,0,2
1673569092,0,2,0,0,2
1297212457828704256,0,2,0,0,2
168566474,0,2,0,0,2
2976584450,0,2,0,0,2
984551397285945344,0,2,0,0,2
1297154614467399680,0,2,0,0,2
2984659296,2,0,0,0,2
747885665883348992,0,2,0,0,2
163655954,0,1,1,0,2
1297132545197273088,0,0,0,2,2
1297447117544476672,0,2,0,0,2
167736169,2,0,0,0,2
166929600,1,1,0,0,2
167735422,1,0,1,0,2
917916327096045568,0,2,0,0,2
983760391217008640,0,2,0,0,2
984098946149765120,0,2,0,0,2
164357577,0,2,0,0,2
2979314212,0,2,0,0,2
1297988952654114816,2,0,0,0,2
747285470325858304,2,0,0,0,2
2984496896,1,0,0,1,2
167091076,1,0,0,1,2
1297930232846929920,0,2,0,0,2
1186841839,1,1,0,0,2
167285293,1,1,0,0,2
1297795266779787264,0,2,0,0,2
1299925568188641280,2,0,0,0,2
1297766968104062976,0,2,0,0,2
1297705585261985792,1,1,0,0,2
984330868033556480,0,2,0,0,2
173212647,2,0,0,0,2
173326511,0,2,0,0,2
181134499,0,2,0,0,2
2955472020,0,2,0,0,2
158080824,0,2,0,0,2
177650297,0,2,0,0,2
751204756673007616,2,0,0,0,2
751307176094920704,1,0,0,1,2
2955533476,0,2,0,0,2
1291728442673844224,0,2,0,0,2
1199421578,2,0,0,0,2
177980349,0,2,0,0,2
751470861459288064,1,0,0,1,2
161620762,0,1,0,1,2
158066000,0,2,0,0,2
1291626002553040896,1,1,0,0,2
178290163,0,1,0,1,2
178315951,0,2,0,0,2
178331309,0,0,0,2,2
1170203690,0,2,0,0,2
2994470720,0,2,0,0,2
1676556722,0,2,0,0,2
177590559,0,2,0,0,2
985444389630726144,0,2,0,0,2
2994169968,0,2,0,0,2
177576761,0,2,0,0,2
177047795,0,2,0,0,2
743740197871857664,0,2,0,0,2
1292377105884278784,0,2,0,0,2
1171890439,0,2,0,0,2
1302702270254112768,0,2,0,0,2
1292317794738962432,0,2,0,0,2
177226195,0,2,0,0,2
158750958,0,2,0,0,2
1292235489202728960,1,1,0,0,2
1292148428508524544,0,2,0,0,2
2956880672,0,2,0,0,2
177512074,0,2,0,0,2
1303013496825753600,0,2,0,0,2
177531124,0,2,0,0,2
1292135570827644928,2,0,0,0,2
1171582363,0,2,0,0,2
1303017848952905728,0,2,0,0,2
178655258,0,2,0,0,2
1676940242,2,0,0,0,2
2994505935,0,2,0,0,2
1677425180,0,2,0,0,2
752142281248010240,1,1,0,0,2
2951894690,0,2,0,0,2
752185708501237760,0,2,0,0,2
1167486020,2,0,0,0,2
743345824071983104,1,0,0,1,2
1290512412244729856,0,0,0,2,2
2996454216,0,2,0,0,2
157265909,0,2,0,0,2
743224356294189056,1,1,0,0,2
180562587,0,2,0,0,2
916927665826947072,2,0,0,0,2
1290472513659703296,1,1,0,0,2
2997012404,0,2,0,0,2
752432947421216768,0,2,0,0,2
156914601,0,2,0,0,2
752434136586018816,0,2,0,0,2
752457195661524992,0,2,0,0,2
179969743,0,2,0,0,2
1290808134647324672,1,1,0,0,2
2994624990,0,2,0,0,2
1668954858,1,1,0,0,2
178674627,0,2,0,0,2
1303194268056477696,1,0,0,1,2
751730280210235392,0,2,0,0,2
178761716,0,2,0,0,2
178898656,0,2,0,0,2
1199600384,1,1,0,0,2
2994810372,0,0,2,0,2
1291314585044099072,2,0,0,0,2
1291290484824879104,1,1,0,0,2
1169469416,0,0,1,1,2
179062372,0,2,0,0,2
1169426036,0,0,0,2,2
751811856482836480,0,2,0,0,2
1303410248430940160,0,1,0,1,2
2954533518,0,2,0,0,2
751857898972667904,0,2,0,0,2
752038483015766016,0,2,0,0,2
982669140229050368,0,2,0,0,2
2958124108,1,1,0,0,2
751022391380377600,0,2,0,0,2
1293999702472396800,0,2,0,0,2
174638076,0,2,0,0,2
174643719,0,2,0,0,2
1293922425231425536,0,2,0,0,2
744453839873421312,0,2,0,0,2
1301449677238198272,0,2,0,0,2
174717996,0,2,0,0,2
174781714,0,2,0,0,2
174976586,0,2,0,0,2
917385109266935808,0,2,0,0,2
1675353398,0,2,0,0,2
175055258,0,2,0,0,2
175099348,0,2,0,0,2
744240351435591680,2,0,0,0,2
160532922,0,2,0,0,2
1174451010,0,2,0,0,2
983020618516979712,0,2,0,0,2
1301521199734890496,2,0,0,0,2
1175392802,0,2,0,0,2
744658923613990912,1,1,0,0,2
2961178498,0,2,0,0,2
1175661217,0,2,0,0,2
2966294049,0,2,0,0,2
983340965774659584,0,2,0,0,2
2989479735,0,2,0,0,2
2965825641,0,2,0,0,2
745116169380626432,1,1,0,0,2
2989656040,0,2,0,0,2
1294567847855828992,0,2,0,0,2
173763798,0,2,0,0,2
1301134270468173824,0,2,0,0,2
918224456937558016,0,2,0,0,2
749824450124587008,0,2,0,0,2
1294303091156713472,0,2,0,0,2
983276000082644992,0,2,0,0,2
983226851559706624,0,2,0,0,2
161084256,0,2,0,0,2
2964960658,2,0,0,0,2
1176415704,0,2,0,0,2
2961608068,0,2,0,0,2
1174073838,2,0,0,0,2
1676028217,0,2,0,0,2
1197578730,2,0,0,0,2
2958923678,0,2,0,0,2
1172716512,0,2,0,0,2
918496148855377920,2,0,0,0,2
1302322235269681152,0,2,0,0,2
750821752318537728,2,0,0,0,2
159399634,0,2,0,0,2
159359543,1,1,0,0,2
159244485,2,0,0,0,2
982724796038426624,0,2,0,0,2
1292568759786504192,0,2,0,0,2
2993798572,1,0,0,1,2
1292563337394307072,0,1,0,1,2
176783541,1,0,0,1,2
176783979,1,1,0,0,2
750893218439593984,0,2,0,0,2
1675858771,0,2,0,0,2
158912165,0,2,0,0,2
2959143236,0,2,0,0,2
985258422961491968,0,0,0,2,2
2960762470,0,2,0,0,2
2959477367,1,1,0,0,2
985223900177956864,2,0,0,0,2
750410598685478912,0,2,0,0,2
2991314076,1,1,0,0,2
2960346942,0,2,0,0,2
160243745,0,2,0,0,2
175748159,0,0,0,2,2
1301623204448854016,0,2,0,0,2
1293330468444811264,1,1,0,0,2
1301777738383065088,0,1,1,0,2
1293313434654781440,0,2,0,0,2
175864424,0,2,0,0,2
176028324,0,2,0,0,2
159934997,0,2,0,0,2
176091355,0,2,0,0,2
2991860779,0,2,0,0,2
750502644830052352,0,2,0,0,2
750589983862456320,0,2,0,0,2
197456165,0,2,0,0,2
1307346032909520896,0,2,0,0,2
197491057,0,2,0,0,2
214067643,0,2,0,0,2
763769263828115456,0,2,0,0,2
143479871,0,2,0,0,2
1272776294028148736,0,2,0,0,2
1272727024944087040,2,0,0,0,2
214475652,1,0,1,0,2
2900192589,0,2,0,0,2
143352232,0,2,0,0,2
214518097,2,0,0,0,2
3028446855,0,2,0,0,2
735555190183452672,1,0,0,1,2
1125611347,0,2,0,0,2
764127273742106624,0,2,0,0,2
215036455,0,2,0,0,2
215036952,1,1,0,0,2
990515477503008768,0,2,0,0,2
990537607410077696,0,2,0,0,2
3028594464,2,0,0,0,2
1272820124160897024,0,0,1,1,2
763397759160377344,0,2,0,0,2
736231985186779136,0,2,0,0,2
1272970465477136384,0,1,1,0,2
143904132,0,2,0,0,2
2902918599,2,0,0,0,2
1273494529052557312,0,2,0,0,2
143852568,2,0,0,0,2
143755845,2,0,0,0,2
1126517570,1,1,0,0,2
763075811817754624,0,2,0,0,2
2902641484,0,2,0,0,2
213210647,0,2,0,0,2
2902537764,0,2,0,0,2
2902177833,0,2,0,0,2
1126054759,0,1,1,0,2
2902077177,0,2,0,0,2
213320362,0,2,0,0,2
143523762,0,2,0,0,2
213425066,0,2,0,0,2
1273023270300856320,0,2,0,0,2
764273718550007808,0,2,0,0,2
3028642653,2,0,0,0,2
1272194079716192256,2,0,0,0,2
920767944774238208,0,2,0,0,2
216442687,0,2,0,0,2
216454342,0,2,0,0,2
1271702158505766912,2,0,0,0,2
1271662479651864576,0,2,0,0,2
1229613865,1,0,1,0,2
216636336,0,0,1,1,2
216653157,0,2,0,0,2
1659703400,0,0,2,0,2
216677271,0,2,0,0,2
2896502823,0,1,1,0,2
216760280,0,2,0,0,2
979365772198850560,0,2,0,0,2
1271490728359845888,2,0,0,0,2
142749925,0,2,0,0,2
735182951298813952,0,2,0,0,2
2896471770,0,2,0,0,2
142710389,0,2,0,0,2
920844583071879168,0,2,0,0,2
2896880808,0,2,0,0,2
1271713590811095040,0,2,0,0,2
990870466293268480,0,2,0,0,2
215530097,0,2,0,0,2
2898466692,0,2,0,0,2
1272104412442484736,1,1,0,0,2
1693782402,0,2,0,0,2
1272051061885370368,1,1,0,0,2
990811388401434624,0,2,0,0,2
1229186448,0,2,0,0,2
2898082974,0,2,0,0,2
735420888368156672,2,0,0,0,2
1271888660129091584,0,2,0,0,2
216223999,2,0,0,0,2
1123374108,0,2,0,0,2
1313741321882959872,2,0,0,0,2
1271738546597003264,0,2,0,0,2
990963430885642240,1,1,0,0,2
1313763460904374272,0,2,0,0,2
212589565,1,1,0,0,2
1313149325309087744,2,0,0,0,2
1275990107259109376,0,2,0,0,2
1312304317626548224,1,1,0,0,2
209178738,0,2,0,0,2
915292173347803136,1,1,0,0,2
761339240315781120,0,2,0,0,2
145148207,0,2,0,0,2
1690966824,0,2,0,0,2
1275007204739837952,0,2,0,0,2
145142347,0,2,0,0,2
1312376282382991360,0,2,0,0,2
1131974666,0,2,0,0,2
1274885820839653376,0,2,0,0,2
144914211,1,1,0,0,2
209990420,0,2,0,0,2
761475825153826816,1,1,0,0,2
989165710671740928,0,0,0,2,2
920593708726317056,0,2,0,0,2
1274769260535939072,2,0,0,0,2
1274769014992982016,2,0,0,0,2
1661172798,0,2,0,0,2
208989307,1,1,0,0,2
212334804,0,2,0,0,2
208925100,0,2,0,0,2
760888530293907456,1,1,0,0,2
915476282476859392,1,1,0,0,2
1275536942936076288,0,2,0,0,2
207489722,1,0,0,1,2
207746229,1,1,0,0,2
920581531294404608,0,2,0,0,2
207862728,0,1,1,0,2
208399713,0,2,0,0,2
208412704,0,1,1,0,2
145239027,0,2,0,0,2
208434898,0,1,0,1,2
1225475436,0,2,0,0,2
208468373,0,2,0,0,2
1133516413,0,2,0,0,2
208880538,0,2,0,0,2
1132793774,0,2,0,0,2
208903029,0,2,0,0,2
210073429,0,0,2,0,2
736954731029880832,0,2,0,0,2
1274717873068367872,2,0,0,0,2
210217393,2,0,0,0,2
2905465582,0,0,0,2,2
211118059,0,2,0,0,2
1274311029221015552,0,2,0,0,2
736414651664224256,0,2,0,0,2
211264735,2,0,0,0,2
914951038054031360,0,2,0,0,2
2904509258,0,2,0,0,2
211510248,0,2,0,0,2
1273981546274394112,2,0,0,0,2
736260305974595584,1,1,0,0,2
144087344,0,2,0,0,2
762531107866808320,0,2,0,0,2
1273915953869283328,0,2,0,0,2
762538861549514752,0,2,0,0,2
144051281,0,2,0,0,2
1273901099787968512,0,2,0,0,2
989924618654928896,0,2,0,0,2
148961431,0,2,0,0,2
144280305,1,1,0,0,2
736470733916901376,0,2,0,0,2
736850981472874496,0,2,0,0,2
1131630708,0,0,1,1,2
1226877416,0,2,0,0,2
2906685167,0,1,0,1,2
1227249326,0,2,0,0,2
3023313926,1,1,0,0,2
989215946005884928,2,0,0,0,2
761742616601985024,1,1,0,0,2
3023866642,0,2,0,0,2
761928597976256512,0,2,0,0,2
736626065012051968,0,2,0,0,2
2906137926,1,1,0,0,2
736549807901282304,0,1,0,1,2
1274426232688574464,0,2,0,0,2
980013877160239104,1,1,0,0,2
210885856,0,2,0,0,2
144313291,0,2,0,0,2
1659686630,0,0,0,2,2
1122901064,1,1,0,0,2
216986620,0,2,0,0,2
141244967,0,2,0,0,2
221876324,2,0,0,0,2
221892927,0,2,0,0,2
766305396072022016,0,2,0,0,2
1117087356,0,2,0,0,2
991798761318961152,0,2,0,0,2
222023206,0,2,0,0,2
2890428369,1,1,0,0,2
3036223097,0,2,0,0,2
1269068503916707840,0,2,0,0,2
766533557837635584,0,2,0,0,2
1268968486199533568,0,2,0,0,2
222141147,0,2,0,0,2
141222734,0,2,0,0,2
1268817894613364736,0,1,1,0,2
979055339726258176,1,0,1,0,2
222395695,0,1,0,1,2
222433502,1,0,1,0,2
1269229836423163904,0,1,0,1,2
1314698864562233344,0,0,1,1,2
1271345239567953920,0,2,0,0,2
734076682307411968,0,2,0,0,2
766151269761355776,0,2,0,0,2
1269550393849077760,0,0,0,2,2
221154085,0,2,0,0,2
221278741,1,1,0,0,2
221306078,0,2,0,0,2
1269506260224876544,1,1,0,0,2
141536934,0,2,0,0,2
221379821,0,2,0,0,2
766211046063349760,0,2,0,0,2
141521806,0,2,0,0,2
221496040,0,2,0,0,2
2890786745,0,2,0,0,2
3035175182,2,0,0,0,2
1314672250273050624,0,2,0,0,2
141462408,0,0,1,1,2
221694529,0,2,0,0,2
1117221224,2,0,0,0,2
222496725,0,1,0,1,2
1268769242364751872,0,1,0,1,2
2889734561,0,2,0,0,2
1268703641495580672,0,2,0,0,2
140882987,0,2,0,0,2
1115115542,0,2,0,0,2
1315396836484579328,0,2,0,0,2
223488388,0,2,0,0,2
1268095865794723840,0,2,0,0,2
913753737700757504,0,2,0,0,2
223653815,0,2,0,0,2
1268050892651212800,0,2,0,0,2
223732513,0,2,0,0,2
2888096979,0,2,0,0,2
1267999769311371264,1,1,0,0,2
1315416753283960832,0,2,0,0,2
992067560878366720,1,1,0,0,2
1113823230,0,2,0,0,2
1315422401363050496,2,0,0,0,2
1315511812981485568,1,1,0,0,2
140789118,0,2,0,0,2
733730193043542016,0,2,0,0,2
223456456,0,2,0,0,2
223317490,1,1,0,0,2
766565977819578368,0,2,0,0,2
1268680824779661312,1,1,0,0,2
1268660425710809088,0,2,0,0,2
1314978645635629056,0,2,0,0,2
921168071959699456,1,1,0,0,2
991858527261118464,0,2,0,0,2
1315075019567964160,0,2,0,0,2
222856365,0,2,0,0,2
141114797,0,2,0,0,2
2888798206,1,1,0,0,2
766591901051064320,0,2,0,0,2
141110027,0,1,1,0,2
3036764830,0,2,0,0,2
1315237280391495680,0,2,0,0,2
1268497883319267328,0,0,0,2,2
222934464,0,2,0,0,2
223108118,1,0,0,1,2
1658242308,0,0,2,0,2
1269562161279504384,0,2,0,0,2
1118090725,0,1,0,1,2
219217830,1,1,0,0,2
1314137887911411712,0,2,0,0,2
1121565908,0,2,0,0,2
218078914,0,2,0,0,2
1270660816942047232,0,2,0,0,2
3032276252,0,2,0,0,2
1270622360706711552,0,2,0,0,2
1121254782,0,2,0,0,2
142398574,2,0,0,0,2
734858096275795968,0,2,0,0,2
914373255670112256,1,1,0,0,2
218649112,1,0,1,0,2
1270373376910135296,0,2,0,0,2
1270369197843980288,0,2,0,0,2
765469200328515584,0,0,0,2,2
991305550083383296,2,0,0,0,2
1314181637375242240,2,0,0,0,2
1314194666401796096,0,2,0,0,2
142485702,0,1,0,1,2
979317138564567040,0,2,0,0,2
217984893,0,2,0,0,2
1270988790132346880,0,2,0,0,2
1694757049,2,0,0,0,2
764833902544424960,0,2,0,0,2
3031707628,0,2,0,0,2
1271072459710742528,0,2,0,0,2
1121951191,0,2,0,0,2
2895650537,1,1,0,0,2
1270992593875111936,0,2,0,0,2
764909748693196800,0,2,0,0,2
217966278,0,2,0,0,2
764921841802579968,2,0,0,0,2
765051063925821440,1,1,0,0,2
1314080569907728384,0,2,0,0,2
217610623,0,2,0,0,2
1270890902257451008,1,1,0,0,2
1270839806034153472,0,2,0,0,2
2895136126,0,2,0,0,2
219054765,2,0,0,0,2
219277520,0,2,0,0,2
3034884015,0,2,0,0,2
765805129316589568,0,2,0,0,2
1269890252556185600,0,0,0,2,2
220297646,2,0,0,0,2
220597119,1,0,0,1,2
220674188,0,2,0,0,2
142159165,2,0,0,0,2
142030802,2,0,0,0,2
220727422,0,2,0,0,2
734705368450932736,2,0,0,0,2
3033618112,0,2,0,0,2
765993987454959616,0,2,0,0,2
1269641446920990720,1,1,0,0,2
1314330074557054976,0,2,0,0,2
2892113954,0,2,0,0,2
220967407,0,2,0,0,2
1696780987,0,2,0,0,2
1314498968575934464,2,0,0,0,2
1314588125994217472,0,2,0,0,2
1269955564223827968,0,2,0,0,2
1119672919,0,2,0,0,2
220033257,0,2,0,0,2
765855843132801024,0,0,0,2,2
914258046569783296,2,0,0,0,2
142235423,1,1,0,0,2
2893122595,1,0,0,1,2
142230300,1,1,0,0,2
765841339632214016,0,2,0,0,2
219565128,0,2,0,0,2
142227400,0,2,0,0,2
219613402,0,2,0,0,2
1314226426585862144,0,0,0,2,2
219656950,2,0,0,0,2
2893046668,0,2,0,0,2
142207047,1,0,0,1,2
219881302,0,2,0,0,2
1269987367986892800,0,2,0,0,2
1269982385866768384,1,0,0,1,2
1269961920494178304,0,2,0,0,2
1689721332,2,0,0,0,2
1299102192788537344,0,2,0,0,2
145268001,0,2,0,0,2
146027825,1,0,1,0,2
203217934,0,2,0,0,2
146358401,1,1,0,0,2
146427781,0,2,0,0,2
758713220018368512,0,2,0,0,2
759730300582817792,0,0,0,2,2
738782776887939072,2,0,0,0,2
737895710943805440,0,2,0,0,2
1143670118,0,2,0,0,2
920373181344550912,0,0,0,2,2
915584155009912832,0,2,0,0,2
2918113143,0,2,0,0,2
1311146990726594560,0,2,0,0,2
203131589,0,2,0,0,2
738020803871047680,1,0,0,1,2
738780132639440896,0,1,0,1,2
1662648403,0,2,0,0,2
1143310597,0,2,0,0,2
2914388753,0,2,0,0,2
147882040,2,0,0,0,2
738180557041893376,0,2,0,0,2
2914421262,0,2,0,0,2
980404484152135680,1,1,0,0,2
1278285172862078976,0,2,0,0,2
1278299524977623040,1,1,0,0,2
988465470494851072,0,2,0,0,2
1310909719419277312,0,2,0,0,2
199669887,0,2,0,0,2
1140183523,0,2,0,0,2
146293139,0,2,0,0,2
988598542791884800,0,2,0,0,2
1280638863849984000,0,2,0,0,2
204712759,0,2,0,0,2
2920596429,0,2,0,0,2
2920376675,0,2,0,0,2
1277166387803217920,0,2,0,0,2
1137669272,2,0,0,0,2
204385671,0,2,0,0,2
1138909573,0,0,2,0,2
2920334024,0,2,0,0,2
1280648773346066432,0,2,0,0,2
148343392,0,2,0,0,2
988716087297630208,0,2,0,0,2
1277527656209276928,0,2,0,0,2
204000525,0,2,0,0,2
2913693957,0,2,0,0,2
1688271702,0,2,0,0,2
2913294318,0,2,0,0,2
758644384627843072,1,1,0,0,2
199262623,0,2,0,0,2
146076406,0,0,0,2,2
1139956981,2,0,0,0,2
1280522911292555264,0,2,0,0,2
203723337,0,2,0,0,2
980743853081686016,2,0,0,0,2
980721906927177728,0,2,0,0,2
1277830489106046976,0,2,0,0,2
758681043805364224,0,2,0,0,2
758886119786160128,0,2,0,0,2
2917896000,0,2,0,0,2
199753123,0,2,0,0,2
1279314473774272512,0,2,0,0,2
1310296381240737792,0,2,0,0,2
201479849,0,2,0,0,2
738535408158560256,0,1,1,0,2
1279115096862539776,2,0,0,0,2
738777583693758464,0,2,0,0,2
201227750,2,0,0,0,2
1310057189021634560,0,2,0,0,2
1279118192011550720,0,2,0,0,2
2916416858,0,2,0,0,2
200069859,1,1,0,0,2
2916441695,0,2,0,0,2
1310090088756523008,0,2,0,0,2
759344721353465856,1,1,0,0,2
1142984611,0,2,0,0,2
759035373380960256,0,2,0,0,2
200192268,1,1,0,0,2
147229553,0,1,1,0,2
200918966,0,2,0,0,2
1310114923817693184,0,2,0,0,2
147514670,0,2,0,0,2
738583257311150080,0,2,0,0,2
1279646890561138688,0,2,0,0,2
200910412,0,2,0,0,2
1142502205,0,2,0,0,2
2916579712,0,2,0,0,2
200549764,0,2,0,0,2
201655153,2,0,0,0,2
3017511498,0,2,0,0,2
2914678476,0,2,0,0,2
1278600143823142912,1,1,0,0,2
738334416733364224,0,2,0,0,2
1310873173114617856,2,0,0,0,2
2914966741,0,2,0,0,2
1309793525093994496,0,2,0,0,2
1278576626817732608,1,0,0,1,2
2915054112,0,2,0,0,2
1280064325563158528,0,2,0,0,2
3016080090,2,0,0,0,2
147757482,0,2,0,0,2
199856187,0,2,0,0,2
1309884033707307008,0,1,1,0,2
202523144,0,1,0,1,2
202243967,0,2,0,0,2
1310594358459199488,0,2,0,0,2
199927736,0,2,0,0,2
759511663116709888,0,2,0,0,2
1141501166,0,2,0,0,2
3016083390,1,1,0,0,2
1662876584,2,0,0,0,2
202088771,0,2,0,0,2
1278994121068122112,0,2,0,0,2
201784867,0,2,0,0,2
2915716577,0,2,0,0,2
147643968,0,2,0,0,2
1279017975387832320,0,2,0,0,2
759450734920343552,0,2,0,0,2
1277100634332737536,0,2,0,0,2
759856620293750784,0,2,0,0,2
198089759,0,2,0,0,2
145619730,1,0,1,0,2
206357288,0,2,0,0,2
1276766615955095552,0,2,0,0,2
148784006,2,0,0,0,2
988196740607217664,0,2,0,0,2
145736753,0,2,0,0,2
737405458638606336,0,2,0,0,2
206069955,0,1,1,0,2
1276811260684693504,0,2,0,0,2
3013386939,0,2,0,0,2
148719639,0,2,0,0,2
1281338756939894784,0,2,0,0,2
760524878772445184,0,1,1,0,2
1663686450,1,1,0,0,2
198248713,0,2,0,0,2
1281307268731015168,0,2,0,0,2
145802194,0,2,0,0,2
1281254505443586048,0,2,0,0,2
148646076,0,2,0,0,2
198405503,1,1,0,0,2
3014258712,1,1,0,0,2
198576379,0,2,0,0,2
205694126,2,0,0,0,2
3021286740,0,2,0,0,2
1689355855,0,2,0,0,2
148611702,1,0,1,0,2
1223642239,1,0,0,1,2
145552590,1,1,0,0,2
205598137,2,0,0,0,2
2922371131,0,2,0,0,2
207076657,0,2,0,0,2
1225034977,0,2,0,0,2
207050122,2,0,0,0,2
145443046,0,2,0,0,2
197541260,0,2,0,0,2
758003095158808576,0,2,0,0,2
1147300526,0,2,0,0,2
1276040384833974272,0,2,0,0,2
207035678,0,2,0,0,2
1281651438309920768,0,1,0,1,2
1224238676,0,2,0,0,2
1276119048783138816,0,2,0,0,2
207018808,1,1,0,0,2
737351975004737536,2,0,0,0,2
1276180558582710272,0,0,1,1,2
148910268,0,2,0,0,2
739514327665922048,0,2,0,0,2
1276262036230430720,0,2,0,0,2
760803639338217472,0,2,0,0,2
2910727479,0,2,0,0,2
1276369123254173696,0,2,0,0,2
1136444190,0,2,0,0,2
148870231,0,2,0,0,2
3021581551,0,2,0,0,2
206418544,0,2,0,0,2
3021258574,0,2,0,0,2
759339101460041728,0,2,0,0,2
3020531027,0,2,0,0,2
3020187746,0,2,0,0,2
1145098316,0,2,0,0,2
2912032738,0,2,0,0,2
205080800,0,2,0,0,2
760252128984260608,0,2,0,0,2
198771818,2,0,0,0,2
198790634,0,2,0,0,2
3014329598,1,1,0,0,2
1137641695,0,2,0,0,2
204734352,1,1,0,0,2
1662187483,0,2,0,0,2
2912481712,0,2,0,0,2
1144878690,1,1,0,0,2
1281193933188431872,2,0,0,0,2
148569427,0,2,0,0,2
1309230749166559232,0,2,0,0,2
3021192465,0,2,0,0,2
1688950572,0,2,0,0,2
1144483362,0,2,0,0,2
198809901,0,2,0,0,2
889553128344965120,1,0,0,0,1
921982026621833216,1,0,0,0,1
938570089158365184,0,0,1,0,1
905379405308055552,0,1,0,0,1
896356915315445760,0,1,0,0,1
905317695477882880,0,1,0,0,1
921590195551703040,0,1,0,0,1
906016696963497984,0,1,0,0,1
922161167354576896,0,1,0,0,1
918129914326454272,0,1,0,0,1
936846292919107584,0,1,0,0,1
887678264663089152,0,1,0,0,1
938680509328011264,0,1,0,0,1
905111954628411392,0,1,0,0,1
889558694589059072,0,1,0,0,1
906158924344250368,0,1,0,0,1
888817776688848896,0,1,0,0,1
936930263048839168,0,1,0,0,1
896715715461480448,1,0,0,0,1
906139899136528384,1,0,0,0,1
906059737040535552,0,1,0,0,1
922065709093588992,0,1,0,0,1
922036375922397184,0,1,0,0,1
922104316722384896,0,0,0,1,1
889779437616730112,1,0,0,0,1
889874062733914112,0,1,0,0,1
938588657707110400,1,0,0,0,1
906117790276362240,1,0,0,0,1
904704678553944064,0,1,0,0,1
921362489425760256,0,0,0,1,1
905053633506619392,0,1,0,0,1
896068858758533120,0,1,0,0,1
906082234490290176,0,1,0,0,1
904706298167664640,0,1,0,0,1
887669718424924160,0,1,0,0,1
905148014179876864,0,1,0,0,1
935808637301387264,0,1,0,0,1
905382764840607744,0,1,0,0,1
936883942355095552,0,1,0,0,1
905901640670162944,0,1,0,0,1
918063358900916224,1,0,0,0,1
906063775601762304,0,1,0,0,1
905132251788099584,0,1,0,0,1
889556558794956800,0,1,0,0,1
919876440212099072,1,0,0,0,1
938698599038365696,0,1,0,0,1
923262662510866432,0,1,0,0,1
897459818834706432,0,1,0,0,1
897449351756341248,0,1,0,0,1
906155830738788352,0,1,0,0,1
897427070250299392,0,1,0,0,1
921392135299043328,0,1,0,0,1
922058122474283008,0,1,0,0,1
907033278938583040,0,0,1,0,1
920081865767256064,0,1,0,0,1
897063991226257408,1,0,0,0,1
907197438892675072,0,1,0,0,1
906937059616555008,1,0,0,0,1
923370389346144256,0,1,0,0,1
895476852151558144,0,1,0,0,1
922040671833223168,0,1,0,0,1
907212171733618688,0,1,0,0,1
936867606081945600,0,1,0,0,1
938667363729330176,1,0,0,0,1
887986395922534400,0,1,0,0,1
897877730376732672,0,1,0,0,1
889863760768376832,0,0,0,1,1
904060089404985344,1,0,0,0,1
896943851302203392,0,1,0,0,1
897061374681133056,0,1,0,0,1
920268398323433472,0,1,0,0,1
888481764947243008,1,0,0,0,1
896905068380684288,0,1,0,0,1
904741048932605952,0,1,0,0,1
903942469624233984,0,1,0,0,1
888502261638475776,0,1,0,0,1
936983057260863488,0,1,0,0,1
921012639093882880,0,1,0,0,1
895619840010055680,0,1,0,0,1
923325871200620544,1,0,0,0,1
917984292545974272,0,1,0,0,1
921003785199202304,0,1,0,0,1
919966507031056384,0,1,0,0,1
906938748100890624,0,1,0,0,1
895495292887248896,0,1,0,0,1
905074287194791936,1,0,0,0,1
921437789606031360,0,1,0,0,1
896885344162914304,0,1,0,0,1
921000274524811264,0,1,0,0,1
906194045881409536,0,1,0,0,1
895638541497192448,0,1,0,0,1
922067039962914816,0,1,0,0,1
887921357773692928,1,0,0,0,1
905159858525261824,0,0,1,0,1
921416801988132864,0,1,0,0,1
888070416576770048,0,1,0,0,1
889718479535910912,0,1,0,0,1
904702690797735936,0,1,0,0,1
889858138358337536,0,0,0,1,1
904761900621291520,0,1,0,0,1
904126115878494208,0,1,0,0,1
907136523065323520,0,0,1,0,1
918069117264859136,0,1,0,0,1
888666929455652864,0,1,0,0,1
889816004133621760,0,0,1,0,1
889744591515156480,0,1,0,0,1
888478808369659904,0,1,0,0,1
920261048841719808,0,1,0,0,1
921417180885016576,0,1,0,0,1
936991824538824704,0,1,0,0,1
888019614793293824,1,0,0,0,1
888015332190830592,0,1,0,0,1
922154762979692544,0,1,0,0,1
938475366708105216,0,1,0,0,1
895635903636439040,0,1,0,0,1
920967089099345920,0,1,0,0,1
903972762439622656,0,1,0,0,1
935814638742142976,0,0,1,0,1
896264946807259136,0,1,0,0,1
904976187340070912,0,1,0,0,1
905841344047980544,0,1,0,0,1
920629912993705984,0,1,0,0,1
936264482585743360,0,1,0,0,1
936299450124955648,1,0,0,0,1
906639309918281728,0,1,0,0,1
905539126551875584,0,1,0,0,1
936329855871979520,0,1,0,0,1
904569931303456768,0,1,0,0,1
918772338040205312,0,1,0,0,1
937954677362122752,0,1,0,0,1
919457161746567168,0,1,0,0,1
920618842258370560,0,1,0,0,1
905551607798128640,0,1,0,0,1
906476298280738816,0,1,0,0,1
905577916062425088,0,1,0,0,1
936342058779971584,0,0,0,1,1
897650803149811712,0,1,0,0,1
889090102869282816,0,1,0,0,1
904823363176103936,0,1,0,0,1
895695071097520128,0,1,0,0,1
936419862812880896,1,0,0,0,1
896596781147893760,1,0,0,0,1
922369184243372032,0,1,0,0,1
918756594569109504,1,0,0,0,1
905530064984576000,0,1,0,0,1
936169105106919424,0,1,0,0,1
905799466409541632,0,1,0,0,1
897827268269137920,0,1,0,0,1
937340303127793664,0,1,0,0,1
922861260366123008,0,1,0,0,1
920416516767715328,0,1,0,0,1
906475156754898944,0,0,1,0,1
897819860972994560,0,1,0,0,1
919526857422266368,0,1,0,0,1
920703682106281984,0,1,0,0,1
936176527292559360,0,1,0,0,1
889446059356848128,0,1,0,0,1
888268895341035520,0,1,0,0,1
904317459041325056,0,1,0,0,1
918731588656959488,0,1,0,0,1
897294495745679360,0,1,0,0,1
920670349947232256,0,1,0,0,1
905804752587563008,0,1,0,0,1
921656536329572352,0,1,0,0,1
906665403383820288,0,1,0,0,1
896511254931664896,0,1,0,0,1
918745775466860544,0,1,0,0,1
904859393107349504,0,1,0,0,1
919266678055292928,0,0,1,0,1
936602965179359232,0,1,0,0,1
921662557319868416,1,0,0,0,1
921710425800085504,0,1,0,0,1
936565739628236800,0,1,0,0,1
937440289924485120,0,1,0,0,1
889335466952085504,0,1,0,0,1
889168379184951296,0,1,0,0,1
896558334458740736,0,1,0,0,1
937505919751081984,0,1,0,0,1
905764856615329792,0,1,0,0,1
897328908768485376,0,1,0,0,1
895780831339438080,0,1,0,0,1
906532756066152448,0,1,0,0,1
888356928056942592,0,1,0,0,1
904805585115373568,0,1,0,0,1
922489399161606144,0,1,0,0,1
906513847896305664,0,1,0,0,1
921835869442658304,0,1,0,0,1
889143762689155072,0,1,0,0,1
904819499223977984,0,1,0,0,1
896569414904041472,1,0,0,0,1
897302006187958272,0,1,0,0,1
895720702061547520,0,1,0,0,1
922540617955250176,0,1,0,0,1
922542410411991040,0,1,0,0,1
906503454583029760,0,1,0,0,1
904361322191568896,0,1,0,0,1
919013034604896256,0,1,0,0,1
921715930010329088,0,1,0,0,1
918830941027622912,1,0,0,0,1
922382402756005888,0,1,0,0,1
904387011167092736,0,1,0,0,1
889377561444331520,0,1,0,0,1
922733027158999040,0,1,0,0,1
888441770475999232,0,1,0,0,1
937410235492421632,0,1,0,0,1
905772993535770624,0,1,0,0,1
905629859086458880,1,0,0,0,1
936572997737041920,0,1,0,0,1
888406624263704576,1,0,0,0,1
937435940393496576,0,1,0,0,1
936592070638268416,0,1,0,0,1
922683974828244992,0,0,0,1,1
904351923083517952,0,1,0,0,1
936578233889427456,0,1,0,0,1
897758451346153472,0,1,0,0,1
905641526470090752,0,1,0,0,1
919071040722137088,1,0,0,0,1
920397950714630144,1,0,0,0,1
922882448597438464,0,1,0,0,1
919795749054857216,1,0,0,0,1
905409686098337792,0,1,0,0,1
937048716053221376,0,1,0,0,1
904587060807270400,0,1,0,0,1
920269645340344320,0,1,0,0,1
897875959105429504,0,1,0,0,1
938307834080620544,0,1,0,0,1
936091774967209984,0,1,0,0,1
897866566649356288,1,0,0,0,1
922320710877376512,1,0,0,0,1
936802724355760128,0,1,0,0,1
922501941447585792,1,0,0,0,1
897230298752200704,0,1,0,0,1
905416677034041344,0,1,0,0,1
897512029883445248,0,1,0,0,1
896385239542616064,0,1,0,0,1
919780493201235968,0,1,0,0,1
896048642842218496,1,0,0,0,1
888109997346795520,0,0,1,0,1
937079952608030720,0,0,1,0,1
904225431133446144,0,1,0,0,1
896695903339384832,0,1,0,0,1
922991186750603264,0,1,0,0,1
921655257427521536,0,1,0,0,1
906851688107134976,0,1,0,0,1
889528120457535488,0,1,0,0,1
938330098305990656,0,1,0,0,1
906198046588911616,0,1,0,0,1
938405472662638592,0,1,0,0,1
906896737528360960,0,1,0,0,1
906874646032723968,0,1,0,0,1
888090590692376576,0,1,0,0,1
922201348434784256,0,1,0,0,1
888469100728508416,0,1,0,0,1
923258378465562624,0,1,0,0,1
938387506286006272,1,0,0,0,1
923243412228153344,0,1,0,0,1
888829360949649408,0,1,0,0,1
888106363242528768,0,1,0,0,1
905014039511785472,0,1,0,0,1
906202346459418624,0,1,0,0,1
918417922678169600,0,1,0,0,1
896713064602456064,0,1,0,0,1
923236578817925120,0,1,0,0,1
920861781853171712,1,0,0,0,1
922256189571981312,0,1,0,0,1
936003374423707648,0,1,0,0,1
889548279452639232,0,1,0,0,1
888958943220957184,0,1,0,0,1
888459909620224000,0,1,0,0,1
888976831864479744,0,1,0,0,1
938084433277493248,0,0,0,1,1
904570246111133696,0,1,0,0,1
918527030890819584,0,1,0,0,1
905436502741700608,0,1,0,0,1
906328964553199616,0,1,0,0,1
936122385924632576,1,0,0,0,1
921890221771382784,0,1,0,0,1
937100602815008768,0,1,0,0,1
936126637048971264,0,1,0,0,1
906396288895385600,0,1,0,0,1
906760627183423488,1,0,0,0,1
895693223368081408,0,1,0,0,1
937966625629851648,0,1,0,0,1
905819535869190144,0,1,0,0,1
921855026049380352,0,1,0,0,1
922892214061080576,0,0,1,0,1
889534836981063680,0,1,0,0,1
895885372902834176,0,1,0,0,1
936130959245799424,0,1,0,0,1
906725886132715520,1,0,0,0,1
904934230035021824,0,1,0,0,1
904794613654986752,0,1,0,0,1
906312971172896768,0,1,0,0,1
888125372012699648,0,1,0,0,1
889538194265526272,0,1,0,0,1
938040266832990208,1,0,0,0,1
918451063069511680,0,1,0,0,1
937096494858911744,0,1,0,0,1
906265099807199232,0,1,0,0,1
888445840083341312,0,1,0,0,1
906789849486815232,0,1,0,0,1
936762858779525120,0,1,0,0,1
906785747180470272,0,1,0,0,1
922978250271293440,0,1,0,0,1
906781243458691072,1,0,0,0,1
919670095261118464,0,1,0,0,1
920286476545425408,1,0,0,0,1
922367527417769984,1,0,0,0,1
919624901245440000,0,1,0,0,1
906773532021071872,0,1,0,0,1
922368588534517760,1,0,0,0,1
895955282555269120,0,1,0,0,1
906295600936873984,0,0,0,1,1
936120905813647360,0,1,0,0,1
919548186590621696,0,1,0,0,1
897831224256999424,1,0,0,0,1
920610802180214784,0,1,0,0,1
913689072283144192,0,1,0,0,1
923445877871484928,0,1,0,0,1
926728311652229120,0,1,0,0,1
911633412905144320,0,1,0,0,1
892474842737463296,0,1,0,0,1
899023766642098176,0,1,0,0,1
892496304462364672,0,1,0,0,1
926917422069747712,0,1,0,0,1
931202068597084160,0,1,0,0,1
892522370774310912,0,1,0,0,1
926949590577934336,1,0,0,0,1
901362451547029504,0,1,0,0,1
927001327846154240,0,1,0,0,1
892662432568619008,0,1,0,0,1
911655054926528512,0,0,0,1,1
931188179817902080,0,1,0,0,1
893966485802160128,1,0,0,0,1
931186752177561600,0,1,0,0,1
931157677530591232,0,1,0,0,1
911732897094225920,0,1,0,0,1
927050655205810176,0,0,1,0,1
927055295737577472,0,1,0,0,1
915616837303402496,0,1,0,0,1
911622857465020416,0,1,0,0,1
926861893616115712,0,1,0,0,1
926774432764268544,0,1,0,0,1
931477800091078656,0,1,0,0,1
931402106539458560,0,0,0,1,1
926743801967898624,0,1,0,0,1
926750476221034496,0,1,0,0,1
915809396910886912,0,1,0,0,1
931384872039432192,0,1,0,0,1
911443114195271680,0,1,0,0,1
893999752538243072,0,1,0,0,1
898981356528709632,0,1,0,0,1
911617187785273344,0,1,0,0,1
926807947602268160,0,1,0,0,1
931339865886724096,0,1,0,0,1
931313102813057024,1,0,0,0,1
926825258589540352,0,1,0,0,1
899011964030132224,0,1,0,0,1
931232784332607488,0,1,0,0,1
911581891798503424,0,0,0,1,1
931229787724451840,0,1,0,0,1
931142810031591424,0,1,0,0,1
931120434703163392,0,1,0,0,1
893962284451717120,0,1,0,0,1
901051043752153088,0,1,0,0,1
927311207631073280,0,1,0,0,1
901118709187485696,0,1,0,0,1
911954168889319424,0,1,0,0,1
911969694856261632,1,0,0,0,1
901071048250150912,0,1,0,0,1
893876807002402816,1,0,0,0,1
901068452777078784,1,0,0,0,1
930913062781181952,0,1,0,0,1
927357503784005632,0,1,0,0,1
911935721979744256,0,1,0,0,1
930859488562876416,0,1,0,0,1
901046640017940480,0,1,0,0,1
915437438192975872,0,1,0,0,1
915432859208265728,0,1,0,0,1
892838204994453504,0,1,0,0,1
899159853112995840,0,1,0,0,1
899183284923416576,0,1,0,0,1
912021185046687744,0,1,0,0,1
911936361283932160,0,1,0,0,1
915517357929271296,0,1,0,0,1
915559862179901440,0,0,0,1,1
899041544552017920,0,1,0,0,1
915529657985970176,0,1,0,0,1
930948558035046400,1,0,0,0,1
892812470821277696,0,1,0,0,1
930938415096397824,0,1,0,0,1
927153201446612992,0,1,0,0,1
927197131580026880,0,1,0,0,1
911905943285268480,1,0,0,0,1
930929145227423744,0,1,0,0,1
901340209312354304,1,0,0,0,1
893895357951877120,1,0,0,0,1
927197987855482880,0,1,0,0,1
899119145043640320,0,1,0,0,1
901300890778324992,0,0,1,0,1
927252051725307904,0,1,0,0,1
893950456682229760,0,1,0,0,1
927304809371316224,0,1,0,0,1
901210272471404544,0,1,0,0,1
893937167248101376,0,1,0,0,1
894052660009152512,0,0,1,0,1
926727479980711936,0,1,0,0,1
915430049268060160,0,1,0,0,1
892443628349640704,1,0,0,0,1
915999496093536256,0,1,0,0,1
901842603720585216,0,1,0,0,1
892287817170255872,0,1,0,0,1
926451329379258368,1,0,0,0,1
926469225467858944,0,1,0,0,1
931984369601757184,0,1,0,0,1
926516638475624448,0,1,0,0,1
931974938508038144,0,1,0,0,1
894137838454919168,0,1,0,0,1
931974287459803136,0,1,0,0,1
910918009304354816,0,0,0,1,1
898892510285750272,0,1,0,0,1
910931972989554688,0,1,0,0,1
931960226345095168,0,1,0,0,1
892322254943473664,0,1,0,0,1
931876825499709440,0,1,0,0,1
892322871296524288,0,0,0,1,1
931866887755059200,0,1,0,0,1
926535473945890816,0,1,0,0,1
926420569297387520,0,1,0,0,1
910835466601209856,0,1,0,0,1
892265476264529920,0,1,0,0,1
910603543777648640,1,0,0,0,1
902293163078909952,0,1,0,0,1
916085742832459776,1,0,0,0,1
910572372410949632,0,1,0,0,1
932369870154498048,0,1,0,0,1
932262495753986048,0,1,0,0,1
894186669347307520,0,1,0,0,1
926272830345498624,0,1,0,0,1
910572621758046208,0,1,0,0,1
932259697318604800,0,1,0,0,1
916016371204575232,0,1,0,0,1
898747273441685504,0,0,0,1,1
932257843830493184,1,0,0,0,1
932225727092740096,1,0,0,0,1
926319606930857984,0,0,0,1,1
910778825344249856,1,0,0,0,1
932156755693461504,0,1,0,0,1
932107160661778432,1,0,0,0,1
901847484074299392,0,1,0,0,1
901810580331352064,1,0,0,0,1
931779219192815616,0,0,0,1,1
915973825933856768,0,1,0,0,1
931588727897329664,0,1,0,0,1
931643993011707904,1,0,0,0,1
901457651158196224,0,1,0,0,1
931642205420351488,0,1,0,0,1
931612768041623552,0,1,0,0,1
926663206835294208,0,1,0,0,1
911235075395739648,0,1,0,0,1
926701985373605888,1,0,0,0,1
901437580448628736,0,1,0,0,1
926703991651782656,1,0,0,0,1
931644830907813888,0,0,0,1,1
911272862681505792,0,1,0,0,1
926712890236788736,1,0,0,0,1
892438584635957248,0,0,0,1,1
931494589260689408,0,1,0,0,1
898922213172269056,0,1,0,0,1
898954142886047744,0,1,0,0,1
926725774052270080,0,1,0,0,1
915848278721175552,0,1,0,0,1
911233308113211392,0,1,0,0,1
911155841423654912,1,0,0,0,1
915963661079920640,1,0,0,0,1
901681216650346496,0,1,0,0,1
901723396706357248,0,1,0,0,1
892336913008525312,0,1,0,0,1
926571068394962944,0,1,0,0,1
926581102021632000,0,1,0,0,1
894078632766959616,0,0,1,0,1
915950048541802496,0,1,0,0,1
901692403219816448,0,1,0,0,1
892367044422901760,0,1,0,0,1
892406151840759808,0,1,0,0,1
892410134865080320,0,1,0,0,1
931750529319030784,0,1,0,0,1
898906476902838272,0,1,0,0,1
931729149990965248,0,0,1,0,1
901677785932062720,0,1,0,0,1
931693199520944128,0,1,0,0,1
911105090471198720,0,1,0,0,1
901621512087724032,0,0,0,1,1
915937431886721024,0,1,0,0,1
912175401308389376,0,1,0,0,1
912232937839620096,0,1,0,0,1
935792138360688640,0,1,0,0,1
893781809703649280,0,1,0,0,1
893212478909403136,0,1,0,0,1
899583763126071296,0,1,0,0,1
893710113675984896,0,1,0,0,1
893280847369039872,1,0,0,0,1
899621151667892224,0,1,0,0,1
929292999451852800,1,0,0,0,1
928279933528543232,0,1,0,0,1
929271086096584704,0,1,0,0,1
913189957577117696,0,1,0,0,1
913190675146874880,0,0,0,1,1
913259876318560256,0,0,0,1,1
929211448668037120,0,1,0,0,1
929170402391113728,0,1,0,0,1
913274980372115456,0,1,0,0,1
929161441155928064,1,0,0,0,1
929105616894906368,1,0,0,0,1
928295434740789248,0,1,0,0,1
893340154429100032,0,1,0,0,1
900286727624941568,1,0,0,0,1
893710436306223104,0,1,0,0,1
899574763424595968,1,0,0,0,1
914129450824081408,0,1,0,0,1
913035564122873856,1,0,0,0,1
893770962675675136,0,1,0,0,1
893195823139487744,0,0,0,1,1
899367787445006336,0,1,0,0,1
928109848352272384,1,0,0,0,1
899508873618436096,0,1,0,0,1
928216781465907200,0,1,0,0,1
900330335556300800,0,1,0,0,1
929501011097636864,0,1,0,0,1
893757562633338880,0,1,0,0,1
899561089582727168,0,1,0,0,1
914283761940000768,0,1,0,0,1
914222392058142720,0,1,0,0,1
893750541267894272,1,0,0,0,1
913066051650379776,0,1,0,0,1
893743015000326144,0,0,0,1,1
900312252858978304,0,1,0,0,1
929463133122584576,0,1,0,0,1
928237353604407296,0,1,0,0,1
929076635181240320,0,1,0,0,1
928303025415950336,0,1,0,0,1
899645924850491392,0,1,0,0,1
928707902872854528,0,1,0,0,1
899881124629016576,0,1,0,0,1
928774646551535616,0,1,0,0,1
928758334903214080,0,1,0,0,1
928755063396454400,0,1,0,0,1
928716755517820928,0,1,0,0,1
913573475457085440,0,1,0,0,1
928439656869330944,1,0,0,0,1
900215325488283648,0,0,0,1,1
913671582056198144,1,0,0,0,1
900275487838273536,0,1,0,0,1
900076778252898304,0,0,0,1,1
928630613644627968,0,1,0,0,1
899995717506387968,0,1,0,0,1
913745171849924608,0,1,0,0,1
913741565255933952,0,1,0,0,1
899960103008391168,0,1,0,0,1
913727993201283072,0,1,0,0,1
913689153568681984,0,1,0,0,1
913521372311236608,0,1,0,0,1
913487330958303232,0,1,0,0,1
893364388001976320,0,1,0,0,1
913320284991533056,0,1,0,0,1
913275137897590784,0,0,1,0,1
929020763339927552,1,0,0,0,1
893364426648076288,0,1,0,0,1
893604361611476992,0,1,0,0,1
929018753924370432,0,1,0,0,1
928971036711890944,0,1,0,0,1
928945737672441856,0,0,1,0,1
893597198646206464,1,0,0,0,1
928323021260996608,0,0,0,1,1
913485498793975808,0,1,0,0,1
913337298099621888,0,1,0,0,1
928324800312938496,0,1,0,0,1
893416133327552512,0,1,0,0,1
913817856541851648,0,1,0,0,1
899655287870820352,0,1,0,0,1
893453389257887744,0,1,0,0,1
928907750398144512,0,1,0,0,1
913794498156650496,0,1,0,0,1
893173323001200640,1,0,0,0,1
913004898211516416,0,1,0,0,1
930749276480835584,0,1,0,0,1
927909674837458944,1,0,0,0,1
915026152762130432,0,1,0,0,1
899257775238336512,0,1,0,0,1
930107587680280576,0,1,0,0,1
930101877567455232,0,1,0,0,1
914905279740940288,0,1,0,0,1
927496091636981760,1,0,0,0,1
927497108583829504,0,1,0,0,1
930027467791667200,0,1,0,0,1
912609979592560640,0,1,0,0,1
912613470994092032,0,1,0,0,1
927544180305305600,1,0,0,0,1
912643132885487616,0,1,0,0,1
914902461294374912,1,0,0,0,1
914891543252754432,0,1,0,0,1
914862443339202560,1,0,0,0,1
893088539092451328,0,1,0,0,1
914760163248177152,0,1,0,0,1
930024334835400704,0,1,0,0,1
914628382222057472,0,1,0,0,1
900680966057988096,1,0,0,0,1
915100545563660288,0,1,0,0,1
915159136224137216,0,1,0,0,1
912375169087352832,0,1,0,0,1
892849850722770944,0,1,0,0,1
912244477070323712,0,1,0,0,1
912274775157772288,0,1,0,0,1
930690161008168960,0,1,0,0,1
892853768592674816,0,1,0,0,1
930419187549216768,0,1,0,0,1
912324226572603392,0,1,0,0,1
915237177839243264,0,1,0,0,1
930410736257519616,0,1,0,0,1
912571516843433984,0,1,0,0,1
927488143506444288,0,1,0,0,1
930399257382801408,0,1,0,0,1
915233754284740608,0,1,0,0,1
900796629954985984,0,1,0,0,1
930314033114353664,0,1,0,0,1
930109032009994240,0,1,0,0,1
900772904106897408,0,1,0,0,1
900764450059431936,0,1,0,0,1
914591814417620992,0,1,0,0,1
927576881532194816,0,1,0,0,1
912659598703808512,0,1,0,0,1
893795918641676288,1,0,0,0,1
900495639443906560,0,1,0,0,1
929704270588530688,0,1,0,0,1
900417076074082304,0,1,0,0,1
893855138791604224,0,1,0,0,1
893807042913329152,0,1,0,0,1
893166099365339136,0,1,0,0,1
929678874656382976,1,0,0,0,1
929656603346984960,0,1,0,0,1
914496593272872960,0,1,0,0,1
927850190962229248,0,0,0,1,1
912797520119586816,0,1,0,0,1
914373284816314368,0,1,0,0,1
929641456784068608,0,1,0,0,1
912838855153405952,0,1,0,0,1
893795443179638784,0,1,0,0,1
929510736568582144,0,1,0,0,1
912987516864811008,0,1,0,0,1
899365092403200000,0,1,0,0,1
899364890321833984,0,1,0,0,1
914496671840702464,0,1,0,0,1
893111899348287488,0,1,0,0,1
929925326628536320,0,1,0,0,1
900558605841293312,0,0,1,0,1
899282583409872896,0,1,0,0,1
912676654505447424,0,1,0,0,1
927613797719687168,0,1,0,0,1
927797778608136192,0,1,0,0,1
929976043892592640,0,1,0,0,1
914553090455605248,0,1,0,0,1
893147387019046912,0,1,0,0,1
912705842654441472,0,1,0,0,1
893868617711964160,0,1,0,0,1
912727976479002624,0,1,0,0,1
914522920612798464,0,1,0,0,1
914522918629134336,0,1,0,0,1
927821295898595328,0,1,0,0,1
929802343398256640,0,1,0,0,1
893162633313923072,0,1,0,0,1
929760559976894464,1,0,0,0,1
900555081778552832,0,1,0,0,1
894284923800100864,0,1,0,0,1
910533077851656192,0,1,0,0,1
932542574694359040,0,1,0,0,1
917425398002073600,1,0,0,0,1
908726702980902912,0,1,0,0,1
890550877332934656,0,1,0,0,1
908838943365398528,0,1,0,0,1
908895207432716288,0,1,0,0,1
934585668176613376,0,1,0,0,1
908916586534248448,1,0,0,0,1
934578759054909440,0,1,0,0,1
924728258091941888,0,1,0,0,1
924883003402108928,0,1,0,0,1
903426821168889856,0,1,0,0,1
917287378561069056,0,1,0,0,1
908916715341443072,0,1,0,0,1
903399776485613568,0,1,0,0,1
934574535143317504,0,1,0,0,1
924923364543565824,0,1,0,0,1
908961543341166592,0,1,0,0,1
924937329680281600,1,0,0,0,1
908995375348043776,0,1,0,0,1
917178767398674432,0,1,0,0,1
924686207203860480,0,1,0,0,1
908719634483834880,0,1,0,0,1
924655476469653504,0,1,0,0,1
934741345217974272,0,1,0,0,1
934827376294244352,0,1,0,0,1
898037037000949760,1,0,0,0,1
917419815412862976,0,1,0,0,1
924588019989876736,0,1,0,0,1
924642362092957696,0,1,0,0,1
898042821294161920,1,0,0,0,1
890435718765588480,0,1,0,0,1
934750601732222976,1,0,0,0,1
903595119462330368,0,1,0,0,1
903519265831108608,0,1,0,0,1
924642629895122944,0,1,0,0,1
890497101507031040,0,1,0,0,1
890517422536617984,0,1,0,0,1
934713683753672704,0,1,0,0,1
917339811400310784,0,1,0,0,1
917327877930213376,0,1,0,0,1
934707457703673856,0,1,0,0,1
908640034131107840,0,1,0,0,1
909051813437087744,0,1,0,0,1
909217217052426240,1,0,0,0,1
917091618183933952,0,1,0,0,1
890915817663213568,1,0,0,0,1
890886953037647872,1,0,0,0,1
909328713418002432,1,0,0,0,1
894916947325972480,0,1,0,0,1
898115533463330816,0,1,0,0,1
898116633595486208,1,0,0,0,1
909349874088497152,0,1,0,0,1
917045221912743936,0,1,0,0,1
934384223577919488,0,1,0,0,1
890975892230549504,0,1,0,0,1
890821797087776768,0,1,0,0,1
925018375058853888,0,1,0,0,1
898155339165683712,0,1,0,0,1
934235416596746240,0,1,0,0,1
894842972960837632,0,1,0,0,1
894824582930079744,0,1,0,0,1
925110227820740608,0,1,0,0,1
925131929388834816,0,1,0,0,1
934054707416350720,0,1,0,0,1
934404952557887488,0,1,0,0,1
903187654820454400,0,1,0,0,1
909231508941975552,0,1,0,0,1
917065130239651840,0,1,0,0,1
909234928835088384,0,1,0,0,1
917078498187075584,0,1,0,0,1
890577253020708864,0,1,0,0,1
903343494651105280,0,1,0,0,1
903279855042736128,0,1,0,0,1
890640328956497920,0,1,0,0,1
890647654224580608,0,1,0,0,1
934430708973621248,1,0,0,0,1
894985467480997888,0,1,0,0,1
903203172361043968,0,1,0,0,1
934406499039883264,0,1,0,0,1
894982421484937216,0,1,0,0,1
890703664549179392,0,1,0,0,1
898058315334393856,0,1,0,0,1
903216308296155136,0,1,0,0,1
924964587266609152,0,1,0,0,1
898077268894986240,0,1,0,0,1
894927282904719360,0,1,0,0,1
890412573903826944,1,0,0,0,1
908393394321334272,0,1,0,0,1
926240259364540416,1,0,0,0,1
917442561970704384,1,0,0,0,1
935377423830417408,0,1,0,0,1
923681819031203840,0,1,0,0,1
923711307689414656,0,1,0,0,1
895258189775503360,0,1,0,0,1
907544275121876992,0,1,0,0,1
895250117602803712,1,0,0,0,1
935373147561512960,0,1,0,0,1
903870678386053120,0,1,0,0,1
924005564199383040,0,1,0,0,1
917744125574811648,0,1,0,0,1
903810877538918400,0,0,0,1,1
935366035829538816,0,1,0,0,1
897977311978430464,0,1,0,0,1
924018600201072640,0,1,0,0,1
924052751218118656,0,1,0,0,1
907626560664035328,0,1,0,0,1
935329005384777728,0,1,0,0,1
935319658936356864,0,1,0,0,1
924116102862405632,0,1,0,0,1
935384124579135488,0,1,0,0,1
889978396373123072,0,1,0,0,1
895282208818085888,0,1,0,0,1
923576979777040384,1,0,0,0,1
923471172230176768,0,1,0,0,1
917765810621259776,0,1,0,0,1
923518281838944256,1,0,0,0,1
935775171453116416,0,1,0,0,1
895407067674095616,0,1,0,0,1
907265678230425600,0,1,0,0,1
907273855370227712,0,0,0,1,1
895405793645809664,0,1,0,0,1
907309042749583360,0,1,0,0,1
889951235155132416,1,0,0,0,1
895331927053520896,0,1,0,0,1
935495993952493568,0,1,0,0,1
907344029687226368,0,1,0,0,1
935471466308558848,0,1,0,0,1
895294867512930304,1,0,0,0,1
923645226698321920,0,1,0,0,1
907456163545014272,0,1,0,0,1
935449792561459200,0,1,0,0,1
935250217254957056,0,1,0,0,1
917738261237215232,0,1,0,0,1
935240388562046976,0,1,0,0,1
908376498263883776,1,0,0,0,1
924309724513779712,1,0,0,0,1
924491069282140160,1,0,0,0,1
908266987482177536,0,1,0,0,1
890357228003356672,0,1,0,0,1
924545445518602240,0,1,0,0,1
935033085762007040,0,1,0,0,1
917516344500744192,0,1,0,0,1
908365750146039808,0,0,1,0,1
924552159206797312,1,0,0,0,1
890329205719871488,0,1,0,0,1
935026302448537600,0,1,0,0,1
908384254588887040,0,1,0,0,1
934835818467696640,0,1,0,0,1
903731667856121856,0,1,0,0,1
895113611537993728,0,0,0,1,1
895098539042258944,0,1,0,0,1
924554419559165952,0,1,0,0,1
903602673039134720,1,0,0,0,1
903752441706844160,0,1,0,0,1
924282658926063616,0,1,0,0,1
907648044358828032,0,1,0,0,1
917696537253232640,0,1,0,0,1
935182101955137536,0,1,0,0,1
903788607307214848,1,0,0,0,1
903788373432610816,0,1,0,0,1
903787703891873792,0,1,0,0,1
907710332168232960,0,1,0,0,1
935180045085216768,0,1,0,0,1
907819776122118144,0,1,0,0,1
890172075721330688,0,1,0,0,1
935133680779120640,0,1,0,0,1
935095268847919104,0,1,0,0,1
890240318641197056,0,1,0,0,1
935116361218576384,0,0,0,1,1
907850173656825856,0,1,0,0,1
908168044299669504,0,1,0,0,1
908202319057227776,0,1,0,0,1
924193514325528576,0,1,0,0,1
935107238414503936,0,1,0,0,1
917678925928697856,0,1,0,0,1
898159917609168896,0,1,0,0,1
893495876081119232,0,1,0,0,1
934047351202832384,0,1,0,0,1
909354957870063616,0,1,0,0,1
902600223012290560,0,1,0,0,1
902587734098923520,0,1,0,0,1
894457272562139136,0,1,0,0,1
933278295830999040,0,1,0,0,1
910018203962761216,0,1,0,0,1
926035851703971840,0,1,0,0,1
926049601576042496,1,0,0,0,1
902562721207603200,0,0,0,1,1
933270862710616064,0,1,0,0,1
902558838443913216,0,1,0,0,1
902550750252777472,0,1,0,0,1
891580523914686464,0,1,0,0,1
894422387722117120,0,1,0,0,1
933252366404485120,0,1,0,0,1
891600679499902976,0,1,0,0,1
926105032755425280,0,1,0,0,1
910050529069469696,0,1,0,0,1
902535493065228288,0,1,0,0,1
894417495616090112,0,1,0,0,1
891466309619380224,0,1,0,0,1
916331712958943232,0,1,0,0,1
916376460612571136,0,1,0,0,1
933315195363086336,0,1,0,0,1
925802580202147840,0,1,0,0,1
933401124387938304,0,1,0,0,1
933359949882695680,1,0,0,0,1
933348470760538112,0,1,0,0,1
898427672614678528,0,1,0,0,1
933329673131577344,0,1,0,0,1
916542606846431232,0,1,0,0,1
925812264850083840,0,1,0,0,1
894519947157684224,0,1,0,0,1
909994438356647936,0,1,0,0,1
894471870996676608,0,1,0,0,1
891443586553831424,0,1,0,0,1
925874293115969536,0,1,0,0,1
925876396878020608,0,1,0,0,1
898607269692137472,1,0,0,0,1
916495608172744704,0,1,0,0,1
916486899023323136,0,1,0,0,1
925990869962018816,0,0,0,1,1
898619580129660928,1,0,0,0,1
910068859268472832,0,0,1,0,1
902510775356375040,0,1,0,0,1
932740219564118016,0,1,0,0,1
910236118540365824,1,0,0,0,1
932880959518756864,0,1,0,0,1
910271733462130688,0,1,0,0,1
910377155246346240,0,0,0,1,1
910448940612444160,0,1,0,0,1
910460567369977856,1,0,0,0,1
932874952113520640,0,1,0,0,1
910462985633705984,0,1,0,0,1
932660359953076224,0,1,0,0,1
910211838272348160,0,1,0,0,1
894328281939533824,0,1,0,0,1
932645901482553344,1,0,0,0,1
902332475619278848,1,0,0,0,1
898630163428233216,0,1,0,0,1
932645798445289472,0,1,0,0,1
910517173797425152,0,1,0,0,1
910524111696351232,0,1,0,0,1
894300619519012864,0,1,0,0,1
932885738563297280,1,0,0,0,1
916215624161996800,0,1,0,0,1
933211199688155136,0,1,0,0,1
894368848178278400,0,1,0,0,1
902484068415221760,0,1,0,0,1
910080527759273984,0,1,0,0,1
891631170227765248,0,1,0,0,1
933199832075964416,0,1,0,0,1
933167783931768832,0,1,0,0,1
933069224184045568,0,0,1,0,1
926173217277874176,0,1,0,0,1
891672653165154304,0,1,0,0,1
926180822062743552,1,0,0,0,1
891706847337619456,0,1,0,0,1
910093928241577984,0,1,0,0,1
916327706488324096,0,1,0,0,1
910148727985274880,0,1,0,0,1
898621217636220928,0,1,0,0,1
932987662620905472,0,0,1,0,1
891690551409508352,0,1,0,0,1
932922450148515840,0,1,0,0,1
910185074045235200,1,0,0,0,1
933447807020814336,0,1,0,0,1
894522710180724736,0,1,0,0,1
898337570190491648,0,1,0,0,1
902964285697085440,0,1,0,0,1
925358025350795264,0,0,0,1,1
909443911038504960,0,1,0,0,1
909449808200351744,0,1,0,0,1
891208155438252032,0,1,0,0,1
916818495026974720,1,0,0,0,1
909604209993048064,0,1,0,0,1
916805796125728768,0,1,0,0,1
909664725088264192,0,1,0,0,1
909690036186226688,0,1,0,0,1
903060618978238464,0,0,1,0,1
898250761502679040,0,1,0,0,1
909694332713631744,0,1,0,0,1
894537714514763776,0,0,0,1,1
933834294816051200,0,1,0,0,1
925373310904385536,0,1,0,0,1
916674562540167168,0,1,0,0,1
902951519921811456,1,0,0,0,1
891248456022536192,0,1,0,0,1
891202379009241088,0,1,0,0,1
894549339359649792,1,0,0,0,1
916631720488849408,0,1,0,0,1
909380027585847296,0,1,0,0,1
925214571312189440,0,1,0,0,1
934027291415293952,0,1,0,0,1
916920306983489536,0,1,0,0,1
933911757969485824,0,1,0,0,1
925241804844425216,0,0,1,0,1
916907888857063424,1,0,0,0,1
925253191687688192,0,1,0,0,1
898229271566667776,0,1,0,0,1
933892767281025024,0,1,0,0,1
909423790232363008,0,1,0,0,1
925266097896648704,1,0,0,0,1
909386676589359104,0,1,0,0,1
903094879412035584,0,1,0,0,1
894728198382080000,1,0,0,0,1
890982534091288576,0,1,0,0,1
894714130187399168,0,1,0,0,1
891049009976160256,0,1,0,0,1
916884379229503488,0,1,0,0,1
891315798257664000,0,1,0,0,1
891333398022770688,0,1,0,0,1
916553249183993856,0,1,0,0,1
902720925212315648,0,1,0,0,1
902810529638395904,0,0,0,1,1
925688306427363328,0,0,0,1,1
898325661298941952,0,1,0,0,1
933730335594090496,0,1,0,0,1
902808337833754624,0,1,0,0,1
933718971072897024,0,1,0,0,1
902762830440562688,0,1,0,0,1
902731778170826752,0,1,0,0,1
925716887132164096,0,1,0,0,1
909897053156859904,0,1,0,0,1
909907505895149568,0,1,0,0,1
933689953120239616,1,0,0,0,1
909937308937457664,0,1,0,0,1
933634251035209728,0,1,0,0,1
933600543607533568,1,0,0,0,1
933574642052169728,0,1,0,0,1
933568747662708736,0,1,0,0,1
933471071705161728,0,1,0,0,1
916572769684303872,1,0,0,0,1
898321068431200256,0,1,0,0,1
891361131180064768,0,1,0,0,1
933766816060641280,0,1,0,0,1
925453240354983936,0,1,0,0,1
898305010944974848,0,1,0,0,1
909710365428260864,0,1,0,0,1
925533296733204480,0,1,0,0,1
891429270169559040,0,1,0,0,1
925556023703851008,0,1,0,0,1
909715861044416512,0,1,0,0,1
916584442277199872,0,1,0,0,1
925567204048887808,0,1,0,0,1
925641113255456768,0,1,0,0,1
902845865244717056,0,1,0,0,1
925630199110275072,0,1,0,0,1
909761942876753920,0,1,0,0,1
909796839762857984,0,1,0,0,1
909812860192096256,0,1,0,0,1
925633587176542208,0,1,0,0,1
933760685951070208,0,0,0,1,1
909830450474049536,0,1,0,0,1
921269304661647360,0,1,0,0,1
7468,0,1,0,0,1
887590100544229376,0,1,0,0,1
728786008339263488,0,1,0,0,1
728875313090973696,0,1,0,0,1
728926545226518528,0,1,0,0,1
728963808459268096,1,0,0,0,1
729007165265022976,1,0,0,0,1
729150199587868672,0,1,0,0,1
729189694970322944,0,1,0,0,1
729240348149481472,1,0,0,0,1
729358759810768896,0,1,0,0,1
729376662161231872,0,1,0,0,1
729444585039134720,1,0,0,0,1
729491448899375104,0,1,0,0,1
729538330166239232,1,0,0,0,1
729638560807194624,0,1,0,0,1
729652160506400768,0,1,0,0,1
729804032462573568,0,1,0,0,1
728835478779248640,0,1,0,0,1
728631637173518336,0,1,0,0,1
729933706597699584,0,0,0,1,1
728606890838523904,0,1,0,0,1
727997315097702400,0,1,0,0,1
728032148574375936,0,1,0,0,1
728061879688437760,1,0,0,0,1
728095557999165440,1,0,0,0,1
728116942968479744,0,1,0,0,1
728266268646776832,1,0,0,0,1
728279220405846016,0,1,0,0,1
728282042472005632,0,1,0,0,1
728302022487773184,0,1,0,0,1
728306889553907712,0,1,0,0,1
728327030203355136,0,1,0,0,1
728364348071022592,0,1,0,0,1
728457807805087744,0,1,0,0,1
728497757896486912,0,1,0,0,1
728562424534728704,0,1,0,0,1
729902291311013888,0,1,0,0,1
729941026740260864,0,1,0,0,1
731948752731308032,0,1,0,0,1
730898785241440256,0,1,0,0,1
731083330502963200,0,1,0,0,1
731232916764827648,0,1,0,0,1
731250522645106688,0,1,0,0,1
731259722226094080,1,0,0,0,1
731367290978086912,0,1,0,0,1
731368259770028032,0,1,0,0,1
731416437215072256,0,1,0,0,1
731470143444910080,0,1,0,0,1
731520652608315392,0,1,0,0,1
731521574919114752,0,1,0,0,1
731551753263419392,0,1,0,0,1
731555206320754688,0,1,0,0,1
731582896427937792,0,1,0,0,1
731706232738701312,1,0,0,0,1
731751785011019776,0,1,0,0,1
731059332213800960,0,1,0,0,1
730847352278253568,1,0,0,0,1
729988061942169600,0,1,0,0,1
730842345579675648,0,1,0,0,1
729991987634573312,1,0,0,0,1
730049628100546560,0,1,0,0,1
730055380563275776,0,1,0,0,1
730076807521812480,0,1,0,0,1
730088643658801152,0,1,0,0,1
730185234105257984,1,0,0,0,1
730192218913300480,0,1,0,0,1
730200301802762240,1,0,0,0,1
730307929451024384,0,1,0,0,1
730340068687228928,0,1,0,0,1
730379722891374592,0,1,0,0,1
730427370071572480,0,1,0,0,1
730461357158600704,0,1,0,0,1
730569565873176576,0,1,0,0,1
730774792740208640,1,0,0,0,1
727897725899964416,0,1,0,0,1
727893974279655424,0,1,0,0,1
727765575397683200,1,0,0,0,1
725113593696542720,0,1,0,0,1
725209384746373120,0,1,0,0,1
725259612891570176,0,1,0,0,1
725270432870490112,0,1,0,0,1
725287688920817664,0,1,0,0,1
725310309712404480,0,1,0,0,1
725326065531539456,0,1,0,0,1
725348445444173824,0,1,0,0,1
725355826806841344,1,0,0,0,1
725389829819781120,0,1,0,0,1
725526021663924224,0,1,0,0,1
725539545362534400,0,1,0,0,1
725690730568671232,0,1,0,0,1
725731637141618688,0,1,0,0,1
725740100131409920,0,1,0,0,1
725761939595366400,1,0,0,0,1
725198336047853568,1,0,0,0,1
725073230155927552,0,1,0,0,1
727659186792763392,0,1,0,0,1
725063402284945408,0,1,0,0,1
724177544589791232,0,1,0,0,1
724231279638515712,0,1,0,0,1
724243294817902592,0,1,0,0,1
724333519221198848,0,1,0,0,1
724537191473512448,0,1,0,0,1
724589646521458688,0,1,0,0,1
724602796834693120,0,1,0,0,1
724637758048718848,0,1,0,0,1
724663004453842944,1,0,0,0,1
724683033870254080,0,1,0,0,1
724693633488834560,0,0,1,0,1
724733071929520128,0,1,0,0,1
724912201027457024,0,1,0,0,1
724937669285916672,0,1,0,0,1
725052945025384448,0,1,0,0,1
725778154774794240,0,1,0,0,1
725864975294697472,0,1,0,0,1
725886152952131584,0,1,0,0,1
725909810135207936,1,0,0,0,1
726849991336153088,1,0,0,0,1
726850020536885248,0,1,0,0,1
727069705043861504,0,1,0,0,1
727116497445896192,0,1,0,0,1
727173928804868096,0,1,0,0,1
727248964098084864,0,1,0,0,1
727348263972683776,0,1,0,0,1
727387736143974400,0,1,0,0,1
727400694773350400,0,1,0,0,1
727407545489444864,0,1,0,0,1
727421775211028480,1,0,0,0,1
727439910303600640,1,0,0,0,1
727527084197814272,1,0,0,0,1
727584580765618176,0,0,0,1,1
727633648992845824,1,0,0,0,1
726771417778245632,0,1,0,0,1
726751187521949696,0,1,0,0,1
726685565127692288,0,1,0,0,1
726205983135920128,1,0,0,0,1
725968843563225088,0,1,0,0,1
725994887330562048,0,1,0,0,1
726051903294046208,0,1,0,0,1
726054589674479616,1,0,0,0,1
726076246661185536,0,1,0,0,1
726138920963063808,1,0,0,0,1
726285970392252416,0,1,0,0,1
726637636388020224,0,1,0,0,1
726323379855347712,1,0,0,0,1
726334775363956736,0,1,0,0,1
726440942912344064,0,1,0,0,1
726453247154728960,0,1,0,0,1
726515789667401728,0,1,0,0,1
726614610011381760,0,1,0,0,1
731774530574819328,0,1,0,0,1
732116067078840320,0,1,0,0,1
724166773537427456,0,1,0,0,1
738293890533330944,0,1,0,0,1
738347079639126016,0,1,0,0,1
738350403784441856,0,1,0,0,1
738442145061851136,0,1,0,0,1
738455772665806848,0,1,0,0,1
738594166993625088,0,1,0,0,1
738678023935909888,0,1,0,0,1
738736734821834752,0,1,0,0,1
738901470586621952,0,1,0,0,1
738962621362118656,0,1,0,0,1
739016980003495936,0,1,0,0,1
739044913543794688,0,1,0,0,1
739145086018158592,1,0,0,0,1
739188669232361472,0,1,0,0,1
739272696614260736,0,1,0,0,1
739366225885679616,0,1,0,0,1
738344440851468288,0,1,0,0,1
738267101077594112,0,1,0,0,1
739384237934182400,0,1,0,0,1
738164228268269568,0,1,0,0,1
737240052707790848,0,1,0,0,1
737263654421319680,0,1,0,0,1
737300684287160320,1,0,0,0,1
737308973712482304,0,1,0,0,1
737356437215707136,0,1,0,0,1
737384722410524672,0,1,0,0,1
737423217854406656,0,1,0,0,1
737446915340533760,0,1,0,0,1
737586113695481856,0,1,0,0,1
737613926989332480,0,1,0,0,1
737658244018098176,0,0,1,0,1
737778489948934144,0,1,0,0,1
737977061957095424,0,1,0,0,1
737980006266249216,0,1,0,0,1
738129118370406400,0,1,0,0,1
739378110001512448,0,1,0,0,1
739679176622362624,0,1,0,0,1
732118536315867136,0,0,1,0,1
740968755929481216,0,1,0,0,1
741136306097512448,0,1,0,0,1
741150932050841600,0,1,0,0,1
741205833548058624,1,0,0,0,1
741235163649191936,0,1,0,0,1
741357109418332160,1,0,0,0,1
741359321561370624,1,0,0,0,1
741369679281819648,0,1,0,0,1
741447408706523136,0,1,0,0,1
741552472334835712,0,1,0,0,1
741703892912594944,0,1,0,0,1
741744574536818688,0,1,0,0,1
741966603747794944,0,1,0,0,1
741976693565460480,0,1,0,0,1
742003735476473856,0,1,0,0,1
742030082282295296,0,1,0,0,1
741035667136913408,1,0,0,0,1
740895410844209152,0,1,0,0,1
739702692914864128,0,1,0,0,1
740885811831418880,0,1,0,0,1
739771115359375360,0,0,0,1,1
739846402419924992,0,1,0,0,1
739874583604404224,0,1,0,0,1
740088911968538624,1,0,0,0,1
740119873964118016,0,0,1,0,1
740170436307222528,1,0,0,0,1
740265667467841536,0,1,0,0,1
740423736801759232,0,1,0,0,1
740478436955803648,0,1,0,0,1
740498875455246336,0,1,0,0,1
740552636106215424,0,1,0,0,1
740632286643773440,0,1,0,0,1
740731467349647360,0,1,0,0,1
740763229148839936,0,1,0,0,1
740819407887323136,0,1,0,0,1
737049837774864384,0,1,0,0,1
737016388850712576,0,1,0,0,1
736973427387424768,0,1,0,0,1
732959311207354368,0,1,0,0,1
733189913840123904,0,1,0,0,1
733240777296482304,0,1,0,0,1
733247368590548992,0,1,0,0,1
733331093336641536,0,1,0,0,1
733342099442159616,0,1,0,0,1
733383856154365952,0,1,0,0,1
733682401231134720,0,0,1,0,1
733777427701305344,0,1,0,0,1
733818577829007360,0,1,0,0,1
733917723726602240,0,1,0,0,1
733965200768917504,0,1,0,0,1
733978799562326016,1,0,0,0,1
734020351248728064,0,1,0,0,1
734043519367577600,0,1,0,0,1
734050940693716992,0,1,0,0,1
733167140077895680,0,1,0,0,1
732914135319601152,0,1,0,0,1
736927312327901184,1,0,0,0,1
732857387556741120,0,1,0,0,1
732130185286434816,0,1,0,0,1
732143993706971136,0,1,0,0,1
732237456372826112,0,1,0,0,1
732255558741397504,0,1,0,0,1
732256129594626048,1,0,0,0,1
732319191345156096,1,0,0,0,1
732339588702842880,0,1,0,0,1
732419224786739200,0,1,0,0,1
732451921835909120,0,1,0,0,1
732462728892153856,0,1,0,0,1
732463678809726976,0,1,0,0,1
732527294363897856,0,1,0,0,1
732548070341259264,0,1,0,0,1
732594986437496832,1,0,0,0,1
732620201599111168,1,0,0,0,1
734305869110775808,1,0,0,0,1
734307754462961664,0,1,0,0,1
734348794611916800,0,1,0,0,1
734348860907196416,0,1,0,0,1
735667566010470400,0,1,0,0,1
735801125455044608,0,1,0,0,1
735860118378532864,0,1,0,0,1
735886389972111360,0,1,0,0,1
735906025405042688,0,1,0,0,1
736073528508710912,0,1,0,0,1
736258887041617920,1,0,0,0,1
736271120047955968,0,1,0,0,1
736273066725015552,0,1,0,0,1
736416663386611712,0,0,0,1,1
736444955414171648,1,0,0,0,1
736537778717069312,0,1,0,0,1
736542260662128640,0,1,0,0,1
736869866125307904,0,1,0,0,1
736918274194214912,1,0,0,0,1
735542335912726528,1,0,0,0,1
735495661731336192,0,1,0,0,1
735477312083238912,0,1,0,0,1
734794922444853248,0,1,0,0,1
734413368770039808,0,1,0,0,1
734419620346597376,1,0,0,0,1
734517225298743296,0,1,0,0,1
734646983198158848,0,1,0,0,1
734681673690931200,0,1,0,0,1
734774150321999872,0,1,0,0,1
734869018528632832,1,0,0,0,1
735476068274966528,0,1,0,0,1
735104481172553728,0,1,0,0,1
735112139095019520,0,1,0,0,1
735196568530395136,0,1,0,0,1
735202821272899584,0,1,0,0,1
735211600039251968,1,0,0,0,1
735257179599568896,0,1,0,0,1
724174772028997632,0,1,0,0,1
724147778524483584,0,1,0,0,1
771752667005591552,0,1,0,0,1
713802314700730368,0,0,1,0,1
714035979062013952,0,1,0,0,1
714126982892617728,1,0,0,0,1
714213647007006720,0,0,1,0,1
714220966306390016,0,1,0,0,1
714341891743952896,1,0,0,0,1
714574689528451072,0,1,0,0,1
714614269032198144,0,1,0,0,1
714718180791435264,0,1,0,0,1
714741472923357184,0,1,0,0,1
714898036913283072,0,1,0,0,1
714967514074259456,0,1,0,0,1
714987495985954816,0,1,0,0,1
715035472741928960,1,0,0,0,1
715070924534456320,0,1,0,0,1
715124197874339840,0,1,0,0,1
713998743616548864,0,0,1,0,1
713747511123566592,1,0,0,0,1
715178106982678528,0,1,0,0,1
713738481944682496,1,0,0,0,1
712876011466203136,0,1,0,0,1
713002525226442752,0,0,1,0,1
713003962077609984,0,1,0,0,1
713024972264980480,0,0,0,1,1
713028058207358976,0,1,0,0,1
713051575313367040,0,1,0,0,1
713112219668582400,0,1,0,0,1
713222358283194368,0,1,0,0,1
713291897133998080,0,1,0,0,1
713368574325166080,0,1,0,0,1
713394546466422784,0,1,0,0,1
713403362679635968,1,0,0,0,1
713498795347218432,0,1,0,0,1
713695765269491712,0,1,0,0,1
713700737662869504,0,1,0,0,1
715141077854883840,0,0,0,1,1
715178619904139264,0,1,0,0,1
716993438521155584,0,1,0,0,1
716326960872439808,0,1,0,0,1
716352323455361024,0,1,0,0,1
716380433613606912,0,0,1,0,1
716426032522379264,0,1,0,0,1
716596262276042752,0,1,0,0,1
716603882374234112,1,0,0,0,1
716675896875192320,0,1,0,0,1
716686706804559872,0,1,0,0,1
716712527934144512,0,1,0,0,1
716733642488299520,0,1,0,0,1
716799148348059648,0,1,0,0,1
716834374189121536,0,1,0,0,1
716837382331432960,0,1,0,0,1
716856764302565376,0,1,0,0,1
716890139692179456,0,1,0,0,1
716909714643283968,0,1,0,0,1
716352019389358080,0,1,0,0,1
716221522051002368,0,1,0,0,1
715394189723238400,0,1,0,0,1
716212986902405120,0,0,0,1,1
715408183808757760,1,0,0,0,1
715469785895673856,0,1,0,0,1
715511983299248128,1,0,0,0,1
715534146450235392,0,1,0,0,1
715587665878507520,0,1,0,0,1
715595230288941056,0,1,0,0,1
715644689622372352,0,1,0,0,1
715774636286414848,0,1,0,0,1
715805451384983552,0,1,0,0,1
715868856909230080,0,0,1,0,1
715901780530307072,0,1,0,0,1
715911617687470080,0,1,0,0,1
715951999024570368,0,1,0,0,1
715976554329735168,0,1,0,0,1
716207913807847424,0,1,0,0,1
712852680000073728,0,1,0,0,1
712833968278622208,1,0,0,0,1
712822655292846080,0,0,1,0,1
710212521232236544,1,0,0,0,1
710255190235095040,0,1,0,0,1
710270422290403328,0,1,0,0,1
710282423687221248,0,1,0,0,1
710288020977672192,0,1,0,0,1
710320850809913344,0,1,0,0,1
710337297716219904,1,0,0,0,1
710357399572320256,1,0,0,0,1
710367668226891776,0,1,0,0,1
710372563424309248,0,1,0,0,1
710399570476290048,0,1,0,0,1
710507534621261824,0,1,0,0,1
710579736519512064,0,1,0,0,1
710667633364893696,0,0,0,1,1
710771761554411520,0,1,0,0,1
710776072934170624,0,1,0,0,1
710243111872626688,0,1,0,0,1
710207570917531648,0,0,0,1,1
712803727413895168,0,1,0,0,1
710167610298646528,0,1,0,0,1
709014562574569472,1,0,0,0,1
709026405384753152,0,1,0,0,1
709052445352013824,1,0,0,0,1
709082084061671424,0,1,0,0,1
709086027072315392,0,1,0,0,1
709273228867403776,0,1,0,0,1
709334073278337024,0,1,0,0,1
709368078187028480,0,1,0,0,1
709369764867493888,0,1,0,0,1
709438873768742912,0,1,0,0,1
709574367341092864,1,0,0,0,1
709665645701386240,0,1,0,0,1
709725666674122752,0,1,0,0,1
710018266186514432,0,1,0,0,1
710055321222443008,0,1,0,0,1
710778471950229504,0,1,0,0,1
710786383594561536,0,1,0,0,1
710808946118926336,0,1,0,0,1
710861429285511168,0,1,0,0,1
712057389277716480,1,0,0,0,1
712119296135139328,0,1,0,0,1
712178237426819072,0,1,0,0,1
712185459351429120,1,0,0,0,1
712201568796409856,0,1,0,0,1
712211007343607808,0,1,0,0,1
712324565674819584,0,1,0,0,1
712336272296165376,0,1,0,0,1
712558271278813184,1,0,0,0,1
712559539711660032,1,0,0,0,1
712595106742841344,0,1,0,0,1
712609545726590976,0,1,0,0,1
712667717757698048,0,1,0,0,1
712714220605988864,1,0,0,0,1
712797332685905920,0,1,0,0,1
711937839534088192,0,0,0,1,1
711892604108017664,0,0,1,0,1
711838266719387648,0,1,0,0,1
711272203149557760,0,1,0,0,1
710902279092568064,0,1,0,0,1
710904256463822848,0,1,0,0,1
710920820294557696,0,1,0,0,1
711103520917884928,0,1,0,0,1
711133900651814912,0,1,0,0,1
711197841893371904,1,0,0,0,1
711279049751076864,0,1,0,0,1
711823886573293568,0,1,0,0,1
711378302611488768,0,1,0,0,1
711392514968715264,1,0,0,0,1
711494087753338880,0,1,0,0,1
711554997314519040,0,0,0,1,1
711794641335664640,0,1,0,0,1
711795802184650752,0,1,0,0,1
716983127520845824,0,1,0,0,1
717038554069733376,0,1,0,0,1
724137016447770624,0,1,0,0,1
720937693425704960,0,0,0,1,1
721001920937205760,1,0,0,0,1
721038929609232384,0,1,0,0,1
721103906416173056,0,1,0,0,1
721125395052015616,0,1,0,0,1
721204768031551488,0,1,0,0,1
721208903296528384,0,1,0,0,1
721380676415725568,0,1,0,0,1
721458063102713856,0,1,0,0,1
721521336338632704,1,0,0,0,1
721547483436883968,0,1,0,0,1
721606455028289536,0,1,0,0,1
721659320329371648,0,1,0,0,1
721668298287415296,0,1,0,0,1
721736130417270784,0,1,0,0,1
721758130900770816,0,1,0,0,1
720973914680201216,0,1,0,0,1
720923760774266880,0,1,0,0,1
721825216289181696,1,0,0,0,1
720917447050727424,0,1,0,0,1
720279098338074624,0,0,0,1,1
720323698947858432,0,1,0,0,1
720330735043747840,0,1,0,0,1
720443427977052160,0,1,0,0,1
720546533796683776,0,1,0,0,1
720559048538648576,0,1,0,0,1
720607681518661632,0,1,0,0,1
720653922629722112,0,1,0,0,1
720683092441186304,0,1,0,0,1
720710475743436800,0,1,0,0,1
720750529874391040,0,1,0,0,1
720817320906522624,0,1,0,0,1
720817783060103168,0,0,0,1,1
720866184606801920,0,1,0,0,1
720902820719931392,0,1,0,0,1
721790379868209152,0,1,0,0,1
721980544154759168,0,1,0,0,1
717091150734168064,0,0,1,0,1
723162875179593728,0,1,0,0,1
723238410090065920,0,1,0,0,1
723348687297060864,0,1,0,0,1
723430186423713792,0,1,0,0,1
723459241122488320,0,1,0,0,1
723542106451546112,0,1,0,0,1
723576119895724032,1,0,0,0,1
723587318423019520,0,0,0,1,1
723601861765398528,0,1,0,0,1
723768660301602816,0,1,0,0,1
723823054502133760,0,1,0,0,1
723825104040370176,0,1,0,0,1
723836252383006720,0,1,0,0,1
723898856853770240,0,1,0,0,1
724033020282314752,0,1,0,0,1
724132918751272960,0,1,0,0,1
723235609792380928,0,1,0,0,1
723151895624339456,0,1,0,0,1
722012477873991680,0,1,0,0,1
723113644951801856,0,1,0,0,1
722105852170100736,0,1,0,0,1
722125311559798784,0,1,0,0,1
722194882417336320,0,0,1,0,1
722218633145880576,0,1,0,0,1
722235000410791936,0,1,0,0,1
722298661540085760,0,1,0,0,1
722343190888607744,0,1,0,0,1
722652370979721216,0,0,0,1,1
722743672333275136,0,0,0,1,1
722850376827809792,0,1,0,0,1
722862665970884608,1,0,0,0,1
722894632011620352,0,1,0,0,1
722932253144301568,0,1,0,0,1
723021233458188288,0,1,0,0,1
723060429551853568,0,1,0,0,1
720237894066053120,0,1,0,0,1
720106476660985856,1,0,0,0,1
719990793419812864,0,1,0,0,1
717743940074651648,0,1,0,0,1
717773937514516480,0,0,0,1,1
717804319081422848,0,1,0,0,1
717815638895435776,0,1,0,0,1
717873818212151296,1,0,0,0,1
717878384664023040,1,0,0,0,1
717918306989002752,1,0,0,0,1
717968840580161536,0,1,0,0,1
717982773013790720,1,0,0,0,1
718027489029853184,0,1,0,0,1
718032410873569280,0,1,0,0,1
718035014500368384,0,1,0,0,1
718067962830131200,1,0,0,0,1
718079591248736256,0,1,0,0,1
718081999160750080,0,1,0,0,1
718146559955902464,1,0,0,0,1
717745259866787840,0,1,0,0,1
717691876984262656,0,1,0,0,1
719979273000468480,0,1,0,0,1
717652200818737152,1,0,0,0,1
717115904643870720,0,1,0,0,1
717127321988116480,1,0,0,0,1
717200436797636608,0,1,0,0,1
717232109077798912,0,1,0,0,1
717312894300524544,0,1,0,0,1
717371709809172480,0,1,0,0,1
717459451859611648,0,1,0,0,1
717464400903450624,0,1,0,0,1
717482914599071744,0,1,0,0,1
717483861886812160,1,0,0,0,1
717516707510620160,0,1,0,0,1
717518995444875264,0,1,0,0,1
717532420300476416,0,1,0,0,1
717614210662981632,0,1,0,0,1
717616876545814528,0,1,0,0,1
718147939177136128,1,0,0,0,1
718153607380615168,0,1,0,0,1
718235390403035136,0,1,0,0,1
718336397137047552,0,1,0,0,1
719186337132363776,0,1,0,0,1
719225166228811776,0,1,0,0,1
719318490084208640,0,1,0,0,1
719335864501817344,0,0,1,0,1
719392377161564160,0,1,0,0,1
719412527633797120,0,1,0,0,1
719749866021367808,0,1,0,0,1
719765627053989888,1,0,0,0,1
719805743164190720,0,1,0,0,1
719812255060213760,0,1,0,0,1
719818294862209024,1,0,0,0,1
719841567767400448,1,0,0,0,1
719866076486610944,0,1,0,0,1
719879172437446656,0,1,0,0,1
719924657063858176,1,0,0,0,1
719147371045765120,0,1,0,0,1
719133827243864064,0,1,0,0,1
719019136135913472,0,1,0,0,1
718473521337393152,0,1,0,0,1
718393131515961344,0,1,0,0,1
718405771147481088,0,1,0,0,1
718433446440398848,0,1,0,0,1
718434803188637696,0,1,0,0,1
718451529695502336,0,1,0,0,1
718460428121214976,0,1,0,0,1
718506418022682624,0,0,0,1,1
718861048720269312,0,1,0,0,1
718603119194742784,0,1,0,0,1
718682468291911680,0,1,0,0,1
718740383233024000,0,1,0,0,1
718787149584150528,1,0,0,0,1
718797152617521152,0,0,0,1,1
718819696167030784,0,1,0,0,1
742072367703298048,1,0,0,0,1
742078646119202816,1,0,0,0,1
742093441270743040,0,1,0,0,1
761576101139189760,0,1,0,0,1
761636815455588352,0,0,1,0,1
761637445121220608,0,1,0,0,1
761709612965953536,0,1,0,0,1
761802440148516864,0,1,0,0,1
761921928160485376,1,0,0,0,1
761935847138684928,0,1,0,0,1
761965160403578880,0,1,0,0,1
761976377167912960,0,1,0,0,1
762033920124788736,0,1,0,0,1
762184670092095488,0,1,0,0,1
762203850199666688,0,1,0,0,1
762204746581151744,1,0,0,0,1
762284013952393216,0,1,0,0,1
762547792522973184,1,0,0,0,1
762557967438864384,0,1,0,0,1
761596553215746048,0,1,0,0,1
761356071533441024,1,0,0,0,1
762649692014608384,1,0,0,0,1
761345631357108224,0,1,0,0,1
760773145716555776,0,1,0,0,1
760845377016922112,0,1,0,0,1
760904868320075776,1,0,0,0,1
760949037092642816,0,1,0,0,1
760999937740070912,0,1,0,0,1
761066286440849408,0,1,0,0,1
761097787106746368,0,0,0,1,1
761112654261788672,0,1,0,0,1
761116022724177920,0,1,0,0,1
761137399900565504,1,0,0,0,1
761223139066085376,0,1,0,0,1
761267848190853120,0,1,0,0,1
761271909333995520,0,1,0,0,1
761275026498871296,0,1,0,0,1
761320523221508096,0,1,0,0,1
762558702675038208,1,0,0,0,1
762722885496635392,0,1,0,0,1
764666841759354880,0,1,0,0,1
763744961519124480,0,1,0,0,1
763994063892652032,0,1,0,0,1
764193860071325696,0,1,0,0,1
764258180310237184,1,0,0,0,1
764302664901558272,0,1,0,0,1
764383069616807936,0,1,0,0,1
764418176671178752,0,1,0,0,1
764425347752398848,0,1,0,0,1
764480161974812672,0,1,0,0,1
764504243063648256,1,0,0,0,1
764528914383470592,0,1,0,0,1
764563293587513344,1,0,0,0,1
764579972862337024,1,0,0,0,1
764589676040638464,0,1,0,0,1
764596329301549056,0,1,0,0,1
764608410817957888,0,1,0,0,1
763862646814683136,0,0,1,0,1
763636319851601920,0,0,0,1,1
762852757812293632,0,1,0,0,1
763480117955989504,0,1,0,0,1
762879086783926272,0,1,0,0,1
762917371254276096,0,1,0,0,1
762977626088697856,1,0,0,0,1
763002600249778176,0,1,0,0,1
763010046250872832,0,1,0,0,1
763010733831516160,0,1,0,0,1
763026389544996864,0,1,0,0,1
763046705629630464,0,1,0,0,1
763054680486404096,0,0,0,1,1
763055049203253248,1,0,0,0,1
763187961101967360,0,1,0,0,1
763254693988556800,0,1,0,0,1
763288680442191872,0,1,0,0,1
763302623264976896,1,0,0,0,1
763456872342880256,0,1,0,0,1
760748399763349504,0,1,0,0,1
760739927705341952,0,1,0,0,1
760681174977183744,0,1,0,0,1
758237185598431232,0,1,0,0,1
758314336653893632,0,1,0,0,1
758431408096415744,0,1,0,0,1
758439544559591424,0,1,0,0,1
758446963864068096,0,1,0,0,1
758447393356472320,0,1,0,0,1
758453336643436544,1,0,0,0,1
758482064924610560,0,1,0,0,1
758486492813660160,0,1,0,0,1
758597416924831744,1,0,0,0,1
758624593137500160,0,1,0,0,1
758687043685912576,0,1,0,0,1
758764435267842048,1,0,0,0,1
758799189237051392,0,1,0,0,1
758950070679023616,1,0,0,0,1
758981589204250624,0,0,0,1,1
758238257310236672,0,1,0,0,1
758234475419561984,0,0,1,0,1
760429270594445312,0,1,0,0,1
758201966292008960,0,1,0,0,1
757424180946210816,1,0,0,0,1
757450507640246272,0,1,0,0,1
757552356561215488,1,0,0,0,1
757591935368437760,0,1,0,0,1
757804628499058688,1,0,0,0,1
757807676009041920,0,1,0,0,1
757808205929906176,1,0,0,0,1
757894703408898048,0,1,0,0,1
757906168220094464,0,1,0,0,1
757953004016377856,0,1,0,0,1
758005894613467136,0,1,0,0,1
758016936655683584,0,1,0,0,1
758057736978378752,1,0,0,0,1
758076823372718080,0,1,0,0,1
758099963196747776,1,0,0,0,1
758987688280068096,1,0,0,0,1
759061868409393152,1,0,0,0,1
759074121510682624,0,1,0,0,1
759249183064948736,0,1,0,0,1
759816746127720448,0,1,0,0,1
759848566248660992,0,1,0,0,1
759903278159237120,0,1,0,0,1
759992740893581312,0,1,0,0,1
759994712384217088,0,1,0,0,1
759997869638098944,0,1,0,0,1
760037187064827904,0,1,0,0,1
760135450573082624,1,0,0,0,1
760198192935768064,0,1,0,0,1
760214620267216896,0,1,0,0,1
760219193195302912,0,1,0,0,1
760333055152295936,0,1,0,0,1
760357874438639616,0,1,0,0,1
760378417284014080,0,1,0,0,1
760394187829288960,1,0,0,0,1
759776965930815488,0,1,0,0,1
759730077160595456,0,1,0,0,1
759703188337336320,0,0,0,1,1
759427949410017280,1,0,0,0,1
759263663559671808,0,1,0,0,1
759297870583439360,0,1,0,0,1
759298198141865984,0,1,0,0,1
759321352239210496,0,1,0,0,1
759339469795229696,1,0,0,0,1
759387565115973632,0,1,0,0,1
759449446765780992,0,1,0,0,1
759656800291553280,1,0,0,0,1
759476782731030528,0,1,0,0,1
759499247465205760,0,1,0,0,1
759523278276943872,0,1,0,0,1
759535635321401344,0,1,0,0,1
759579776638156800,0,1,0,0,1
759645350881820672,1,0,0,0,1
764614888354410496,0,1,0,0,1
764744059831410688,0,1,0,0,1
742149508583305216,0,1,0,0,1
768667760205434880,0,1,0,0,1
768814157294514176,1,0,0,0,1
768909917990203392,0,1,0,0,1
769004458990678016,0,1,0,0,1
769169447005282304,0,1,0,0,1
769209041587273728,0,1,0,0,1
769222351779012608,0,1,0,0,1
769222537981026304,1,0,0,0,1
769233721375461376,0,1,0,0,1
769239064499200000,0,1,0,0,1
769405877023600640,0,1,0,0,1
769449208210391040,0,1,0,0,1
769468539191394304,0,1,0,0,1
769530918767919104,1,0,0,0,1
769570087351230464,0,1,0,0,1
769574820107411456,0,1,0,0,1
768813198061416448,1,0,0,0,1
768572857043615744,0,1,0,0,1
769694100744445952,0,1,0,0,1
768560791347990528,0,1,0,0,1
767793889113698304,0,1,0,0,1
768022076808695808,1,0,0,0,1
768064268625383424,0,1,0,0,1
768090789788475392,0,1,0,0,1
768151874432225280,1,0,0,0,1
768169624466698240,0,1,0,0,1
768254616181977088,0,1,0,0,1
768263713916850176,0,1,0,0,1
768285731672305664,0,1,0,0,1
768353622518267904,1,0,0,0,1
768388314046926848,0,1,0,0,1
768390244970422272,0,1,0,0,1
768502348779884544,0,1,0,0,1
768502558272856064,0,1,0,0,1
768535707400929280,0,1,0,0,1
769580555914637312,0,1,0,0,1
769753074046996480,0,1,0,0,1
764760085658755072,0,1,0,0,1
770910161573670912,0,1,0,0,1
771003871716073472,0,1,0,0,1
771106447614705664,0,0,0,1,1
771148244432719872,0,1,0,0,1
771304211157966848,0,1,0,0,1
771325781737893888,0,1,0,0,1
771329500831440896,0,1,0,0,1
771340681805701120,1,0,0,0,1
771347412375990272,0,1,0,0,1
771359245384159232,0,1,0,0,1
771360963601784832,0,1,0,0,1
771413539281969152,1,0,0,0,1
771462178880778240,1,0,0,0,1
771566332189945856,1,0,0,0,1
771574019178901504,1,0,0,0,1
771605010736001024,0,1,0,0,1
770925484406411264,0,1,0,0,1
770768557483266048,0,1,0,0,1
769858967531061248,0,1,0,0,1
770760393576689664,0,1,0,0,1
769978274252460032,0,1,0,0,1
770070113953390592,0,1,0,0,1
770211442947682304,1,0,0,0,1
770240770314035200,0,1,0,0,1
770260432099631104,0,1,0,0,1
770328361122013184,0,1,0,0,1
770336211617648640,1,0,0,0,1
770338818843090944,0,1,0,0,1
770379411153641472,0,1,0,0,1
770407209989701632,1,0,0,0,1
770601255177637888,1,0,0,0,1
770630833615011840,0,1,0,0,1
770668038370844672,0,1,0,0,1
770680791617732608,0,1,0,0,1
770751937457381376,0,1,0,0,1
767771938311790592,0,1,0,0,1
767741481713016832,1,0,0,0,1
767660177382379520,0,1,0,0,1
765811801732833280,0,1,0,0,1
765839403759472640,0,1,0,0,1
765862891228581888,0,1,0,0,1
765868467459387392,1,0,0,0,1
765876164921556992,0,1,0,0,1
765879604208869376,0,1,0,0,1
765900742544748544,0,1,0,0,1
765923062931984384,0,1,0,0,1
765931764263088128,0,1,0,0,1
765953095549521920,0,1,0,0,1
766003898935115776,0,1,0,0,1
766020739678044160,0,1,0,0,1
766024565533343744,0,1,0,0,1
766038919976783872,0,1,0,0,1
766171572772212736,0,1,0,0,1
766179072519069696,1,0,0,0,1
765836601909882880,1,0,0,0,1
765687390488891392,0,1,0,0,1
767651839210819584,0,1,0,0,1
765638725460172800,1,0,0,0,1
764773198072279040,0,0,0,1,1
764801330305171456,0,1,0,0,1
764886503155765248,1,0,0,0,1
764909460888387584,0,1,0,0,1
765069093196165120,0,1,0,0,1
765113269438783488,0,1,0,0,1
765120120041639936,0,1,0,0,1
765128768117739520,0,1,0,0,1
765183391377592320,0,1,0,0,1
765198609407016960,0,1,0,0,1
765218103399677952,0,1,0,0,1
765361296325738496,0,1,0,0,1
765444572499484672,0,1,0,0,1
765491462549102592,0,1,0,0,1
765599356980498432,0,1,0,0,1
766253165352288256,0,1,0,0,1
766283524525723648,0,1,0,0,1
766292907787689984,0,1,0,0,1
766310821823733760,0,0,1,0,1
766891728938950656,0,0,0,1,1
766906093440208896,1,0,0,0,1
766961117629452288,1,0,0,0,1
767018979693105152,1,0,0,0,1
767034247018319872,0,1,0,0,1
767042082846470144,0,1,0,0,1
767079541181296640,1,0,0,0,1
767185237990178816,0,1,0,0,1
767210017653035008,0,1,0,0,1
767290226339438592,0,1,0,0,1
767291170645041152,0,1,0,0,1
767342381859475456,0,1,0,0,1
767343220271439872,0,1,0,0,1
767413584859103232,0,1,0,0,1
767546791571009536,0,0,1,0,1
766882999426125824,0,1,0,0,1
766865786489102336,0,1,0,0,1
766861660514463744,0,1,0,0,1
766668640842293248,1,0,0,0,1
766332550189092864,1,0,0,0,1
766335874988736512,0,1,0,0,1
766536870855532544,0,1,0,0,1
766542804680007680,0,1,0,0,1
766559034698764288,0,1,0,0,1
766630034035576832,0,1,0,0,1
766677095133089792,1,0,0,0,1
766853019094904832,0,0,1,0,1
766724343627907072,0,1,0,0,1
766727349220077568,0,1,0,0,1
766743060428550144,0,1,0,0,1
766788487286779904,0,1,0,0,1
766805608695668736,0,1,0,0,1
766851601583570944,0,1,0,0,1
757293998037929984,0,1,0,0,1
757285441762684928,0,1,0,0,1
757274724506411008,0,1,0,0,1
747068058053664768,0,1,0,0,1
747151327973744640,0,1,0,0,1
747153999082700800,0,1,0,0,1
747183021179179008,0,1,0,0,1
747184721935933440,0,1,0,0,1
747205713219424256,0,1,0,0,1
747377796322832384,0,1,0,0,1
747385006037794816,0,1,0,0,1
747404437577138176,0,1,0,0,1
747526567484657664,0,1,0,0,1
747578450618122240,0,1,0,0,1
747619958255915008,0,1,0,0,1
747686931501322240,0,1,0,0,1
747709457556250624,1,0,0,0,1
747750191747502080,0,1,0,0,1
747767454055694336,0,0,0,1,1
747115486823985152,0,1,0,0,1
747000463413886976,0,1,0,0,1
747878978866843648,0,1,0,0,1
746929945146859520,0,1,0,0,1
746049224156975104,0,1,0,0,1
746057008617521152,0,1,0,0,1
746087229047578624,0,1,0,0,1
746272839410585600,0,1,0,0,1
746304933415297024,0,1,0,0,1
746363847171317760,1,0,0,0,1
746484244986339328,0,1,0,0,1
746663864360665088,0,1,0,0,1
746665948065705984,0,1,0,0,1
746685104202743808,0,1,0,0,1
746707110520455168,0,1,0,0,1
746720850649415680,0,1,0,0,1
746765577818079232,0,1,0,0,1
746783675552006144,0,1,0,0,1
746827737265016832,0,1,0,0,1
747859570228338688,0,1,0,0,1
747880209060368384,0,1,0,0,1
757270831600840704,0,1,0,0,1
749118482189459456,1,0,0,0,1
749132476405063680,1,0,0,0,1
749184119800758272,0,1,0,0,1
749219337202855936,0,1,0,0,1
749267122321256448,1,0,0,0,1
749300734387257344,0,1,0,0,1
749382003049504768,0,1,0,0,1
749406276006838272,1,0,0,0,1
749501614839431168,0,0,1,0,1
749594376481931264,0,1,0,0,1
749606004225085440,0,1,0,0,1
749629492478574592,0,1,0,0,1
749730209071521792,0,1,0,0,1
749828117825486848,0,1,0,0,1
749889175722323968,0,1,0,0,1
749902479601664000,0,1,0,0,1
749124379263500288,0,1,0,0,1
749117832240046080,0,1,0,0,1
747983757035048960,0,0,0,1,1
748958874846322688,0,1,0,0,1
748021145874604032,0,1,0,0,1
748041063600918528,0,1,0,0,1
748171849821880320,0,1,0,0,1
748233989551329280,0,1,0,0,1
748258225326292992,0,1,0,0,1
748305847621660672,0,1,0,0,1
748336362269483008,0,1,0,0,1
748416032700772352,0,1,0,0,1
748484552625131520,1,0,0,0,1
748486319467266048,0,1,0,0,1
748502599075307520,1,0,0,0,1
748567688524472320,1,0,0,0,1
748910237499977728,0,1,0,0,1
748928064252436480,0,1,0,0,1
748952675585298432,0,1,0,0,1
746044812554551296,0,1,0,0,1
746002033581371392,0,1,0,0,1
745916282520879104,0,1,0,0,1
742846109287059456,0,1,0,0,1
742915642689474560,1,0,0,0,1
742968710051287040,0,1,0,0,1
742984761153597440,0,1,0,0,1
743009446222254080,0,1,0,0,1
743105446018322432,0,1,0,0,1
743106675775803392,0,1,0,0,1
743108925071970304,1,0,0,0,1
743351685204959232,0,1,0,0,1
743366567988170752,0,1,0,0,1
743369468072570880,0,1,0,0,1
743385775522324480,0,1,0,0,1
743427426101919744,0,1,0,0,1
743440007973711872,0,0,1,0,1
743451775148109824,0,1,0,0,1
743478222029881344,0,1,0,0,1
742877717444632576,0,1,0,0,1
742747547941392384,0,1,0,0,1
745897588562464768,0,1,0,0,1
742732083769020416,1,0,0,0,1
742166698673864704,0,1,0,0,1
742241777558650880,0,1,0,0,1
742303796437602304,0,1,0,0,1
742308563427680256,0,1,0,0,1
742333281748848640,1,0,0,0,1
742352959225335808,0,0,0,1,1
742422323815387136,0,1,0,0,1
742436592753606656,0,1,0,0,1
742491088619872256,0,1,0,0,1
742589036846587904,0,1,0,0,1
742618110885122048,0,1,0,0,1
742672188856274944,0,1,0,0,1
742679026926505984,0,1,0,0,1
742685173922332672,0,1,0,0,1
742690606560870400,0,1,0,0,1
743600378646716416,0,1,0,0,1
743637780748656640,1,0,0,0,1
743750655097995264,0,1,0,0,1
743794459876425728,1,0,0,0,1
744798137466818560,0,1,0,0,1
744798993939496960,0,1,0,0,1
745194874467684352,1,0,0,0,1
745209998721024000,0,1,0,0,1
745248477077192704,0,1,0,0,1
745333331953389568,0,1,0,0,1
745348710113153024,0,1,0,0,1
745361933067558912,0,1,0,0,1
745382292223307776,0,1,0,0,1
745573025463078912,0,1,0,0,1
745577776099500032,0,1,0,0,1
745605894474432512,0,1,0,0,1
745676787536003072,0,1,0,0,1
745727775672262656,0,1,0,0,1
745806204773990400,0,1,0,0,1
744703980719190016,0,1,0,0,1
744693888447823872,0,1,0,0,1
744558322561449984,0,1,0,0,1
744023496230117376,0,1,0,0,1
743879497838174208,0,1,0,0,1
743880278079246336,0,1,0,0,1
743882105604702208,0,1,0,0,1
743886931944148992,0,1,0,0,1
743900254936899584,1,0,0,0,1
743993949891792896,0,1,0,0,1
744039109887418368,0,1,0,0,1
744430319860776960,0,0,0,1,1
744074154941489152,0,1,0,0,1
744130052409954304,0,1,0,0,1
744165746654253056,1,0,0,0,1
744212401818578944,0,1,0,0,1
744266319449698304,0,1,0,0,1
744430120153260032,0,1,0,0,1
749991074874044416,0,1,0,0,1
750105504433577984,0,1,0,0,1
750112571068342272,0,1,0,0,1
754859913038344192,0,1,0,0,1
754876476403621888,0,1,0,0,1
754949427652165632,0,1,0,0,1
754963994784501760,0,1,0,0,1
755076861659578368,0,1,0,0,1
755082039880257536,0,1,0,0,1
755166044075859968,0,1,0,0,1
755197610198052864,0,1,0,0,1
755198178211819520,0,1,0,0,1
755243811236827136,1,0,0,0,1
755278178222956544,0,1,0,0,1
755282846839926784,0,1,0,0,1
755374073853710336,0,1,0,0,1
755377890598977536,0,1,0,0,1
755427798097866752,1,0,0,0,1
755502821399728128,0,1,0,0,1
754868824323727360,0,1,0,0,1
754772514878943232,0,1,0,0,1
753682436702208000,0,1,0,0,1
754747684871888896,0,1,0,0,1
753796738322931712,0,1,0,0,1
753902751990427648,0,1,0,0,1
753942041000747008,0,1,0,0,1
753968281900449792,0,1,0,0,1
754062197958053888,0,1,0,0,1
754074754437578752,0,1,0,0,1
754238704911343616,0,1,0,0,1
754287540992143360,0,1,0,0,1
754319066844762112,1,0,0,0,1
754346907992985600,1,0,0,0,1
754357461797134336,0,1,0,0,1
754359933219594240,0,1,0,0,1
754408214263832576,0,1,0,0,1
754431282881462272,0,1,0,0,1
754726391694913536,0,1,0,0,1
755649172389367808,0,1,0,0,1
755767278940151808,0,1,0,0,1
755794782211936256,0,1,0,0,1
755878952615419904,0,1,0,0,1
756786404902907904,0,1,0,0,1
756814850932744192,0,1,0,0,1
756820453549674496,0,1,0,0,1
756834539557773312,0,1,0,0,1
756848467901841408,0,1,0,0,1
756887238915522560,0,1,0,0,1
756888430718713856,0,1,0,0,1
756931812593700864,1,0,0,0,1
756951471502004224,0,1,0,0,1
757008369936953344,0,1,0,0,1
757129585347727360,0,1,0,0,1
757220212890624000,0,1,0,0,1
757221006406742016,0,1,0,0,1
757223171875565568,0,1,0,0,1
757243203292499968,0,1,0,0,1
756773421149716480,0,1,0,0,1
756748714740359168,0,1,0,0,1
756731239554543616,0,1,0,0,1
756374159924625408,0,1,0,0,1
755991120807620608,0,1,0,0,1
756116611841552384,0,1,0,0,1
756213097283682304,0,1,0,0,1
756243348139216896,0,0,0,1,1
756294151180877824,0,1,0,0,1
756348544450125824,0,1,0,0,1
756404750694883328,0,1,0,0,1
756645889020682240,1,0,0,0,1
756422999415324672,0,1,0,0,1
756514884041474048,0,1,0,0,1
756540680839782400,0,1,0,0,1
756541205765296128,0,0,1,0,1
756570726962896896,0,1,0,0,1
756574184734597120,0,1,0,0,1
753694937225502720,0,1,0,0,1
753642516021469184,1,0,0,0,1
750121607545237504,0,1,0,0,1
751037087659548672,0,1,0,0,1
751138478579212288,0,1,0,0,1
751172488575455232,0,1,0,0,1
751178310017835008,0,1,0,0,1
751180558936530944,0,1,0,0,1
751515757620686848,0,1,0,0,1
751553467383181312,0,1,0,0,1
751608135605899264,0,1,0,0,1
751679127862800384,0,1,0,0,1
751756539476713472,0,1,0,0,1
751774005707825152,0,1,0,0,1
751776180957741056,0,1,0,0,1
751789051196370944,1,0,0,0,1
751801605364776960,0,1,0,0,1
751840204051349504,0,1,0,0,1
751852733527945216,0,1,0,0,1
751088972076609536,0,1,0,0,1
751034242675646464,0,1,0,0,1
753628551564365824,1,0,0,0,1
750966425163034624,0,1,0,0,1
750206615131975680,0,1,0,0,1
750210911919566848,0,1,0,0,1
750231763369222144,0,1,0,0,1
750246183847821312,1,0,0,0,1
750288734810206208,1,0,0,0,1
750313656525549568,0,1,0,0,1
750351101245919232,0,1,0,0,1
750387038617268224,0,1,0,0,1
750423810210402304,0,1,0,0,1
750735419126517760,1,0,0,0,1
750789910412558336,0,1,0,0,1
750798525332586496,0,1,0,0,1
750804473975537664,1,0,0,0,1
750826878764773376,0,0,0,1,1
750918517197864960,0,1,0,0,1
751943779242930176,0,1,0,0,1
752058782574866432,0,1,0,0,1
752059390430248960,1,0,0,0,1
752068551301816320,0,1,0,0,1
753120204520099840,0,1,0,0,1
753130769153822720,0,1,0,0,1
753153806599323648,0,1,0,0,1
753231908125966336,0,0,0,1,1
753235876814159872,0,1,0,0,1
753372287332524032,1,0,0,0,1
753456866722799616,0,1,0,0,1
753473771046969344,0,1,0,0,1
753488564315426816,0,1,0,0,1
753524032839028736,0,1,0,0,1
753527035918749696,0,1,0,0,1
753545965890629632,0,1,0,0,1
753553137319944192,0,1,0,0,1
753554422924513280,0,1,0,0,1
753605281016344576,0,1,0,0,1
753091404696616960,0,1,0,0,1
752960507188051968,0,1,0,0,1
752928099805736960,0,1,0,0,1
752483379975745536,1,0,0,0,1
752109865267585024,0,1,0,0,1
752138877557694464,0,1,0,0,1
752201500223479808,1,0,0,0,1
752239189685665792,0,1,0,0,1
752314280758931456,0,0,1,0,1
752411078110375936,0,1,0,0,1
752510809528471552,0,1,0,0,1
752924501529296896,0,1,0,0,1
752684327436156928,0,1,0,0,1
752780735187128320,0,1,0,0,1
752827556483649536,1,0,0,0,1
752834503576588288,0,1,0,0,1
752837416759750656,0,1,0,0,1
752905622056828928,0,1,0,0,1
708935568588087296,0,1,0,0,1
708898409009291264,0,0,0,1,1
708864809131855872,0,1,0,0,1
4516686682,0,1,0,0,1
4517387332,0,1,0,0,1
4517568737,0,1,0,0,1
4518610392,0,1,0,0,1
4518653069,0,1,0,0,1
4518670767,0,1,0,0,1
4528372454,0,1,0,0,1
4528398383,0,1,0,0,1
4528463974,0,1,0,0,1
4528688195,0,1,0,0,1
4529266174,0,1,0,0,1
4529885191,0,1,0,0,1
4530400156,0,1,0,0,1
4530487828,1,0,0,0,1
4534546865,0,1,0,0,1
4535676207,0,1,0,0,1
4516843157,0,1,0,0,1
4512956121,1,0,0,0,1
4538367450,0,1,0,0,1
4510400961,0,1,0,0,1
4498969512,0,1,0,0,1
4502059761,0,1,0,0,1
4502504778,0,1,0,0,1
4503728776,0,1,0,0,1
4505127853,0,0,1,0,1
4506057201,0,0,1,0,1
4506427829,0,1,0,0,1
4506699737,0,1,0,0,1
4506908183,0,1,0,0,1
4507537699,1,0,0,0,1
4508225053,0,1,0,0,1
4508242839,0,1,0,0,1
4508697615,0,1,0,0,1
4509127822,0,1,0,0,1
4510200382,0,1,0,0,1
4537759096,0,1,0,0,1
4538377641,0,1,0,0,1
4591313964,0,1,0,0,1
4557625767,0,1,0,0,1
4560539472,0,1,0,0,1
4561420415,1,0,0,0,1
4561437209,0,1,0,0,1
4565103792,1,0,0,0,1
4567431555,0,1,0,0,1
4567983076,1,0,0,0,1
4568116634,0,1,0,0,1
4572668141,1,0,0,0,1
4576420872,0,1,0,0,1
4579506736,0,1,0,0,1
4581071836,0,1,0,0,1
4584282501,0,1,0,0,1
4586376913,1,0,0,0,1
4589133795,1,0,0,0,1
4589745316,0,1,0,0,1
4558585468,1,0,0,0,1
4555583242,0,1,0,0,1
4540076960,0,1,0,0,1
4554861569,1,0,0,0,1
4540600392,0,1,0,0,1
4540652414,0,1,0,0,1
4544016208,0,1,0,0,1
4545219574,0,1,0,0,1
4545231973,0,1,0,0,1
4545282455,0,1,0,0,1
4546356286,1,0,0,0,1
4546731284,0,1,0,0,1
4549782257,0,0,0,1,1
4550516781,0,1,0,0,1
4550555847,0,1,0,0,1
4550743513,0,1,0,0,1
4552805954,1,0,0,0,1
4554120017,0,1,0,0,1
4554623543,0,1,0,0,1
4498931352,0,1,0,0,1
4498543335,1,0,0,0,1
4497993159,0,1,0,0,1
4440732914,1,0,0,0,1
4441950880,0,1,0,0,1
4444058307,0,1,0,0,1
4444578679,0,1,0,0,1
4446614234,0,1,0,0,1
4447237392,0,1,0,0,1
4449407302,0,1,0,0,1
4449480208,0,1,0,0,1
4450176509,0,1,0,0,1
4450492216,1,0,0,0,1
4451804363,0,1,0,0,1
4452198495,0,1,0,0,1
4456062737,0,1,0,0,1
4456454661,0,1,0,0,1
4457037268,0,1,0,0,1
4459080435,0,1,0,0,1
4441303487,0,1,0,0,1
4439290607,0,0,1,0,1
4497866249,0,1,0,0,1
4438780055,1,0,0,0,1
4427802562,0,1,0,0,1
4428039953,0,1,0,0,1
4428158488,0,1,0,0,1
4428575837,0,1,0,0,1
4429204454,0,1,0,0,1
4429290257,0,0,0,1,1
4429535653,1,0,0,0,1
4429543583,0,1,0,0,1
4429995316,0,1,0,0,1
4430412377,0,1,0,0,1
4430714240,0,1,0,0,1
4432127054,0,1,0,0,1
4434433899,0,1,0,0,1
4435799902,1,0,0,0,1
4437796093,1,0,0,0,1
4459457057,0,1,0,0,1
4459889713,0,1,0,0,1
4460304316,0,1,0,0,1
4461116021,0,1,0,0,1
4478240656,0,1,0,0,1
4478300957,1,0,0,0,1
4482019223,0,1,0,0,1
4482297209,0,1,0,0,1
4482799392,0,1,0,0,1
4485587980,0,1,0,0,1
4488955574,0,1,0,0,1
4489335673,0,1,0,0,1
4489462216,0,1,0,0,1
4491571639,0,1,0,0,1
4492984707,0,1,0,0,1
4494476062,0,1,0,0,1
4497214575,0,1,0,0,1
4497666142,1,0,0,0,1
4497806187,1,0,0,0,1
4477778839,0,1,0,0,1
4474553297,0,1,0,0,1
4474214774,1,0,0,0,1
4468574472,0,1,0,0,1
4461574223,0,1,0,0,1
4463244492,0,1,0,0,1
4463330117,1,0,0,0,1
4464291083,0,1,0,0,1
4466400442,0,1,0,0,1
4467781452,0,1,0,0,1
4468817122,1,0,0,0,1
4473615040,0,1,0,0,1
4469145082,0,1,0,0,1
4469684721,0,1,0,0,1
4469955912,0,1,0,0,1
4470976279,0,1,0,0,1
4471283243,0,1,0,0,1
4472750975,0,1,0,0,1
4591305200,0,1,0,0,1
4591436314,0,1,0,0,1
4733353113,0,1,0,0,1
4694918898,0,1,0,0,1
4695376826,0,1,0,0,1
4695828564,0,1,0,0,1
4696708364,0,1,0,0,1
4697462407,0,1,0,0,1
4697733253,0,1,0,0,1
4698040693,0,1,0,0,1
4698729846,0,1,0,0,1
4699020859,0,1,0,0,1
4699200162,0,1,0,0,1
4699740416,0,1,0,0,1
4701168588,0,1,0,0,1
4701458406,0,1,0,0,1
4701534732,0,1,0,0,1
4701842107,0,1,0,0,1
4701941726,0,1,0,0,1
4695171320,0,1,0,0,1
4694853360,0,1,0,0,1
4702348081,0,1,0,0,1
4694807839,0,1,0,0,1
4686170306,1,0,0,0,1
4686221528,0,1,0,0,1
4687925724,0,1,0,0,1
4688538570,0,1,0,0,1
4688871854,0,1,0,0,1
4688899897,0,0,0,1,1
4690230878,1,0,0,0,1
4690363074,0,1,0,0,1
4690566006,0,1,0,0,1
4690899666,0,1,0,0,1
4692132991,0,1,0,0,1
4692553609,0,1,0,0,1
4694300732,0,1,0,0,1
4694392034,0,1,0,0,1
4694393503,1,0,0,0,1
4702122852,0,1,0,0,1
4702881528,0,1,0,0,1
4593083080,1,0,0,0,1
4716191154,0,1,0,0,1
4717519041,0,1,0,0,1
4719429282,0,1,0,0,1
4719562009,1,0,0,0,1
4719843468,0,1,0,0,1
4721092093,0,1,0,0,1
4721911208,0,1,0,0,1
4721977633,1,0,0,0,1
4723417575,0,1,0,0,1
4727525061,0,1,0,0,1
4728536772,0,1,0,0,1
4729038552,0,1,0,0,1
4731845501,0,1,0,0,1
4732119553,0,1,0,0,1
4732239732,0,1,0,0,1
4732466957,1,0,0,0,1
4716812657,1,0,0,0,1
4715830275,0,1,0,0,1
4703974222,0,1,0,0,1
4715797281,0,1,0,0,1
4704035485,0,1,0,0,1
4704166346,0,1,0,0,1
4704793922,0,1,0,0,1
4704966023,0,1,0,0,1
4705034652,0,1,0,0,1
4706212034,0,1,0,0,1
4706453072,0,1,0,0,1
4707558686,0,1,0,0,1
4709219967,1,0,0,0,1
4709591356,0,1,0,0,1
4712429184,0,1,0,0,1
4712651287,0,1,0,0,1
4713753376,0,1,0,0,1
4713795436,0,1,0,0,1
4715551380,1,0,0,0,1
4686048224,0,1,0,0,1
4684509500,0,1,0,0,1
4682111599,0,1,0,0,1
4611653243,1,0,0,0,1
4612779753,0,1,0,0,1
4615119261,1,0,0,0,1
4616369121,0,1,0,0,1
4621742774,0,1,0,0,1
4626627675,0,1,0,0,1
4629486856,0,1,0,0,1
4630463483,0,1,0,0,1
4631404936,0,1,0,0,1
4633022941,1,0,0,0,1
4634448622,0,0,0,1,1
4634470276,0,1,0,0,1
4635116367,0,1,0,0,1
4635477557,0,1,0,0,1
4635482548,0,1,0,0,1
4637494462,1,0,0,0,1
4612546632,1,0,0,0,1
4608168322,0,1,0,0,1
4678516034,0,1,0,0,1
4607869997,0,1,0,0,1
4593100643,0,1,0,0,1
4593321455,0,1,0,0,1
4593931462,0,1,0,0,1
4595001438,0,1,0,0,1
4596713596,1,0,0,0,1
4596768814,0,1,0,0,1
4597709842,0,1,0,0,1
4599288794,0,1,0,0,1
4600858736,1,0,0,0,1
4601171429,0,1,0,0,1
4601241072,0,1,0,0,1
4601413342,0,1,0,0,1
4602706168,0,1,0,0,1
4603685419,0,1,0,0,1
4604377048,1,0,0,0,1
4640418387,1,0,0,0,1
4641671605,0,1,0,0,1
4643087009,1,0,0,0,1
4644666675,0,1,0,0,1
4658751529,0,1,0,0,1
4661775614,1,0,0,0,1
4661848873,1,0,0,0,1
4663068017,0,1,0,0,1
4663163689,0,1,0,0,1
4664453652,0,1,0,0,1
4665455474,0,1,0,0,1
4665618853,0,0,0,1,1
4668758600,0,1,0,0,1
4671189380,0,0,1,0,1
4671902040,1,0,0,0,1
4677551298,0,1,0,0,1
4677808106,0,1,0,0,1
4677869904,0,1,0,0,1
4678095373,0,1,0,0,1
4656675553,0,1,0,0,1
4656624072,0,0,0,1,1
4655664072,0,1,0,0,1
4648841023,0,1,0,0,1
4645010655,0,1,0,0,1
4645720889,0,1,0,0,1
4645765168,0,1,0,0,1
4646070863,0,1,0,0,1
4646976314,1,0,0,0,1
4648026800,1,0,0,0,1
4649132552,0,1,0,0,1
4655211852,0,1,0,0,1
4650175159,0,1,0,0,1
4652147555,0,1,0,0,1
4652440702,0,1,0,0,1
4653076697,1,0,0,0,1
4654381460,0,1,0,0,1
4654964183,0,1,0,0,1
4426509455,0,0,1,0,1
4425894262,0,1,0,0,1
4424622373,0,1,0,0,1
4213467808,1,0,0,0,1
4215174922,0,1,0,0,1
4216340380,0,1,0,0,1
4216596868,0,1,0,0,1
4216875321,0,1,0,0,1
4217775484,0,1,0,0,1
4218009012,0,1,0,0,1
4218544408,0,1,0,0,1
4219666935,0,1,0,0,1
4220180414,1,0,0,0,1
4220532821,0,1,0,0,1
4220689995,0,1,0,0,1
4221688518,0,1,0,0,1
4222566013,0,1,0,0,1
4223468902,0,1,0,0,1
4223671702,0,1,0,0,1
4213775052,1,0,0,0,1
4212338474,0,1,0,0,1
4225332199,0,1,0,0,1
4212197895,0,1,0,0,1
4200834867,0,1,0,0,1
4201051223,1,0,0,0,1
4201300533,0,1,0,0,1
4201996751,0,0,0,1,1
4202389606,0,1,0,0,1
4202408603,0,1,0,0,1
4202463088,0,1,0,0,1
4203140060,0,1,0,0,1
4203175661,1,0,0,0,1
4203771755,0,1,0,0,1
4204736054,0,1,0,0,1
4206594687,0,1,0,0,1
4208238437,0,1,0,0,1
4209850851,0,1,0,0,1
4209907693,1,0,0,0,1
4224371374,0,1,0,0,1
4225767500,0,1,0,0,1
4424387422,0,1,0,0,1
4244999398,1,0,0,0,1
4246758134,0,1,0,0,1
4248294196,0,1,0,0,1
4250013328,0,1,0,0,1
4250730921,0,1,0,0,1
4251334768,0,1,0,0,1
4251822915,0,1,0,0,1
4252162694,0,1,0,0,1
4252169717,0,1,0,0,1
4255526532,1,0,0,0,1
4256808992,0,1,0,0,1
4257595710,0,0,0,1,1
4258245868,1,0,0,0,1
4258598074,0,1,0,0,1
4259070857,1,0,0,0,1
4259774153,0,1,0,0,1
4245248561,0,1,0,0,1
4243822034,1,0,0,0,1
4226290954,1,0,0,0,1
4242871036,0,1,0,0,1
4227444262,1,0,0,0,1
4228076064,0,1,0,0,1
4228324474,0,1,0,0,1
4228442620,0,1,0,0,1
4230458721,0,1,0,0,1
4232823867,0,1,0,0,1
4233940595,0,1,0,0,1
4235810366,0,1,0,0,1
4236521727,0,1,0,0,1
4236960432,1,0,0,0,1
4237369813,0,1,0,0,1
4239708029,0,1,0,0,1
4240403777,1,0,0,0,1
4241915475,0,1,0,0,1
4242611819,1,0,0,0,1
4200632549,0,1,0,0,1
4197535978,0,1,0,0,1
4197116481,0,1,0,0,1
4163533103,0,1,0,0,1
4165578673,0,1,0,0,1
4165855106,0,1,0,0,1
4167149953,0,1,0,0,1
4167340514,0,1,0,0,1
4167751334,0,1,0,0,1
4168080994,0,1,0,0,1
4170326079,0,1,0,0,1
4170677429,0,1,0,0,1
4171012641,0,1,0,0,1
4171593377,1,0,0,0,1
4171778092,0,1,0,0,1
4173412594,1,0,0,0,1
4174078291,0,0,0,1,1
4174595135,0,1,0,0,1
4175497277,1,0,0,0,1
4165476015,0,1,0,0,1
4161275655,0,1,0,0,1
4195130625,1,0,0,0,1
4160878880,0,1,0,0,1
4147043403,0,1,0,0,1
4148592149,0,1,0,0,1
4149717443,0,1,0,0,1
4149780519,0,1,0,0,1
4149878551,0,1,0,0,1
4151252536,0,1,0,0,1
4153639343,0,1,0,0,1
4153890972,0,1,0,0,1
4155047233,0,1,0,0,1
4155147881,0,1,0,0,1
4155683307,0,1,0,0,1
4156176244,0,1,0,0,1
4156528156,0,0,0,1,1
4156788268,0,1,0,0,1
4160044192,0,1,0,0,1
4176756573,0,1,0,0,1
4177035262,0,1,0,0,1
4177076739,1,0,0,0,1
4178361555,0,1,0,0,1
4185984258,0,1,0,0,1
4186673536,0,1,0,0,1
4187780375,0,1,0,0,1
4188190409,0,1,0,0,1
4188221547,0,1,0,0,1
4188284292,0,1,0,0,1
4188920409,0,1,0,0,1
4191923434,0,1,0,0,1
4191950956,0,1,0,0,1
4192864594,1,0,0,0,1
4193229012,0,1,0,0,1
4193808335,0,1,0,0,1
4193834998,0,1,0,0,1
4194640697,1,0,0,0,1
4194869625,0,1,0,0,1
4185565096,0,0,1,0,1
4185543317,0,1,0,0,1
4185528053,1,0,0,0,1
4181464755,0,1,0,0,1
4178606165,0,1,0,0,1
4178724491,0,1,0,0,1
4178764222,0,1,0,0,1
4180375651,0,1,0,0,1
4180638383,0,1,0,0,1
4180886293,0,1,0,0,1
4181664267,0,1,0,0,1
4185460815,0,1,0,0,1
4181925754,0,1,0,0,1
4183720043,0,1,0,0,1
4184466087,1,0,0,0,1
4185194188,0,1,0,0,1
4185230674,1,0,0,0,1
4185260297,0,1,0,0,1
4260517393,0,1,0,0,1
4260943515,0,1,0,0,1
4261296322,0,1,0,0,1
4358478913,0,1,0,0,1
4359154223,0,1,0,0,1
4359284240,0,1,0,0,1
4361457977,1,0,0,0,1
4362928221,0,1,0,0,1
4363580539,0,1,0,0,1
4365669674,0,1,0,0,1
4366364657,0,1,0,0,1
4366861452,0,1,0,0,1
4369137074,0,1,0,0,1
4370663537,0,1,0,0,1
4373145315,0,1,0,0,1
4374151517,0,1,0,0,1
4374783440,0,1,0,0,1
4375095617,0,1,0,0,1
4375626323,0,1,0,0,1
4359010695,1,0,0,0,1
4357935622,0,1,0,0,1
4344401487,0,1,0,0,1
4357465281,0,1,0,0,1
4345823659,0,1,0,0,1
4345832368,0,1,0,0,1
4346490554,1,0,0,0,1
4346641215,0,1,0,0,1
4348048516,0,1,0,0,1
4348729572,0,1,0,0,1
4349369901,0,1,0,0,1
4349804295,0,1,0,0,1
4351194854,0,1,0,0,1
4351563034,0,0,0,1,1
4351697956,0,1,0,0,1
4351777061,1,0,0,0,1
4352212707,0,1,0,0,1
4352724015,0,0,0,1,1
4353586103,0,1,0,0,1
4377007637,0,1,0,0,1
4382508706,0,1,0,0,1
4383248542,0,1,0,0,1
4385322552,0,1,0,0,1
4407384374,1,0,0,0,1
4407564808,0,1,0,0,1
4417328603,0,1,0,0,1
4417657161,0,1,0,0,1
4418201592,0,1,0,0,1
4419316512,0,1,0,0,1
4419512321,0,1,0,0,1
4419776253,1,0,0,0,1
4420868369,0,1,0,0,1
4422941900,0,1,0,0,1
4423277779,0,1,0,0,1
4423287267,0,1,0,0,1
4423463293,0,1,0,0,1
4423872313,0,1,0,0,1
4424385559,0,1,0,0,1
4407357863,0,1,0,0,1
4405767318,1,0,0,0,1
4403549415,0,1,0,0,1
4392531155,0,1,0,0,1
4385783859,0,1,0,0,1
4386040589,1,0,0,0,1
4387850548,0,1,0,0,1
4388748915,0,0,1,0,1
4389695799,1,0,0,0,1
4391662576,0,1,0,0,1
4392670767,0,1,0,0,1
4401466753,0,1,0,0,1
4392898757,0,1,0,0,1
4394751563,1,0,0,0,1
4395434332,0,1,0,0,1
4395827780,0,1,0,0,1
4396803443,0,1,0,0,1
4398280779,0,1,0,0,1
4345266081,1,0,0,0,1
4343468776,0,1,0,0,1
4262714239,0,1,0,0,1
4281744734,1,0,0,0,1
4285892477,1,0,0,0,1
4287266119,0,1,0,0,1
4287277696,0,1,0,0,1
4287595823,0,1,0,0,1
4288161855,0,1,0,0,1
4289868203,0,1,0,0,1
4289991921,0,1,0,0,1
4290550463,0,1,0,0,1
4290794897,0,1,0,0,1
4290886107,1,0,0,0,1
4292078358,1,0,0,0,1
4296995243,1,0,0,0,1
4298527235,0,1,0,0,1
4299883996,1,0,0,0,1
4300157005,0,1,0,0,1
4283593935,1,0,0,0,1
4277678625,0,1,0,0,1
4343104335,0,1,0,0,1
4277254061,0,1,0,0,1
4262890751,0,1,0,0,1
4262983755,0,1,0,0,1
4263256992,1,0,0,0,1
4263707879,1,0,0,0,1
4264228577,0,1,0,0,1
4265884905,0,1,0,0,1
4266638931,0,1,0,0,1
4267912409,0,1,0,0,1
4268350948,0,1,0,0,1
4269030077,0,1,0,0,1
4269411094,0,1,0,0,1
4269693400,0,1,0,0,1
4271862623,0,1,0,0,1
4272205293,1,0,0,0,1
4272497368,1,0,0,0,1
4301372057,0,1,0,0,1
4302956294,0,1,0,0,1
4304569574,1,0,0,0,1
4305725908,0,1,0,0,1
4321162765,1,0,0,0,1
4321387217,1,0,0,0,1
4322828413,0,1,0,0,1
4325521888,0,1,0,0,1
4325575653,0,1,0,0,1
4325802014,1,0,0,0,1
4327196057,0,1,0,0,1
4328377333,0,1,0,0,1
4331507302,0,1,0,0,1
4331531667,1,0,0,0,1
4332680414,0,1,0,0,1
4337483363,0,1,0,0,1
4338250223,0,1,0,0,1
4340353456,0,1,0,0,1
4340526383,0,0,1,0,1
4319632335,0,1,0,0,1
4319228296,0,1,0,0,1
4318772129,0,1,0,0,1
4311004174,0,1,0,0,1
4307771475,0,1,0,0,1
4308515782,0,1,0,0,1
4309032449,0,1,0,0,1
4309513946,0,1,0,0,1
4310369860,0,1,0,0,1
4310805203,0,1,0,0,1
4311252375,0,1,0,0,1
4318534332,0,1,0,0,1
4311994947,1,0,0,0,1
4315224687,0,1,0,0,1
4315719437,0,1,0,0,1
4316393547,0,1,0,0,1
4316863576,1,0,0,0,1
4318206613,1,0,0,0,1
4733243112,0,1,0,0,1
4734012196,0,1,0,0,1
708569976311914496,0,1,0,0,1
4912507513,0,1,0,0,1
4913589013,0,1,0,0,1
4913933178,1,0,0,0,1
4914104102,0,1,0,0,1
4915016297,0,1,0,0,1
4916303606,0,1,0,0,1
4916577225,0,1,0,0,1
4916706728,0,1,0,0,1
4916897300,0,1,0,0,1
4917391564,1,0,0,0,1
4918357565,0,1,0,0,1
4919392720,0,1,0,0,1
4919951756,0,1,0,0,1
4920698019,0,1,0,0,1
4920765341,1,0,0,0,1
4921184836,0,1,0,0,1
4913553011,0,1,0,0,1
4911926114,0,1,0,0,1
4922308941,0,1,0,0,1
4911414707,1,0,0,0,1
4906366649,0,1,0,0,1
4906385042,0,1,0,0,1
4906475745,0,1,0,0,1
4906786753,0,0,0,1,1
4908654079,0,1,0,0,1
4908879857,0,1,0,0,1
4908924023,0,1,0,0,1
4909285097,0,1,0,0,1
4909464202,0,1,0,0,1
4909671616,0,1,0,0,1
4909812112,0,1,0,0,1
4909874625,0,1,0,0,1
4909954461,0,0,1,0,1
4910058137,1,0,0,0,1
4911175200,0,1,0,0,1
4921611621,0,1,0,0,1
4924608172,1,0,0,0,1
700739995141672960,1,0,0,0,1
698415846880894976,1,0,0,0,1
699263075258654720,0,1,0,0,1
699284439931682816,1,0,0,0,1
699938629410562048,0,1,0,0,1
699978986378698752,0,1,0,0,1
700119512197304320,0,1,0,0,1
700386651823022080,0,1,0,0,1
700415988228059136,0,1,0,0,1
700437838215700480,0,0,1,0,1
700595764922191872,0,1,0,0,1
700601398874939392,0,1,0,0,1
700614061340266496,0,1,0,0,1
700616583408959488,0,1,0,0,1
700620335456980992,0,1,0,0,1
700633778880778240,0,1,0,0,1
700636913078697984,1,0,0,0,1
699007033014624256,0,1,0,0,1
697311881447366656,1,0,0,0,1
4924872679,1,0,0,0,1
697192473676943360,1,0,0,0,1
4924920011,0,0,0,1,1
4925021579,0,1,0,0,1
4925408111,1,0,0,0,1
4926138918,1,0,0,0,1
4926325318,0,1,0,0,1
4926407554,1,0,0,0,1
4926810568,0,1,0,0,1
694892875113345024,0,0,1,0,1
694968477665337344,0,1,0,0,1
695262642819067904,1,0,0,0,1
695850765110374400,0,1,0,0,1
696129755737890816,0,1,0,0,1
696548466781220864,1,0,0,0,1
696576693230764032,0,1,0,0,1
696712317275402240,0,0,1,0,1
4906164766,0,1,0,0,1
4905816724,0,1,0,0,1
4905589152,0,1,0,0,1
4885795389,0,1,0,0,1
4886854895,0,1,0,0,1
4887810672,0,1,0,0,1
4889797737,0,1,0,0,1
4890220084,0,1,0,0,1
4891172542,0,1,0,0,1
4891543839,0,1,0,0,1
4892627313,0,1,0,0,1
4892638820,0,0,0,1,1
4892693626,0,1,0,0,1
4892760987,0,1,0,0,1
4893123640,0,1,0,0,1
4893478696,0,1,0,0,1
4893549734,1,0,0,0,1
4893676696,0,1,0,0,1
4894010081,0,1,0,0,1
4886756001,0,1,0,0,1
4885090647,0,1,0,0,1
4904782869,0,1,0,0,1
4885068579,0,1,0,0,1
4877662222,0,1,0,0,1
4877668480,1,0,0,0,1
4877842191,1,0,0,0,1
4878207796,0,1,0,0,1
4878208805,0,1,0,0,1
4880240272,0,1,0,0,1
4880457147,1,0,0,0,1
4881441425,0,1,0,0,1
4881603483,0,1,0,0,1
4881664264,0,1,0,0,1
4882228756,0,1,0,0,1
4882312191,0,1,0,0,1
4882556008,0,1,0,0,1
4884512903,0,1,0,0,1
4884607107,0,1,0,0,1
4894095909,0,1,0,0,1
4894099617,0,1,0,0,1
4894258829,1,0,0,0,1
4894321325,1,0,0,0,1
4898193988,1,0,0,0,1
4898212234,0,1,0,0,1
4898696548,0,1,0,0,1
4898986229,0,1,0,0,1
4899071951,0,0,1,0,1
4899084173,0,1,0,0,1
4899431338,0,1,0,0,1
4901077638,0,1,0,0,1
4901178537,0,1,0,0,1
4901825914,0,1,0,0,1
4902140660,0,1,0,0,1
4903487359,0,1,0,0,1
4903862068,0,1,0,0,1
4904527635,0,1,0,0,1
4904619394,0,1,0,0,1
4897739578,0,1,0,0,1
4897655489,0,0,0,1,1
4897459204,0,1,0,0,1
4895652325,0,0,0,1,1
4894397111,1,0,0,0,1
4894507653,0,1,0,0,1
4894631638,0,1,0,0,1
4894662647,0,1,0,0,1
4894748674,0,1,0,0,1
4895062065,0,1,0,0,1
4895705171,0,1,0,0,1
4897197119,0,1,0,0,1
4896025664,0,1,0,0,1
4896126746,0,0,0,1,1
4896258532,0,1,0,0,1
4896307942,0,1,0,0,1
4896508588,0,1,0,0,1
4896616697,0,1,0,0,1
700682089293742080,0,1,0,0,1
700810789020639232,0,1,0,0,1
4734327532,1,0,0,0,1
705660981935009792,0,1,0,0,1
705748553109528576,1,0,0,0,1
705800178071171072,0,1,0,0,1
705808476912623616,0,1,0,0,1
705893669547614208,1,0,0,0,1
705912214352326656,0,1,0,0,1
705961758666702848,0,1,0,0,1
705969784307871744,0,1,0,0,1
706026399644196864,0,1,0,0,1
706070545108901888,0,1,0,0,1
706118971045511168,0,1,0,0,1
706229872646103040,1,0,0,0,1
706394190486355968,1,0,0,0,1
706445607037181952,0,1,0,0,1
706453548784029696,0,1,0,0,1
706490429106216960,0,1,0,0,1
705708234104020992,0,1,0,0,1
705625334553530368,0,1,0,0,1
706685162977792000,0,1,0,0,1
705622220341575680,0,1,0,0,1
705144507780591616,0,1,0,0,1
705170005558751232,0,1,0,0,1
705176881524547584,0,1,0,0,1
705256443415502848,0,1,0,0,1
705289682603610112,0,0,0,1,1
705321789518389248,0,1,0,0,1
705332372540137472,1,0,0,0,1
705346083422150656,0,1,0,0,1
705367398380085248,0,1,0,0,1
705427204390268928,0,1,0,0,1
705453196265664512,1,0,0,0,1
705519734213705728,0,1,0,0,1
705525388081045504,0,1,0,0,1
705528864571654144,0,0,0,1,1
705605450507513856,0,1,0,0,1
706668459355025408,0,1,0,0,1
706722814678667264,0,1,0,0,1
700865756586586112,0,1,0,0,1
707842606143770624,0,1,0,0,1
707914999168147456,0,1,0,0,1
707973215017013248,0,1,0,0,1
708006792257773568,1,0,0,0,1
708098562769289216,0,1,0,0,1
708202345151070208,0,1,0,0,1
708269685612142592,0,1,0,0,1
708311056989462528,0,0,0,1,1
708314191745179648,0,1,0,0,1
708359512567226368,0,1,0,0,1
708376656055017472,1,0,0,0,1
708383206790316032,0,1,0,0,1
708417067100332032,0,1,0,0,1
708472320155914240,0,1,0,0,1
708488513751101440,0,1,0,0,1
708511238448357376,1,0,0,0,1
707854745885667328,0,1,0,0,1
707782826217721856,0,1,0,0,1
706805117572534272,0,1,0,0,1
707772116096122880,0,1,0,0,1
706860681287606272,0,1,0,0,1
706863698976051200,0,1,0,0,1
706875423024619520,0,1,0,0,1
706879943548928000,0,1,0,0,1
706882422747615232,0,0,0,1,1
707006522031677440,1,0,0,0,1
707183242265362432,0,1,0,0,1
707253140077334528,0,1,0,0,1
707313886882603008,1,0,0,0,1
707425811058528256,1,0,0,0,1
707450543258669056,1,0,0,0,1
707460584376311808,1,0,0,0,1
707585271919996928,0,1,0,0,1
707708956366544896,1,0,0,0,1
707721716097658880,0,1,0,0,1
705140887324659712,1,0,0,0,1
705127244570738688,0,1,0,0,1
705120682896543744,0,1,0,0,1
701447104649105408,0,1,0,0,1
701685183234367488,0,1,0,0,1
701705444578955264,0,1,0,0,1
701708536414388224,0,1,0,0,1
701729530034135040,1,0,0,0,1
701781967029710848,0,1,0,0,1
701827165944311808,0,1,0,0,1
701941266716762112,0,1,0,0,1
702046225848213504,0,1,0,0,1
702071635394826240,0,1,0,0,1
702075407269548032,0,1,0,0,1
702094867858481152,0,1,0,0,1
702134330013970432,0,1,0,0,1
702180919122206720,0,1,0,0,1
702534606407360512,0,1,0,0,1
702802455013302272,0,1,0,0,1
701474713768308736,0,1,0,0,1
701438951396155392,0,1,0,0,1
704983601872392192,0,1,0,0,1
701419628329885696,0,0,0,1,1
700928929071284224,1,0,0,0,1
700964598967463936,0,0,1,0,1
700967230763245568,0,1,0,0,1
701028435557093376,0,1,0,0,1
701029045048373248,0,1,0,0,1
701033761463525376,0,1,0,0,1
701036357393711104,0,1,0,0,1
701090946348285952,0,1,0,0,1
701131289873801216,0,1,0,0,1
701136828061986816,0,0,0,1,1
701244536283004928,0,1,0,0,1
701346140604784640,1,0,0,0,1
701369594326470656,0,1,0,0,1
701376204901900288,0,1,0,0,1
701386125575897088,0,1,0,0,1
702811375077367808,0,1,0,0,1
702824672480649216,0,1,0,0,1
702892409248591872,0,1,0,0,1
702906360263000064,0,1,0,0,1
703985143028031488,0,1,0,0,1
704004615386361856,0,1,0,0,1
704061989891416064,0,1,0,0,1
704158660629544960,0,1,0,0,1
704237071700004864,0,1,0,0,1
704280944581218304,0,1,0,0,1
704360444555763712,0,1,0,0,1
704493247691816960,1,0,0,0,1
704557604694069248,0,1,0,0,1
704564426997932032,1,0,0,0,1
704597850479534080,0,1,0,0,1
704601974545625088,0,1,0,0,1
704680687513817088,0,1,0,0,1
704859814455697408,0,0,1,0,1
704973444648202240,0,1,0,0,1
703914304962207744,0,1,0,0,1
703887408820056064,0,1,0,0,1
703835406035341312,0,1,0,0,1
703315492673626112,0,1,0,0,1
702938104353533952,0,1,0,0,1
702980123214094336,0,1,0,0,1
703021628561567744,0,1,0,0,1
703024554680037376,0,1,0,0,1
703043727107891200,0,1,0,0,1
703289641106087936,0,1,0,0,1
703506122217492480,0,1,0,0,1
703828547442315264,0,1,0,0,1
703630394147672064,0,1,0,0,1
703634630289846272,0,1,0,0,1
703644800134856704,1,0,0,0,1
703662514194649088,0,1,0,0,1
703758311502417920,0,1,0,0,1
703768541712011264,0,1,0,0,1
4877127868,0,1,0,0,1
4877092161,0,1,0,0,1
4876744247,0,1,0,0,1
4793472788,1,0,0,0,1
4794017448,1,0,0,0,1
4794558504,0,1,0,0,1
4794785479,1,0,0,0,1
4795778200,1,0,0,0,1
4798417215,0,1,0,0,1
4798823780,0,1,0,0,1
4801344265,0,1,0,0,1
4801661841,0,1,0,0,1
4802337925,0,1,0,0,1
4802546793,0,0,0,1,1
4802738319,0,1,0,0,1
4802864176,0,1,0,0,1
4803495497,0,1,0,0,1
4804460968,0,0,0,1,1
4804673806,0,1,0,0,1
4793508411,1,0,0,0,1
4793317858,0,1,0,0,1
4805336235,0,1,0,0,1
4790792002,0,1,0,0,1
4776060555,0,1,0,0,1
4779107713,0,1,0,0,1
4779217822,0,1,0,0,1
4780628952,0,1,0,0,1
4781730200,0,1,0,0,1
4782681272,0,1,0,0,1
4782738021,0,1,0,0,1
4782841934,0,1,0,0,1
4784599212,0,1,0,0,1
4786178489,0,1,0,0,1
4787882094,1,0,0,0,1
4788342328,0,1,0,0,1
4788591615,1,0,0,0,1
4789910557,0,1,0,0,1
4790178439,0,1,0,0,1
4805164463,0,1,0,0,1
4807182633,0,1,0,0,1
4875964570,0,1,0,0,1
4818532683,0,1,0,0,1
4818782932,0,1,0,0,1
4818861741,0,1,0,0,1
4818884309,0,1,0,0,1
4819057036,0,1,0,0,1
4820723426,0,1,0,0,1
4820790231,0,1,0,0,1
4820882092,0,1,0,0,1
4821124938,0,1,0,0,1
4821296565,0,1,0,0,1
4822030061,0,0,0,1,1
4823235579,0,1,0,0,1
4823525049,0,1,0,0,1
4824461819,0,1,0,0,1
4825268117,1,0,0,0,1
4825553181,0,1,0,0,1
4818656860,0,1,0,0,1
4818405292,0,0,1,0,1
4807507638,1,0,0,0,1
4818382805,0,1,0,0,1
4807666048,0,1,0,0,1
4807836076,0,1,0,0,1
4807879976,1,0,0,0,1
4807901774,0,1,0,0,1
4808259360,0,1,0,0,1
4811886026,0,1,0,0,1
4812513794,1,0,0,0,1
4814991598,0,1,0,0,1
4815282387,0,1,0,0,1
4816537608,0,0,0,1,1
4816563782,0,1,0,0,1
4816624739,0,1,0,0,1
4816904956,0,0,1,0,1
4817563775,1,0,0,0,1
4817724383,0,1,0,0,1
4774686659,0,1,0,0,1
4773904127,0,1,0,0,1
4773295883,0,1,0,0,1
4744627337,0,1,0,0,1
4745591296,0,1,0,0,1
4745624717,1,0,0,0,1
4745735986,0,1,0,0,1
4747304587,1,0,0,0,1
4747312653,0,1,0,0,1
4747575108,0,0,0,1,1
4747949368,0,1,0,0,1
4747952721,0,1,0,0,1
4748039415,0,1,0,0,1
4748806642,0,1,0,0,1
4749355681,0,1,0,0,1
4749959478,0,1,0,0,1
4750128859,0,1,0,0,1
4750473576,0,1,0,0,1
4751063174,0,1,0,0,1
4745280949,0,1,0,0,1
4744178678,1,0,0,0,1
4772796408,0,1,0,0,1
4744059735,0,1,0,0,1
4734545471,1,0,0,0,1
4734901781,0,1,0,0,1
4736149135,0,1,0,0,1
4736553927,1,0,0,0,1
4736648423,0,1,0,0,1
4736868621,1,0,0,0,1
4737543074,0,1,0,0,1
4738001974,0,1,0,0,1
4738556654,0,1,0,0,1
4740329835,0,1,0,0,1
4741667773,0,1,0,0,1
4742592254,0,1,0,0,1
4742850678,0,1,0,0,1
4743900403,0,0,0,1,1
4743933021,0,0,0,1,1
4751901558,0,1,0,0,1
4752404568,0,1,0,0,1
4752762375,0,1,0,0,1
4752794313,1,0,0,0,1
4762405655,1,0,0,0,1
4765416953,0,0,0,1,1
4765806554,1,0,0,0,1
4766080285,1,0,0,0,1
4766713813,0,1,0,0,1
4766744250,0,1,0,0,1
4766921977,0,1,0,0,1
4766968227,0,1,0,0,1
4767320804,0,1,0,0,1
4767857302,0,1,0,0,1
4768079214,1,0,0,0,1
4768168359,0,1,0,0,1
4768775886,0,1,0,0,1
4771314439,0,1,0,0,1
4772053652,0,1,0,0,1
4762050271,0,1,0,0,1
4761739536,0,1,0,0,1
4760934230,0,1,0,0,1
4756693815,0,1,0,0,1
4753256237,0,1,0,0,1
4753814662,1,0,0,0,1
4754134390,0,1,0,0,1
4754955801,0,1,0,0,1
4755737236,0,1,0,0,1
4756631121,0,1,0,0,1
4756827563,0,1,0,0,1
4760247019,0,1,0,0,1
4756947079,1,0,0,0,1
4756951274,1,0,0,0,1
4757367079,1,0,0,0,1
4759364974,0,1,0,0,1
4759790834,0,1,0,0,1
4760175254,0,1,0,0,1
4825592254,0,1,0,0,1
4825638207,1,0,0,0,1
4825798217,0,1,0,0,1
4860937087,0,1,0,0,1
4861486911,0,1,0,0,1
4862175755,0,1,0,0,1
4863294015,0,1,0,0,1
4863322630,1,0,0,0,1
4863483359,0,1,0,0,1
4863821947,0,1,0,0,1
4864217043,0,0,0,1,1
4864839203,0,0,1,0,1
4864970332,0,1,0,0,1
4865614515,0,1,0,0,1
4866165495,1,0,0,0,1
4866271300,1,0,0,0,1
4866318443,0,1,0,0,1
4866427174,0,1,0,0,1
4866707872,0,0,0,1,1
4861394061,0,1,0,0,1
4860564623,0,1,0,0,1
4854599877,1,0,0,0,1
4860164596,0,1,0,0,1
4854739871,0,1,0,0,1
4855325600,0,1,0,0,1
4855859187,0,1,0,0,1
4856207615,0,1,0,0,1
4856365301,0,1,0,0,1
4856595321,1,0,0,0,1
4856782993,0,1,0,0,1
4857027321,0,1,0,0,1
4857294552,0,0,0,1,1
4857416872,0,1,0,0,1
4858332809,0,1,0,0,1
4858969653,0,1,0,0,1
4859111944,0,1,0,0,1
4859752811,0,1,0,0,1
4859759487,1,0,0,0,1
4867139949,1,0,0,0,1
4867401832,0,1,0,0,1
4867659298,0,0,0,1,1
4868223130,0,1,0,0,1
4872098653,1,0,0,0,1
4872212321,0,0,0,1,1
4872359385,0,1,0,0,1
4872728925,0,1,0,0,1
4873364379,0,1,0,0,1
4873445657,1,0,0,0,1
4873675355,1,0,0,0,1
4874288943,0,1,0,0,1
4874361435,0,1,0,0,1
4874593973,0,1,0,0,1
4875268439,0,1,0,0,1
4875416488,0,1,0,0,1
4875475569,0,1,0,0,1
4875615193,0,1,0,0,1
4875740127,0,1,0,0,1
4871814909,0,1,0,0,1
4871725884,0,1,0,0,1
4871559711,0,0,1,0,1
4870908089,0,1,0,0,1
4869130227,0,1,0,0,1
4869152985,0,1,0,0,1
4869331755,0,1,0,0,1
4870065874,0,1,0,0,1
4870087299,0,1,0,0,1
4870871625,0,1,0,0,1
4870951065,0,1,0,0,1
4871445723,0,1,0,0,1
4871244362,0,1,0,0,1
4871253915,0,1,0,0,1
4871331615,0,1,0,0,1
4871395751,0,0,1,0,1
4871404653,1,0,0,0,1
4871432433,1,0,0,0,1
4854683278,0,0,1,0,1
4854575801,0,0,0,1,1
4826023236,0,1,0,0,1
4834256885,0,1,0,0,1
4834507852,0,1,0,0,1
4834545603,0,1,0,0,1
4834717955,0,0,0,1,1
4835082743,0,1,0,0,1
4835279913,0,1,0,0,1
4835417218,0,1,0,0,1
4835533666,0,1,0,0,1
4835711650,0,1,0,0,1
4835919314,0,1,0,0,1
4836321909,0,1,0,0,1
4837909683,0,1,0,0,1
4838041016,0,1,0,0,1
4838166143,1,0,0,0,1
4838281019,0,1,0,0,1
4838343143,0,1,0,0,1
4834360804,0,1,0,0,1
4833255246,0,1,0,0,1
4854411262,0,1,0,0,1
4832440536,0,1,0,0,1
4826474931,0,1,0,0,1
4827510405,0,1,0,0,1
4827885425,0,1,0,0,1
4828249600,0,1,0,0,1
4828450452,0,1,0,0,1
4829479450,0,1,0,0,1
4829627002,0,1,0,0,1
4830396500,1,0,0,0,1
4830933796,0,1,0,0,1
4830948641,0,1,0,0,1
4831065671,0,1,0,0,1
4831324040,0,0,0,1,1
4831670476,0,1,0,0,1
4831892079,0,1,0,0,1
4832432715,1,0,0,0,1
4838760919,0,1,0,0,1
4838870036,0,1,0,0,1
4838913374,0,1,0,0,1
4839634275,1,0,0,0,1
4849213403,0,1,0,0,1
4849359892,0,1,0,0,1
4849441930,0,1,0,0,1
4850588718,1,0,0,0,1
4850865783,0,1,0,0,1
4851336778,0,1,0,0,1
4851509969,0,1,0,0,1
4851549843,0,1,0,0,1
4851560266,0,1,0,0,1
4852175914,0,0,0,1,1
4852678565,0,1,0,0,1
4853229133,0,1,0,0,1
4853592615,0,1,0,0,1
4853695089,0,1,0,0,1
4853779233,1,0,0,0,1
4848887625,0,1,0,0,1
4847174595,0,1,0,0,1
4847137958,0,1,0,0,1
4842864215,0,1,0,0,1
4840348781,0,1,0,0,1
4841091072,0,1,0,0,1
4841246152,1,0,0,0,1
4841499245,0,1,0,0,1
4841930157,0,1,0,0,1
4842419854,0,0,1,0,1
4843139493,0,1,0,0,1
4846845369,0,1,0,0,1
4843219943,0,1,0,0,1
4843991381,0,0,1,0,1
4844184945,0,1,0,0,1
4844997694,1,0,0,0,1
4845048772,0,1,0,0,1
4845731487,0,1,0,0,1
771730574495080448,0,1,0,0,1
771759566455529472,0,1,0,0,1
887590009200549888,0,1,0,0,1
843782854773555200,0,1,0,0,1
843819562160209920,0,1,0,0,1
843821446963105792,0,0,0,1,1
843855880454127616,0,1,0,0,1
843857175713910784,0,1,0,0,1
843935275076280320,0,1,0,0,1
843939696283664384,0,1,0,0,1
843967514791022592,1,0,0,0,1
843970773182242816,0,1,0,0,1
843983797473492992,0,1,0,0,1
844121222728302592,0,0,1,0,1
844133683305070592,0,1,0,0,1
844258719449956352,0,1,0,0,1
844337511153455104,0,1,0,0,1
844345323694833664,0,1,0,0,1
844365737254903808,0,1,0,0,1
843789188990427136,0,1,0,0,1
843654603849850880,1,0,0,0,1
844578484773007360,0,1,0,0,1
843600326565355520,0,1,0,0,1
842827346981806080,0,0,1,0,1
842877237061980160,1,0,0,0,1
842967745109114880,0,1,0,0,1
842987372677648384,0,1,0,0,1
843046145764995072,0,1,0,0,1
843066024660516864,0,1,0,0,1
843069330984189952,0,1,0,0,1
843113510167035904,0,0,0,1,1
843162152265437184,0,1,0,0,1
843226933638914048,1,0,0,0,1
843252397661011968,0,1,0,0,1
843258645576142848,0,1,0,0,1
843402553870245888,0,1,0,0,1
843549615643377664,0,1,0,0,1
843584933993971712,0,1,0,0,1
844504367487057920,0,1,0,0,1
844602703263289344,0,0,0,1,1
846294752488251392,0,1,0,0,1
845102562692890624,0,1,0,0,1
845151650033512448,0,1,0,0,1
845283773566607360,0,1,0,0,1
845368263097901056,0,1,0,0,1
845607554810068992,0,1,0,0,1
845635022644137984,0,1,0,0,1
845657409192386560,0,1,0,0,1
845737337292148736,0,0,0,1,1
845754458936094720,0,1,0,0,1
845803037688041472,0,1,0,0,1
845819261507420160,0,1,0,0,1
845852796557582336,0,1,0,0,1
845963703564558336,0,1,0,0,1
846016722939379712,0,1,0,0,1
846040060218789888,0,1,0,0,1
846072916366282752,0,1,0,0,1
845129074372632576,1,0,0,0,1
845083942059311104,0,1,0,0,1
844603003327991808,1,0,0,0,1
845068915151654912,0,1,0,0,1
844609606462660608,0,1,0,0,1
844657386585501696,0,1,0,0,1
844678581192200192,0,1,0,0,1
844715838032822272,1,0,0,0,1
844778403177779200,1,0,0,0,1
844780466053955584,0,1,0,0,1
844809696921858048,0,1,0,0,1
844871076035280896,0,1,0,0,1
844886147159359488,1,0,0,0,1
844886858379251712,0,1,0,0,1
844916003947589632,0,1,0,0,1
844916684347576320,0,1,0,0,1
844945892889313280,0,1,0,0,1
844987560984236032,0,1,0,0,1
845056741926686720,0,1,0,0,1
842754218297573376,0,1,0,0,1
842716972295081984,0,1,0,0,1
842651865712119808,1,0,0,0,1
839414180671279104,0,1,0,0,1
839477479932846080,0,1,0,0,1
839486411426394112,0,1,0,0,1
839770693336096768,1,0,0,0,1
839787779118809088,0,1,0,0,1
839805071248486400,0,1,0,0,1
839839962979782656,0,1,0,0,1
839908073212882944,0,1,0,0,1
840045153545015296,0,1,0,0,1
840058803672424448,0,1,0,0,1
840093454336049152,1,0,0,0,1
840176742585233408,0,1,0,0,1
840243371901878272,0,0,0,1,1
840245863997947904,0,1,0,0,1
840283321208836096,0,1,0,0,1
840298869820874752,1,0,0,0,1
839428834407632896,0,1,0,0,1
839303241603108864,0,1,0,0,1
842544334226386944,0,1,0,0,1
839223436052475904,1,0,0,0,1
838597703873462272,0,1,0,0,1
838722478990049280,0,1,0,0,1
838783470000275456,0,1,0,0,1
838792431592058880,1,0,0,0,1
838828650183061504,0,1,0,0,1
838829785849692160,0,1,0,0,1
838829921380274176,0,1,0,0,1
838842239287758848,1,0,0,0,1
838842872392712192,0,1,0,0,1
838915287802052608,0,1,0,0,1
838977943305084928,0,1,0,0,1
839016987334479872,0,1,0,0,1
839064930372448256,1,0,0,0,1
839077845607448576,1,0,0,0,1
839221113808801792,0,1,0,0,1
840382239514976256,0,0,1,0,1
840601598845947904,0,1,0,0,1
840635327429636096,0,1,0,0,1
840755503089221632,0,1,0,0,1
841625519779139584,0,0,0,1,1
841708248008810496,0,1,0,0,1
841709489594216448,1,0,0,0,1
841791870606934016,0,1,0,0,1
841843848724779008,0,1,0,0,1
841848923652255744,1,0,0,0,1
842127655289864192,0,1,0,0,1
842155016634884096,0,1,0,0,1
842166131553058816,0,1,0,0,1
842235070513467392,0,1,0,0,1
842358930235834368,1,0,0,0,1
842366191242903552,1,0,0,0,1
842393728199364608,1,0,0,0,1
842443389794623488,0,0,1,0,1
842525537683755008,0,1,0,0,1
841611894913945600,1,0,0,0,1
841608947379363840,0,1,0,0,1
841590353841004544,0,1,0,0,1
840949596293627904,0,1,0,0,1
840756660666810368,0,1,0,0,1
840822084729212928,0,1,0,0,1
840890919553519616,0,1,0,0,1
840921311853568000,0,1,0,0,1
840921532666908672,0,1,0,0,1
840942769573105664,0,1,0,0,1
841094873864392704,0,1,0,0,1
841549568361783296,1,0,0,0,1
841165976775360512,1,0,0,0,1
841208555126554624,0,1,0,0,1
841227279606902784,0,1,0,0,1
841377383299051520,0,1,0,0,1
841452164568473600,0,1,0,0,1
841532221743910912,0,1,0,0,1
846107755228397568,0,1,0,0,1
846342120084570112,0,0,1,0,1
838367819129577472,0,1,0,0,1
851645030838259712,1,0,0,0,1
851743309575802880,0,1,0,0,1
851886480154927104,0,1,0,0,1
851937878112444416,0,1,0,0,1
851988092387024896,0,1,0,0,1
852054835721646080,0,1,0,0,1
852232753911406592,0,1,0,0,1
852262961511112704,0,1,0,0,1
852307723483922432,1,0,0,0,1
852324685459079168,0,1,0,0,1
852344686132035584,1,0,0,0,1
852421882011951104,0,1,0,0,1
852431203793858560,0,1,0,0,1
852435376752832512,0,1,0,0,1
852454004047175680,0,1,0,0,1
852544828361625600,0,1,0,0,1
851710432083574784,0,0,0,1,1
851619739386368000,1,0,0,0,1
852722437250797568,1,0,0,0,1
851502536976683008,0,1,0,0,1
850936313511636992,0,1,0,0,1
850970098567348224,0,1,0,0,1
851038088792911872,1,0,0,0,1
851061141627441152,0,1,0,0,1
851081095126761472,0,1,0,0,1
851174229127159808,0,1,0,0,1
851232922191319040,0,1,0,0,1
851291220856889344,0,1,0,0,1
851348880075534336,0,1,0,0,1
851399400224149504,1,0,0,0,1
851429367725117440,0,1,0,0,1
851476384786415616,1,0,0,0,1
851481901416288256,0,1,0,0,1
851483268201537536,1,0,0,0,1
851502014227820544,1,0,0,0,1
852691387229384704,0,1,0,0,1
852738364432306176,1,0,0,0,1
846355601013833728,0,1,0,0,1
853673765913415680,0,1,0,0,1
853802969862504448,0,1,0,0,1
853848732093349888,0,1,0,0,1
853861896847413248,0,0,1,0,1
853918775099482112,0,0,0,1,1
853940973574823936,0,1,0,0,1
854019561959632896,0,1,0,0,1
854131139925217280,1,0,0,0,1
854152217326211072,0,1,0,0,1
854158061505740800,0,0,0,1,1
854167786549104640,0,1,0,0,1
854187358870278144,1,0,0,0,1
854190992580374528,0,1,0,0,1
854202275337834496,0,1,0,0,1
854207167473123328,0,1,0,0,1
854207922045415424,0,1,0,0,1
853711114894528512,0,1,0,0,1
853585958775787520,0,0,0,1,1
852795427950698496,0,1,0,0,1
853554930476605440,1,0,0,0,1
852809283821490176,0,1,0,0,1
852905276403589120,0,0,0,1,1
852941963569627136,0,1,0,0,1
852973168407056384,0,1,0,0,1
853093749806649344,0,1,0,0,1
853182405049561088,0,0,0,1,1
853228712661307392,1,0,0,0,1
853268953573072896,0,1,0,0,1
853294583450673152,0,1,0,0,1
853294825642356736,0,1,0,0,1
853319873660846080,0,1,0,0,1
853489308510154752,0,0,1,0,1
853490457656967168,0,1,0,0,1
853554039270891520,0,1,0,0,1
853554668219363328,0,1,0,0,1
850928461980069888,0,1,0,0,1
850909459811635200,0,1,0,0,1
850887417355579392,0,0,1,0,1
847425950165815296,0,1,0,0,1
847473652387815424,0,1,0,0,1
847509558897639424,0,1,0,0,1
847582500457197568,0,1,0,0,1
847613135166906368,0,1,0,0,1
847616636177666048,0,1,0,0,1
847682943917072384,0,1,0,0,1
847811049063690240,0,1,0,0,1
847863683040587776,1,0,0,0,1
848097430373629952,0,1,0,0,1
848171754191237120,1,0,0,0,1
848178709395668992,0,1,0,0,1
848194045637783552,0,1,0,0,1
848249810411032576,0,1,0,0,1
848420286818951168,0,0,1,0,1
848450802599555072,0,1,0,0,1
847426220543287296,0,1,0,0,1
847379127988506624,0,1,0,0,1
850882371389992960,1,0,0,0,1
847355449091342336,0,1,0,0,1
846370791864356864,0,1,0,0,1
846415655666638848,0,1,0,0,1
846550689664778240,1,0,0,0,1
846598788143759360,0,1,0,0,1
846602022849859584,0,1,0,0,1
846627649971765248,0,1,0,0,1
846697817297113088,0,1,0,0,1
846784781991981056,1,0,0,0,1
846785509091397632,1,0,0,0,1
846859494063833088,1,0,0,0,1
846862187431788544,0,1,0,0,1
846883319816110080,0,0,0,1,1
847035052361994240,0,1,0,0,1
847051931738624000,0,0,0,1,1
847355173273874432,0,1,0,0,1
848474583632052224,0,0,0,1,1
848489196373368832,0,1,0,0,1
848498171294691328,0,1,0,0,1
848505042944626688,1,0,0,0,1
850034125859835904,0,1,0,0,1
850247358633791488,0,1,0,0,1
850252306327117824,0,1,0,0,1
850280081301876736,1,0,0,0,1
850313513927102464,1,0,0,0,1
850419420749070336,0,1,0,0,1
850441701558824960,0,1,0,0,1
850484423577542656,0,1,0,0,1
850591430783492096,0,1,0,0,1
850618870771531776,0,1,0,0,1
850632741821349888,0,1,0,0,1
850700109667086336,0,1,0,0,1
850749139537342464,0,1,0,0,1
850754149503389696,0,1,0,0,1
850856585945464832,1,0,0,0,1
849953955828441088,0,1,0,0,1
849900666843738112,0,1,0,0,1
849751978808717312,0,1,0,0,1
849375993835991040,0,1,0,0,1
848571284443340800,1,0,0,0,1
848578313920663552,0,1,0,0,1
848584560447295488,0,1,0,0,1
848650689827880960,0,1,0,0,1
849217175789424640,1,0,0,0,1
849349079335407616,0,1,0,0,1
849443979817037824,0,1,0,0,1
849741996642250752,0,1,0,0,1
849502690136686592,1,0,0,0,1
849505024535408640,0,1,0,0,1
849542330810081280,0,1,0,0,1
849598363351887872,1,0,0,0,1
849607654351810560,0,1,0,0,1
849638702754168832,0,1,0,0,1
838378519596052480,0,1,0,0,1
838289962206310400,0,1,0,0,1
771761071778660352,0,1,0,0,1
828289929650307072,1,0,0,0,1
828372436114632704,0,1,0,0,1
828391533137256448,0,1,0,0,1
828466233284521984,0,1,0,0,1
828528354596904960,0,1,0,0,1
828570523902803968,0,1,0,0,1
828572493304692736,0,1,0,0,1
828668143052558336,1,0,0,0,1
828737756142637056,1,0,0,0,1
828816593576566784,0,1,0,0,1
828847819184156672,0,1,0,0,1
828858251055763456,1,0,0,0,1
828890704214634496,0,1,0,0,1
828903198287077376,0,1,0,0,1
828929314364219392,0,1,0,0,1
828962004958343168,0,1,0,0,1
828348977078796288,1,0,0,0,1
828289481073582080,0,1,0,0,1
829047821668143104,0,1,0,0,1
828278059140861952,1,0,0,0,1
827579608199467008,0,1,0,0,1
827757680781643776,0,1,0,0,1
827800679020380160,0,0,1,0,1
827819570488446976,0,1,0,0,1
827836609756229632,1,0,0,0,1
827900960169095168,0,0,0,1,1
827907620711329792,0,1,0,0,1
827925794773204992,0,1,0,0,1
827974930692177920,0,1,0,0,1
827994454137004032,1,0,0,0,1
828108643388108800,0,1,0,0,1
828154974366429184,1,0,0,0,1
828203139732008960,0,1,0,0,1
828251320704458752,0,1,0,0,1
828269160668991488,0,1,0,0,1
829001088007360512,0,1,0,0,1
829075581245485056,0,1,0,0,1
830751836827222016,0,1,0,0,1
830259490045857792,0,1,0,0,1
830326501052669952,0,1,0,0,1
830365152373530624,0,1,0,0,1
830382870359339008,0,1,0,0,1
830406471858925568,1,0,0,0,1
830431070797590528,0,1,0,0,1
830503073474891776,0,1,0,0,1
830523931492806656,0,1,0,0,1
830526932609593344,0,1,0,0,1
830557187936231424,0,1,0,0,1
830561789804945408,0,1,0,0,1
830597539216830464,0,1,0,0,1
830607623984517120,1,0,0,0,1
830613966875402240,1,0,0,0,1
830647731291095040,0,1,0,0,1
830648322570457088,0,1,0,0,1
830311916635639808,0,1,0,0,1
830255229664952320,1,0,0,0,1
829087274084208640,0,1,0,0,1
830180631845883904,1,0,0,0,1
829119906293641216,1,0,0,0,1
829150305338216448,0,1,0,0,1
829170633535811584,0,0,1,0,1
829177571933720576,0,1,0,0,1
829210842637950976,0,1,0,0,1
829251104605085696,0,1,0,0,1
829488740879986688,0,1,0,0,1
829490315698528256,0,1,0,0,1
829606522300686336,1,0,0,0,1
829635853055975424,0,1,0,0,1
829729162562764800,1,0,0,0,1
829746684192120832,0,1,0,0,1
830099141153976320,0,1,0,0,1
830123211656343552,0,1,0,0,1
830127771888283648,0,1,0,0,1
827552326311358464,0,1,0,0,1
827511654657191936,1,0,0,0,1
827498887187345408,0,1,0,0,1
824702679616278528,0,1,0,0,1
824711067372810240,1,0,0,0,1
824724883707944960,0,1,0,0,1
824765280157126656,0,1,0,0,1
824836691844276224,0,1,0,0,1
824938012416958464,1,0,0,0,1
825030296844185600,0,1,0,0,1
825058549847855104,0,1,0,0,1
825061447419965440,1,0,0,0,1
825088666313822208,0,1,0,0,1
825088670403145728,0,1,0,0,1
825198218384273408,0,1,0,0,1
825248890165223424,0,0,0,1,1
825334683454013440,0,1,0,0,1
825420478009405440,0,1,0,0,1
825645189029064704,0,1,0,0,1
824707902409732096,0,1,0,0,1
824672445542100992,1,0,0,0,1
827403451730587648,0,1,0,0,1
824569200047906816,1,0,0,0,1
824074288495853568,0,1,0,0,1
824076652061675520,0,1,0,0,1
824126860569280512,1,0,0,0,1
824309426177896448,0,1,0,0,1
824357681972383744,0,1,0,0,1
824388643045380096,0,1,0,0,1
824389772537782272,0,1,0,0,1
824390182552162304,0,1,0,0,1
824396526495694848,0,1,0,0,1
824417604525821952,0,1,0,0,1
824423012745179136,0,0,1,0,1
824438829092368384,0,1,0,0,1
824519954473095168,0,1,0,0,1
824527773800824832,1,0,0,0,1
824528835874029568,0,1,0,0,1
825653199096860672,1,0,0,0,1
825694546700886016,1,0,0,0,1
825711418611740672,0,1,0,0,1
825716762670948352,1,0,0,0,1
826527382194511872,0,1,0,0,1
826585118567305216,0,1,0,0,1
826613512491249664,0,1,0,0,1
826642533853704192,1,0,0,0,1
826687662220312576,0,1,0,0,1
826690577076994048,0,1,0,0,1
826741425542930432,1,0,0,0,1
826819028966572032,0,1,0,0,1
826822217166180352,0,1,0,0,1
826872089911185408,0,1,0,0,1
826958610106195968,0,1,0,0,1
827015133188743168,0,1,0,0,1
827145318437355520,0,1,0,0,1
827195767844528128,0,1,0,0,1
827227726369132544,0,1,0,0,1
826512944733233152,0,1,0,0,1
826476393793941504,0,1,0,0,1
826458285083594752,0,1,0,0,1
826001772674170880,0,1,0,0,1
825731836542386176,0,1,0,0,1
825733051791634432,0,1,0,0,1
825813437544542208,0,1,0,0,1
825915505915654144,0,1,0,0,1
825932184217214976,0,1,0,0,1
825946777438265344,0,1,0,0,1
826027582571298816,0,1,0,0,1
826373502823456768,0,1,0,0,1
826074691664179200,0,1,0,0,1
826109393624260608,0,1,0,0,1
826121256168615936,0,1,0,0,1
826238530494009344,0,1,0,0,1
826331413410639872,0,1,0,0,1
826345248951513088,0,1,0,0,1
830686243176448000,0,1,0,0,1
830762350034767872,1,0,0,0,1
838277096451473408,0,1,0,0,1
835043472512020480,0,0,0,1,1
835077285199794176,0,1,0,0,1
835132898219020288,0,1,0,0,1
835219229569753088,0,1,0,0,1
835431983362670592,0,0,1,0,1
835544111969005568,0,1,0,0,1
835625130571112448,0,1,0,0,1
835642164981923840,0,1,0,0,1
835643290426957824,0,1,0,0,1
835775485682593792,0,1,0,0,1
835779192063209472,0,1,0,0,1
835781853000925184,1,0,0,0,1
835814562012270592,0,1,0,0,1
835868769079734272,0,1,0,0,1
835985282709086208,0,0,1,0,1
836017539549433856,1,0,0,0,1
835044010817372160,1,0,0,0,1
834892723652018176,0,1,0,0,1
836246884687568896,0,0,1,0,1
834885864266285056,1,0,0,0,1
834004867488370688,0,0,0,1,1
834022822062100480,0,1,0,0,1
834026564945842176,0,1,0,0,1
834033178067234816,0,1,0,0,1
834045952591798272,0,1,0,0,1
834056034981404672,1,0,0,0,1
834070676927549440,0,1,0,0,1
834076819729031168,0,1,0,0,1
834096034766786560,0,1,0,0,1
834324121454473216,0,1,0,0,1
834386837745577984,0,1,0,0,1
834438547180486656,0,1,0,0,1
834451512311025664,0,1,0,0,1
834620953455972352,0,1,0,0,1
834861692953690112,0,1,0,0,1
836162626937896960,0,1,0,0,1
836326279389544448,0,1,0,0,1
830772888475226112,0,1,0,0,1
837192899649495040,0,1,0,0,1
837286698253967360,0,0,0,1,1
837286824309587968,0,1,0,0,1
837317095360614400,0,1,0,0,1
837531224453214208,1,0,0,0,1
837584644673396736,0,1,0,0,1
837629774235373568,0,1,0,0,1
837857876827848704,0,1,0,0,1
837989041496854528,0,1,0,0,1
837989685406355456,0,1,0,0,1
837992348181147648,0,1,0,0,1
838045113624354816,0,1,0,0,1
838119354688540672,0,1,0,0,1
838123249179508736,0,1,0,0,1
838240757781671936,1,0,0,0,1
838254678844583936,0,1,0,0,1
837249578583863296,0,1,0,0,1
837174247432699904,0,1,0,0,1
836379971937583104,1,0,0,0,1
837172729010847744,0,1,0,0,1
836444772776607744,0,1,0,0,1
836478108672929792,0,1,0,0,1
836534607893798912,0,1,0,0,1
836554677453996032,0,1,0,0,1
836617514075357184,1,0,0,0,1
836656159612260352,0,1,0,0,1
836686622091534336,0,1,0,0,1
836766362622119936,0,1,0,0,1
836904567740694528,1,0,0,0,1
836912210869825536,0,1,0,0,1
836918013676900352,0,1,0,0,1
836920499842199552,0,0,0,1,1
836952966221479936,0,1,0,0,1
837171383381667840,0,1,0,0,1
837171728434393088,0,1,0,0,1
833991110775209984,0,1,0,0,1
833946052252225536,0,0,0,1,1
833706110120923136,1,0,0,0,1
831678527753838592,0,1,0,0,1
831813608552136704,1,0,0,0,1
831824087790080000,1,0,0,0,1
831860163372015616,0,1,0,0,1
831885177953546240,0,1,0,0,1
831920504562995200,0,1,0,0,1
831939911821434880,1,0,0,0,1
831967838839635968,0,1,0,0,1
832012532852355072,0,1,0,0,1
832012596110725120,0,1,0,0,1
832019161454817280,0,0,1,0,1
832029322693267456,0,0,1,0,1
832047828167950336,1,0,0,0,1
832098457108246528,1,0,0,0,1
832123684248813568,1,0,0,0,1
832128001886343168,0,1,0,0,1
831807793820741632,0,1,0,0,1
831542180866985984,0,1,0,0,1
833651894706925568,0,1,0,0,1
831505102376562688,0,1,0,0,1
830818727453138944,0,1,0,0,1
830828239832616960,0,1,0,0,1
830850517932732416,0,1,0,0,1
830854689222717440,0,1,0,0,1
830950246154850304,1,0,0,0,1
831055694203908096,1,0,0,0,1
831132086249594880,0,1,0,0,1
831140867369005056,0,1,0,0,1
831155407938846720,0,1,0,0,1
831159773886312448,0,1,0,0,1
831219408509030400,0,1,0,0,1
831303141668687872,0,1,0,0,1
831388497890144256,1,0,0,0,1
831415300235132928,0,1,0,0,1
831449515022508032,0,1,0,0,1
832222430131343360,0,1,0,0,1
832252872528101376,0,1,0,0,1
832314237498318848,0,1,0,0,1
832335504548917248,1,0,0,0,1
833025237109325824,0,1,0,0,1
833133253120884736,0,1,0,0,1
833160174311448576,0,1,0,0,1
833272693554311168,0,1,0,0,1
833273141916991488,0,0,0,1,1
833302381727211520,0,1,0,0,1
833350834842902528,0,1,0,0,1
833357561923506176,0,1,0,0,1
833380478916952064,0,1,0,0,1
833389959176413184,0,1,0,0,1
833416084812398592,0,1,0,0,1
833421470722310144,0,1,0,0,1
833609830875160576,0,1,0,0,1
833617072521220096,0,1,0,0,1
833627443365871616,0,1,0,0,1
832988692855844864,1,0,0,0,1
832956154066124800,0,1,0,0,1
832943738389344256,0,1,0,0,1
832649716185706496,0,1,0,0,1
832427522956488704,0,1,0,0,1
832516233232674816,0,1,0,0,1
832549600238174208,0,1,0,0,1
832569529687539712,0,1,0,0,1
832572481361866752,0,1,0,0,1
832593524369534976,0,1,0,0,1
832650064942264320,0,1,0,0,1
832931497678139392,1,0,0,0,1
832663901246361600,0,1,0,0,1
832695323440996352,1,0,0,0,1
832712827630608384,0,1,0,0,1
832804150660497408,0,1,0,0,1
832811210596839424,1,0,0,0,1
832875764223717376,0,1,0,0,1
854211659719557120,0,1,0,0,1
854242231699603456,0,1,0,0,1
854352340731785216,1,0,0,0,1
876733879314460672,0,1,0,0,1
876794275467415552,0,1,0,0,1
876835339570212864,0,1,0,0,1
876846367418732544,0,1,0,0,1
876850898366083072,1,0,0,0,1
876891092628590592,0,1,0,0,1
877036403330297856,0,1,0,0,1
877037871873609728,0,1,0,0,1
877165506763132928,1,0,0,0,1
877333255137054720,0,1,0,0,1
877365785928359936,1,0,0,0,1
877457379738124288,0,1,0,0,1
877500720920088576,0,1,0,0,1
877515248676294656,1,0,0,0,1
877527881303203840,0,1,0,0,1
877620985968701440,1,0,0,0,1
876789133909401600,0,1,0,0,1
876663325248995328,0,1,0,0,1
877685410347995136,0,0,0,1,1
876620127621574656,0,1,0,0,1
876353826235854848,0,1,0,0,1
876358395472773120,1,0,0,0,1
876373857132834816,0,1,0,0,1
876376471224410112,0,1,0,0,1
876396176425312256,0,1,0,0,1
876422099564449792,0,1,0,0,1
876423067978919936,0,1,0,0,1
876435926892916736,0,1,0,0,1
876464855741591552,0,1,0,0,1
876494511345737728,0,1,0,0,1
876518337584414720,0,1,0,0,1
876521805195956224,0,1,0,0,1
876570882566758400,0,1,0,0,1
876606429708288000,1,0,0,0,1
876620094654173184,0,1,0,0,1
877672647848587264,0,1,0,0,1
877748895815794688,0,1,0,0,1
880108214314041344,1,0,0,0,1
878869992548294656,1,0,0,0,1
879005940451815424,0,0,0,1,1
879031929965817856,0,1,0,0,1
879050782414434304,0,1,0,0,1
879075278932385792,0,1,0,0,1
879094430879236096,0,1,0,0,1
879214763137433600,0,0,1,0,1
879321501849325568,0,1,0,0,1
879377662371868672,0,1,0,0,1
879465895097122816,0,1,0,0,1
879574275857973248,0,1,0,0,1
879581966772916224,0,1,0,0,1
879633986817077248,1,0,0,0,1
879741127829536768,1,0,0,0,1
879786202144047104,0,1,0,0,1
879823977400721408,0,1,0,0,1
878974345372082176,0,0,0,1,1
878644645370245120,0,1,0,0,1
877823923999698944,1,0,0,0,1
878583183264153600,0,1,0,0,1
877853257783287808,0,1,0,0,1
877863596893495296,0,1,0,0,1
877874276589752320,1,0,0,0,1
877901556347060224,1,0,0,0,1
877970905300967424,0,1,0,0,1
878118058774155264,0,1,0,0,1
878144094337249280,0,1,0,0,1
878192308092645376,0,1,0,0,1
878220325980450816,0,1,0,0,1
878241256756977664,0,1,0,0,1
878291073226993664,0,1,0,0,1
878373653494341632,0,1,0,0,1
878531388940701696,0,1,0,0,1
878531468556853248,0,1,0,0,1
878547160580620288,0,1,0,0,1
876176679839944704,0,1,0,0,1
876171984966623232,0,1,0,0,1
876140132709138432,1,0,0,0,1
873270860815060992,1,0,0,0,1
873337896102658048,0,1,0,0,1
873391086915530752,0,0,0,1,1
873421952525979648,0,1,0,0,1
873447331580059648,0,1,0,0,1
873453028501803008,0,1,0,0,1
873484162803654656,0,1,0,0,1
873506340571762688,1,0,0,0,1
873528356481970176,0,1,0,0,1
873529476352798720,0,1,0,0,1
873664546967142400,0,1,0,0,1
873791606159286272,0,1,0,0,1
873829138175545344,0,1,0,0,1
873850146915729408,0,1,0,0,1
874232060642295808,1,0,0,0,1
874233315691311104,0,1,0,0,1
873277335537102848,1,0,0,0,1
873250606097498112,0,1,0,0,1
876090347302117376,0,1,0,0,1
873147135348293632,0,1,0,0,1
872252886863892480,0,1,0,0,1
872445388397170688,0,1,0,0,1
872463024879276032,0,1,0,0,1
872469732192124928,0,1,0,0,1
872477161545977856,0,1,0,0,1
872482561267781632,0,1,0,0,1
872545932029591552,0,1,0,0,1
872547287741935616,1,0,0,0,1
872577850490093568,0,1,0,0,1
872579649729155072,0,0,1,0,1
872597380725481472,0,1,0,0,1
872934120589897728,0,1,0,0,1
873046736591142912,0,1,0,0,1
873111666283520000,0,1,0,0,1
873117100671356928,0,1,0,0,1
874241096901165056,0,1,0,0,1
874254547891499008,0,1,0,0,1
874402553844334592,0,1,0,0,1
874414267071475712,0,1,0,0,1
875382218545401856,0,1,0,0,1
875539547873988608,0,1,0,0,1
875665159699800064,0,1,0,0,1
875667749271248896,0,1,0,0,1
875695444218851328,0,1,0,0,1
875707690328174592,1,0,0,0,1
875723129703682048,0,1,0,0,1
875738101053894656,0,1,0,0,1
875788897468526592,0,1,0,0,1
875889198250696704,1,0,0,0,1
875984009544605696,1,0,0,0,1
876001947601575936,0,1,0,0,1
876028909111922688,0,0,0,1,1
876029617894764544,1,0,0,0,1
876075595431645184,1,0,0,0,1
875374941134258176,0,1,0,0,1
875313930075348992,0,1,0,0,1
875307928093327360,0,1,0,0,1
874831490739318784,0,1,0,0,1
874417955458568192,0,0,0,1,1
874480145838493696,1,0,0,0,1
874501740145631232,0,1,0,0,1
874543709232254976,0,1,0,0,1
874727864368869376,1,0,0,0,1
874805809288331264,0,1,0,0,1
874892444374093824,1,0,0,0,1
875213987977109504,0,1,0,0,1
874931085167165440,0,1,0,0,1
875017025432674304,0,0,0,1,1
875020540435718144,0,1,0,0,1
875068930913644544,0,1,0,0,1
875193439968743424,0,1,0,0,1
875210637244153856,0,1,0,0,1
880091237348392960,0,1,0,0,1
880236046897860608,1,0,0,0,1
854571853318377472,0,1,0,0,1
885274741652819968,0,1,0,0,1
885393324273795072,0,1,0,0,1
885559048816537600,0,1,0,0,1
885564289779716096,0,1,0,0,1
885621114709442560,0,1,0,0,1
885666980950310912,0,1,0,0,1
885669388858339328,1,0,0,0,1
885722809602912256,1,0,0,0,1
885737391184527360,0,1,0,0,1
885741846118400000,0,1,0,0,1
885800392512208896,0,1,0,0,1
885810656204795904,0,1,0,0,1
885842863585669120,0,1,0,0,1
885848852045201408,0,1,0,0,1
885849999736811520,0,1,0,0,1
885882947244445696,0,1,0,0,1
885387375886708736,0,1,0,0,1
885224061881786368,0,1,0,0,1
885962054808555520,0,1,0,0,1
885206342239084544,0,1,0,0,1
884645338753007616,1,0,0,0,1
884664403609735168,0,1,0,0,1
884757889327521792,1,0,0,0,1
884844170568847360,1,0,0,0,1
884875629279166464,0,1,0,0,1
885000254529187840,0,1,0,0,1
885083532405743616,1,0,0,0,1
885106430004613120,0,1,0,0,1
885144255223787520,0,1,0,0,1
885151778622369792,1,0,0,0,1
885157614597709824,0,1,0,0,1
885169191933947904,0,1,0,0,1
885170462807937024,0,1,0,0,1
885179531882930176,1,0,0,0,1
885193650489049088,0,1,0,0,1
885957619919200256,0,1,0,0,1
886051509720326144,0,1,0,0,1
880319611513823232,0,0,0,1,1
886892177694932992,0,1,0,0,1
886956025890443264,1,0,0,0,1
887127857046077440,1,0,0,0,1
887179954307387392,0,1,0,0,1
887183134114144256,0,1,0,0,1
887187296897912832,0,1,0,0,1
887246407798673408,0,0,0,1,1
887286308451872768,0,1,0,0,1
887350185617219584,0,1,0,0,1
887356293652107264,0,1,0,0,1
887396761169297408,0,1,0,0,1
887502314495463424,0,1,0,0,1
887505550883213312,0,1,0,0,1
887545508360634368,0,1,0,0,1
887585020684247040,0,1,0,0,1
887587874568376320,1,0,0,0,1
886919616127090688,1,0,0,0,1
886840789669629952,0,1,0,0,1
886175664935665664,0,1,0,0,1
886763354609659904,0,1,0,0,1
886204902317412352,0,1,0,0,1
886218260420730880,0,1,0,0,1
886234607930167296,0,1,0,0,1
886235712089190400,0,1,0,0,1
886298326903259136,0,1,0,0,1
886345088896335872,0,1,0,0,1
886364537657708544,0,1,0,0,1
886379573092503552,0,1,0,0,1
886398296146706432,0,1,0,0,1
886440864028872704,0,1,0,0,1
886513375743688704,0,1,0,0,1
886515099913125888,0,1,0,0,1
886575878469296128,0,1,0,0,1
886639159238164480,0,1,0,0,1
886720697321574400,0,1,0,0,1
884519634078138368,0,1,0,0,1
884480061956554752,0,1,0,0,1
884462284042645504,0,1,0,0,1
881118936716259328,0,1,0,0,1
881271074129932288,0,1,0,0,1
881316339637518336,0,1,0,0,1
881335508718301184,0,1,0,0,1
881358656893325312,0,1,0,0,1
881402066912120832,0,1,0,0,1
881420484952432640,0,1,0,0,1
881483780510404608,0,1,0,0,1
881488341912346624,0,1,0,0,1
881627544503627776,0,1,0,0,1
881634191586316288,0,1,0,0,1
881765465655320576,1,0,0,0,1
881783017869631488,0,1,0,0,1
881829885152571392,0,1,0,0,1
881896421766512640,0,1,0,0,1
881946547168190464,0,1,0,0,1
881121908904914944,0,1,0,0,1
881044021346410496,0,1,0,0,1
884392803928756224,1,0,0,0,1
881039889176829952,0,1,0,0,1
880361069306425344,0,1,0,0,1
880387599503728640,0,1,0,0,1
880477584286519296,1,0,0,0,1
880756599622705152,0,1,0,0,1
880758834268123136,0,1,0,0,1
880767603915898880,0,1,0,0,1
880768846780608512,0,1,0,0,1
880783125143576576,1,0,0,0,1
880811795220488192,0,1,0,0,1
880827295530975232,0,1,0,0,1
880867888701337600,1,0,0,0,1
880882293841297408,0,1,0,0,1
880902442451337216,0,1,0,0,1
880909801420726272,0,1,0,0,1
880959783465078784,1,0,0,0,1
881955186352287744,0,1,0,0,1
882113366894018560,0,1,0,0,1
882113736034500608,0,1,0,0,1
882130374595235840,0,1,0,0,1
883586841374588928,1,0,0,0,1
883658730155409408,0,1,0,0,1
883799598153818112,1,0,0,0,1
883856100130512896,0,1,0,0,1
883876326272364544,0,1,0,0,1
883936035905961984,0,1,0,0,1
883974014477238272,0,1,0,0,1
883984732735782912,1,0,0,0,1
884044149145468928,0,1,0,0,1
884159737826291712,1,0,0,0,1
884197405410959360,0,1,0,0,1
884337077961326592,0,1,0,0,1
884339067139366912,1,0,0,0,1
884339692468129792,0,1,0,0,1
884372834343976960,0,1,0,0,1
883544810103201792,0,1,0,0,1
883520706255998976,1,0,0,0,1
883407709093212160,0,1,0,0,1
882986224327303168,0,1,0,0,1
882142205556772864,0,1,0,0,1
882268444028276736,0,1,0,0,1
882509006287196160,0,1,0,0,1
882531736613158912,0,1,0,0,1
882778833904050176,0,1,0,0,1
882905540552257536,0,1,0,0,1
883014762027769856,0,1,0,0,1
883390176818417664,0,1,0,0,1
883024366048620544,0,1,0,0,1
883045953170755584,0,1,0,0,1
883052398750703616,0,1,0,0,1
883063014685016064,0,1,0,0,1
883195345307435008,0,1,0,0,1
883291293878767616,0,1,0,0,1
872252295966273536,0,1,0,0,1
872242535367938048,0,1,0,0,1
872166664049233920,0,1,0,0,1
859653706136027136,0,1,0,0,1
859664895683559424,1,0,0,0,1
859730668179337216,0,0,0,1,1
859744681730625536,0,1,0,0,1
859757183533293568,0,1,0,0,1
859907158472888320,0,1,0,0,1
860031046016000000,0,1,0,0,1
860107716710289408,0,1,0,0,1
860181621965824000,0,1,0,0,1
860395258710028288,0,1,0,0,1
860418191742431232,0,1,0,0,1
860501282771128320,0,1,0,0,1
860532316535480320,1,0,0,0,1
860732060419461120,0,1,0,0,1
860751768753516544,0,1,0,0,1
860798293596614656,1,0,0,0,1
859662324449280000,0,0,1,0,1
859606094641078272,0,1,0,0,1
860813561135853568,0,1,0,0,1
859527666088759296,0,1,0,0,1
858868909134434304,0,1,0,0,1
858964828681109504,0,1,0,0,1
858978225854218240,0,1,0,0,1
859030304740323328,0,1,0,0,1
859049792110034944,0,1,0,0,1
859051164318392320,0,1,0,0,1
859067543473995776,0,1,0,0,1
859143981040627712,0,1,0,0,1
859320715354550272,0,1,0,0,1
859336650454970368,0,1,0,0,1
859365784400932864,0,1,0,0,1
859406232037187584,0,1,0,0,1
859453851010772992,1,0,0,0,1
859461148248244224,0,0,0,1,1
859485814060978176,0,1,0,0,1
860806472313192448,0,1,0,0,1
860815949586477056,0,1,0,0,1
872152873101963264,0,1,0,0,1
862313376235626496,0,1,0,0,1
862503277287546880,0,1,0,0,1
862563263275450368,1,0,0,0,1
862563621192306688,0,0,1,0,1
862619391191638016,0,1,0,0,1
862713282997649408,0,1,0,0,1
862746263783178240,0,0,0,1,1
862960460676694016,0,1,0,0,1
862970692958138368,0,1,0,0,1
862990476382785536,0,0,0,1,1
863031041883340800,0,1,0,0,1
863144550323408896,0,1,0,0,1
863184801817178112,0,1,0,0,1
863348273750327296,1,0,0,0,1
863353094951682048,0,1,0,0,1
863387632658788352,0,0,0,1,1
862412644531163136,0,1,0,0,1
862193856141328384,0,1,0,0,1
861189250846384128,0,1,0,0,1
862114613235777536,0,1,0,0,1
861251910107451392,0,1,0,0,1
861302667079024640,1,0,0,0,1
861411333245456384,1,0,0,0,1
861509275394461696,1,0,0,0,1
861532210196819968,0,1,0,0,1
861544858833518592,0,1,0,0,1
861655599133720576,0,1,0,0,1
861780979614007296,0,1,0,0,1
861823385088774144,0,1,0,0,1
861922212374249472,0,1,0,0,1
861927663669321728,0,1,0,0,1
861958126500818944,0,1,0,0,1
861971736908230656,0,1,0,0,1
861973150438969344,1,0,0,0,1
862109580536532992,0,1,0,0,1
858867849997299712,0,1,0,0,1
858705841624502272,0,1,0,0,1
858669939548225536,0,1,0,0,1
855677866339516416,1,0,0,0,1
855882963707408384,0,1,0,0,1
855958908820742144,0,1,0,0,1
855963867641458688,0,1,0,0,1
856020696211873792,1,0,0,0,1
856103900549701632,1,0,0,0,1
856168515178450944,0,1,0,0,1
856189893332094976,1,0,0,0,1
856215202865397760,0,1,0,0,1
856273008310333440,0,1,0,0,1
856588439000666112,1,0,0,0,1
856603482773753856,0,1,0,0,1
856772631273635840,0,1,0,0,1
856795363243565056,0,1,0,0,1
856831880674586624,0,1,0,0,1
856890355907743744,1,0,0,0,1
855736199423684608,1,0,0,0,1
855635253649481728,0,1,0,0,1
858658163876409344,1,0,0,0,1
855617414276407296,0,1,0,0,1
854683914706792448,0,1,0,0,1
854691094424162304,0,1,0,0,1
854714870117302272,0,1,0,0,1
854730047030124544,0,1,0,0,1
854740849984405504,0,1,0,0,1
854814062324187136,0,1,0,0,1
854942164064894976,0,1,0,0,1
854971257753935872,1,0,0,0,1
854986865644122112,1,0,0,0,1
854992615380537344,0,1,0,0,1
855073786663718912,0,1,0,0,1
855175444404088832,0,1,0,0,1
855443450262683648,0,1,0,0,1
855449051042639872,1,0,0,0,1
855536475378765824,0,1,0,0,1
856923211019243520,0,1,0,0,1
857078053142487040,0,1,0,0,1
857144629082370048,0,1,0,0,1
857148776762544128,0,1,0,0,1
858088037196201984,0,1,0,0,1
858141480900341760,0,1,0,0,1
858225169453555712,0,0,1,0,1
858269286007271424,0,1,0,0,1
858279993478086656,1,0,0,0,1
858287110587068416,0,1,0,0,1
858305299610042368,0,0,1,0,1
858394126450122752,0,1,0,0,1
858409330902786048,0,1,0,0,1
858416138559954944,1,0,0,0,1
858471853974749184,0,1,0,0,1
858475176765292544,1,0,0,0,1
858475407229714432,0,1,0,0,1
858584217709678592,0,1,0,0,1
858649565850984448,0,1,0,0,1
858021522560225280,0,1,0,0,1
857958484209532928,0,1,0,0,1
857931967609831424,1,0,0,0,1
857573541537099776,0,1,0,0,1
857165636635676672,0,1,0,0,1
857240255283548160,0,1,0,0,1
857256731717517312,0,0,1,0,1
857285067831484416,0,1,0,0,1
857429014994067456,0,1,0,0,1
857539762156130304,0,1,0,0,1
857599588164874240,0,1,0,0,1
857890894929899520,0,1,0,0,1
857655216455528448,0,1,0,0,1
857677870965108736,1,0,0,0,1
857772508010905600,0,1,0,0,1
857823916340858880,0,1,0,0,1
857834482270969856,1,0,0,0,1
857847844266536960,0,1,0,0,1
863626054505607168,0,1,0,0,1
863684829577179136,0,1,0,0,1
863791264650735616,0,1,0,0,1
869207251457724416,0,1,0,0,1
869288192440193024,0,1,0,0,1
869297458559369216,0,1,0,0,1
869381737511477248,1,0,0,0,1
869610526086758400,0,1,0,0,1
869788622903537664,0,0,1,0,1
869803423423635456,0,1,0,0,1
869825784961216512,0,1,0,0,1
869862524321230848,0,1,0,0,1
869891729192882176,0,1,0,0,1
869930193800089600,0,1,0,0,1
869952409136750592,1,0,0,0,1
869992386138710016,0,1,0,0,1
870129079327928320,0,1,0,0,1
870232886649266176,1,0,0,0,1
870270604473192448,0,1,0,0,1
869257047849791488,0,1,0,0,1
869192988580343808,0,1,0,0,1
868033246663192576,0,1,0,0,1
869192276614012928,0,1,0,0,1
868155132273451008,0,1,0,0,1
868286601281118208,0,1,0,0,1
868357542426140672,0,1,0,0,1
868464482250616832,0,0,0,1,1
868673067223887872,0,1,0,0,1
868724367072546816,1,0,0,0,1
868812350974869504,0,1,0,0,1
868862646333751296,0,1,0,0,1
868903091768315904,0,1,0,0,1
868920881426333696,0,1,0,0,1
868933893503594496,1,0,0,0,1
869003720012464128,1,0,0,0,1
869090583708651520,0,1,0,0,1
869095665393172480,0,1,0,0,1
869163500916150272,0,1,0,0,1
870273288618074112,0,1,0,0,1
870348872236892160,0,1,0,0,1
870356133810237440,0,1,0,0,1
870363113308160000,1,0,0,0,1
871657265652281344,0,1,0,0,1
871718351696928768,0,1,0,0,1
871722310964850688,0,1,0,0,1
871749960164835328,0,1,0,0,1
871750203065479168,0,0,1,0,1
871785866129285120,0,0,1,0,1
871816047686496256,0,1,0,0,1
871857372179902464,0,1,0,0,1
871990561531625472,0,1,0,0,1
872000867557404672,0,1,0,0,1
872038955352510464,0,1,0,0,1
872085660886282240,0,1,0,0,1
872102013990916096,0,0,1,0,1
872105413126344704,0,1,0,0,1
872152748518723584,1,0,0,0,1
871513263795716096,0,1,0,0,1
871423486383857664,0,1,0,0,1
871396350033887232,1,0,0,0,1
870896973611753472,0,1,0,0,1
870404541455388672,1,0,0,0,1
870406736313696256,0,1,0,0,1
870443793174020096,0,1,0,0,1
870474451074260992,0,1,0,0,1
870748460491911168,0,1,0,0,1
870791201968050176,0,1,0,0,1
870897801256894464,0,1,0,0,1
871340884427776000,0,1,0,0,1
870912534093549568,0,1,0,0,1
870925459856519168,1,0,0,0,1
871022157459009536,0,1,0,0,1
871130660370489344,1,0,0,0,1
871297341159952384,0,1,0,0,1
871328719096471552,1,0,0,0,1
868137278966829056,1,0,0,0,1
867943519410933760,1,0,0,0,1
864007651247755264,0,1,0,0,1
864936451561148416,0,1,0,0,1
865053864608903168,0,1,0,0,1
865155316987592704,1,0,0,0,1
865157861927768064,0,1,0,0,1
865167524542992384,0,1,0,0,1
865205076159344640,0,1,0,0,1
865245923550654464,1,0,0,0,1
865270191856529408,0,1,0,0,1
865327785300111360,0,1,0,0,1
865505045323800576,0,1,0,0,1
865592534344400896,0,1,0,0,1
865623403226578944,0,1,0,0,1
865630509656821760,0,1,0,0,1
865635068395388928,0,1,0,0,1
865708174308933632,0,1,0,0,1
865719298865504256,1,0,0,0,1
865036084018794496,0,1,0,0,1
864861033307000832,0,1,0,0,1
867942245759991808,0,1,0,0,1
864800468874268672,0,0,1,0,1
864072367617830912,1,0,0,0,1
864096169013780480,0,0,0,1,1
864103699680985088,0,1,0,0,1
864118645089329152,0,1,0,0,1
864162176117985280,0,1,0,0,1
864198358197469184,0,1,0,0,1
864232967773851648,0,1,0,0,1
864348668886827008,1,0,0,0,1
864387149851918336,0,1,0,0,1
864395580574978048,0,1,0,0,1
864479779097018368,0,1,0,0,1
864521371354710016,0,1,0,0,1
864546360388984832,0,1,0,0,1
864647712087523328,0,1,0,0,1
864793086517551104,0,0,0,1,1
865817977148645376,0,1,0,0,1
865853782055407616,0,1,0,0,1
866026245666082816,0,1,0,0,1
866103969671598080,0,1,0,0,1
867022620817936384,0,1,0,0,1
867030186583183360,0,1,0,0,1
867051225535131648,0,1,0,0,1
867118374643544064,0,1,0,0,1
867119767135678464,1,0,0,0,1
867126773233975296,0,1,0,0,1
867167404878700544,0,1,0,0,1
867219420489371648,0,1,0,0,1
867322513059086336,0,1,0,0,1
867371372930093056,0,1,0,0,1
867396369396498432,0,1,0,0,1
867423411835854848,0,1,0,0,1
867450974692143104,0,1,0,0,1
867460428758220800,0,1,0,0,1
867729595113644032,0,1,0,0,1
866987805012090880,1,0,0,0,1
866986607764811776,0,1,0,0,1
866969174953906176,0,1,0,0,1
866508071211872256,0,1,0,0,1
866158509284630528,0,1,0,0,1
866217820463525888,0,1,0,0,1
866301253420232704,0,1,0,0,1
866400144631230464,0,1,0,0,1
866465063267221504,1,0,0,0,1
866479325985423360,1,0,0,0,1
866548244314062848,0,1,0,0,1
866925085449486336,0,1,0,0,1
866649535707217920,1,0,0,0,1
866709226424590336,0,1,0,0,1
866709465290203136,0,1,0,0,1
866718968568045568,0,1,0,0,1
866889110019092480,0,1,0,0,1
866903745975783424,0,1,0,0,1
824063002894893056,0,1,0,0,1
824033332753264640,0,1,0,0,1
823966306919706624,1,0,0,0,1
790327341809565696,0,1,0,0,1
790408492234399744,0,1,0,0,1
790443341787779072,0,1,0,0,1
790486869175701504,0,1,0,0,1
790566530492669952,1,0,0,0,1
790597081853493248,0,1,0,0,1
790648000192196608,0,0,1,0,1
790693721679523840,0,1,0,0,1
790754678569103360,0,1,0,0,1
790883536739774464,0,1,0,0,1
790891028785995776,0,1,0,0,1
790911556892504064,1,0,0,0,1
790912121282240512,1,0,0,0,1
790983203863527424,1,0,0,0,1
791069195324694528,0,1,0,0,1
791135637403467776,0,1,0,0,1
790363747348951040,0,1,0,0,1
790318902785998848,0,1,0,0,1
791192962030067712,0,1,0,0,1
790298150556794880,0,1,0,0,1
789683230668619776,0,1,0,0,1
789732738962161664,0,1,0,0,1
789760964254195712,0,1,0,0,1
789804428098465792,0,1,0,0,1
789900454067052544,0,1,0,0,1
789931658891759616,0,1,0,0,1
789956888783908864,0,1,0,0,1
790058005526147072,0,1,0,0,1
790164922537762816,0,1,0,0,1
790173608178028544,1,0,0,0,1
790193524205510656,0,1,0,0,1
790208838813245440,0,1,0,0,1
790215976335794176,0,1,0,0,1
790244545229381632,0,1,0,0,1
790296672236548096,0,1,0,0,1
791181063691395072,0,1,0,0,1
791244661910188032,0,1,0,0,1
793152488765591552,0,1,0,0,1
792110389295058944,0,1,0,0,1
792233419090587648,0,1,0,0,1
792244459333234688,0,1,0,0,1
792348395604029440,0,1,0,0,1
792363299929284608,1,0,0,0,1
792367364893511680,0,1,0,0,1
792393470782636032,0,1,0,0,1
792395884164186112,0,1,0,0,1
792416640516386816,1,0,0,0,1
792444242295652352,0,1,0,0,1
792506355693289472,0,1,0,0,1
792654237561790464,1,0,0,0,1
792661948961792000,0,1,0,0,1
792753751513821184,0,1,0,0,1
792763441635270656,0,1,0,0,1
792846705704054784,0,1,0,0,1
792198362045046784,1,0,0,0,1
792079588851580928,0,1,0,0,1
791248485811118080,0,1,0,0,1
792070515309576192,0,1,0,0,1
791296774019440640,0,1,0,0,1
791352462468866048,0,0,0,1,1
791388100014538752,0,1,0,0,1
791527056848936960,1,0,0,0,1
791568834046066688,0,1,0,0,1
791690141014392832,1,0,0,0,1
791729294946992128,1,0,0,0,1
791783135088443392,0,1,0,0,1
791790123478241280,0,1,0,0,1
791865836449529856,0,1,0,0,1
791874916589113344,0,1,0,0,1
791914744714301440,1,0,0,0,1
791924450484781056,0,1,0,0,1
791928579835637760,0,1,0,0,1
792011591634092032,0,0,0,1,1
789625746620837888,0,1,0,0,1
789521996577116160,0,1,0,0,1
789520217789562880,0,1,0,0,1
786774286681780224,0,1,0,0,1
786853143074205696,0,1,0,0,1
786904907827720192,0,1,0,0,1
786938428034351104,1,0,0,0,1
786952257174638592,0,1,0,0,1
787080805159952384,1,0,0,0,1
787234467773607936,0,1,0,0,1
787240862900219904,0,1,0,0,1
787255230618439680,0,1,0,0,1
787273976473083904,0,1,0,0,1
787329296427737088,0,1,0,0,1
787376392333844480,0,1,0,0,1
787391563756408832,0,1,0,0,1
787577484229406720,0,1,0,0,1
787616141388636160,0,1,0,0,1
787670796910993408,0,1,0,0,1
786795430868680704,0,1,0,0,1
786690352484913152,0,1,0,0,1
789500351204306944,0,1,0,0,1
786660052996349952,0,1,0,0,1
785953223689416704,0,1,0,0,1
786074065853349888,1,0,0,0,1
786088910778695680,0,1,0,0,1
786134207986819072,1,0,0,0,1
786139738809913344,1,0,0,0,1
786148936226639872,0,1,0,0,1
786246748637270016,0,1,0,0,1
786249179135815680,0,1,0,0,1
786256829869334528,1,0,0,0,1
786328055253864448,0,1,0,0,1
786390302021922816,0,1,0,0,1
786450764457738240,0,1,0,0,1
786560668996603904,0,1,0,0,1
786603260954238976,0,1,0,0,1
786642209563172864,0,1,0,0,1
787682107485224960,0,1,0,0,1
787831418118373376,0,1,0,0,1
787895300056809472,0,1,0,0,1
787955435340963840,1,0,0,0,1
788942950168457216,1,0,0,0,1
788983104861982720,0,1,0,0,1
788985443467481088,0,1,0,0,1
789002952937771008,0,1,0,0,1
789014604709924864,0,1,0,0,1
789056635163508736,0,1,0,0,1
789065478140493824,1,0,0,0,1
789089451817504768,0,1,0,0,1
789112995389419520,0,1,0,0,1
789122870781894656,0,1,0,0,1
789243566027571200,0,1,0,0,1
789329632239681536,0,1,0,0,1
789402702341996544,0,1,0,0,1
789412273659928576,0,1,0,0,1
789455958250496000,0,1,0,0,1
788874932574949376,0,1,0,0,1
788868594662793216,0,1,0,0,1
788839574176985088,0,1,0,0,1
788369319881244672,0,1,0,0,1
787966477366202368,1,0,0,0,1
788130957576507392,0,1,0,0,1
788174438390837248,0,1,0,0,1
788253979373342720,0,1,0,0,1
788292004996345856,0,1,0,0,1
788339648514953216,0,1,0,0,1
788386792923856896,0,1,0,0,1
788795851003035648,0,1,0,0,1
788539707680366592,1,0,0,0,1
788601419414827008,0,1,0,0,1
788666082391363584,0,1,0,0,1
788702944413773824,0,1,0,0,1
788706969737687040,0,1,0,0,1
788727789566431232,0,1,0,0,1
793004126145748992,0,1,0,0,1
793167944217927680,0,1,0,0,1
798234722778411008,0,1,0,0,1
796728680605253632,0,1,0,0,1
796754900034158592,0,1,0,0,1
796768047851851776,0,1,0,0,1
796812617700569088,1,0,0,0,1
796814501794508800,0,1,0,0,1
796833045881888768,0,1,0,0,1
796845382152163328,0,1,0,0,1
796890351151841280,1,0,0,0,1
796899824624865280,1,0,0,0,1
796918378564820992,0,1,0,0,1
796941969494863872,1,0,0,0,1
796948287295254528,0,1,0,0,1
796965216370229248,0,1,0,0,1
796983741000216576,0,1,0,0,1
796991936380833792,0,1,0,0,1
797000249621512192,0,1,0,0,1
796743637438701568,0,1,0,0,1
796724650449534976,0,1,0,0,1
797039077254008832,0,1,0,0,1
796693921611022336,0,1,0,0,1
796298731783995392,1,0,0,0,1
796306428516597760,0,1,0,0,1
796312606709608448,0,1,0,0,1
796373146999914496,1,0,0,0,1
796381417819295744,0,1,0,0,1
796401029650653184,0,1,0,0,1
796402979062554624,0,1,0,0,1
796429394990370816,0,0,1,0,1
796431633494769664,0,1,0,0,1
796448709978357760,0,1,0,0,1
796466485866745856,0,1,0,0,1
796513276238643200,0,1,0,0,1
796575808861171712,1,0,0,0,1
796576709617324032,0,1,0,0,1
796660652710338560,0,1,0,0,1
797017678766624768,1,0,0,0,1
797071569960976384,0,1,0,0,1
793204194421383168,0,1,0,0,1
797797238902640640,0,1,0,0,1
797798241672671232,0,1,0,0,1
797804053925339136,0,1,0,0,1
797845151737610240,0,0,0,1,1
797855368047104000,0,1,0,0,1
797862440415285248,0,1,0,0,1
797907039557074944,1,0,0,0,1
797909733168521216,0,1,0,0,1
798002469196349440,0,1,0,0,1
798012931656945664,0,1,0,0,1
798046763148046336,0,1,0,0,1
798079791085723648,1,0,0,0,1
798090706539737088,0,1,0,0,1
798106574132649984,0,1,0,0,1
798116588880797696,0,1,0,0,1
798155476672380928,0,1,0,0,1
797797514124496896,0,1,0,0,1
797764766689329152,0,1,0,0,1
797074392102662144,0,1,0,0,1
797623237568032768,0,0,0,1,1
797155736459640832,0,1,0,0,1
797177719632990208,0,1,0,0,1
797193663042424832,1,0,0,0,1
797281337874989056,0,1,0,0,1
797294497042415616,1,0,0,0,1
797311793400082432,0,1,0,0,1
797363095660298240,0,1,0,0,1
797374926416216064,0,1,0,0,1
797397853324922880,0,1,0,0,1
797402842197794816,0,1,0,0,1
797411777743093760,0,0,0,1,1
797431677580615680,1,0,0,0,1
797454885310631936,0,1,0,0,1
797460317479563264,1,0,0,0,1
797495443513114624,0,1,0,0,1
796278634092826624,0,1,0,0,1
796249109455728640,0,1,0,0,1
796172840076775424,0,1,0,0,1
793876317976526848,0,1,0,0,1
794013809732100096,0,0,0,1,1
794021634806005760,0,1,0,0,1
794106512318853120,1,0,0,0,1
794169879318429696,0,1,0,0,1
794236356746690560,0,1,0,0,1
794246050949251072,0,1,0,0,1
794274505895989248,0,0,1,0,1
794315440080048128,1,0,0,0,1
794332494489325568,0,1,0,0,1
794503851810390016,0,1,0,0,1
794534820382699520,0,1,0,0,1
794556559057682432,0,1,0,0,1
794575159424380928,0,1,0,0,1
794583124256718848,0,1,0,0,1
794618613344899072,0,1,0,0,1
793964342442131456,0,1,0,0,1
793873253278314496,0,1,0,0,1
796137176157171712,0,1,0,0,1
793863499684409344,0,1,0,0,1
793234425417007104,0,1,0,0,1
793239673028030464,1,0,0,0,1
793263741945126912,0,1,0,0,1
793349500727390208,0,1,0,0,1
793351844630237184,0,1,0,0,1
793389335936630784,1,0,0,0,1
793392151291949056,0,1,0,0,1
793398994303082496,0,1,0,0,1
793423584756629504,0,1,0,0,1
793434386003820544,0,0,1,0,1
793471396773060608,0,1,0,0,1
793531516622082048,0,1,0,0,1
793540167021670400,0,1,0,0,1
793717960338731008,0,1,0,0,1
793757360670011392,0,1,0,0,1
794671033945063424,0,1,0,0,1
794746261253427200,0,1,0,0,1
794828799347224576,0,1,0,0,1
794838394065055744,1,0,0,0,1
795619335591100416,0,1,0,0,1
795626471645548544,0,1,0,0,1
795668960586960896,0,1,0,0,1
795887712796426240,0,1,0,0,1
795899708979970048,0,1,0,0,1
938832614277963776,0,1,0,0,1
795985628022370304,0,1,0,0,1
796029903472730112,0,1,0,0,1
796036162590801920,1,0,0,0,1
796066838622994432,0,1,0,0,1
796068935884017664,0,1,0,0,1
796087166027911168,1,0,0,0,1
796088389606871040,0,1,0,0,1
796091737387270144,0,1,0,0,1
796091738058276864,0,1,0,0,1
795614118208278528,0,1,0,0,1
795455449332142080,0,1,0,0,1
795384422644191232,0,1,0,0,1
794912991762378752,0,1,0,0,1
794845886010523648,1,0,0,0,1
794869183913857024,0,1,0,0,1
794882331051954176,0,1,0,0,1
794888836430041088,1,0,0,0,1
794892369875308544,0,1,0,0,1
794898670923743232,0,1,0,0,1
794913247161946112,0,1,0,0,1
795335987354185728,1,0,0,0,1
794925891017199616,1,0,0,0,1
795005867733172224,0,1,0,0,1
795113275897839616,0,1,0,0,1
795191420210528256,1,0,0,0,1
795232225931333632,0,1,0,0,1
795244740836868096,1,0,0,0,1
785834750296592384,0,1,0,0,1
785804309179039744,0,1,0,0,1
785764222504345600,0,1,0,0,1
776331065086451712,0,1,0,0,1
776416769724456960,0,0,1,0,1
776424014428471296,0,1,0,0,1
776651089831530496,0,1,0,0,1
776684168268898304,0,1,0,0,1
776749110091255808,0,1,0,0,1
776769212484292608,0,1,0,0,1
776806133239517184,0,1,0,0,1
776868996654170112,0,1,0,0,1
776871389794009088,0,1,0,0,1
776984729916694528,1,0,0,0,1
777027502346735616,0,1,0,0,1
777135751838437376,0,1,0,0,1
777201451672088576,0,1,0,0,1
777333275660476416,0,1,0,0,1
777394046927011840,0,1,0,0,1
776351254838599680,1,0,0,0,1
776324395874869248,1,0,0,0,1
777441382197714944,0,1,0,0,1
776279308041990144,1,0,0,0,1
775334920419958784,1,0,0,0,1
775391062768492544,0,1,0,0,1
775577428722913280,1,0,0,0,1
775626843319783424,0,1,0,0,1
775665018977280000,0,1,0,0,1
775709112210427904,0,1,0,0,1
775716604457791488,0,1,0,0,1
775886589813665792,0,1,0,0,1
775945061091512320,0,1,0,0,1
775964306458279936,0,1,0,0,1
776050057598472192,1,0,0,0,1
776087353437720576,0,1,0,0,1
776093974188662784,0,1,0,0,1
776096465194070016,0,1,0,0,1
776172503068803072,0,1,0,0,1
777402680356417536,1,0,0,0,1
777471782995492864,1,0,0,0,1
785658467293929472,0,1,0,0,1
778198028066971648,0,1,0,0,1
778225764709826560,0,1,0,0,1
778240473206919168,0,1,0,0,1
778254566278230016,0,1,0,0,1
778265358163701760,0,1,0,0,1
778266554320453632,0,1,0,0,1
778274075424780288,0,1,0,0,1
778295169351356416,0,1,0,0,1
778346517019131904,0,1,0,0,1
778536077111857152,1,0,0,0,1
778538725416562688,0,0,1,0,1
778650613336768512,0,1,0,0,1
778690878277681152,0,1,0,0,1
778724973917503488,1,0,0,0,1
778768265304608768,1,0,0,0,1
778786879428759552,0,1,0,0,1
778209235297599488,0,1,0,0,1
778196167918321664,0,0,0,1,1
777484268910026752,0,1,0,0,1
778139952685191168,0,1,0,0,1
777530997483069440,0,1,0,0,1
777563995897290752,1,0,0,0,1
777639857883611136,0,1,0,0,1
777693763636301824,1,0,0,0,1
777704525146755072,0,1,0,0,1
777705433171693568,0,1,0,0,1
777732297260871680,0,0,0,1,1
777752230699073536,1,0,0,0,1
777762481057898496,0,1,0,0,1
777784541373136896,0,1,0,0,1
777833724423573504,0,0,0,1,1
777839368757186560,0,1,0,0,1
777974086009970688,0,1,0,0,1
778111817281306624,0,1,0,0,1
778120791443603456,0,1,0,0,1
775334764702228480,0,1,0,0,1
775238037512921088,0,1,0,0,1
775235220408762368,0,1,0,0,1
772794424954916864,0,1,0,0,1
772802946174246912,0,1,0,0,1
772823622238863360,0,1,0,0,1
772944547504619520,0,1,0,0,1
773002169553457152,0,0,1,0,1
773007001253052416,0,1,0,0,1
773049600982786048,1,0,0,0,1
773086161707405312,1,0,0,0,1
773090777471684608,0,1,0,0,1
773119735701639168,0,1,0,0,1
773132733098946560,0,1,0,0,1
773184396950179840,0,1,0,0,1
773280711520509952,0,1,0,0,1
773417426205671424,1,0,0,0,1
773421820884180992,0,1,0,0,1
773427496830308352,0,1,0,0,1
772798081444241408,0,1,0,0,1
772786265313931264,0,1,0,0,1
775229624246738944,0,1,0,0,1
772785611702927360,0,1,0,0,1
771837165789675520,0,0,0,1,1
771847685154361344,0,1,0,0,1
772084034407108608,0,1,0,0,1
772085297513455616,0,1,0,0,1
772117985448329216,0,1,0,0,1
772133459187957760,1,0,0,0,1
772230013374566400,0,1,0,0,1
772335881638273024,0,1,0,0,1
772353522184650752,1,0,0,0,1
772371235732795392,0,1,0,0,1
772399273673711616,1,0,0,0,1
772486009388949504,0,1,0,0,1
772491844743598080,0,1,0,0,1
772526731114737664,0,1,0,0,1
772739965537099776,1,0,0,0,1
773534525615931392,0,1,0,0,1
773548893003014144,0,1,0,0,1
773575597775781888,0,1,0,0,1
773575699919691776,0,1,0,0,1
774468716302045184,0,1,0,0,1
774509625207054336,0,1,0,0,1
774535822167212032,1,0,0,0,1
774582459270856704,0,1,0,0,1
774592185949880320,1,0,0,0,1
774602503124058112,0,1,0,0,1
774624218755403776,0,1,0,0,1
774641495647383552,0,1,0,0,1
774682762506665984,0,1,0,0,1
774883356265762816,0,1,0,0,1
774914674194120704,0,1,0,0,1
774956800093421568,0,1,0,0,1
774960297933103104,0,1,0,0,1
774970972231331840,0,1,0,0,1
775207523720790016,0,1,0,0,1
774307556927733760,1,0,0,0,1
774258996744220672,0,1,0,0,1
774258795283447808,0,1,0,0,1
773829114402922496,1,0,0,0,1
773583307628052480,0,1,0,0,1
773605665487159296,0,1,0,0,1
773630822578618368,0,1,0,0,1
773638463484821504,0,1,0,0,1
773646632114065408,0,1,0,0,1
773769601746407424,0,1,0,0,1
773905872523239424,0,1,0,0,1
774168372401451008,0,1,0,0,1
773960530763603968,0,1,0,0,1
773987073284009984,0,1,0,0,1
774061311072342016,0,1,0,0,1
774083594570596352,0,1,0,0,1
774101185892454400,0,1,0,0,1
774112901388836864,0,1,0,0,1
778933215495086080,0,1,0,0,1
778940238311919616,0,1,0,0,1
778990706740178944,0,1,0,0,1
783666426603311104,0,1,0,0,1
783738233804972032,0,1,0,0,1
783763975586582528,0,1,0,0,1
783790882105466880,0,1,0,0,1
783815012418719744,0,1,0,0,1
783834646278799360,1,0,0,0,1
783900513179840512,0,1,0,0,1
783902222845227008,0,1,0,0,1
783916442853007360,0,1,0,0,1
783920098188922880,0,1,0,0,1
783948567169859584,0,1,0,0,1
784021315233677312,0,1,0,0,1
784072324739768320,0,1,0,0,1
784109351170613248,0,1,0,0,1
784159237819641856,0,1,0,0,1
784164670475304960,0,1,0,0,1
783699234436575232,0,1,0,0,1
783568341218758656,0,1,0,0,1
782525394402566144,0,1,0,0,1
783552779969323008,0,1,0,0,1
782666388292775936,1,0,0,0,1
782685380478836736,0,1,0,0,1
782758575680520192,0,1,0,0,1
782806026873561088,1,0,0,0,1
782820015762472960,0,1,0,0,1
782893110263156736,0,1,0,0,1
782916585933668352,0,1,0,0,1
782918337198034944,0,1,0,0,1
782943591589109760,0,1,0,0,1
783191198642995200,0,1,0,0,1
783241339370606592,0,1,0,0,1
783377313262104576,0,1,0,0,1
783484555172782080,0,1,0,0,1
783493790619279360,0,1,0,0,1
783497532672466944,1,0,0,0,1
784172745101762560,0,1,0,0,1
784199492044218368,0,1,0,0,1
784287512927703040,1,0,0,0,1
784295856606441472,0,1,0,0,1
785227212047863808,1,0,0,0,1
785355105138831360,0,1,0,0,1
785371302542581760,0,1,0,0,1
785395009939963904,0,1,0,0,1
785402179402227712,0,1,0,0,1
785408959364665344,0,1,0,0,1
785411354047971328,0,0,1,0,1
785444207997571072,0,1,0,0,1
785462666886254592,0,1,0,0,1
785481902706810880,0,1,0,0,1
785505231601750016,0,0,0,1,1
785512205890392064,0,1,0,0,1
785524797237293056,0,1,0,0,1
785553167387729920,0,1,0,0,1
785562753998196736,0,1,0,0,1
785035276800385024,0,1,0,0,1
785026461195350016,0,1,0,0,1
785006932276850688,1,0,0,0,1
784546118893989888,0,1,0,0,1
784366602095628288,0,1,0,0,1
784391808277159936,0,1,0,0,1
784433530734534656,0,1,0,0,1
784464110180245504,0,1,0,0,1
784476137086980096,0,0,0,1,1
784507622116495360,1,0,0,0,1
784569394529759232,0,1,0,0,1
784888209675198464,0,1,0,0,1
784688629595635712,0,1,0,0,1
784804987050217472,0,1,0,0,1
784824338520342528,0,1,0,0,1
784842898105708544,1,0,0,0,1
784868733026263040,0,1,0,0,1
784879615269539840,0,1,0,0,1
782624583316758528,0,0,1,0,1
782451067372068864,1,0,0,0,1
779085787761635328,0,1,0,0,1
780085464883757056,0,1,0,0,1
780263678683680768,0,1,0,0,1
780283587501363200,1,0,0,0,1
780345813109276672,0,1,0,0,1
780346892249075712,0,1,0,0,1
780367705090068480,0,1,0,0,1
780396259806941184,1,0,0,0,1
780420402980020224,0,1,0,0,1
780490010030137344,0,1,0,0,1
780521106511892480,0,1,0,0,1
780525872553992192,0,1,0,0,1
780540916184395776,0,1,0,0,1
780557367066845184,0,1,0,0,1
780577562430873600,0,1,0,0,1
780639889314369536,0,1,0,0,1
780651889108975616,0,1,0,0,1
780149234578362368,0,1,0,0,1
780080055116558336,0,1,0,0,1
782373558831943680,0,1,0,0,1
779961721125502976,1,0,0,0,1
779091626727763968,0,0,1,0,1
779140880192118784,0,1,0,0,1
779197568731402240,0,1,0,0,1
779311460749086720,0,1,0,0,1
779338198665355264,0,1,0,0,1
779359873947557888,0,1,0,0,1
779641356197167104,0,1,0,0,1
779659205187817472,0,1,0,0,1
779699757728034816,0,1,0,0,1
779758447059431424,0,1,0,0,1
779866347274588160,0,1,0,0,1
779879391606087680,0,1,0,0,1
779899115853537280,0,1,0,0,1
779910004967079936,0,1,0,0,1
779946063746727936,0,1,0,0,1
780820974383935488,0,1,0,0,1
780858954599403520,0,1,0,0,1
780922542643044352,1,0,0,0,1
780976709319421952,0,1,0,0,1
781786218006798336,0,1,0,0,1
781850776184426496,0,1,0,0,1
781886815737376768,0,1,0,0,1
781942836786712576,0,1,0,0,1
781970804523274240,0,1,0,0,1
782021564464234496,0,1,0,0,1
782150306486419456,0,1,0,0,1
782169170100293632,0,0,0,1,1
782199615999311872,0,1,0,0,1
782200729406672896,0,1,0,0,1
782254642482774016,1,0,0,0,1
782261367583739904,0,1,0,0,1
782262428780355584,0,1,0,0,1
782360267074273280,1,0,0,0,1
782361004638437376,0,1,0,0,1
781758283363323904,0,1,0,0,1
781753611785150464,0,1,0,0,1
781738660848820224,0,1,0,0,1
781489936184651776,1,0,0,0,1
781088284986511360,1,0,0,0,1
781182627663360000,0,1,0,0,1
781185088172072960,0,1,0,0,1
781227484499079168,1,0,0,0,1
781287557891895296,0,0,0,1,1
781356865288626176,0,1,0,0,1
781508775681351680,0,1,0,0,1
781703328648617984,0,1,0,0,1
781517952927563776,0,1,0,0,1
781534869331378176,0,1,0,0,1
781551243571232768,0,1,0,0,1
781579563809796096,1,0,0,0,1
781623996269883392,0,1,0,0,1
781625905286418432,0,1,0,0,1
798220694509289472,0,1,0,0,1
798247336140906496,0,1,0,0,1
823954919807860736,0,1,0,0,1
815520441909407744,0,1,0,0,1
815556890906202112,0,1,0,0,1
815576846091878400,0,1,0,0,1
815580552371773440,0,0,0,1,1
815599991481921536,0,0,0,1,1
815639836207910912,1,0,0,0,1
815659557552844800,0,1,0,0,1
815667058809540608,0,1,0,0,1
815795410157629440,0,1,0,0,1
815819884038852608,0,1,0,0,1
815869463954395136,1,0,0,0,1
815899310516600832,0,1,0,0,1
815947625191116800,1,0,0,0,1
815948110904094720,0,1,0,0,1
816034616247078912,0,1,0,0,1
816083077453725696,0,1,0,0,1
815550200156712960,0,1,0,0,1
815453655704993792,1,0,0,0,1
816254841785815040,0,1,0,0,1
815448415966523392,0,1,0,0,1
815001451672047616,0,0,0,1,1
815066586189099008,1,0,0,0,1
815112607069798400,1,0,0,0,1
815212187350368256,1,0,0,0,1
815237336090845184,0,1,0,0,1
815249997117521920,0,1,0,0,1
815277312241438720,1,0,0,0,1
815316961693462528,0,1,0,0,1
815323599472971776,0,1,0,0,1
815327626801872896,0,1,0,0,1
815345739408834560,0,1,0,0,1
815354245704601600,0,1,0,0,1
815378561632784384,0,1,0,0,1
815396499882442752,0,1,0,0,1
815448143789785088,0,1,0,0,1
816195715538022400,0,1,0,0,1
816306031265517568,0,1,0,0,1
818486333043867648,0,1,0,0,1
817608643524730880,0,1,0,0,1
817704294304665600,0,1,0,0,1
817752101812047872,0,1,0,0,1
817778393957748736,0,1,0,0,1
817779104498012160,0,1,0,0,1
817817976032337920,0,1,0,0,1
817866832459788288,0,1,0,0,1
817970300650274816,0,1,0,0,1
818081779953389568,0,1,0,0,1
818093333625106432,0,1,0,0,1
818100365824589824,0,1,0,0,1
818103555659886592,0,0,0,1,1
818243820877922304,0,1,0,0,1
818373432350044160,0,1,0,0,1
818413145236668416,0,1,0,0,1
818433584977629184,1,0,0,0,1
817679124697403392,0,1,0,0,1
817310406104465408,0,1,0,0,1
816326693199679488,0,1,0,0,1
817056727531134976,1,0,0,0,1
816476581816242176,0,1,0,0,1
816514697369448448,0,1,0,0,1
816589359952654336,0,1,0,0,1
816625828545130496,0,1,0,0,1
816701381486714880,0,1,0,0,1
816759041020063744,0,1,0,0,1
816765063226867712,1,0,0,0,1
816810814220931072,0,1,0,0,1
816820217892323328,0,1,0,0,1
816873520084852736,0,1,0,0,1
816877089781489664,1,0,0,0,1
816984924628615168,0,1,0,0,1
816999845173071872,0,1,0,0,1
817036925324455936,0,1,0,0,1
817049414279823360,1,0,0,0,1
814973596137353216,0,1,0,0,1
814958348344836096,0,1,0,0,1
814926494573072384,0,1,0,0,1
811878278990544896,0,1,0,0,1
811951426150825984,1,0,0,0,1
811964100653776896,0,1,0,0,1
812014210053971968,0,1,0,0,1
812174489731493888,0,0,0,1,1
812191790082170880,0,1,0,0,1
812398529750691840,0,1,0,0,1
812487066395119616,0,1,0,0,1
812593549220937728,0,1,0,0,1
812716350665850880,0,1,0,0,1
812725667141980160,0,1,0,0,1
812998349959761920,1,0,0,0,1
813080659136745472,0,1,0,0,1
813091594878550016,0,1,0,0,1
813116115421462528,0,1,0,0,1
813167431732498432,1,0,0,0,1
811948410932723712,0,0,0,1,1
811862100465303552,0,1,0,0,1
814912519731081216,0,1,0,0,1
811825789427654656,0,1,0,0,1
810898389575598080,0,1,0,0,1
810964336030060544,1,0,0,0,1
811087560084779008,0,1,0,0,1
811093269073526784,0,1,0,0,1
811135456100356096,0,1,0,0,1
811164456021618688,0,1,0,0,1
811200413055729664,0,1,0,0,1
811232692004069376,0,1,0,0,1
811335668433489920,0,0,1,0,1
811351717895950336,0,1,0,0,1
811573320365830144,1,0,0,0,1
811576886291664896,0,0,0,1,1
811611510342447104,0,1,0,0,1
811623799640756224,0,1,0,0,1
811711601422123008,0,1,0,0,1
813327411513278464,0,1,0,0,1
813331872939986944,0,1,0,0,1
813337572432904192,0,1,0,0,1
813361071616462848,0,1,0,0,1
814191102597144576,0,1,0,0,1
814227604026912768,0,1,0,0,1
814256314020986880,0,1,0,0,1
814354813907517440,1,0,0,0,1
814400045365784576,0,1,0,0,1
814479475601801216,0,1,0,0,1
814489610159951872,0,1,0,0,1
814716969626796032,0,1,0,0,1
814729791387512832,1,0,0,0,1
814758171407421440,1,0,0,0,1
814774267850145792,0,1,0,0,1
814791903942246400,0,1,0,0,1
814845908173078528,1,0,0,0,1
814901663471378432,0,1,0,0,1
814911128388194304,0,1,0,0,1
814132702370820096,0,1,0,0,1
814071365623914496,0,1,0,0,1
814023417502404608,0,1,0,0,1
813648044600082432,0,1,0,0,1
813373263841755136,1,0,0,0,1
813476477668851712,0,1,0,0,1
813554350245212160,0,1,0,0,1
813602303085162496,0,1,0,0,1
813602987251761152,0,1,0,0,1
813646976273227776,0,1,0,0,1
813675479202988032,0,1,0,0,1
814020719831031808,1,0,0,0,1
813756163703640064,0,0,0,1,1
813770169621286912,0,1,0,0,1
813796418007638016,0,1,0,0,1
813852605130620928,0,1,0,0,1
813884524086067200,0,1,0,0,1
814002911537758208,0,1,0,0,1
818451587467071488,0,0,0,1,1
818489822797070336,1,0,0,0,1
798289667774889984,1,0,0,0,1
822108846193864704,0,1,0,0,1
822261873110183936,0,1,0,0,1
822280430938419200,1,0,0,0,1
822393490675933184,0,1,0,0,1
822439794848526336,0,1,0,0,1
822459897627480064,0,1,0,0,1
822466689757573120,0,1,0,0,1
822486955661344768,0,1,0,0,1
822504473025282048,0,1,0,0,1
822522820454449152,0,1,0,0,1
822532222565683200,0,1,0,0,1
822600382887116800,0,1,0,0,1
822630613375217664,0,1,0,0,1
822662137684312064,0,1,0,0,1
822679686656512000,0,1,0,0,1
822694068224458752,0,1,0,0,1
822248495172173824,0,1,0,0,1
822005946109100032,0,1,0,0,1
822708754525417472,0,0,1,0,1
821977945241620480,0,1,0,0,1
821216905549623296,0,1,0,0,1
821240299703955456,0,1,0,0,1
821285198075674624,0,1,0,0,1
821285752575246336,0,1,0,0,1
821292542524329984,0,1,0,0,1
821429403137740800,0,1,0,0,1
821564856163856384,1,0,0,0,1
821690659421716480,1,0,0,0,1
821695824086364160,0,1,0,0,1
821753143927054336,0,1,0,0,1
821761167110574080,0,1,0,0,1
821787845664866304,0,1,0,0,1
821852547182755840,0,1,0,0,1
821937047405375488,0,1,0,0,1
821946621462253568,1,0,0,0,1
822708274986385408,0,1,0,0,1
822713738956402688,0,1,0,0,1
818507597573738496,1,0,0,0,1
823461905884774400,0,1,0,0,1
823466267709493248,0,1,0,0,1
823474620636524544,0,1,0,0,1
823502376057372672,0,1,0,0,1
823502609910616064,0,0,0,1,1
823568311187345408,0,1,0,0,1
823575160737460224,0,1,0,0,1
823578053636784128,0,1,0,0,1
823632932141142016,0,1,0,0,1
823702142896762880,1,0,0,0,1
823702352242896896,0,1,0,0,1
823826017848532992,0,1,0,0,1
823826890079301632,0,1,0,0,1
823841884292476928,0,1,0,0,1
823871955099123712,1,0,0,0,1
823917423585873920,0,1,0,0,1
823465285281837056,0,1,0,0,1
823434697988575232,0,1,0,0,1
822759750022660096,0,1,0,0,1
823409476787142656,1,0,0,0,1
822807097217875968,1,0,0,0,1
822825758150238208,0,1,0,0,1
822841692864778240,0,1,0,0,1
822888425590292480,0,1,0,0,1
822979614192627712,0,1,0,0,1
823037390864482304,0,1,0,0,1
823050224285392896,0,1,0,0,1
823098144917520384,1,0,0,0,1
823133047847522304,0,1,0,0,1
823151019802574848,1,0,0,0,1
823168352118046720,0,1,0,0,1
823183898838441984,0,1,0,0,1
823229663379980288,0,1,0,0,1
823248012373794816,0,1,0,0,1
823375449392693248,0,1,0,0,1
821204581480886272,0,1,0,0,1
821161768772845568,0,1,0,0,1
821061800753958912,0,1,0,0,1
819171026269536256,0,1,0,0,1
819190082053640192,1,0,0,0,1
819195877801783296,0,1,0,0,1
819201542863601664,0,1,0,0,1
819208872812482560,0,1,0,0,1
819294551743623168,1,0,0,0,1
819308475369058304,0,1,0,0,1
819351903570104320,0,1,0,0,1
819395845602897920,0,1,0,0,1
819403013450305536,0,1,0,0,1
819438515956121600,0,1,0,0,1
819473324732362752,0,1,0,0,1
819475629938655232,0,1,0,0,1
819593708995772416,0,1,0,0,1
819645949408583680,0,1,0,0,1
819666746143555584,1,0,0,0,1
819180585004503040,0,1,0,0,1
819092245194231808,1,0,0,0,1
821034757349920768,1,0,0,0,1
819079204952227840,0,1,0,0,1
818543150348255232,0,1,0,0,1
818553855956971520,0,1,0,0,1
818560194900852736,0,1,0,0,1
818640682264961024,0,1,0,0,1
818652503982112768,0,1,0,0,1
818658744355749888,0,1,0,0,1
818750188705685504,0,0,1,0,1
818800320386072576,0,1,0,0,1
818867456995368960,0,1,0,0,1
818920427716104192,0,1,0,0,1
818966538690723840,0,1,0,0,1
818991287378526208,0,1,0,0,1
819014526745968640,1,0,0,0,1
819025866860675072,0,1,0,0,1
819076252141121536,0,1,0,0,1
819717215100420096,1,0,0,0,1
819734722032988160,0,1,0,0,1
819808522128850944,0,1,0,0,1
819839843748327424,0,1,0,0,1
820495958496591872,1,0,0,0,1
820503982799982592,1,0,0,0,1
820522999740776448,0,1,0,0,1
820527353445027840,0,0,1,0,1
820561930289053696,0,1,0,0,1
820657327044968448,0,1,0,0,1
820664352617431040,0,1,0,0,1
820722930170597376,0,1,0,0,1
820730062152617984,0,1,0,0,1
820734343513600000,0,1,0,0,1
820806333561761792,0,1,0,0,1
820825372568776704,0,1,0,0,1
820876451419488256,0,1,0,0,1
820961651344162816,0,1,0,0,1
820966907671101440,0,1,0,0,1
820439347619102720,0,1,0,0,1
820431669509427200,0,1,0,0,1
820428187658137600,0,1,0,0,1
819917303043280896,0,1,0,0,1
819856714505879552,1,0,0,0,1
819862199812366336,0,1,0,0,1
819871231705042944,1,0,0,0,1
819890262973546496,0,1,0,0,1
819900691103842304,0,1,0,0,1
819903037812527104,0,1,0,0,1
820011717291835392,0,1,0,0,1
820352025271468032,0,1,0,0,1
820020020491251712,0,1,0,0,1
820195416650158080,0,1,0,0,1
820246166247997440,0,1,0,0,1
820265894211420160,1,0,0,0,1
820316348756561920,1,0,0,0,1
820334710748540928,0,1,0,0,1
810864944518340608,0,1,0,0,1
810849090930089984,0,1,0,0,1
810836733042380800,0,1,0,0,1
801867970603601920,0,1,0,0,1
802019676318351360,0,1,0,0,1
802057057528643584,1,0,0,0,1
802091154766438400,0,0,0,1,1
802199961391796224,1,0,0,0,1
802212714273710080,0,1,0,0,1
802312941320175616,0,1,0,0,1
802338749547945984,0,1,0,0,1
802434536768315392,1,0,0,0,1
802508702070804480,0,1,0,0,1
802516449382322176,0,1,0,0,1
802609024332140544,0,1,0,0,1
802645199692369920,0,1,0,0,1
802712453142429696,1,0,0,0,1
802726019199369216,0,1,0,0,1
802786678448549888,0,1,0,0,1
801994724395487232,0,1,0,0,1
801851357061906432,0,1,0,0,1
802852666464419840,1,0,0,0,1
801840882035163136,0,1,0,0,1
801334893196275712,0,1,0,0,1
801339647347589120,1,0,0,0,1
801360671468359680,0,1,0,0,1
801372727651237888,0,1,0,0,1
801385313541255168,0,1,0,0,1
801393552336924672,0,1,0,0,1
801408457433759744,0,1,0,0,1
801438568002519040,0,1,0,0,1
801494686955208704,0,1,0,0,1
801508302014316544,0,0,1,0,1
801610180865781760,0,1,0,0,1
801635732242755584,1,0,0,0,1
801638119196000256,0,1,0,0,1
801757526421368832,1,0,0,0,1
801827618005729280,0,1,0,0,1
802810509070311424,0,0,1,0,1
802887354293911552,0,1,0,0,1
810820217865695232,1,0,0,0,1
803637686141526016,0,1,0,0,1
803716209556541440,0,1,0,0,1
803738487887458304,0,1,0,0,1
803745119618863104,0,1,0,0,1
803817912012132352,0,1,0,0,1
803848891938566144,0,1,0,0,1
803858484697636864,0,1,0,0,1
803861432320294912,0,1,0,0,1
803863466805071872,1,0,0,0,1
803990517516222464,0,1,0,0,1
804005275229388800,0,1,0,0,1
804035449396178944,1,0,0,0,1
804125353878769664,0,1,0,0,1
804136622153498624,0,1,0,0,1
804161239568052224,0,1,0,0,1
804216617202651136,0,1,0,0,1
803668188886077440,0,1,0,0,1
803628329697824768,0,1,0,0,1
802889913666600960,0,1,0,0,1
803611098272374784,0,1,0,0,1
802894667327029248,0,1,0,0,1
802895322267586560,1,0,0,0,1
802943880400355328,0,1,0,0,1
803034737526894592,0,1,0,0,1
803095633078808576,0,1,0,0,1
803122146146926592,0,1,0,0,1
803131444608565248,0,1,0,0,1
803228860435365888,1,0,0,0,1
803266943004397568,0,1,0,0,1
803293109190676480,0,1,0,0,1
803321122125123584,0,1,0,0,1
803447007918559232,0,1,0,0,1
803479285105233920,1,0,0,0,1
803578777393467392,0,1,0,0,1
803596717522296832,0,1,0,0,1
801304331131715584,0,1,0,0,1
801257627963506688,0,1,0,0,1
801181284458516480,1,0,0,0,1
799018950617157632,0,1,0,0,1
799095732271771648,0,1,0,0,1
799096424927367168,1,0,0,0,1
799143683593420800,1,0,0,0,1
799157517246988288,0,1,0,0,1
799178839427575808,1,0,0,0,1
799183438402252800,0,1,0,0,1
799208756437544960,0,1,0,0,1
799210827643490304,0,1,0,0,1
799355985437622272,0,1,0,0,1
799420973019701248,0,1,0,0,1
799437474242117632,0,1,0,0,1
799465376857858048,1,0,0,0,1
799559915886940160,0,1,0,0,1
799582772595605504,1,0,0,0,1
799593305738805248,1,0,0,0,1
799070125139914752,1,0,0,0,1
798894742201364480,0,1,0,0,1
801135898398113792,0,1,0,0,1
798808074894983168,0,1,0,0,1
798305099634409472,0,1,0,0,1
798306693910142976,0,1,0,0,1
798358364208168960,0,1,0,0,1
798365442603503616,0,1,0,0,1
798380274161569792,0,1,0,0,1
798461063494828032,0,1,0,0,1
798477680265961472,0,1,0,0,1
798513196428566528,0,1,0,0,1
798519238180749312,0,1,0,0,1
798527572086767616,0,1,0,0,1
798540883981463552,0,1,0,0,1
798591540696379392,0,1,0,0,1
798664982410002432,0,1,0,0,1
798698969576525824,0,1,0,0,1
798772059518009344,0,1,0,0,1
799621619039801344,0,1,0,0,1
799622523600117760,0,1,0,0,1
799642261554429952,1,0,0,0,1
799656652173692928,1,0,0,0,1
800379156361986048,0,1,0,0,1
800392445745709056,0,1,0,0,1
800510955771699200,0,1,0,0,1
800572762003677184,0,1,0,0,1
800680348153573376,1,0,0,0,1
800690654149943296,1,0,0,0,1
800742568795324416,0,1,0,0,1
800774796543856640,0,1,0,0,1
800849507000942592,0,0,0,1,1
800965661941960704,0,1,0,0,1
800966124540137472,0,0,0,1,1
801038417987567616,1,0,0,0,1
801040720710615040,0,1,0,0,1
801073480817053696,0,1,0,0,1
801105200450670592,1,0,0,0,1
800326464818159616,0,1,0,0,1
800323762281279488,0,0,1,0,1
800307037716369408,0,1,0,0,1
800051860119912448,0,1,0,0,1
799665441316700160,0,1,0,0,1
799666997021659136,0,1,0,0,1
799755547503312896,0,1,0,0,1
799853815843450880,0,1,0,0,1
799869982704279552,0,1,0,0,1
799900914840649728,0,1,0,0,1
800070262897029120,0,1,0,0,1
800275992795197440,0,1,0,0,1
800096749347975168,0,1,0,0,1
800125863077392384,0,1,0,0,1
800153709766246400,0,1,0,0,1
800168637109633024,0,0,0,1,1
800223807172546560,1,0,0,0,1
800260353233854464,0,1,0,0,1
804223299395928064,0,1,0,0,1
804237179971141632,0,1,0,0,1
804261060664524800,1,0,0,0,1
808297178657619968,0,1,0,0,1
808311767042494464,0,1,0,0,1
808334337343193088,0,1,0,0,1
808344172382089216,0,1,0,0,1
808411840590086144,0,1,0,0,1
808419700787056640,0,1,0,0,1
808440829446647808,0,1,0,0,1
808458568328511488,0,1,0,0,1
808562870384529408,0,1,0,0,1
808582716098744320,0,0,1,0,1
808591257073287168,0,1,0,0,1
808602735255896064,0,1,0,0,1
808611375635374080,0,1,0,0,1
808638747059359744,0,1,0,0,1
808687808407814144,0,1,0,0,1
808705838332383232,0,1,0,0,1
808303504775348224,0,1,0,0,1
808276771300843520,0,1,0,0,1
807371516564434944,0,1,0,0,1
808241729115660288,0,1,0,0,1
807538821743214592,0,1,0,0,1
807569151518711808,0,0,0,1,1
807574681175937024,0,1,0,0,1
807625254172405760,0,1,0,0,1
807640520646217728,0,1,0,0,1
807670516114919424,0,1,0,0,1
807672187243130880,0,1,0,0,1
807685182664876032,0,1,0,0,1
807808518006992896,0,1,0,0,1
807810626307457024,0,1,0,0,1
807891737179865088,0,1,0,0,1
807909098641616896,0,1,0,0,1
807916806669111296,0,1,0,0,1
807984328869347328,0,1,0,0,1
808102174085369856,0,1,0,0,1
808714123995291648,0,1,0,0,1
808765408312459264,0,1,0,0,1
808780692922318848,0,1,0,0,1
808891499547136000,0,1,0,0,1
809984133472677888,0,1,0,0,1
809991150098644992,1,0,0,0,1
810049372624801792,0,1,0,0,1
810140839729098752,0,1,0,0,1
810182471560077312,0,1,0,0,1
810237957923696640,0,1,0,0,1
810352215340777472,0,1,0,0,1
810373008602763264,0,1,0,0,1
810457631131217920,0,1,0,0,1
810477997794983936,0,1,0,0,1
810599833882890240,0,1,0,0,1
810633926880411648,0,1,0,0,1
810679717670088704,0,1,0,0,1
810732713581879296,0,1,0,0,1
810815407116283904,0,1,0,0,1
809895142681440256,0,1,0,0,1
809894451632078848,0,0,1,0,1
809837603008774144,0,1,0,0,1
809164701116596224,0,1,0,0,1
808964495926296576,0,1,0,0,1
808973554456858624,0,1,0,0,1
809004555769933824,0,1,0,0,1
809028372848328704,0,1,0,0,1
809100382693720064,0,1,0,0,1
809126965038882816,0,1,0,0,1
809167492836917248,0,1,0,0,1
809790067602554880,0,1,0,0,1
809270830123225088,1,0,0,0,1
809274587426996224,0,1,0,0,1
809346247278690304,0,1,0,0,1
809407569584209920,1,0,0,0,1
809416736558575616,1,0,0,0,1
809457976817881088,0,1,0,0,1
807382749787160576,0,1,0,0,1
807354317334138880,0,1,0,0,1
804265138589200384,0,1,0,0,1
804963272772517888,0,1,0,0,1
805025780967374848,0,1,0,0,1
805067789258072064,0,1,0,0,1
805074154521317376,0,1,0,0,1
805087947892604928,0,0,0,1,1
805135601112596480,0,1,0,0,1
805230534112575488,1,0,0,0,1
805257917012316160,1,0,0,0,1
805403040115294208,0,1,0,0,1
805410665804402688,0,1,0,0,1
805417547659087872,0,1,0,0,1
805455527417413632,0,1,0,0,1
805481073828315136,0,1,0,0,1
805498327055945728,0,1,0,0,1
805528077753286656,0,1,0,0,1
805673867649941504,0,1,0,0,1
804988959436767232,0,1,0,0,1
804895043546910720,0,1,0,0,1
807321533110685696,0,1,0,0,1
804877723428483072,0,1,0,0,1
804267526771376128,0,1,0,0,1
804295050028945408,1,0,0,0,1
804305864848908288,1,0,0,0,1
804317119794057216,0,1,0,0,1
804367560040972288,0,1,0,0,1
804387211173068800,1,0,0,0,1
804390753631801344,0,1,0,0,1
804398836936507392,0,1,0,0,1
804472528936824832,0,1,0,0,1
804516838608633856,0,1,0,0,1
804624863046541312,0,0,0,1,1
804689594876760064,0,1,0,0,1
804725665257943040,0,1,0,0,1
804729704909598720,0,1,0,0,1
804734928235556864,0,1,0,0,1
805685321333608448,1,0,0,0,1
805707602889842688,0,0,1,0,1
805730933621960704,0,1,0,0,1
805749780098023424,0,1,0,0,1
806607788772360192,0,1,0,0,1
806626072410390528,0,1,0,0,1
806710982487789568,0,1,0,0,1
806726020388659200,1,0,0,0,1
806741938007220224,0,1,0,0,1
806759410005487616,0,1,0,0,1
806916841679585280,0,1,0,0,1
807064854871863296,0,1,0,0,1
807069114044846080,1,0,0,0,1
807109720548982784,0,1,0,0,1
807146470289895424,0,1,0,0,1
807171252372680704,0,1,0,0,1
807273906918699008,1,0,0,0,1
807295569223938048,0,1,0,0,1
807300587469479936,0,1,0,0,1
806595464841854976,0,1,0,0,1
806578424529768448,0,1,0,0,1
806428624849092608,0,1,0,0,1
805982513109680128,1,0,0,0,1
805753199059750912,0,1,0,0,1
805753447295422464,0,1,0,0,1
805769657256792064,0,1,0,0,1
805773140236210176,0,1,0,0,1
805794367629828096,0,1,0,0,1
805837025723187200,0,1,0,0,1
806024298741846016,0,1,0,0,1
806421535913295872,0,0,0,1,1
806094846570201088,0,1,0,0,1
806099656304455680,0,1,0,0,1
806168823728586752,0,1,0,0,1
806268226246217728,0,1,0,0,1
806305558013689856,0,1,0,0,1
806392336657874944,0,1,0,0,1
938783033259380736,0,1,0,0,1
1106253806604558336,0,1,0,0,1
938866546675511296,0,0,1,0,1
1298518145808969728,0,1,0,0,1
1295969864260046848,1,0,0,0,1
1296010411645571072,0,1,0,0,1
1296012680562708480,0,1,0,0,1
1296100321941364736,0,1,0,0,1
1296103998643027968,0,1,0,0,1
1296152035398754304,0,1,0,0,1
1296179772163346432,0,1,0,0,1
1296241129663455232,1,0,0,0,1
1296281398349791232,0,1,0,0,1
1296316269914755072,0,1,0,0,1
1296331699261972480,0,1,0,0,1
1296393149942771712,0,1,0,0,1
1296431236487970816,0,1,0,0,1
1296460103973994496,0,1,0,0,1
1296528084875780096,0,1,0,0,1
1296595654903504896,0,1,0,0,1
1296617482438864896,0,1,0,0,1
1296693009212473344,0,1,0,0,1
1296698166276845568,0,1,0,0,1
1296700545013604352,0,1,0,0,1
1296709123665350656,0,1,0,0,1
1295945679647453184,0,1,0,0,1
1295885146067853312,0,1,0,0,1
1295811578512551936,0,1,0,0,1
1295377136497254400,0,1,0,0,1
1295149054066794496,0,1,0,0,1
1295215468421115904,0,0,0,1,1
1295227334061105152,0,1,0,0,1
1295232090393309184,0,1,0,0,1
1295272553825497088,1,0,0,0,1
1295310307045253120,0,1,0,0,1
1295328269793927168,0,1,0,0,1
1295348754233475072,0,1,0,0,1
1295374795421278208,0,1,0,0,1
1295409219345293312,0,1,0,0,1
1295794067176071168,0,1,0,0,1
1295436499815735296,0,1,0,0,1
1295439272137207808,0,1,0,0,1
1295496125496152064,0,1,0,0,1
1295501941515137024,0,1,0,0,1
1295570165644562432,1,0,0,0,1
1295590729570496512,0,1,0,0,1
1295597385981341696,0,1,0,0,1
1295698683372150784,1,0,0,0,1
1295699934952513536,0,1,0,0,1
1296710362046357504,0,1,0,0,1
1296723139309604864,1,0,0,0,1
1296738096789192704,0,1,0,0,1
1298166344110813184,0,1,0,0,1
1297610599984181248,0,1,0,0,1
1297628086633209856,0,1,0,0,1
1297816200936853504,0,1,0,0,1
1297854326287863808,0,1,0,0,1
1297950735015936000,0,1,0,0,1
1297982912206270464,1,0,0,0,1
1297991979372933120,0,1,0,0,1
1298052780762963968,0,1,0,0,1
1298075014097301504,1,0,0,0,1
1298178034705600512,0,1,0,0,1
1297591124803149824,0,1,0,0,1
1298190064476979200,0,1,0,0,1
1298215958742360064,1,0,0,0,1
1298220356768063488,0,1,0,0,1
1298272530235498496,0,1,0,0,1
1298282927067987968,1,0,0,0,1
1298294400326356992,1,0,0,0,1
1298319825983471616,0,1,0,0,1
1298331410319564800,0,1,0,0,1
1298454299782066176,0,1,0,0,1
1297598680371990528,1,0,0,0,1
1297583550636519424,0,1,0,0,1
1296745095996219392,0,1,0,0,1
1297205350240747520,0,1,0,0,1
1296775380456497152,0,1,0,0,1
1296815521527078912,0,1,0,0,1
1296874985882034176,0,1,0,0,1
1296896041460076544,0,1,0,0,1
1296939216186699776,0,1,0,0,1
1297077615849697280,0,1,0,0,1
1297095789747961856,1,0,0,0,1
1297141559037657088,0,1,0,0,1
1297189993589411840,0,1,0,0,1
1297209394573316096,0,1,0,0,1
1297498629813309440,0,1,0,0,1
1297213131698180096,1,0,0,0,1
1297258127524425728,0,1,0,0,1
1297277238748909568,0,1,0,0,1
1297329126886449152,0,1,0,0,1
1297356357952126976,0,1,0,0,1
1297400869617631232,0,1,0,0,1
1297413985067610112,0,1,0,0,1
1297457829658284032,0,1,0,0,1
1297464842287226880,0,1,0,0,1
1295125417867784192,0,1,0,0,1
1295014969851785216,0,1,0,0,1
1295002885458034688,1,0,0,0,1
1292822189176057856,0,1,0,0,1
1292463168166526976,0,1,0,0,1
1292467347299667968,1,0,0,0,1
1292549206163574784,0,1,0,0,1
1292599834096984064,0,1,0,0,1
1292681963715719168,0,1,0,0,1
1292689602172424192,0,1,0,0,1
1292736193000624128,0,1,0,0,1
1292744220256530432,1,0,0,0,1
1292780086421123072,0,1,0,0,1
1292839252431011840,0,1,0,0,1
1292456486594125824,0,1,0,0,1
1292993225209212928,1,0,0,0,1
1293007002403102720,0,1,0,0,1
1293044807565287424,0,1,0,0,1
1293122947406757888,0,1,0,0,1
1293126601442394112,0,0,0,1,1
1293168723671633920,1,0,0,0,1
1293203328919195648,1,0,0,0,1
1293237804667768832,0,1,0,0,1
1293253245033500672,0,1,0,0,1
1292457873356685312,0,1,0,0,1
1292413059756101632,0,1,0,0,1
1293328449390747648,0,1,0,0,1
1292064693419298816,0,1,0,0,1
1291618528869720064,0,1,0,0,1
1291622677711597568,0,1,0,0,1
1291641893495828480,0,0,0,1,1
1291651128065654784,1,0,0,0,1
1291746782725042176,0,1,0,0,1
1291776157361160192,1,0,0,0,1
1291953205639811072,0,1,0,0,1
1291977211084304384,1,0,0,0,1
1291995892594032640,1,0,0,0,1
1292067998061207552,0,1,0,0,1
1292406403899035648,0,1,0,0,1
1292077497950117888,0,1,0,0,1
1292082181012152320,0,1,0,0,1
1292144106471215104,0,1,0,0,1
1292176062886092800,0,1,0,0,1
1292226946768596992,0,1,0,0,1
1292268003267088384,0,0,0,1,1
1292365710266638336,1,0,0,0,1
1292368106766163968,0,1,0,0,1
1292372476068941824,1,0,0,0,1
1293292497083469824,0,1,0,0,1
1293331520816644096,0,1,0,0,1
1294976102713004032,0,1,0,0,1
1294590221619802112,0,1,0,0,1
1294246375417405440,0,1,0,0,1
1294299828105515008,0,1,0,0,1
1294304623747112960,1,0,0,0,1
1294337714913857536,0,1,0,0,1
1294396736958418944,0,1,0,0,1
1294464161112567808,1,0,0,0,1
1294507803848171520,0,1,0,0,1
1294533420807151616,0,1,0,0,1
1294590118028812288,0,1,0,0,1
1294612253472247808,0,1,0,0,1
1294179104443576320,0,1,0,0,1
1294612605294841856,0,1,0,0,1
1294654022813659136,0,1,0,0,1
1294770402858762240,0,1,0,0,1
1294888674589577216,1,0,0,0,1
1294891098482106368,0,1,0,0,1
1294922069176725504,0,1,0,0,1
1294933483937312768,0,1,0,0,1
1294956797070118912,0,1,0,0,1
1294964662069604352,0,1,0,0,1
1294213940457734144,1,0,0,0,1
1294172496770535424,0,1,0,0,1
1293385252828839936,1,0,0,0,1
1293571093349851136,0,0,1,0,1
1293417020382478336,0,1,0,0,1
1293434362491318272,0,1,0,0,1
1293454954200522752,1,0,0,0,1
1293457231862812672,0,1,0,0,1
1293480145643352064,0,1,0,0,1
1293502404940320768,1,0,0,0,1
1293506131764142080,0,1,0,0,1
1293537937456594944,0,1,0,0,1
1293539912906670080,0,1,0,0,1
1293596927011905536,0,1,0,0,1
1294009113597431808,0,1,0,0,1
1293606053532151808,1,0,0,0,1
1293757447111204864,0,1,0,0,1
1293802455042527232,1,0,0,0,1
1293857693648556032,0,1,0,0,1
1293886829280681984,1,0,0,0,1
1293960758351597568,0,1,0,0,1
1293962706920316928,0,1,0,0,1
1293977451886866432,0,1,0,0,1
1294003481330688000,0,1,0,0,1
1298508129588506624,0,1,0,0,1
1298552503919718400,0,1,0,0,1
1291615841964810240,0,1,0,0,1
1298555580609703936,0,1,0,0,1
1303299041602621440,1,0,0,0,1
1303316524644462592,0,1,0,0,1
1303423799195504640,0,1,0,0,1
1303523197837627392,1,0,0,0,1
1303583305053294592,0,1,0,0,1
1303591015132139520,0,1,0,0,1
1303600541860151296,0,1,0,0,1
1303619864263905280,0,1,0,0,1
1303638017983180800,0,1,0,0,1
1303639271929032704,0,1,0,0,1
1303642760386236416,1,0,0,0,1
1303667510194180096,0,0,0,1,1
1303711261499076608,0,1,0,0,1
1303752104197189632,1,0,0,0,1
1303761477111869440,0,1,0,0,1
1303767409782788096,0,1,0,0,1
1303772035437309952,1,0,0,0,1
1303772194342756352,0,0,0,1,1
1303785262422593536,0,1,0,0,1
1303797928549593088,1,0,0,0,1
1303861291304529920,0,1,0,0,1
1303286460200693760,0,1,0,0,1
1303225162951655424,0,1,0,0,1
1303156229422952448,0,1,0,0,1
1302616789348691968,0,1,0,0,1
1302190221631655936,0,1,0,0,1
1302240768959152128,0,1,0,0,1
1302267692540256256,0,1,0,0,1
1302300711724613632,0,1,0,0,1
1302483531885666304,0,1,0,0,1
1302491169285267456,0,1,0,0,1
1302513545225973760,0,1,0,0,1
1302557007883296768,0,0,0,1,1
1302580416851959808,0,1,0,0,1
1302684750801334272,0,1,0,0,1
1303140940102512640,0,1,0,0,1
1302879770267525120,1,0,0,0,1
1302882406798635008,0,1,0,0,1
1302941553477005312,0,1,0,0,1
1302952005158285312,0,1,0,0,1
1302967232239202304,0,1,0,0,1
1303037551289102336,1,0,0,0,1
1303108366017806336,0,0,0,1,1
1303118893419048960,0,1,0,0,1
1303131738416144384,0,1,0,0,1
1303887509407948800,0,1,0,0,1
1303909443533377536,0,1,0,0,1
1303921135491268608,1,0,0,0,1
1304944506568085504,1,0,0,0,1
1304655505177161728,1,0,0,0,1
1304657932047409152,0,1,0,0,1
1304713483578208256,0,1,0,0,1
1304774638375821312,1,0,0,0,1
1304779951267291136,0,1,0,0,1
1304784687144095744,0,1,0,0,1
1304811940984782848,0,1,0,0,1
1304865759798145024,0,1,0,0,1
1304866124903985152,0,1,0,0,1
1304982298912346112,0,0,0,1,1
1304540369246445568,1,0,0,0,1
1305039851314700288,0,1,0,0,1
1305058906683531264,0,1,0,0,1
1305157869612998656,0,1,0,0,1
1305174493334306816,0,1,0,0,1
1305211168160710656,0,1,0,0,1
1305226390191697920,0,1,0,0,1
1305261605639188480,0,0,0,1,1
1305287697796300800,1,0,0,0,1
1305436519155429376,0,1,0,0,1
1304646562325254144,1,0,0,0,1
1304488616266145792,0,1,0,0,1
1303926387036872704,0,1,0,0,1
1304069457426309120,0,1,0,0,1
1303936320352350208,1,0,0,0,1
1303966745628217344,1,0,0,0,1
1303976064817852416,0,1,0,0,1
1303983689106206720,0,1,0,0,1
1303986253856223232,1,0,0,0,1
1304016833503256576,0,1,0,0,1
1304028777152995328,0,0,1,0,1
1304046069513424896,0,0,0,1,1
1304060281304371200,0,1,0,0,1
1304081395304726528,0,1,0,0,1
1304463781075054592,0,1,0,0,1
1304092028498837504,1,0,0,0,1
1304199488014180352,1,0,0,0,1
1304261888130215936,0,1,0,0,1
1304344292543078400,1,0,0,0,1
1304346673414455296,1,0,0,0,1
1304352747257462784,0,1,0,0,1
1304384124707155968,1,0,0,0,1
1304400104472879104,1,0,0,0,1
1304439914667311104,0,1,0,0,1
1302179469269049344,0,1,0,0,1
1302176429426315264,0,1,0,0,1
1302149514195881984,0,1,0,0,1
1300003359596916736,0,1,0,0,1
1299612669377499136,0,0,1,0,1
1299650943185715200,0,1,0,0,1
1299680278449926144,0,1,0,0,1
1299686147178795008,0,1,0,0,1
1299695421267288064,0,1,0,0,1
1299724483113168896,0,1,0,0,1
1299787304613994496,0,1,0,0,1
1299957432794271744,0,1,0,0,1
1299969051590975488,0,1,0,0,1
1300015518301057024,0,1,0,0,1
1299543082405228544,0,1,0,0,1
1300118039644368896,0,1,0,0,1
1300175044597882880,0,0,0,1,1
1300194600603332608,1,0,0,0,1
1300196564317728768,0,0,0,1,1
1300262675939823616,0,1,0,0,1
1300350694004850688,1,0,0,0,1
1300386813790441472,0,1,0,0,1
1300390817656381440,1,0,0,0,1
1300410351612317696,0,1,0,0,1
1299579688809951232,0,1,0,0,1
1299471372113137664,0,1,0,0,1
1300477019453452288,0,1,0,0,1
1298953953812586496,0,1,0,0,1
1298563710689005568,1,0,0,0,1
1298605805579771904,0,1,0,0,1
1298617807761022976,0,1,0,0,1
1298621341973786624,1,0,0,0,1
1298625690091192320,1,0,0,0,1
1298689046890209280,1,0,0,0,1
1298790500225503232,0,1,0,0,1
1298835703393136640,0,1,0,0,1
1298901805204533248,0,1,0,0,1
1298965595472506880,0,0,1,0,1
1299417848859815936,0,1,0,0,1
1298984580611862528,0,0,1,0,1
1298987486471843840,0,1,0,0,1
1299012035372552192,0,1,0,0,1
1299150046429093888,0,1,0,0,1
1299181809536831488,0,1,0,0,1
1299192547345010688,0,1,0,0,1
1299235322539114496,0,1,0,0,1
1299270125896396800,0,1,0,0,1
1299318392441114624,0,1,0,0,1
1300457504292270080,0,1,0,0,1
1300479806853787648,0,1,0,0,1
1302143783560253440,0,1,0,0,1
1301497035896565760,0,1,0,0,1
1301221068884135936,0,1,0,0,1
1301223370403590144,0,0,1,0,1
1301234702708281344,1,0,0,0,1
1301300109498609664,0,1,0,0,1
1301313984994439168,0,1,0,0,1
1301324393700880384,0,1,0,0,1
1301348369999167488,0,1,0,0,1
1301431687528710144,0,1,0,0,1
1301494612851412992,0,1,0,0,1
1301511406727159808,0,1,0,0,1
1301200979572985856,0,1,0,0,1
1301558331648151552,0,1,0,0,1
1301568810172907520,1,0,0,0,1
1301590679496269824,0,1,0,0,1
1301651633168773120,0,1,0,0,1
1301843331316477952,1,0,0,0,1
1301855796767072256,0,1,0,0,1
1302000955353894912,0,1,0,0,1
1302122342068285440,0,1,0,0,1
1302126301248094208,0,1,0,0,1
1301218417056251904,1,0,0,0,1
1301162181065498624,0,1,0,0,1
1300519800964345856,0,1,0,0,1
1300988274060664832,0,1,0,0,1
1300535739306905600,0,1,0,0,1
1300618431784312832,1,0,0,0,1
1300665737917333504,1,0,0,0,1
1300744654812360704,0,1,0,0,1
1300782218323857408,1,0,0,0,1
1300795924244033536,0,0,0,1,1
1300804594457481216,0,1,0,0,1
1300841461244715008,1,0,0,0,1
1300969128895942656,0,1,0,0,1
1300997994603360256,0,1,0,0,1
1301137357467529216,0,1,0,0,1
1301003023984934912,0,1,0,0,1
1301006800347561984,0,1,0,0,1
1301030370394152960,1,0,0,0,1
1301034764422447104,1,0,0,0,1
1301049421405122560,1,0,0,0,1
1301096764779499520,0,1,0,0,1
1301100916918161408,0,0,0,1,1
1301122461715628032,0,1,0,0,1
1301132639043088384,0,1,0,0,1
1291617960189210624,0,1,0,0,1
1291392285452771328,0,1,0,0,1
1333373035995422720,0,1,0,0,1
1284342167293644800,0,1,0,0,1
1281895439357423616,1,0,0,0,1
1281929655470010368,0,0,1,0,1
1281943563987832832,0,1,0,0,1
1281952143168200704,0,1,0,0,1
1281957880740999168,0,1,0,0,1
1281958322393026560,0,1,0,0,1
1281977295016570880,0,1,0,0,1
1281991543356829696,0,1,0,0,1
1281998867433689088,0,1,0,0,1
1282026374723629056,0,1,0,0,1
1282042834380611584,0,1,0,0,1
1282075715131891712,0,1,0,0,1
1282178903226736640,0,1,0,0,1
1282273011383574528,0,1,0,0,1
1282273448878698496,0,1,0,0,1
1282283126186668032,1,0,0,0,1
1282287321031770112,0,1,0,0,1
1282308304559943680,0,1,0,0,1
1282310396980989952,0,1,0,0,1
1282311240715468800,0,1,0,0,1
1282314859183562752,0,0,0,1,1
1281832873834635264,1,0,0,0,1
1281767876702154752,0,1,0,0,1
1281739134537736192,1,0,0,0,1
1281397286577287168,0,1,0,0,1
1281142121110671360,0,1,0,0,1
1281162250250784768,0,1,0,0,1
1281185327655325696,0,1,0,0,1
1281199976534728704,0,1,0,0,1
1281260419793989632,1,0,0,0,1
1281315000255201280,0,1,0,0,1
1281334439025553408,0,1,0,0,1
1281375819936313344,0,1,0,0,1
1281384208997523456,0,1,0,0,1
1281415204358807552,0,0,0,1,1
1281678196363210752,0,1,0,0,1
1281436568582946816,0,1,0,0,1
1281510966459379712,0,1,0,0,1
1281526645409677312,0,1,0,0,1
1281559836363231232,1,0,0,0,1
1281584149426364416,1,0,0,0,1
1281610489177370624,0,1,0,0,1
1281613154716352512,0,1,0,0,1
1281618964175638528,0,1,0,0,1
1281623608905760768,0,1,0,0,1
1282317388868968448,0,1,0,0,1
1282324596973166592,0,1,0,0,1
1282450227316903936,0,1,0,0,1
1283690351530844160,0,1,0,0,1
1283321629142126592,1,0,0,0,1
1283331415833145344,0,1,0,0,1
1283333167676444672,1,0,0,0,1
1283380088847900672,1,0,0,0,1
1283466776181747712,0,1,0,0,1
1283475785131741184,1,0,0,0,1
1283609338246909952,0,1,0,0,1
1283618877423841280,0,1,0,0,1
1283646071726628864,0,1,0,0,1
1283693959030747136,1,0,0,0,1
1283304575508844544,0,1,0,0,1
1283700627382706176,0,1,0,0,1
1283740699490504704,1,0,0,0,1
1283799436540260352,0,1,0,0,1
1283803271996432384,0,1,0,0,1
1283892526907260928,0,1,0,0,1
1283895155515428864,0,1,0,0,1
1284058343368126464,1,0,0,0,1
1284140387049693184,1,0,0,0,1
1284193720871550976,0,1,0,0,1
1283320538576883712,0,1,0,0,1
1283293201437097984,0,1,0,0,1
1282456865637634048,1,0,0,0,1
1282949901572161536,1,0,0,0,1
1282526759812911104,0,1,0,0,1
1282558131143348224,0,1,0,0,1
1282598191595167744,0,1,0,0,1
1282601155990700032,0,1,0,0,1
1282602896463282176,0,1,0,0,1
1282616558615965696,1,0,0,0,1
1282682661081952256,0,1,0,0,1
1282704889173303296,0,1,0,0,1
1282876093503025152,0,1,0,0,1
1282952226273558528,0,0,0,1,1
1283271896109219840,0,1,0,0,1
1282955243312091136,1,0,0,0,1
1283002620563591168,0,1,0,0,1
1283030887458680832,1,0,0,0,1
1283035200721690624,0,0,0,1,1
1283104510425128960,0,1,0,0,1
1283119874060038144,0,1,0,0,1
1283126493724336128,0,1,0,0,1
1283225712548347904,1,0,0,0,1
1283242176667889664,0,1,0,0,1
1281138650055573504,1,0,0,0,1
1281131413727657984,1,0,0,0,1
1281079509324685312,0,1,0,0,1
1278241757336084480,1,0,0,0,1
1277716670153322496,0,1,0,0,1
1277792472920293376,0,1,0,0,1
1277850423966261248,0,1,0,0,1
1277929471538954240,0,1,0,0,1
1278007217518567424,0,1,0,0,1
1278084774507229184,0,1,0,0,1
1278119296963620864,1,0,0,0,1
1278184395229163520,1,0,0,0,1
1278236890727145472,0,1,0,0,1
1278284779738198016,1,0,0,0,1
1277668129804627968,0,0,0,1,1
1278285100531060736,1,0,0,0,1
1278368104431616000,0,1,0,0,1
1278433511305854976,0,1,0,0,1
1278433678532718592,0,1,0,0,1
1278481715413938176,0,1,0,0,1
1278590518809763840,0,1,0,0,1
1278630817619513344,0,1,0,0,1
1278635208510590976,1,0,0,0,1
1278871702605148160,0,1,0,0,1
1277696906328670208,0,1,0,0,1
1277663041551773696,0,1,0,0,1
1278988884404318208,0,1,0,0,1
1276977815485808640,0,1,0,0,1
1276824291745697792,0,1,0,0,1
1276833180566331392,0,1,0,0,1
1276836760157216768,0,1,0,0,1
1276846666407014400,0,1,0,0,1
1276847208755683328,1,0,0,0,1
1276912674140553216,1,0,0,0,1
1276954447948550144,0,1,0,0,1
1276959446481219584,0,1,0,0,1
1276970535331811328,0,1,0,0,1
1277058572979892224,0,1,0,0,1
1277614773774016512,0,1,0,0,1
1277083073893421056,0,1,0,0,1
1277112297098375168,0,1,0,0,1
1277176749101666304,0,1,0,0,1
1277203674851184640,1,0,0,0,1
1277278194614370304,0,1,0,0,1
1277297481982922752,0,1,0,0,1
1277409770979418112,0,1,0,0,1
1277485525339906048,0,1,0,0,1
1277535309974999040,0,1,0,0,1
1278878627438919680,1,0,0,0,1
1279004148772397056,1,0,0,0,1
1281064499680669696,0,0,1,0,1
1280511734311276544,0,1,0,0,1
1280158137773813760,0,1,0,0,1
1280191259391537152,0,1,0,0,1
1280199241298620416,0,0,1,0,1
1280221153450213376,0,1,0,0,1
1280238164473495552,0,1,0,0,1
1280339629493772288,0,1,0,0,1
1280370321544052736,0,1,0,0,1
1280394105428881408,1,0,0,0,1
1280441598388535296,0,1,0,0,1
1280558788001402880,0,1,0,0,1
1279883423243481088,0,1,0,0,1
1280626292019339264,1,0,0,0,1
1280628458331275264,0,0,0,1,1
1280666005568659456,0,1,0,0,1
1280725646323441664,1,0,0,0,1
1280743153763364864,0,1,0,0,1
1280752390401142784,0,1,0,0,1
1280765956462047232,0,1,0,0,1
1280785810325778432,0,1,0,0,1
1280926284051353600,0,1,0,0,1
1280124090729275392,0,1,0,0,1
1279828474430058496,0,1,0,0,1
1279024951949881344,0,1,0,0,1
1279454209419677696,0,1,0,0,1
1279152061477576704,0,1,0,0,1
1279157638366928896,0,1,0,0,1
1279185568841314304,0,1,0,0,1
1279252968622010368,1,0,0,0,1
1279259181548068864,0,1,0,0,1
1279342840137551872,0,1,0,0,1
1279420489560018944,1,0,0,0,1
1279423894751858688,0,1,0,0,1
1279427946344841216,0,1,0,0,1
1279484093076516864,0,1,0,0,1
1279739073817571328,0,1,0,0,1
1279500581606797312,0,1,0,0,1
1279501242448764928,0,1,0,0,1
1279544562042703872,0,1,0,0,1
1279567555808681984,0,1,0,0,1
1279604716595408896,0,0,0,1,1
1279643972839718912,0,1,0,0,1
1279651897562054656,0,1,0,0,1
1279668919993683968,1,0,0,0,1
1279676070049058816,1,0,0,0,1
1284270319415558144,1,0,0,0,1
1284421550528225280,0,1,0,0,1
1291373946806378496,0,1,0,0,1
1284429126154231808,0,1,0,0,1
1288915358452195328,0,1,0,0,1
1288919867056369664,0,1,0,0,1
1288951581979938816,0,1,0,0,1
1288981356014374912,0,0,1,0,1
1289040492433375232,0,1,0,0,1
1289099207257726976,0,1,0,0,1
1289143140071419904,0,1,0,0,1
1289230609471217664,0,1,0,0,1
1289251418344497152,0,1,0,0,1
1289271207624417280,0,1,0,0,1
1289427809790603264,0,1,0,0,1
1289446281237139456,1,0,0,0,1
1289538468528480256,0,1,0,0,1
1289574399046230016,0,1,0,0,1
1289586315219087360,0,1,0,0,1
1289643219597299712,0,1,0,0,1
1289653274317119488,0,1,0,0,1
1289673753643765760,0,1,0,0,1
1289710541695602688,0,1,0,0,1
1289721767263703040,1,0,0,0,1
1289746940775800832,1,0,0,0,1
1288900436628471808,0,1,0,0,1
1288861736527974400,0,1,0,0,1
1288861558320201728,0,0,0,1,1
1288329283111276544,0,1,0,0,1
1288160517169659904,0,1,0,0,1
1288161378109333504,0,1,0,0,1
1288175613161938944,0,0,1,0,1
1288248315222646784,0,1,0,0,1
1288283588694364160,0,1,0,0,1
1288300188222631936,0,1,0,0,1
1288310890777829376,1,0,0,0,1
1288315227239399424,1,0,0,0,1
1288316024773906432,0,1,0,0,1
1288346489283117056,1,0,0,0,1
1288855262569226240,1,0,0,0,1
1288389494165712896,0,1,0,0,1
1288392154310750208,0,1,0,0,1
1288462188013912064,0,1,0,0,1
1288483182933934080,0,1,0,0,1
1288490772002611200,0,1,0,0,1
1288646108642594816,1,0,0,0,1
1288702397242413056,0,1,0,0,1
1288712353597595648,0,1,0,0,1
1288818769570275328,0,1,0,0,1
1289753108432609280,1,0,0,0,1
1289786637002579968,0,1,0,0,1
1289794037075963904,1,0,0,0,1
1290906057380966400,1,0,0,0,1
1290697110329782272,0,1,0,0,1
1290713814158069760,0,1,0,0,1
1290718006230708224,0,0,0,1,1
1290727783555948544,0,1,0,0,1
1290731038545784832,0,1,0,0,1
1290731626796744704,0,1,0,0,1
1290836274543079424,1,0,0,0,1
1290854067913101312,0,1,0,0,1
1290905519197224960,0,1,0,0,1
1290912266846720000,1,0,0,0,1
1290645245894381568,0,1,0,0,1
1290973290488451072,0,1,0,0,1
1291012550507757568,0,1,0,0,1
1291056520847908864,0,1,0,0,1
1291066914454802432,1,0,0,0,1
1291103298506776576,1,0,0,0,1
1291268995371413504,0,1,0,0,1
1291287672909111296,0,1,0,0,1
1291327665748750336,0,1,0,0,1
1291373472489385984,0,1,0,0,1
1290659205792387072,0,1,0,0,1
1290619127783215104,0,1,0,0,1
1289806542976495616,0,1,0,0,1
1290248590565220352,0,1,0,0,1
1289814148612788224,0,1,0,0,1
1289829683358384128,0,1,0,0,1
1289829741243985920,0,1,0,0,1
1289850274719444992,0,1,0,0,1
1289856238281535488,0,1,0,0,1
1290007408798863360,0,1,0,0,1
1290014873309663232,1,0,0,0,1
1290205854235492352,0,1,0,0,1
1290209176057049088,0,1,0,0,1
1290287948399697920,0,1,0,0,1
1290582058444697600,1,0,0,0,1
1290296931806314496,1,0,0,0,1
1290297899058954240,0,1,0,0,1
1290305324528750592,0,0,0,1,1
1290311609529724928,0,0,0,1,1
1290413561332654080,0,1,0,0,1
1290474657603366912,0,1,0,0,1
1290494474368376832,1,0,0,0,1
1290519186024927232,0,1,0,0,1
1290552055216603136,0,1,0,0,1
1288157918995591168,1,0,0,0,1
1288085083451199488,0,1,0,0,1
1288080590634274816,0,1,0,0,1
1285536339664998400,0,1,0,0,1
1285310787527962624,0,1,0,0,1
1285356488299474944,0,1,0,0,1
1285380269558517760,0,1,0,0,1
1285411914856779776,0,1,0,0,1
1285438268117483520,0,1,0,0,1
1285438843399868416,0,1,0,0,1
1285462126660706304,0,1,0,0,1
1285506607527235584,0,1,0,0,1
1285526878892126208,0,1,0,0,1
1285575950336274432,0,1,0,0,1
1285295149082447872,0,1,0,0,1
1285608444595068928,0,0,0,1,1
1285636191086411776,0,1,0,0,1
1285654291248820224,0,1,0,0,1
1285708648090566656,0,1,0,0,1
1285856139419086848,1,0,0,0,1
1285862711029637120,0,1,0,0,1
1285864082181103616,1,0,0,0,1
1285866977693700096,0,1,0,0,1
1285897459064020992,0,1,0,0,1
1285302200923635712,0,1,0,0,1
1285281508866097152,0,1,0,0,1
1285961387957616640,0,1,0,0,1
1284867377734266880,0,1,0,0,1
1284495324170649600,0,0,1,0,1
1284504188261736448,0,1,0,0,1
1284534782806814720,1,0,0,0,1
1284584639420600320,0,1,0,0,1
1284630457355837440,0,1,0,0,1
1284649277352902656,0,0,1,0,1
1284744005532545024,0,1,0,0,1
1284754071426039808,0,1,0,0,1
1284809969854971904,0,1,0,0,1
1284972806338379776,0,1,0,0,1
1285251727340589056,0,1,0,0,1
1284999723196338176,0,1,0,0,1
1285025065197867008,0,1,0,0,1
1285073053932597248,0,1,0,0,1
1285115505758531584,1,0,0,0,1
1285132818046226432,1,0,0,0,1
1285138700427382784,0,1,0,0,1
1285141474615586816,0,1,0,0,1
1285205716106727424,0,1,0,0,1
1285209760917266432,0,1,0,0,1
1285947260086308864,0,1,0,0,1
1285986754697113600,0,1,0,0,1
1288023403308421120,0,1,0,0,1
1287302886309888000,0,1,0,0,1
1286979119331319808,0,1,0,0,1
1287004798840180736,0,1,0,0,1
1287031840876851200,0,1,0,0,1
1287051971824943104,0,1,0,0,1
1287054713825845248,0,1,0,0,1
1287093956677980160,0,1,0,0,1
1287104039617024000,0,1,0,0,1
1287166866952085504,0,1,0,0,1
1287266229426614272,0,1,0,0,1
1287338380318081024,0,0,0,1,1
1286961645680435200,0,0,0,1,1
1287339992835072000,0,1,0,0,1
1287409900574986240,0,1,0,0,1
1287456596671561728,0,1,0,0,1
1287546127869501440,1,0,0,0,1
1287588488041377792,0,1,0,0,1
1287780462564462592,0,0,0,1,1
1287815956270637056,1,0,0,0,1
1287913975905234944,0,1,0,0,1
1288007272606597120,0,1,0,0,1
1286971769044099072,0,1,0,0,1
1286942423277477888,1,0,0,0,1
1285986996733779968,1,0,0,0,1
1286247063231987712,0,1,0,0,1
1285990519923933184,0,0,0,1,1
1286024670358233088,0,1,0,0,1
1286062745889067008,0,1,0,0,1
1286080961168445440,0,1,0,0,1
1286101558170734592,0,1,0,0,1
1286144724492066816,1,0,0,0,1
1286150696820236288,0,1,0,0,1
1286183232346742784,0,1,0,0,1
1286190258334445568,0,1,0,0,1
1286325675813564416,0,1,0,0,1
1286921821015683072,0,1,0,0,1
1286437427989614592,0,1,0,0,1
1286457924374499328,0,1,0,0,1
1286489765202690048,0,1,0,0,1
1286514348324782080,0,0,1,0,1
1286582174318116864,0,1,0,0,1
1286707472099500032,0,0,1,0,1
1286786306241179648,1,0,0,0,1
1286831745757614080,1,0,0,0,1
1286845337706143744,0,1,0,0,1
1305495704387821568,0,1,0,0,1
1305498210480173056,0,1,0,0,1
1305550291413037056,0,1,0,0,1
1325125969196191744,0,1,0,0,1
1323279468010508288,1,0,0,0,1
1323288950971101184,0,1,0,0,1
1323319439178240000,0,1,0,0,1
1323320537368600576,0,1,0,0,1
1323368485024653312,0,1,0,0,1
1323377028998012928,1,0,0,0,1
1323483887251591168,0,1,0,0,1
1323501297572540416,0,1,0,0,1
1323547129537769472,0,1,0,0,1
1323559286950211584,0,1,0,0,1
1323612902184620032,0,0,1,0,1
1323623396660436992,0,1,0,0,1
1323633919913304064,0,1,0,0,1
1323652989459070976,0,1,0,0,1
1323688487812395008,0,1,0,0,1
1323769024522579968,0,1,0,0,1
1323772343034937344,0,1,0,0,1
1323773890334777344,0,1,0,0,1
1323856113389903872,0,1,0,0,1
1323869192421101568,0,1,0,0,1
1323893818056474624,1,0,0,0,1
1323266368251273216,0,1,0,0,1
1323178038222233600,0,1,0,0,1
1323173875396456448,1,0,0,0,1
1322881034124320768,1,0,0,0,1
1322360026766462976,0,1,0,0,1
1322361849942315008,0,1,0,0,1
1322393669203353600,0,1,0,0,1
1322465957332340736,0,1,0,0,1
1322473877168037888,0,1,0,0,1
1322518824843968512,0,1,0,0,1
1322545184127811584,0,0,0,1,1
1322786070027661312,1,0,0,0,1
1322853638788861952,0,1,0,0,1
1322888069586935808,1,0,0,0,1
1323160665750646784,0,1,0,0,1
1322889269573259264,0,1,0,0,1
1322906378076184576,0,1,0,0,1
1322925249298632704,1,0,0,0,1
1323003822059511808,0,1,0,0,1
1323055120737656832,0,1,0,0,1
1323065312934322176,0,1,0,0,1
1323091435160326144,0,1,0,0,1
1323141368563326976,1,0,0,0,1
1323149609405837312,0,1,0,0,1
1323906868809506816,0,0,1,0,1
1323913207430356992,0,1,0,0,1
1323944033622937600,0,0,1,0,1
1324792730204229632,0,1,0,0,1
1324601135487873024,0,1,0,0,1
1324622567706013696,0,1,0,0,1
1324636849890086912,0,1,0,0,1
1324642672339025920,0,1,0,0,1
1324721550252142592,0,1,0,0,1
1324753737588609024,0,1,0,0,1
1324757654229651456,1,0,0,0,1
1324769051286134784,0,1,0,0,1
1324779555236859904,0,1,0,0,1
1324795271092555776,0,1,0,0,1
1324555937500155904,0,1,0,0,1
1324820142119886848,0,1,0,0,1
1324844400137039872,0,1,0,0,1
1324861952091328512,0,0,0,1,1
1324864407906611200,0,1,0,0,1
1324907141757603840,0,1,0,0,1
1324913108758880256,0,1,0,0,1
1324947765550571520,0,1,0,0,1
1325040901425651712,0,1,0,0,1
1325062361313636352,0,1,0,0,1
1324575278002184192,1,0,0,0,1
1324554425852063744,0,1,0,0,1
1323944963248304128,0,1,0,0,1
1324173989158158336,0,1,0,0,1
1323957962294075392,1,0,0,0,1
1323962001199169536,0,1,0,0,1
1323978090268237824,1,0,0,0,1
1323984961368543232,1,0,0,0,1
1324031183391477760,0,1,0,0,1
1324074727812509696,0,1,0,0,1
1324088635742920704,0,1,0,0,1
1324110093592514560,0,1,0,0,1
1324152554817613824,1,0,0,0,1
1324203810626007040,0,1,0,0,1
1324540136365809664,0,1,0,0,1
1324208977081733120,0,1,0,0,1
1324215306848358400,0,1,0,0,1
1324216837089992704,0,1,0,0,1
1324235599902085120,0,1,0,0,1
1324260425563803648,0,1,0,0,1
1324306541520936960,0,1,0,0,1
1324336290159071232,0,1,0,0,1
1324353002145222656,1,0,0,0,1
1324456112062648320,0,1,0,0,1
1322349941344346112,0,1,0,0,1
1322302397528637440,0,1,0,0,1
1322298299731369984,0,1,0,0,1
1320231280915607552,0,1,0,0,1
1319842817896640512,0,1,0,0,1
1319862120683503616,0,1,0,0,1
1319866037496664064,1,0,0,0,1
1319878070753513472,0,1,0,0,1
1319887349304725504,0,1,0,0,1
1319910390109790208,0,0,1,0,1
1319917571337080832,0,1,0,0,1
1319985066953625600,0,1,0,0,1
1320130484458852352,0,1,0,0,1
1320237133702025216,0,1,0,0,1
1319799204638683136,0,1,0,0,1
1320281162451881984,0,1,0,0,1
1320341799618048000,1,0,0,0,1
1320346133701353472,0,1,0,0,1
1320355739211304960,0,1,0,0,1
1320362834052734976,0,1,0,0,1
1320385822496096256,1,0,0,0,1
1320386019150254080,0,1,0,0,1
1320396924675977216,1,0,0,0,1
1320475087779364864,0,1,0,0,1
1319807055465689088,0,1,0,0,1
1319748867605340160,0,1,0,0,1
1320610849820712960,0,1,0,0,1
1319199362929491968,0,0,0,1,1
1318717109816512512,0,1,0,0,1
1318721870955380736,0,1,0,0,1
1318791022047100928,0,1,0,0,1
1318871507859312640,0,1,0,0,1
1318903015831646208,1,0,0,0,1
1318934163190370304,0,1,0,0,1
1318989402274631680,0,0,0,1,1
1319040410656886784,1,0,0,0,1
1319184589370363904,0,1,0,0,1
1319211961280876544,0,1,0,0,1
1319698491682082816,0,1,0,0,1
1319300674039943168,0,1,0,0,1
1319387818267901952,0,1,0,0,1
1319488141854674944,0,1,0,0,1
1319525416684511232,0,0,1,0,1
1319535575179743232,0,1,0,0,1
1319543280468721664,0,1,0,0,1
1319585687755235328,0,1,0,0,1
1319607784443383808,0,1,0,0,1
1319651596846977024,0,1,0,0,1
1320560122058465280,0,1,0,0,1
1320675198945771520,1,0,0,0,1
1322278947476828160,0,1,0,0,1
1321950631712739328,1,0,0,0,1
1321737650986872832,1,0,0,0,1
1321742145947160576,1,0,0,0,1
1321761401430560768,0,1,0,0,1
1321790345324101632,0,1,0,0,1
1321791347620151296,1,0,0,0,1
1321856500780904448,0,0,0,1,1
1321860651048980480,0,1,0,0,1
1321898064802697216,0,1,0,0,1
1321948821568606208,0,1,0,0,1
1322033412966883328,0,1,0,0,1
1321724231621771264,0,1,0,0,1
1322050278225444864,0,1,0,0,1
1322055234689052672,0,1,0,0,1
1322059016625741824,0,0,1,0,1
1322072666522689536,0,1,0,0,1
1322087925807538176,0,1,0,0,1
1322128852743819264,1,0,0,0,1
1322140803183960064,1,0,0,0,1
1322183214270656512,0,1,0,0,1
1322205933225811968,0,1,0,0,1
1321735576584966144,0,1,0,0,1
1321699519327834112,0,1,0,0,1
1320686772477710336,0,1,0,0,1
1321174239504990208,0,1,0,0,1
1320722263155552256,0,1,0,0,1
1320784616274481152,0,1,0,0,1
1320829917454573568,0,1,0,0,1
1320864171009974272,0,0,0,1,1
1320887307776319488,0,1,0,0,1
1320941074555101184,0,1,0,0,1
1320942529253167104,0,1,0,0,1
1321129726103072768,0,1,0,0,1
1321152184507981824,0,1,0,0,1
1321180395518517248,0,1,0,0,1
1321690808668639232,0,1,0,0,1
1321197081063788544,0,1,0,0,1
1321328756837920768,1,0,0,0,1
1321397904318353408,0,1,0,0,1
1321413040458399744,0,0,1,0,1
1321453667703087104,0,1,0,0,1
1321488724706938880,0,1,0,0,1
1321523668837519360,0,1,0,0,1
1321590585074110464,0,1,0,0,1
1321669070941544448,1,0,0,0,1
1325125494338019328,0,1,0,0,1
1325136374807343104,0,1,0,0,1
1305583926509936640,0,1,0,0,1
1325217196969250816,1,0,0,0,1
1330436787857223680,1,0,0,0,1
1330475949767397376,0,0,1,0,1
1330558277676134400,1,0,0,0,1
1330560364883308544,0,1,0,0,1
1330570213692207104,0,1,0,0,1
1330574884544671744,0,1,0,0,1
1330577834105065472,0,1,0,0,1
1330578165501202432,0,1,0,0,1
1330625047011225600,0,1,0,0,1
1330754656902008832,0,1,0,0,1
1330759516447641600,0,1,0,0,1
1330768292722606080,1,0,0,0,1
1330776261447340032,0,1,0,0,1
1330821582240047104,0,1,0,0,1
1330822275864604672,0,1,0,0,1
1330825063394910208,0,1,0,0,1
1330948629100564480,0,1,0,0,1
1331047275620147200,0,1,0,0,1
1331073319077081088,0,1,0,0,1
1331129314843234304,1,0,0,0,1
1331149820405288960,1,0,0,0,1
1330361555725193216,0,1,0,0,1
1330223759211573248,0,1,0,0,1
1330198544876187648,1,0,0,0,1
1329530045241716736,0,1,0,0,1
1329094317516890112,1,0,0,0,1
1329127472042975232,0,1,0,0,1
1329193032126582784,0,1,0,0,1
1329213940576833536,0,1,0,0,1
1329322978551721984,0,0,0,1,1
1329333389506318336,0,1,0,0,1
1329371186032209920,0,1,0,0,1
1329491737354518528,0,0,1,0,1
1329511953606144000,0,1,0,0,1
1329572377513091072,0,1,0,0,1
1330197302955413504,0,0,0,1,1
1329615277479391232,0,1,0,0,1
1329643052479246336,0,1,0,0,1
1329742824753905664,0,1,0,0,1
1329829965433626624,0,1,0,0,1
1329842266463117312,0,1,0,0,1
1329928511256190976,0,0,1,0,1
1330001205293027328,1,0,0,0,1
1330027356380037120,1,0,0,0,1
1330174663134224384,0,1,0,0,1
1331255417972801536,0,1,0,0,1
1331270872297070592,0,1,0,0,1
1331282756010065920,0,1,0,0,1
1333022231111356416,0,1,0,0,1
1332599065545224192,0,1,0,0,1
1332640972119838720,0,1,0,0,1
1332657534155382784,0,1,0,0,1
1332714868881858560,0,1,0,0,1
1332749731630497792,1,0,0,0,1
1332861388696522752,0,0,0,1,1
1332956392399966208,0,1,0,0,1
1332992482167173120,0,1,0,0,1
1333012623458123776,0,1,0,0,1
1333047299837145088,0,1,0,0,1
1332516434128224256,0,1,0,0,1
1333059888575090688,0,1,0,0,1
1333077454718595072,1,0,0,0,1
1333077869379997696,0,1,0,0,1
1333118440740163584,0,1,0,0,1
1333135833386409984,0,1,0,0,1
1333225027534262272,0,1,0,0,1
1333234420682264576,0,1,0,0,1
1333300602000920576,0,1,0,0,1
1333364002953433088,0,1,0,0,1
1332523917609627648,0,1,0,0,1
1332423385171812352,0,1,0,0,1
1331435821291991040,0,1,0,0,1
1331865741377810432,0,0,1,0,1
1331584683033849856,0,1,0,0,1
1331605361112080384,0,1,0,0,1
1331608839733567488,0,1,0,0,1
1331734090131890176,1,0,0,0,1
1331750011365822464,1,0,0,0,1
1331764645053534208,0,1,0,0,1
1331771131741683712,0,1,0,0,1
1331803113863270400,0,0,1,0,1
1331859081636679680,0,1,0,0,1
1331914822917578752,0,0,1,0,1
1332386495987113984,0,1,0,0,1
1331942278236090368,0,1,0,0,1
1331962890220425216,1,0,0,0,1
1332004230530469888,0,1,0,0,1
1332017558124302336,0,1,0,0,1
1332018162808745984,0,1,0,0,1
1332107373213753344,0,1,0,0,1
1332313160557207552,1,0,0,0,1
1332328760993988608,0,0,0,1,1
1332381099780169728,0,1,0,0,1
1329064367317512192,1,0,0,0,1
1328974411236597760,0,1,0,0,1
1328972451318009856,0,1,0,0,1
1326448934802378752,0,1,0,0,1
1326104010542247936,0,1,0,0,1
1326138120799051776,0,1,0,0,1
1326156250200076288,1,0,0,0,1
1326235371911352320,0,0,1,0,1
1326282707937103872,1,0,0,0,1
1326286523801640960,0,1,0,0,1
1326352568625352704,0,1,0,0,1
1326382110526107648,0,1,0,0,1
1326431395305107456,0,1,0,0,1
1326455549261713408,1,0,0,0,1
1326072770313158656,0,1,0,0,1
1326714874794180608,0,1,0,0,1
1326809774390988800,0,1,0,0,1
1326923744904966144,0,1,0,0,1
1326936688069894144,0,1,0,0,1
1326984459011309568,1,0,0,0,1
1326994379119058944,0,1,0,0,1
1327025001745231872,1,0,0,0,1
1327060688582414336,0,0,0,1,1
1327061067101470720,0,1,0,0,1
1326080503351451648,0,1,0,0,1
1326071431503941632,0,1,0,0,1
1327100886246592512,0,1,0,0,1
1325521948722532352,0,1,0,0,1
1325278969415888896,0,1,0,0,1
1325309772850212864,0,1,0,0,1
1325353328767885312,0,1,0,0,1
1325353711103737856,0,1,0,0,1
1325393411382288384,0,0,1,0,1
1325403021744988160,0,1,0,0,1
1325403651049984000,0,0,1,0,1
1325463275719454720,0,1,0,0,1
1325517208961777664,0,1,0,0,1
1325527466425856000,0,1,0,0,1
1325936880051871744,1,0,0,0,1
1325610621069533184,0,1,0,0,1
1325623757839364096,0,1,0,0,1
1325733342478819328,1,0,0,0,1
1325757397269315584,0,1,0,0,1
1325770194900357120,0,1,0,0,1
1325790087121080320,0,1,0,0,1
1325797276422463488,0,1,0,0,1
1325846890089508864,0,1,0,0,1
1325935531583287296,0,1,0,0,1
1327080097182932992,0,1,0,0,1
1327146080258170880,0,1,0,0,1
1328958216210931712,0,1,0,0,1
1328313615699628032,0,1,0,0,1
1328003350592417792,0,1,0,0,1
1328006760741924864,0,1,0,0,1
1328021905304023040,0,1,0,0,1
1328070090768703488,0,1,0,0,1
1328088698722906112,0,1,0,0,1
1328205567161114624,0,1,0,0,1
1328250146975526912,0,1,0,0,1
1328259852544528384,0,1,0,0,1
1328268208596541440,0,1,0,0,1
1328314670172790784,0,0,0,1,1
1327961016475369472,1,0,0,0,1
1328400425280819200,0,1,0,0,1
1328407015908118528,0,1,0,0,1
1328451744926412800,0,1,0,0,1
1328527210467139584,1,0,0,0,1
1328614278396596224,0,0,0,1,1
1328771974462627840,0,1,0,0,1
1328876738928062464,0,1,0,0,1
1328895023337771008,0,1,0,0,1
1328920515046608896,0,1,0,0,1
1327988022265057280,0,1,0,0,1
1327957762106679296,0,1,0,0,1
1327236296981536768,0,1,0,0,1
1327538778861301760,0,1,0,0,1
1327237424305487872,0,1,0,0,1
1327292037729837056,1,0,0,0,1
1327293659906256896,0,1,0,0,1
1327402754374037504,0,1,0,0,1
1327404220786479104,0,1,0,0,1
1327419702700888064,0,1,0,0,1
1327472881446621184,0,1,0,0,1
1327494504908283904,1,0,0,0,1
1327511308267294720,0,1,0,0,1
1327539589393870848,0,1,0,0,1
1327931809255055360,1,0,0,0,1
1327549719539634176,0,1,0,0,1
1327588890933407744,0,1,0,0,1
1327600376665628672,0,1,0,0,1
1327652062952181760,0,1,0,0,1
1327723252651798528,1,0,0,0,1
1327801654100582400,0,1,0,0,1
1327813003807363072,0,1,0,0,1
1327857440025497600,0,1,0,0,1
1327898299139989504,0,1,0,0,1
1318698934055952384,1,0,0,0,1
1318697472961765376,0,1,0,0,1
1318665695509577728,0,1,0,0,1
1318640332763004928,0,1,0,0,1
1310498058107461632,0,1,0,0,1
1310542213382836224,0,1,0,0,1
1310565357556576256,0,1,0,0,1
1310609197172629504,0,1,0,0,1
1310615272735219712,1,0,0,0,1
1310621243356348416,0,1,0,0,1
1310625206495449088,0,1,0,0,1
1310631344477671424,1,0,0,0,1
1310645211991666688,1,0,0,0,1
1310678773772087296,0,1,0,0,1
1310719554520322048,1,0,0,0,1
1310873656529215488,0,1,0,0,1
1310878839598395392,0,1,0,0,1
1310896369616539648,0,1,0,0,1
1310936942616379392,0,1,0,0,1
1310986404437143552,0,1,0,0,1
1310993859258834944,0,0,1,0,1
1311102698356461568,0,1,0,0,1
1311119916905398272,0,1,0,0,1
1311126076051976192,0,0,0,1,1
1311155128871911424,0,1,0,0,1
1310460269416476672,0,1,0,0,1
1310423162505445376,1,0,0,0,1
1310279407764992000,0,0,1,0,1
1309748780216979456,1,0,0,0,1
1309369844668731392,0,1,0,0,1
1309409487254630400,1,0,0,0,1
1309475362514956288,0,0,0,1,1
1309560052848766976,0,1,0,0,1
1309579760717135872,0,1,0,0,1
1309581529518088192,0,1,0,0,1
1309598698796613632,1,0,0,0,1
1309645337057992704,1,0,0,0,1
1309661111084609536,0,1,0,0,1
1309868382112620544,0,1,0,0,1
1310262001562718208,0,0,0,1,1
1309896633522421760,1,0,0,0,1
1310025215557083136,0,1,0,0,1
1310089363980652544,0,1,0,0,1
1310125270301515776,0,1,0,0,1
1310135823908700160,0,1,0,0,1
1310139950738755584,0,1,0,0,1
1310178088039469056,1,0,0,0,1
1310194587407974400,0,1,0,0,1
1310222774133235712,0,1,0,0,1
1311159106661744640,1,0,0,0,1
1311173739338444800,1,0,0,0,1
1311177625314889728,0,1,0,0,1
1312363990043914240,0,1,0,0,1
1312071890937278464,0,1,0,0,1
1312093570879221760,1,0,0,0,1
1312185575466848256,0,1,0,0,1
1312192453307490304,0,1,0,0,1
1312195103344263168,0,1,0,0,1
1312204118224764928,0,0,0,1,1
1312235860818038784,0,1,0,0,1
1312321365668761600,0,1,0,0,1
1312330900131246080,0,1,0,0,1
1312368899304894464,1,0,0,0,1
1311926235317129216,0,1,0,0,1
1312400054158843904,0,1,0,0,1
1312426547094183936,0,1,0,0,1
1312431528111149056,0,1,0,0,1
1312450168701280256,0,1,0,0,1
1312482609520353280,1,0,0,0,1
1312512662513881088,0,1,0,0,1
1312637703717097472,0,1,0,0,1
1312681201623281664,0,1,0,0,1
1312717605887672320,0,1,0,0,1
1311941333918121984,0,1,0,0,1
1311907540054155264,0,0,0,1,1
1311243764308963328,1,0,0,0,1
1311479795079876608,0,1,0,0,1
1311248357600514048,0,1,0,0,1
1311271736764248064,0,1,0,0,1
1311284051857162240,0,1,0,0,1
1311317067207831552,1,0,0,0,1
1311329573183852544,0,1,0,0,1
1311372206555893760,0,1,0,0,1
1311395439502135296,0,1,0,0,1
1311401279613218816,0,1,0,0,1
1311426325110956032,0,1,0,0,1
1311491144442769408,0,1,0,0,1
1311887445617594368,0,1,0,0,1
1311632751305601024,0,1,0,0,1
1311634277994356736,0,1,0,0,1
1311657465570705408,0,1,0,0,1
1311701077822185472,1,0,0,0,1
1311715607956656128,0,1,0,0,1
1311717584463564800,0,1,0,0,1
1311757420868272128,0,1,0,0,1
1311817260483309568,1,0,0,0,1
1311858411311513600,1,0,0,0,1
1309334235812188160,0,1,0,0,1
1309142205886533632,0,1,0,0,1
1309098996821045248,1,0,0,0,1
1306800824241106944,0,1,0,0,1
1306369218594705408,0,1,0,0,1
1306423355864567808,0,1,0,0,1
1306530034648338432,0,1,0,0,1
1306532320887951360,0,1,0,0,1
1306553294840569856,0,1,0,0,1
1306625829921792000,0,1,0,0,1
1306685800831164416,1,0,0,0,1
1306718391663759360,0,1,0,0,1
1306753942102007808,1,0,0,0,1
1306804034846646272,0,1,0,0,1
1306307764189159424,0,1,0,0,1
1306828716459397120,0,1,0,0,1
1306835659261321216,1,0,0,0,1
1306839289653796864,0,1,0,0,1
1306864968558686208,0,1,0,0,1
1306873511114420224,0,1,0,0,1
1306917597649264640,0,1,0,0,1
1306954582644252672,1,0,0,0,1
1306958402073931776,1,0,0,0,1
1306977271039877120,0,1,0,0,1
1306331141289377792,1,0,0,0,1
1306284281405288448,1,0,0,0,1
1307002465166848000,1,0,0,0,1
1305862091014918144,0,1,0,0,1
1305604010855018496,1,0,0,0,1
1305654123480649728,0,1,0,0,1
1305667277023571968,0,1,0,0,1
1305668705049665536,0,1,0,0,1
1305716744732860416,0,1,0,0,1
1305780521881010176,0,1,0,0,1
1305821952951619584,1,0,0,0,1
1305823927441137664,1,0,0,0,1
1305847914019934208,0,1,0,0,1
1305905478979989504,0,1,0,0,1
1306269229847519232,0,1,0,0,1
1305949889977815040,0,1,0,0,1
1305964410150612992,0,1,0,0,1
1305965073546924032,0,1,0,0,1
1306013720913620992,0,1,0,0,1
1306071011436236800,0,1,0,0,1
1306121551658520576,0,1,0,0,1
1306137023607119872,0,1,0,0,1
1306172726479073280,0,1,0,0,1
1306197856819306496,0,1,0,0,1
1306983759095328768,0,1,0,0,1
1307019534868443136,0,1,0,0,1
1309039260163506176,0,1,0,0,1
1308698564940492800,0,1,0,0,1
1308328777169219584,0,1,0,0,1
1308388108044468224,0,1,0,0,1
1308466329012244480,0,1,0,0,1
1308466488572022784,0,1,0,0,1
1308494794713370624,0,0,1,0,1
1308542872111718400,0,1,0,0,1
1308558627716956160,0,1,0,0,1
1308563210308595712,0,1,0,0,1
1308605409423368192,0,1,0,0,1
1308699114050408448,0,1,0,0,1
1308163039238205440,0,1,0,0,1
1308781780623699968,0,1,0,0,1
1308787719401885696,1,0,0,0,1
1308826745018212352,0,1,0,0,1
1308853706163728384,0,1,0,0,1
1308854535067234304,0,1,0,0,1
1308877603537788928,0,1,0,0,1
1308942330779451392,0,1,0,0,1
1309033952519299072,0,1,0,0,1
1309036529608790016,0,1,0,0,1
1308264765538656256,0,1,0,0,1
1308154951642775552,1,0,0,0,1
1307107206677114880,0,1,0,0,1
1307592870573084672,0,1,0,0,1
1307242190364717056,0,1,0,0,1
1307314251237863424,1,0,0,0,1
1307336748175888384,0,1,0,0,1
1307364274692481024,0,1,0,0,1
1307365272173645824,0,1,0,0,1
1307372913411207168,0,1,0,0,1
1307448396521918464,0,1,0,0,1
1307461025093091328,1,0,0,0,1
1307574972303302656,1,0,0,0,1
1307713318929551360,0,1,0,0,1
1308146010833772544,0,1,0,0,1
1307732351552634880,0,1,0,0,1
1307784763164577792,0,1,0,0,1
1307881252976877568,0,1,0,0,1
1308056027166838784,0,1,0,0,1
1308113087107653632,0,1,0,0,1
1308114509463252992,0,1,0,0,1
1308116157849796608,0,1,0,0,1
1308126930382794752,1,0,0,0,1
1308127768551489536,0,1,0,0,1
1312725218763460608,1,0,0,0,1
1312742831493124096,0,1,0,0,1
1312750569543528448,1,0,0,0,1
1316838720868319232,0,1,0,0,1
1316618731561377792,0,1,0,0,1
1316627097876680704,0,1,0,0,1
1316637033469632512,0,1,0,0,1
1316648539884322816,0,1,0,0,1
1316655775599730688,0,1,0,0,1
1316662972685656064,0,1,0,0,1
1316672861499727872,0,1,0,0,1
1316681685988044800,0,1,0,0,1
1316698525300817920,0,1,0,0,1
1316917751835930624,1,0,0,0,1
1316518392887611392,0,0,0,1,1
1316923403215859712,1,0,0,0,1
1317004880029061120,0,1,0,0,1
1317028370887151616,0,1,0,0,1
1317029839275249664,0,1,0,0,1
1317030056573677568,0,1,0,0,1
1317030800689262592,0,1,0,0,1
1317032404280803328,0,1,0,0,1
1317068886404202496,0,1,0,0,1
1317093860900745216,0,1,0,0,1
1316610905560346624,0,1,0,0,1
1316399374008713216,0,1,0,0,1
1317181830873845760,0,0,1,0,1
1315750233293295616,0,1,0,0,1
1315561494671622144,0,1,0,0,1
1315591068679888896,0,1,0,0,1
1315592122263834624,0,1,0,0,1
1315594730542190592,0,1,0,0,1
1315600291404840960,0,1,0,0,1
1315616836969431040,0,1,0,0,1
1315672863773544448,0,1,0,0,1
1315728837305602048,0,1,0,0,1
1315738914351611904,0,1,0,0,1
1315792774118215680,0,1,0,0,1
1316329501106884608,0,1,0,0,1
1315795880109318144,0,1,0,0,1
1315896405702123520,0,1,0,0,1
1315976786912501760,0,1,0,0,1
1316160482932338688,0,1,0,0,1
1316164854047096832,0,0,0,1,1
1316269207286243328,1,0,0,0,1
1316287099063205888,0,1,0,0,1
1316326930057224192,0,1,0,0,1
1316327866183761920,0,1,0,0,1
1317165206674395136,0,0,0,1,1
1317221478903971840,0,1,0,0,1
1315370206173097984,0,1,0,0,1
1318363989760409600,0,1,0,0,1
1318117675239985152,1,0,0,0,1
1318162148842000384,0,1,0,0,1
1318170113812713472,0,1,0,0,1
1318190539347435520,0,1,0,0,1
1318222033034092544,0,1,0,0,1
1318240236212805632,0,1,0,0,1
1318282953798070272,1,0,0,0,1
1318357346377035776,0,1,0,0,1
1318359772480049152,1,0,0,0,1
1318447218693689344,0,1,0,0,1
1318110192668692480,0,1,0,0,1
1318448241701195776,0,1,0,0,1
1318479090010251264,0,1,0,0,1
1318512840232357888,0,0,0,1,1
1318582147230371840,0,1,0,0,1
1318587209402830848,0,1,0,0,1
1318598265651318784,0,1,0,0,1
1318616858539352064,1,0,0,0,1
1318622227613454336,0,1,0,0,1
1318634094578814976,0,1,0,0,1
1318115954551885824,0,1,0,0,1
1318095741689081856,0,1,0,0,1
1317247452764844032,0,1,0,0,1
1317461961538502656,0,1,0,0,1
1317248168157851648,0,1,0,0,1
1317291986123186176,0,1,0,0,1
1317297885017419776,0,1,0,0,1
1317344693517242368,0,1,0,0,1
1317389088534704128,1,0,0,0,1
1317390722253901824,0,1,0,0,1
1317419067582652416,0,1,0,0,1
1317434545856237568,0,1,0,0,1
1317460192863420416,0,0,0,1,1
1317498902510096384,0,1,0,0,1
1318038821322149888,0,1,0,0,1
1317514955080441856,0,1,0,0,1
1317557948101627904,1,0,0,0,1
1317616823429402624,1,0,0,0,1
1317665935793086464,0,1,0,0,1
1317666946129809408,0,1,0,0,1
1317706663734829056,0,1,0,0,1
1317734749520146432,1,0,0,0,1
1317888773045116928,0,1,0,0,1
1317961272835534848,0,1,0,0,1
1315429941513576448,0,0,1,0,1
1315340648757768192,0,1,0,0,1
1312780812375400448,0,1,0,0,1
1313663224793849856,1,0,0,0,1
1313505275324887040,0,1,0,0,1
1313507917623164928,0,1,0,0,1
1313508650045059072,1,0,0,0,1
1313512955686907904,0,1,0,0,1
1313542230230134784,0,1,0,0,1
1313575107303006208,0,1,0,0,1
1313616117617885184,0,1,0,0,1
1313641898419064832,0,1,0,0,1
1313655149777346560,0,1,0,0,1
1313668411969470464,1,0,0,0,1
1313431022026063872,1,0,0,0,1
1313671160723243008,0,1,0,0,1
1313679835332452352,0,1,0,0,1
1313714534461435904,0,1,0,0,1
1313773675796201472,0,1,0,0,1
1313789158662471680,0,1,0,0,1
1313818349432975360,1,0,0,0,1
1313836381538447360,0,1,0,0,1
1313853921266294784,1,0,0,0,1
1313936134121099264,0,1,0,0,1
1313498797385814016,0,1,0,0,1
1313428189809577984,1,0,0,0,1
1313966243616100352,0,1,0,0,1
1313051300641165312,0,1,0,0,1
1312792818541228032,1,0,0,0,1
1312820320298958848,0,0,1,0,1
1312822780031692800,0,1,0,0,1
1312823199155978240,0,1,0,0,1
1312849179916595200,1,0,0,0,1
1312857548379353088,0,1,0,0,1
1312857878047453184,1,0,0,0,1
1312916444871626752,0,1,0,0,1
1312995442477596672,1,0,0,0,1
1313051341888131072,1,0,0,0,1
1313417874283941888,0,1,0,0,1
1313057385632555008,1,0,0,0,1
1313117302196367360,1,0,0,0,1
1313123409895845888,1,0,0,0,1
1313165645748596736,0,1,0,0,1
1313333891223052288,0,1,0,0,1
1313354509968642048,0,1,0,0,1
1313354810918305792,0,1,0,0,1
1313373405048115200,0,1,0,0,1
1313401433883062272,0,1,0,0,1
1313953530051473408,0,1,0,0,1
1313996376951447552,0,1,0,0,1
1315304067967717376,0,1,0,0,1
1314928117081804800,0,1,0,0,1
1314605465498681344,0,1,0,0,1
1314642175355912192,1,0,0,0,1
1314651291411460096,0,1,0,0,1
1314659817533976576,0,1,0,0,1
1314686880206684160,1,0,0,0,1
1314694204811956224,1,0,0,0,1
1314781289292066816,0,1,0,0,1
1314873072005132288,0,1,0,0,1
1314923166674886656,1,0,0,0,1
1315024382150934528,0,1,0,0,1
1314598767656669184,0,1,0,0,1
1315044762114809856,0,1,0,0,1
1315055060037128192,0,1,0,0,1
1315059115060801536,0,1,0,0,1
1315095635461373952,0,1,0,0,1
1315129944289271808,0,1,0,0,1
1315203929240727552,1,0,0,0,1
1315226813774262272,0,1,0,0,1
1315237523376005120,0,1,0,0,1
1315286986756943872,1,0,0,0,1
1314603418200289280,0,1,0,0,1
1314505439082622976,1,0,0,0,1
1313996629490323456,1,0,0,0,1
1314231852933160960,0,1,0,0,1
1314010503694307328,0,1,0,0,1
1314059674690486272,0,1,0,0,1
1314093229923594240,0,1,0,0,1
1314102314677022720,0,1,0,0,1
1314121453462315008,0,1,0,0,1
1314176020782764032,1,0,0,0,1
1314178192630980608,0,1,0,0,1
1314187563498975232,0,1,0,0,1
1314202488543739904,1,0,0,0,1
1314236981258354688,0,1,0,0,1
1314495071539126272,0,1,0,0,1
1314257008372064256,1,0,0,0,1
1314266912562450432,0,1,0,0,1
1314271330271780864,0,1,0,0,1
1314273254509613056,0,0,0,1,1
1314294117925629952,1,0,0,0,1
1314298167622541312,1,0,0,0,1
1314326686574485504,0,1,0,0,1
1314421153931292672,1,0,0,0,1
1314439343004499968,0,1,0,0,1
1276811411369459712,0,1,0,0,1
1276787482558967808,0,1,0,0,1
1276681032566276096,0,1,0,0,1
1246769361009795072,1,0,0,0,1
1244837027394154496,1,0,0,0,1
1244868865642975232,0,1,0,0,1
1244870517183692800,1,0,0,0,1
1244879062662873088,0,0,0,1,1
1244896891369934848,0,1,0,0,1
1244903719864590336,1,0,0,0,1
1244917145135267840,0,0,0,1,1
1245034082976833536,0,1,0,0,1
1245066769712046080,0,1,0,0,1
1245102617619042304,0,1,0,0,1
1245110456106262528,1,0,0,0,1
1245156544460644352,0,1,0,0,1
1245184811272228864,0,1,0,0,1
1245187942265565184,1,0,0,0,1
1245198614491734016,1,0,0,0,1
1245223034539180032,0,1,0,0,1
1245225642003660800,0,1,0,0,1
1245248431481851904,0,1,0,0,1
1245254241293230080,1,0,0,0,1
1245289207645589504,0,1,0,0,1
1245311425679175680,0,1,0,0,1
1244820518227845120,0,1,0,0,1
1244792480198832128,1,0,0,0,1
1244777710259486720,0,1,0,0,1
1244535200081559552,1,0,0,0,1
1244323161270673408,0,1,0,0,1
1244333477266415616,0,1,0,0,1
1244349978073370624,0,0,0,1,1
1244377699176546304,0,1,0,0,1
1244516148231749632,0,1,0,0,1
1244516284269834240,0,1,0,0,1
1244516734389719040,0,1,0,0,1
1244524942277959680,1,0,0,0,1
1244530975599554560,0,1,0,0,1
1244547591997546496,0,1,0,0,1
1244771104062832640,0,1,0,0,1
1244555007212609536,0,1,0,0,1
1244606302346776576,0,1,0,0,1
1244631128998400000,0,1,0,0,1
1244652024836186112,1,0,0,0,1
1244652660634128384,1,0,0,0,1
1244691029468553216,0,0,1,0,1
1244697985604354048,0,1,0,0,1
1244702209742266368,0,1,0,0,1
1244707929846091776,0,1,0,0,1
1245352784192573440,0,1,0,0,1
1245359321271218176,1,0,0,0,1
1245386302708535296,0,1,0,0,1
1246318722693967872,0,1,0,0,1
1246084384895139840,0,1,0,0,1
1246092608813719552,1,0,0,0,1
1246094392332615680,0,1,0,0,1
1246117231592968192,0,1,0,0,1
1246131248746999808,1,0,0,0,1
1246139578081316864,0,1,0,0,1
1246178680507740160,1,0,0,0,1
1246185834124054528,0,1,0,0,1
1246266012854636544,0,1,0,0,1
1246359626951647232,0,1,0,0,1
1246057317361160192,0,1,0,0,1
1246401532880289792,1,0,0,0,1
1246434051822477312,0,1,0,0,1
1246493462142128128,0,1,0,0,1
1246527121201049600,0,1,0,0,1
1246621677909413888,0,1,0,0,1
1246667019258298368,1,0,0,0,1
1246702816086769664,0,1,0,0,1
1246718651048198144,0,1,0,0,1
1246731805488709632,0,1,0,0,1
1246076017237798912,0,1,0,0,1
1246036881499881472,0,1,0,0,1
1245389793611169792,0,1,0,0,1
1245690544568893440,1,0,0,0,1
1245443685308907520,0,1,0,0,1
1245460636349296640,1,0,0,0,1
1245466024696307712,1,0,0,0,1
1245502569188745216,0,0,0,1,1
1245552084864372736,0,1,0,0,1
1245628266427252736,0,1,0,0,1
1245639317168386048,0,1,0,0,1
1245654348304023552,0,1,0,0,1
1245676016816848896,0,1,0,0,1
1245701596052414464,0,1,0,0,1
1246026144362586112,0,1,0,0,1
1245704170763673600,0,1,0,0,1
1245735680480813056,0,1,0,0,1
1245780689359966208,0,1,0,0,1
1245790874463883264,0,0,0,1,1
1245796138348765184,0,1,0,0,1
1245835090749321216,0,1,0,0,1
1245844456101666816,0,1,0,0,1
1245851830573244416,0,1,0,0,1
1245946288048390144,0,1,0,0,1
1244321383867396096,1,0,0,0,1
1244293850673418240,0,1,0,0,1
1244287930753040384,0,1,0,0,1
1242829990103834624,0,1,0,0,1
1242596914060824576,0,1,0,0,1
1242739274996281344,0,1,0,0,1
1242754170526093312,0,1,0,0,1
1242755928656658432,0,1,0,0,1
1242758381024223232,0,1,0,0,1
1242758569377673216,0,1,0,0,1
1242775186400657408,0,1,0,0,1
1242805362408882176,1,0,0,0,1
1242823098950463488,0,1,0,0,1
1242843974722883584,0,1,0,0,1
1242523439958810624,0,1,0,0,1
1242845541878452224,0,1,0,0,1
1242847611821801472,1,0,0,0,1
1242867086419951616,0,1,0,0,1
1242877964569710592,0,0,1,0,1
1242970764891942912,0,1,0,0,1
1243042115904364544,0,0,1,0,1
1243044183818022912,0,1,0,0,1
1243045347158417408,1,0,0,0,1
1243046085842608128,0,1,0,0,1
1242565628596191232,0,1,0,0,1
1242523236275011584,0,1,0,0,1
1243132662702911488,0,1,0,0,1
1242014885824720896,1,0,0,0,1
1241731359883886592,1,0,0,0,1
1241785836661886976,0,1,0,0,1
1241790060090949632,0,1,0,0,1
1241793434337378304,0,0,1,0,1
1241795274021855232,0,1,0,0,1
1241869314635907072,1,0,0,0,1
1241938884994437120,0,0,0,1,1
1241951324008112128,0,1,0,0,1
1241992741837582336,0,0,0,1,1
1242022726715482112,0,1,0,0,1
1242496444298219520,1,0,0,0,1
1242250606565371904,0,1,0,0,1
1242267567575535616,1,0,0,0,1
1242347734247460864,0,1,0,0,1
1242370631695364096,0,1,0,0,1
1242390510393856000,0,1,0,0,1
1242395496183992320,0,1,0,0,1
1242415437410902016,0,1,0,0,1
1242421875864522752,0,1,0,0,1
1242478230013009920,1,0,0,0,1
1243058354370437120,1,0,0,0,1
1243147022267547648,0,1,0,0,1
1244252346818928640,0,1,0,0,1
1244098533365407744,0,1,0,0,1
1243878600396492800,0,1,0,0,1
1243903389236428800,0,1,0,0,1
1243964266312536064,0,1,0,0,1
1243995177917779968,0,1,0,0,1
1244024022645592064,0,1,0,0,1
1244059412798541824,0,1,0,0,1
1244086056737214464,1,0,0,0,1
1244087387690422272,0,1,0,0,1
1244093493292617728,0,1,0,0,1
1244130567446122496,0,1,0,0,1
1243809932220063744,0,1,0,0,1
1244155447290089472,0,1,0,0,1
1244156776410275840,0,1,0,0,1
1244161667799363584,1,0,0,0,1
1244189912183615488,1,0,0,0,1
1244201434679214080,0,1,0,0,1
1244220085536866304,0,1,0,0,1
1244222733237604352,0,1,0,0,1
1244235287695200256,0,1,0,0,1
1244238784146915328,0,1,0,0,1
1243843650280292352,0,1,0,0,1
1243748531204009984,0,1,0,0,1
1243205208450031616,1,0,0,0,1
1243391615823040512,1,0,0,0,1
1243225070744424448,0,1,0,0,1
1243229033308905472,0,1,0,0,1
1243231665062924288,1,0,0,0,1
1243241893120618496,0,1,0,0,1
1243244192043880448,0,1,0,0,1
1243266175326285824,0,1,0,0,1
1243312061016350720,0,1,0,0,1
1243333311591833600,1,0,0,0,1
1243368588221632512,0,1,0,0,1
1243430030467715072,0,1,0,0,1
1243740907133784064,1,0,0,0,1
1243452054057693184,1,0,0,0,1
1243459911574597632,0,1,0,0,1
1243488995616739328,0,1,0,0,1
1243569749277257728,0,1,0,0,1
1243575912337113088,0,1,0,0,1
1243645237609861120,0,1,0,0,1
1243652327145267200,1,0,0,0,1
1243655887220289536,0,1,0,0,1
1243659292055490560,0,1,0,0,1
1246754342050414592,0,1,0,0,1
1246781718155202560,0,1,0,0,1
1252167826464477184,1,0,0,0,1
1246790812303753216,0,1,0,0,1
1250374778835234816,0,1,0,0,1
1250383741396058112,0,1,0,0,1
1250401488188342272,0,1,0,0,1
1250478907696037888,0,1,0,0,1
1250568257616121856,0,0,0,1,1
1250591292989587456,0,1,0,0,1
1250650176668090368,0,1,0,0,1
1250674269681565696,0,1,0,0,1
1250709165984514048,0,1,0,0,1
1250740014171992064,1,0,0,0,1
1250762279060111360,0,1,0,0,1
1250771636485267456,0,1,0,0,1
1250777963366436864,1,0,0,0,1
1250780586597330944,0,1,0,0,1
1250813325098668032,0,1,0,0,1
1250839534859882496,0,1,0,0,1
1250845909828714496,0,1,0,0,1
1250883688805675008,0,1,0,0,1
1250885156967256064,0,1,0,0,1
1250920251887366144,0,0,0,1,1
1250958768705122304,0,1,0,0,1
1250260926390915072,0,1,0,0,1
1250163477009711104,0,1,0,0,1
1250153259072770048,0,1,0,0,1
1249678658089947136,0,1,0,0,1
1249482902921859072,0,1,0,0,1
1249485928193650688,0,0,1,0,1
1249535061193420800,0,1,0,0,1
1249573194396102656,0,1,0,0,1
1249598587165704192,0,1,0,0,1
1249613242634096640,0,1,0,0,1
1249628216379215872,1,0,0,0,1
1249636095236526080,0,1,0,0,1
1249648547714211840,0,1,0,0,1
1249684516500836352,0,1,0,0,1
1250098127706525696,1,0,0,0,1
1249790577983488000,0,1,0,0,1
1249829927010041856,0,1,0,0,1
1249831877671825408,1,0,0,0,1
1249943096248291328,0,1,0,0,1
1249960049113305088,0,1,0,0,1
1250007920324087808,0,1,0,0,1
1250032591895293952,0,1,0,0,1
1250054705616748544,0,1,0,0,1
1250088832000651264,1,0,0,0,1
1250984179002638336,1,0,0,0,1
1250989262826332160,0,1,0,0,1
1251033115608285184,0,1,0,0,1
1251825870257430528,0,1,0,0,1
1251499682913816576,0,1,0,0,1
1251511558385041408,0,1,0,0,1
1251533119770902528,0,1,0,0,1
1251559997135155200,0,0,0,1,1
1251692804968976384,0,1,0,0,1
1251762684212715520,1,0,0,0,1
1251764705712132096,0,1,0,0,1
1251807490385367040,0,1,0,0,1
1251813555491475456,0,1,0,0,1
1251844731836993536,1,0,0,0,1
1251485546427318272,0,1,0,0,1
1251878866089422848,0,1,0,0,1
1251938280913895424,0,1,0,0,1
1251944024237240320,0,1,0,0,1
1251981854250610688,0,1,0,0,1
1251984461643821056,0,1,0,0,1
1252025388894650368,0,1,0,0,1
1252066960881225728,0,1,0,0,1
1252109731868504064,0,1,0,0,1
1252139631895666688,0,1,0,0,1
1251488608768405504,0,1,0,0,1
1251473013922426880,0,1,0,0,1
1251062089113677824,0,1,0,0,1
1251291250663309312,0,1,0,0,1
1251064958026158080,0,1,0,0,1
1251075874268549120,0,1,0,0,1
1251076496665399296,0,1,0,0,1
1251076755739164672,0,1,0,0,1
1251113755414429696,0,1,0,0,1
1251142364879441920,0,1,0,0,1
1251181717966258176,0,1,0,0,1
1251227012179431424,1,0,0,0,1
1251234531807342592,1,0,0,0,1
1251291918903971840,0,1,0,0,1
1251471806898176000,0,1,0,0,1
1251361101054242816,0,1,0,0,1
1251366890611658752,0,1,0,0,1
1251390933855174656,0,1,0,0,1
1251411079776866304,1,0,0,0,1
1251426428714975232,0,1,0,0,1
1251431267951947776,0,1,0,0,1
1251431870400774144,0,1,0,0,1
1251447642971951104,0,1,0,0,1
1251466857678360576,0,1,0,0,1
1249444325794037760,0,1,0,0,1
1249429107588214784,0,1,0,0,1
1249416277937942528,1,0,0,0,1
1247928386548314112,0,1,0,0,1
1247606632009195520,0,1,0,0,1
1247632002209234944,0,1,0,0,1
1247633329433821184,1,0,0,0,1
1247689221579702272,0,1,0,0,1
1247724599535702016,0,1,0,0,1
1247776604484333568,0,1,0,0,1
1247803905343250432,0,0,1,0,1
1247878306004897792,0,1,0,0,1
1247909183564869632,0,1,0,0,1
1247972039396167680,0,1,0,0,1
1247563831934693376,0,1,0,0,1
1247986035943972864,0,1,0,0,1
1248009677322870784,0,1,0,0,1
1248113150244737024,1,0,0,0,1
1248123764342226944,0,1,0,0,1
1248151993539088384,0,1,0,0,1
1248152382401400832,0,1,0,0,1
1248169474773192704,0,1,0,0,1
1248223228700450816,0,1,0,0,1
1248224940848844800,1,0,0,0,1
1247595235611459584,1,0,0,0,1
1247480020873793536,0,1,0,0,1
1248232771337805824,0,1,0,0,1
1247109422444314624,0,1,0,0,1
1246812933964943360,0,1,0,0,1
1246821317489373184,0,0,1,0,1
1246866920495697920,0,1,0,0,1
1246876306886651904,1,0,0,0,1
1246878980948373504,0,1,0,0,1
1247003493052960768,0,1,0,0,1
1247039475328286720,1,0,0,0,1
1247048833797947392,0,1,0,0,1
1247066052061794304,1,0,0,0,1
1247116713830895616,0,1,0,0,1
1247430255314272256,0,1,0,0,1
1247117283534790656,0,1,0,0,1
1247131639785893888,0,1,0,0,1
1247135758684749824,0,1,0,0,1
1247281226089562112,1,0,0,0,1
1247319590616653824,0,1,0,0,1
1247380742406955008,0,1,0,0,1
1247396938149810176,0,1,0,0,1
1247399538664538112,0,1,0,0,1
1247411072052518912,0,1,0,0,1
1248230905417814016,0,1,0,0,1
1248245791577104384,0,1,0,0,1
1249412358637666304,0,1,0,0,1
1249221141614428160,0,0,0,1,1
1249015212277145600,0,1,0,0,1
1249020110083260416,0,1,0,0,1
1249020200818786304,0,1,0,0,1
1249033623371517952,1,0,0,0,1
1249059870013296640,0,1,0,0,1
1249069614748835840,0,1,0,0,1
1249080864761417728,0,1,0,0,1
1249144682640269312,0,1,0,0,1
1249174102318833664,0,1,0,0,1
1249244732808515584,0,1,0,0,1
1248975691825033216,0,1,0,0,1
1249254571156873216,1,0,0,0,1
1249282036059320320,0,1,0,0,1
1249326074217091072,1,0,0,0,1
1249338267511611392,0,1,0,0,1
1249340455776550912,0,1,0,0,1
1249341124981874688,0,1,0,0,1
1249351143102255104,1,0,0,0,1
1249351377735868416,0,0,1,0,1
1249410744786898944,0,1,0,0,1
1249009369829847040,0,1,0,0,1
1248955871884763136,0,1,0,0,1
1248252346376871936,0,1,0,0,1
1248512852492779520,0,1,0,0,1
1248256535593193472,0,1,0,0,1
1248283172896272384,0,1,0,0,1
1248335532288913408,0,0,1,0,1
1248350982536335360,0,0,0,1,1
1248378741035843584,0,1,0,0,1
1248387459156762624,0,1,0,0,1
1248390038934769664,0,1,0,0,1
1248496686403440640,0,1,0,0,1
1248506346091274240,1,0,0,0,1
1248613770143776768,0,1,0,0,1
1248896852763635712,0,1,0,0,1
1248638554680557568,0,1,0,0,1
1248638820641320960,0,1,0,0,1
1248690632882864128,0,1,0,0,1
1248772656435871744,0,1,0,0,1
1248779475568988160,0,1,0,0,1
1248807850509393920,0,1,0,0,1
1248844302345818112,0,1,0,0,1
1248847155025940480,0,1,0,0,1
1248871992167501824,0,1,0,0,1
1241727671316500480,0,1,0,0,1
1241694284027269120,1,0,0,0,1
1241645963405656064,0,1,0,0,1
1241641537106313216,0,1,0,0,1
1232412415884742656,0,1,0,0,1
1232513776127225856,0,1,0,0,1
1232530595705585664,0,1,0,0,1
1232620459553959936,0,1,0,0,1
1232620843014008832,0,1,0,0,1
1232644738513326080,1,0,0,0,1
1232647784815349760,0,1,0,0,1
1232726222892912640,1,0,0,0,1
1232746878032338944,0,1,0,0,1
1232749891522310144,0,1,0,0,1
1232791394139430912,0,1,0,0,1
1232853996873928704,0,1,0,0,1
1232948826325049344,0,1,0,0,1
1232974090610315264,0,1,0,0,1
1232987077639385088,0,1,0,0,1
1233019310395863040,1,0,0,0,1
1233223805457387520,0,1,0,0,1
1233243890703978496,1,0,0,0,1
1233277317750890496,0,1,0,0,1
1233280246666784768,1,0,0,0,1
1233310484939595776,0,1,0,0,1
1232384232208707584,0,1,0,0,1
1232371838573072384,0,1,0,0,1
1232245051163435008,0,1,0,0,1
1231565868062171136,1,0,0,0,1
1230853858974453760,1,0,0,0,1
1230885685227401216,1,0,0,0,1
1231110054339907584,0,1,0,0,1
1231212912624197632,0,1,0,0,1
1231291412710219776,0,1,0,0,1
1231314235948298240,0,1,0,0,1
1231366605105455104,0,1,0,0,1
1231498623365500928,0,0,0,1,1
1231518927236321280,0,1,0,0,1
1231585313392336896,0,1,0,0,1
1232221735698735104,0,1,0,0,1
1231643428041232384,0,1,0,0,1
1231661263404642304,0,1,0,0,1
1231679390389432320,0,1,0,0,1
1231820919053725696,0,1,0,0,1
1231898432635273216,0,1,0,0,1
1232021348748128256,0,1,0,0,1
1232024132826664960,0,1,0,0,1
1232180400581160960,0,1,0,0,1
1232196264529403904,0,1,0,0,1
1233326276942979072,0,1,0,0,1
1233329476190294016,0,1,0,0,1
1233366084889300992,0,1,0,0,1
1234784780618616832,0,1,0,0,1
1234412762119491584,0,1,0,0,1
1234418569678655488,0,0,0,1,1
1234462442589048832,0,1,0,0,1
1234471401807106048,0,1,0,0,1
1234494100155568128,0,1,0,0,1
1234537687073382400,0,1,0,0,1
1234667997945458688,0,1,0,0,1
1234712929943085056,0,1,0,0,1
1234756183904464896,0,1,0,0,1
1234789384261656576,0,1,0,0,1
1234186263361662976,0,1,0,0,1
1234805788012687360,0,1,0,0,1
1234842786828029952,0,0,0,1,1
1234867088810029056,0,1,0,0,1
1234909953342701568,0,1,0,0,1
1234974136704872448,0,1,0,0,1
1235077554832171008,0,0,1,0,1
1235113225529839616,0,1,0,0,1
1235122249591664640,0,1,0,0,1
1235136352603328512,0,1,0,0,1
1234408409023295488,1,0,0,0,1
1234115512889565184,0,1,0,0,1
1233434867431624704,1,0,0,0,1
1233816210392965120,1,0,0,0,1
1233492087326285824,0,1,0,0,1
1233529768391430144,0,1,0,0,1
1233550153937612800,0,1,0,0,1
1233562351581921280,1,0,0,0,1
1233600945684123648,1,0,0,0,1
1233735671644291072,1,0,0,0,1
1233744315685494784,0,1,0,0,1
1233803483725254656,0,1,0,0,1
1233813507617021952,0,1,0,0,1
1233819233642926080,0,1,0,0,1
1234079142095785984,0,1,0,0,1
1233860805344612352,1,0,0,0,1
1233903993266425856,0,1,0,0,1
1233999480384520192,0,1,0,0,1
1234000787824676864,0,1,0,0,1
1234019827955748864,0,1,0,0,1
1234025548118183936,0,1,0,0,1
1234046939563483136,0,1,0,0,1
1234056103442313216,0,1,0,0,1
1234072708759138304,1,0,0,0,1
1230853300913729536,1,0,0,0,1
1230789646034055168,1,0,0,0,1
1230736798139047936,0,1,0,0,1
1228181474869821440,0,0,0,1,1
1227987223418671104,0,1,0,0,1
1227999762261123072,0,1,0,0,1
1227999921879515136,0,1,0,0,1
1228011343749533696,0,1,0,0,1
1228016719962112000,0,1,0,0,1
1228027598812438528,0,1,0,0,1
1228069941787512832,0,1,0,0,1
1228083678510768128,0,1,0,0,1
1228177464947425280,0,1,0,0,1
1228221902239535104,0,1,0,0,1
1227948409669246976,1,0,0,0,1
1228251323998646272,0,1,0,0,1
1228374715670110208,0,1,0,0,1
1228473428023422976,0,1,0,0,1
1228613431336501248,0,0,0,1,1
1228644244568539136,0,1,0,0,1
1228644446842974208,0,1,0,0,1
1228666915712897024,0,1,0,0,1
1228672762866216960,0,1,0,0,1
1228809595377856512,0,1,0,0,1
1227952287668150272,0,1,0,0,1
1227908162377768960,0,1,0,0,1
1229008439294283776,0,1,0,0,1
1227407381618987008,0,1,0,0,1
1226929759331868672,0,1,0,0,1
1226961438771560448,0,1,0,0,1
1227055049823657984,0,0,0,1,1
1227086134641033216,0,1,0,0,1
1227137549472337920,0,1,0,0,1
1227240074036670464,0,0,1,0,1
1227246582036340736,0,1,0,0,1
1227344983163908096,0,1,0,0,1
1227407309057347584,1,0,0,0,1
1227440472748101632,0,1,0,0,1
1227871297180512256,0,1,0,0,1
1227497131537125376,0,1,0,0,1
1227505541166981120,0,1,0,0,1
1227513630410694656,1,0,0,0,1
1227514178493145088,0,1,0,0,1
1227521195190308864,0,1,0,0,1
1227542109579812864,0,1,0,0,1
1227715749340426240,0,1,0,0,1
1227778452876476416,1,0,0,0,1
1227863389885452288,0,1,0,0,1
1228875585700667392,0,1,0,0,1
1229084502959390720,1,0,0,0,1
1230712328372420608,0,1,0,0,1
1230164064686481408,0,1,0,0,1
1229831610050269184,0,1,0,0,1
1229844073177063424,0,1,0,0,1
1229874927668383744,0,1,0,0,1
1229919233837912064,0,1,0,0,1
1230011590159798272,0,1,0,0,1
1230020167158992896,0,1,0,0,1
1230058997673267200,0,1,0,0,1
1230126321520398336,0,0,0,1,1
1230127246050045952,0,1,0,0,1
1230193365397970944,0,1,0,0,1
1229730865535578112,1,0,0,0,1
1230204687942651904,0,1,0,0,1
1230269230316228608,0,1,0,0,1
1230326991791874048,0,1,0,0,1
1230440530213003264,0,1,0,0,1
1230518758407467008,0,1,0,0,1
1230531618323955712,0,1,0,0,1
1230547240550379520,0,1,0,0,1
1230555837715951616,0,1,0,0,1
1230687314734723072,0,1,0,0,1
1229785988764966912,0,1,0,0,1
1229730294229610496,0,1,0,0,1
1229117738309816320,0,1,0,0,1
1229385434909827072,1,0,0,0,1
1229123363802505216,0,1,0,0,1
1229139567644725248,1,0,0,0,1
1229197538202275840,0,1,0,0,1
1229224606810198016,0,1,0,0,1
1229232905127419904,0,1,0,0,1
1229238409928986624,1,0,0,0,1
1229254449828433920,0,1,0,0,1
1229267924667420672,0,0,0,1,1
1229372234994724864,0,1,0,0,1
1229398160616779776,0,0,1,0,1
1229723249229123584,0,1,0,0,1
1229423098409226240,0,1,0,0,1
1229433577210667008,0,1,0,0,1
1229518858660143104,0,1,0,0,1
1229536457104162816,0,1,0,0,1
1229571688037322752,1,0,0,0,1
1229582174350802944,0,1,0,0,1
1229658996371488768,0,1,0,0,1
1229680028235059200,0,1,0,0,1
1229710066309353472,0,1,0,0,1
1235143185074130944,1,0,0,0,1
1235182565197107200,0,0,1,0,1
1235230474626158592,0,0,0,1,1
1239918277280882688,0,1,0,0,1
1239656399782674432,0,1,0,0,1
1239745451454156800,1,0,0,0,1
1239763620252323840,0,1,0,0,1
1239764969656176640,0,1,0,0,1
1239795421859516416,0,1,0,0,1
1239848690895863808,1,0,0,0,1
1239854545267613696,1,0,0,0,1
1239907107358605312,0,1,0,0,1
1239910373328740352,1,0,0,0,1
1239937869696782336,0,0,1,0,1
1239593072201207808,0,1,0,0,1
1239959695852371968,0,1,0,0,1
1239975716755845120,0,1,0,0,1
1239998681316761600,0,0,0,1,1
1240004274676891648,1,0,0,0,1
1240010627638341632,0,1,0,0,1
1240033114749100032,0,1,0,0,1
1240046850985492480,1,0,0,0,1
1240182275569930240,0,1,0,0,1
1240201545603592192,1,0,0,0,1
1239641367246245888,1,0,0,0,1
1239576871429267456,0,1,0,0,1
1240229062083313664,0,1,0,0,1
1239164312306036736,0,1,0,0,1
1238854603061551104,0,1,0,0,1
1238866386740543488,0,1,0,0,1
1238878103239180288,0,1,0,0,1
1238880798742384640,0,1,0,0,1
1238887166983303168,0,1,0,0,1
1238924986351583232,0,1,0,0,1
1239036681002483712,0,1,0,0,1
1239123577795801088,0,1,0,0,1
1239161053663105024,0,1,0,0,1
1239176829119991808,0,1,0,0,1
1239564365080211456,0,0,0,1,1
1239183743920660480,1,0,0,0,1
1239318499996164096,0,1,0,0,1
1239328626690097152,0,1,0,0,1
1239380500550017024,0,1,0,0,1
1239429640587857920,1,0,0,0,1
1239443530012999680,0,0,0,1,1
1239450522027020288,0,1,0,0,1
1239472974807392256,0,1,0,0,1
1239514643787202560,0,1,0,0,1
1240206901754953728,0,1,0,0,1
1240249739242807296,0,1,0,0,1
1238800491632607232,0,1,0,0,1
1241333906592260096,0,0,1,0,1
1241008197751787520,0,0,0,1,1
1241022739470835712,0,1,0,0,1
1241032817527619584,0,1,0,0,1
1241045728761458688,0,1,0,0,1
1241141528552255488,0,1,0,0,1
1241211555749826560,0,1,0,0,1
1241224788263174144,0,1,0,0,1
1241258151921369088,0,1,0,0,1
1241269730150760448,0,1,0,0,1
1241349540659281920,0,1,0,0,1
1240891709170442240,0,1,0,0,1
1241376457512890368,0,1,0,0,1
1241431950994391040,1,0,0,0,1
1241461429544325120,0,1,0,0,1
1241528472822054912,0,1,0,0,1
1241535358640119808,1,0,0,0,1
1241576065681649664,0,1,0,0,1
1241582879211008000,0,1,0,0,1
1241586226496339968,0,1,0,0,1
1241599045975584768,0,1,0,0,1
1240977406787280896,0,1,0,0,1
1240881986228457472,0,1,0,0,1
1240265364375613440,0,1,0,0,1
1240619440955416576,0,1,0,0,1
1240268314624098304,0,1,0,0,1
1240370034360250368,0,1,0,0,1
1240447863777361920,0,1,0,0,1
1240485933729714176,0,1,0,0,1
1240543377696927744,0,1,0,0,1
1240546324392497152,0,0,0,1,1
1240561436289576960,1,0,0,0,1
1240578860225363968,0,1,0,0,1
1240584055558725632,0,1,0,0,1
1240661469152215040,0,1,0,0,1
1240851292488114176,0,1,0,0,1
1240675800271257600,1,0,0,0,1
1240680467906650112,0,1,0,0,1
1240693003213250560,0,1,0,0,1
1240693036646047744,0,0,0,1,1
1240752219055509504,0,1,0,0,1
1240785856551620608,0,1,0,0,1
1240795041888718848,1,0,0,0,1
1240806372977115136,0,1,0,0,1
1240835261467996160,1,0,0,0,1
1238826953584414720,0,1,0,0,1
1238790544865796096,0,1,0,0,1
1235292715174289408,0,0,1,0,1
1236602641809125376,0,1,0,0,1
1236266711004762112,1,0,0,0,1
1236304197315964928,0,0,0,1,1
1236307329089445888,0,1,0,0,1
1236556308070817792,1,0,0,0,1
1236564511240392704,0,1,0,0,1
1236572283688247296,0,1,0,0,1
1236585385049952256,1,0,0,0,1
1236590645235437568,1,0,0,0,1
1236593927140134912,1,0,0,0,1
1236607395985387520,0,1,0,0,1
1236189277169553408,0,1,0,0,1
1236679160204058624,0,1,0,0,1
1236722876289597440,0,1,0,0,1
1236730130287849472,0,1,0,0,1
1236754503090737152,0,0,0,1,1
1236919172178853888,1,0,0,0,1
1236971748979085312,0,0,0,1,1
1236987693084454912,0,1,0,0,1
1237010584685641728,0,1,0,0,1
1237035631227871232,0,1,0,0,1
1236203717591994368,0,1,0,0,1
1236105303940349952,0,1,0,0,1
1237053648649125888,0,1,0,0,1
1235709136442208256,0,1,0,0,1
1235296358979874816,1,0,0,0,1
1235303401707233280,0,1,0,0,1
1235355367116242944,1,0,0,0,1
1235428650473779200,1,0,0,0,1
1235452037715972096,0,0,0,1,1
1235461678394937344,0,1,0,0,1
1235486810093965312,0,1,0,0,1
1235578229697572864,0,1,0,0,1
1235681918022270976,0,1,0,0,1
1235748939091128320,1,0,0,0,1
1236028653361905664,0,1,0,0,1
1235842915022192640,0,1,0,0,1
1235873461551038464,1,0,0,0,1
1235891505073553408,0,1,0,0,1
1235936691342454784,0,1,0,0,1
1235948196196691968,0,1,0,0,1
1235951968951996416,1,0,0,0,1
1235972890245206016,0,1,0,0,1
1235984489915879424,0,1,0,0,1
1235989690433638400,0,1,0,0,1
1237052976281329664,0,1,0,0,1
1237062961954533376,1,0,0,0,1
1238760318177861632,0,1,0,0,1
1238203867063406592,0,1,0,0,1
1237837111040016384,0,1,0,0,1
1237846473435312128,0,1,0,0,1
1237856992099590144,0,1,0,0,1
1237914259536969728,0,1,0,0,1
1237978767248617472,0,1,0,0,1
1238023634737913856,0,1,0,0,1
1238071377263054848,0,1,0,0,1
1238119499225681920,0,1,0,0,1
1238187352834674688,1,0,0,0,1
1238276732253331456,0,1,0,0,1
1237818089225453568,0,1,0,0,1
1238340980857884672,0,1,0,0,1
1238376265276686336,0,1,0,0,1
1238380053534257152,0,0,0,1,1
1238417364808380416,0,1,0,0,1
1238490862910410752,1,0,0,0,1
1238508987537969152,1,0,0,0,1
1238540121575534592,0,0,0,1,1
1238733174575902720,0,1,0,0,1
1238751573897097216,1,0,0,0,1
1237831742255435776,0,1,0,0,1
1237806501810655232,0,1,0,0,1
1237265233128779776,1,0,0,0,1
1237426572270997504,1,0,0,0,1
1237269043419242496,0,1,0,0,1
1237275434921922560,0,1,0,0,1
1237278664879771648,1,0,0,0,1
1237279519532371968,0,1,0,0,1
1237300858137821184,0,1,0,0,1
1237343193584336896,1,0,0,0,1
1237356309214670848,0,1,0,0,1
1237367034972864512,0,1,0,0,1
1237387279330467840,0,0,0,1,1
1237433702394855424,0,1,0,0,1
1237758219004542976,0,1,0,0,1
1237515978000531456,0,1,0,0,1
1237619142913597440,0,1,0,0,1
1237675619883737088,0,1,0,0,1
1237678424782704640,0,1,0,0,1
1237678850311479296,0,1,0,0,1
1237718980707512320,1,0,0,0,1
1237723755205419008,0,1,0,0,1
1237739544218394624,0,1,0,0,1
1237756639215747072,1,0,0,0,1
1252164481746157568,0,1,0,0,1
1252210226155184128,0,1,0,0,1
1276652857853239296,0,0,1,0,1
1270270866853629952,0,1,0,0,1
1268094004396208128,0,1,0,0,1
1268124942085865472,0,1,0,0,1
1268252874590482432,0,1,0,0,1
1268340865937870848,0,1,0,0,1
1268351689557409792,1,0,0,0,1
1268421504615809024,0,1,0,0,1
1268439875222732800,0,1,0,0,1
1268449458993463296,0,1,0,0,1
1268459245013434368,0,1,0,0,1
1268477264674672640,0,1,0,0,1
1268480555714138112,1,0,0,0,1
1268509771373608960,0,1,0,0,1
1268511113316089856,0,1,0,0,1
1268550680115118080,0,1,0,0,1
1268553204364648448,0,1,0,0,1
1268739336083607552,0,1,0,0,1
1268798569013743616,1,0,0,0,1
1268822617135501312,0,1,0,0,1
1268847967194058752,0,1,0,0,1
1268877323761303552,0,1,0,0,1
1268893977727717376,0,0,0,1,1
1268072881830887424,0,1,0,0,1
1268032703485657088,0,0,0,1,1
1268000505676001280,0,1,0,0,1
1267776401165385728,0,1,0,0,1
1267477173595758592,0,1,0,0,1
1267489434766721024,0,1,0,0,1
1267515608226082816,0,1,0,0,1
1267516179599568896,0,1,0,0,1
1267623324592422912,0,1,0,0,1
1267626591187808256,0,1,0,0,1
1267733110457880576,0,1,0,0,1
1267738506434093056,0,1,0,0,1
1267753660114710528,1,0,0,0,1
1267823778777591808,0,1,0,0,1
1267983593877331968,0,1,0,0,1
1267830868338327552,1,0,0,0,1
1267836758395203584,0,1,0,0,1
1267872740050120704,0,1,0,0,1
1267885603745607680,0,1,0,0,1
1267909220696899584,0,1,0,0,1
1267913607788060672,0,1,0,0,1
1267917266731118592,0,1,0,0,1
1267952579452993536,0,1,0,0,1
1267973918624755712,0,1,0,0,1
1268961835912323072,0,1,0,0,1
1269025561843769344,0,1,0,0,1
1269147717353082880,0,1,0,0,1
1270025835257438208,0,1,0,0,1
1269857791071727616,0,1,0,0,1
1269875782278676480,1,0,0,0,1
1269885194779217920,0,0,1,0,1
1269921494596849664,1,0,0,0,1
1269927748186841088,0,1,0,0,1
1269961715611041792,0,1,0,0,1
1269980789359378432,0,1,0,0,1
1269997620090605568,0,1,0,0,1
1270014991794667520,1,0,0,0,1
1270056760687177728,1,0,0,0,1
1269777266034302976,0,0,1,0,1
1270073559302447104,0,1,0,0,1
1270120049768984576,1,0,0,0,1
1270141350961459200,0,0,0,1,1
1270155412268974080,0,1,0,0,1
1270176807916986368,0,1,0,0,1
1270207182584156160,0,1,0,0,1
1270212144114487296,0,1,0,0,1
1270254223649918976,0,1,0,0,1
1270259590391894016,1,0,0,0,1
1269847739719987200,1,0,0,0,1
1269721304657268736,0,1,0,0,1
1269149836521193472,0,1,0,0,1
1269447640971960320,0,1,0,0,1
1269150615298543616,0,1,0,0,1
1269152140833861632,0,1,0,0,1
1269184326060716032,0,1,0,0,1
1269259857141460992,1,0,0,0,1
1269270071186264064,0,1,0,0,1
1269294368537509888,0,1,0,0,1
1269359619236745216,0,0,0,1,1
1269367403001065472,0,1,0,0,1
1269371584797687808,1,0,0,0,1
1269506698034794496,0,1,0,0,1
1269699646504517632,0,1,0,0,1
1269521623322943488,0,1,0,0,1
1269544780234493952,1,0,0,0,1
1269556976373174272,0,1,0,0,1
1269576732597800960,0,0,0,1,1
1269583599935905792,0,1,0,0,1
1269585427025014784,0,1,0,0,1
1269591760562532352,0,0,1,0,1
1269604476282904576,0,1,0,0,1
1269650425994784768,0,1,0,0,1
1267475424218615808,0,1,0,0,1
1267445984176545792,1,0,0,0,1
1267435385665097728,0,1,0,0,1
1265226128312209408,0,1,0,0,1
1264886740780822528,0,1,0,0,1
1264920834398961664,0,1,0,0,1
1264921927812091904,0,1,0,0,1
1264976692495503360,0,0,0,1,1
1264981912600403968,0,0,0,1,1
1265032066858651648,0,1,0,0,1
1265052039563948032,0,1,0,0,1
1265177984463507456,1,0,0,0,1
1265218480233684992,0,1,0,0,1
1265238908213788672,0,1,0,0,1
1264724122350702592,0,1,0,0,1
1265254608055738368,0,1,0,0,1
1265355953106571264,0,1,0,0,1
1265360485819445248,0,1,0,0,1
1265362006007218176,0,1,0,0,1
1265422603692453888,0,1,0,0,1
1265519489262682112,0,1,0,0,1
1265594593292062720,0,0,1,0,1
1265602341937479680,0,1,0,0,1
1265697860042948608,0,1,0,0,1
1264855219663507456,0,1,0,0,1
1264702220169367552,0,1,0,0,1
1265865365776732160,1,0,0,0,1
1264424186354774016,0,1,0,0,1
1264209968103936000,0,1,0,0,1
1264240684959240192,0,1,0,0,1
1264266316510375936,0,1,0,0,1
1264274318663573504,1,0,0,0,1
1264274534028451840,0,1,0,0,1
1264282718545854464,0,1,0,0,1
1264301156181798912,0,1,0,0,1
1264406798338977792,0,1,0,0,1
1264407373738905600,0,1,0,0,1
1264425586837139456,0,1,0,0,1
1264692192557162496,0,1,0,0,1
1264450195577765888,0,1,0,0,1
1264551678667194368,0,1,0,0,1
1264598250868232192,0,1,0,0,1
1264615915213123584,0,1,0,0,1
1264633063998439424,1,0,0,0,1
1264641941465071616,0,1,0,0,1
1264663774826463232,0,1,0,0,1
1264675902278873088,0,1,0,0,1
1264676853458939904,0,1,0,0,1
1265701881029918720,1,0,0,0,1
1265903586065727488,0,1,0,0,1
1267390508764065792,0,1,0,0,1
1266993464371273728,0,1,0,0,1
1266744944053514240,0,1,0,0,1
1266767138825605120,0,1,0,0,1
1266769653474394112,0,1,0,0,1
1266808162159595520,0,1,0,0,1
1266861472556232704,0,1,0,0,1
1266902580996734976,1,0,0,0,1
1266927762662662144,0,1,0,0,1
1266973251609165824,0,0,0,1,1
1266986519811719168,0,1,0,0,1
1267032360933117952,0,1,0,0,1
1266714327551262720,0,1,0,0,1
1267050087391416320,0,0,0,1,1
1267085454316314624,0,1,0,0,1
1267176260888940544,0,0,0,1,1
1267190760266518528,0,1,0,0,1
1267229444315348992,0,0,0,1,1
1267241392838856704,1,0,0,0,1
1267288803754029056,1,0,0,0,1
1267348481901047808,0,1,0,0,1
1267377440986300416,0,1,0,0,1
1266724919057907712,0,0,0,1,1
1266702718808227840,1,0,0,0,1
1265913921694830592,0,1,0,0,1
1266406294757539840,1,0,0,0,1
1265919525565931520,0,1,0,0,1
1265919868878159872,0,1,0,0,1
1265924036149862400,0,1,0,0,1
1266071881867763712,0,1,0,0,1
1266299194395918336,0,1,0,0,1
1266323486592696320,0,0,0,1,1
1266365114657079296,1,0,0,0,1
1266369764026224640,0,1,0,0,1
1266394405809815552,0,0,0,1,1
1266425932354486272,0,1,0,0,1
1266678154002759680,0,1,0,0,1
1266449042533494784,0,1,0,0,1
1266571027934519296,0,0,0,1,1
1266596974003982336,0,1,0,0,1
1266624095531212800,0,1,0,0,1
1266637011823271936,0,1,0,0,1
1266642426749476864,0,1,0,0,1
1266649498312306688,0,0,1,0,1
1266668693670498304,0,1,0,0,1
1266671452905865216,0,1,0,0,1
1270266782197006336,0,1,0,0,1
1270294804396740608,0,0,0,1,1
1252239490686607360,0,1,0,0,1
1270300705828593664,0,1,0,0,1
1274044224296509440,0,1,0,0,1
1274050643397918720,0,1,0,0,1
1274052886436155392,1,0,0,0,1
1274170071045341184,0,1,0,0,1
1274247318733283328,0,1,0,0,1
1274263610018025472,0,0,1,0,1
1274288340372729856,0,1,0,0,1
1274310997130559488,0,1,0,0,1
1274318927603077120,0,1,0,0,1
1274341606372540416,0,1,0,0,1
1274356779850366976,0,1,0,0,1
1274357585311928320,0,0,1,0,1
1274382324961103872,0,1,0,0,1
1274383804497637376,0,1,0,0,1
1274402711841017856,0,1,0,0,1
1274408100200460288,1,0,0,0,1
1274422970300022784,0,1,0,0,1
1274428444328079360,0,1,0,0,1
1274433460040462336,1,0,0,0,1
1274560167884083200,0,1,0,0,1
1274597751234236416,0,1,0,0,1
1274043740479344640,0,1,0,0,1
1274002824058343424,0,1,0,0,1
1273987242919264256,0,1,0,0,1
1273675056300908544,0,1,0,0,1
1273559786068606976,1,0,0,0,1
1273562096773414912,1,0,0,0,1
1273575568118706176,0,1,0,0,1
1273599265848406016,0,1,0,0,1
1273650572244246528,0,1,0,0,1
1273652383718014976,0,1,0,0,1
1273653175925407744,0,1,0,0,1
1273665868547801088,1,0,0,0,1
1273672326098219008,0,1,0,0,1
1273675234755764224,1,0,0,0,1
1273961137520775168,1,0,0,0,1
1273681947957448704,0,1,0,0,1
1273683729727156224,0,1,0,0,1
1273703813015236608,1,0,0,0,1
1273793124733644800,0,1,0,0,1
1273837867186282496,1,0,0,0,1
1273858059056676864,0,0,0,1,1
1273897465159319552,0,1,0,0,1
1273902363674316800,0,0,0,1,1
1273908046905909248,0,1,0,0,1
1274601578633351168,0,1,0,0,1
1274647071631511552,0,1,0,0,1
1274664727780765696,0,1,0,0,1
1275979273057136640,0,1,0,0,1
1275496483282919424,0,1,0,0,1
1275514468550807552,0,1,0,0,1
1275525314467135488,0,1,0,0,1
1275717140889448448,0,1,0,0,1
1275758727757365248,1,0,0,0,1
1275845588051881984,0,1,0,0,1
1275872659767787520,0,1,0,0,1
1275917496101539840,0,1,0,0,1
1275959354626277376,0,1,0,0,1
1275984137065607168,1,0,0,0,1
1275404831838973952,0,1,0,0,1
1276152000175104000,0,1,0,0,1
1276217579271589888,0,1,0,0,1
1276281449537327104,0,1,0,0,1
1276316516124942336,0,1,0,0,1
1276331695776477184,0,1,0,0,1
1276374270252384256,1,0,0,0,1
1276443331451551744,0,1,0,0,1
1276517527477276672,1,0,0,0,1
1276580550464192512,0,1,0,0,1
1275484405369319424,0,1,0,0,1
1275397124134522880,0,1,0,0,1
1274689887392927744,0,1,0,0,1
1275042163131183104,0,1,0,0,1
1274711345464848384,1,0,0,0,1
1274745923101495296,0,1,0,0,1
1274831776553160704,1,0,0,0,1
1274844334270173184,0,1,0,0,1
1274881205356421120,0,1,0,0,1
1274962831813697536,0,1,0,0,1
1274987020213985280,0,1,0,0,1
1274996275008737280,0,1,0,0,1
1275007523704246272,0,1,0,0,1
1275065286748594176,0,1,0,0,1
1275376465219993600,0,1,0,0,1
1275091375474835456,0,1,0,0,1
1275174834876620800,1,0,0,0,1
1275176552356032512,0,1,0,0,1
1275252599579500544,1,0,0,0,1
1275329180369072128,0,1,0,0,1
1275337017732325376,0,1,0,0,1
1275338799669747712,0,1,0,0,1
1275347329600466944,0,1,0,0,1
1275367717693018112,0,1,0,0,1
1273523738231762944,0,1,0,0,1
1273467786774433792,0,1,0,0,1
1273438114774757376,0,1,0,0,1
1271682584930471936,1,0,0,0,1
1271334047680102400,0,0,0,1,1
1271364212389031936,0,0,0,1,1
1271373287591796736,1,0,0,0,1
1271416063750737920,1,0,0,0,1
1271423807748628480,0,1,0,0,1
1271434562002878464,1,0,0,0,1
1271457869146161152,0,1,0,0,1
1271528019023335424,0,1,0,0,1
1271607669145534464,0,1,0,0,1
1271686382994419712,0,1,0,0,1
1271256806988279808,0,1,0,0,1
1271703827440254976,1,0,0,0,1
1271723181481525248,1,0,0,0,1
1271741577216524288,0,1,0,0,1
1271773611435663360,1,0,0,0,1
1271806777340772352,0,1,0,0,1
1271921753959174144,0,1,0,0,1
1271923249446780928,0,1,0,0,1
1271963753458720768,1,0,0,0,1
1272002325872168960,0,1,0,0,1
1271287573856415744,1,0,0,0,1
1271052742648160256,0,1,0,0,1
1272108821813448704,0,1,0,0,1
1270647558730219520,0,1,0,0,1
1270333640950591488,0,0,0,1,1
1270362942450606080,0,1,0,0,1
1270378644062343168,0,0,0,1,1
1270389762633789440,0,1,0,0,1
1270428208668819456,1,0,0,0,1
1270488473527558144,0,1,0,0,1
1270564529412472832,0,1,0,0,1
1270572506752180224,0,1,0,0,1
1270610875188035584,0,1,0,0,1
1270693520907603968,0,1,0,0,1
1271020629018509312,0,1,0,0,1
1270723491176673280,0,0,0,1,1
1270737588438085632,1,0,0,0,1
1270781170930921472,0,1,0,0,1
1270798769098051584,1,0,0,0,1
1270884743333068800,0,1,0,0,1
1270910094205575168,0,1,0,0,1
1270933608023289856,0,1,0,0,1
1270939823147290624,0,1,0,0,1
1270997443480563712,1,0,0,0,1
1272086466089213952,0,1,0,0,1
1272109536158023680,0,1,0,0,1
1273421527602442240,0,1,0,0,1
1273157723434221568,1,0,0,0,1
1272917298257334272,1,0,0,0,1
1272930355641675776,0,1,0,0,1
1272932916402753536,0,1,0,0,1
1272958991317024768,0,1,0,0,1
1272960248802926592,0,1,0,0,1
1272998399604817920,0,1,0,0,1
1273055183371735040,0,1,0,0,1
1273074752916058112,0,1,0,0,1
1273116176835543040,0,1,0,0,1
1273177701919137792,1,0,0,0,1
1272859324751253504,1,0,0,0,1
1273183687849345024,0,1,0,0,1
1273210671639826432,0,1,0,0,1
1273213160250421248,1,0,0,0,1
1273216455849455616,0,1,0,0,1
1273281831371079680,0,1,0,0,1
1273297688528904192,0,1,0,0,1
1273303401833644032,0,1,0,0,1
1273335462506180608,0,1,0,0,1
1273387305588457472,0,1,0,0,1
1272882565385347072,1,0,0,0,1
1272854406627811328,0,1,0,0,1
1272147912726888448,0,1,0,0,1
1272460841619603456,1,0,0,0,1
1272168318795780096,0,0,1,0,1
1272175900512137216,0,1,0,0,1
1272192900206669824,1,0,0,0,1
1272203651830833152,0,0,1,0,1
1272215699851816960,0,1,0,0,1
1272248695086559232,0,1,0,0,1
1272329437279911936,0,1,0,0,1
1272356378095398912,0,1,0,0,1
1272396955063218176,0,1,0,0,1
1272491024489656320,1,0,0,0,1
1272836699165347840,0,0,1,0,1
1272508227695992832,0,0,0,1,1
1272583411840937984,0,0,1,0,1
1272633114578178048,0,1,0,0,1
1272659047234375680,0,1,0,0,1
1272667598795280384,0,0,0,1,1
1272766553319247872,0,1,0,0,1
1272771812435259392,1,0,0,0,1
1272795987719774208,1,0,0,0,1
1272797445676650496,0,1,0,0,1
1264158323395506176,0,1,0,0,1
1264126547402919936,0,1,0,0,1
1264114113925402624,0,1,0,0,1
1264096423630553088,0,1,0,0,1
1255847792754462720,0,1,0,0,1
1255847807954501632,1,0,0,0,1
1255849889247850496,0,1,0,0,1
1255867666746806272,1,0,0,0,1
1255873894172540928,1,0,0,0,1
1255874242534612992,0,1,0,0,1
1255887394286469120,0,1,0,0,1
1255906008288972800,0,1,0,0,1
1255933783532089344,1,0,0,0,1
1255972657788588032,0,1,0,0,1
1256080728837808128,0,0,0,1,1
1256182232659693568,0,1,0,0,1
1256187005085548544,1,0,0,0,1
1256213263198584832,0,1,0,0,1
1256228431869640704,0,1,0,0,1
1256274478486687744,1,0,0,0,1
1256284775071047680,0,1,0,0,1
1256302790005133312,0,0,1,0,1
1256305337780461568,1,0,0,0,1
1256340072384860160,0,1,0,0,1
1256410501489328128,1,0,0,0,1
1255831194882768896,0,0,1,0,1
1255813576914284544,1,0,0,0,1
1255810904534351872,0,1,0,0,1
1255418248159469568,0,1,0,0,1
1254799723191570432,0,1,0,0,1
1254815139104198656,0,1,0,0,1
1254830362976493568,0,1,0,0,1
1254893074360098816,0,1,0,0,1
1254912194162110464,0,1,0,0,1
1254943275309502464,0,1,0,0,1
1255055113749696512,0,1,0,0,1
1255095719771455488,0,1,0,0,1
1255306660895174656,0,1,0,0,1
1255421346483486720,0,1,0,0,1
1255798441818624000,0,1,0,0,1
1255440577526669312,0,1,0,0,1
1255449384856309760,0,1,0,0,1
1255516605154500608,0,1,0,0,1
1255541435002052608,0,1,0,0,1
1255599152399937536,0,1,0,0,1
1255741956866498560,1,0,0,0,1
1255767598743998464,0,1,0,0,1
1255775218296971264,1,0,0,0,1
1255795464445837312,0,1,0,0,1
1256484133238235136,0,1,0,0,1
1256484659518636032,0,1,0,0,1
1256545532027207680,1,0,0,0,1
1257726701565554688,1,0,0,0,1
1257406683912994816,0,1,0,0,1
1257559484471234560,0,1,0,0,1
1257562922651234304,0,1,0,0,1
1257592498362486784,0,1,0,0,1
1257607042442973184,0,1,0,0,1
1257613921785184256,0,1,0,0,1
1257645039636881408,1,0,0,0,1
1257647404318363648,0,1,0,0,1
1257693716602654720,0,1,0,0,1
1257795382127415296,1,0,0,0,1
1257332743698079744,0,1,0,0,1
1257806487780569088,0,1,0,0,1
1257852474125410304,0,1,0,0,1
1257867278969974784,1,0,0,0,1
1257874901429563392,1,0,0,0,1
1257915841422807040,0,1,0,0,1
1257981057980383232,0,1,0,0,1
1257983450449096704,0,1,0,0,1
1258015691837517824,0,1,0,0,1
1258020520211218432,1,0,0,0,1
1257405260722835456,0,0,1,0,1
1257207433438597120,0,1,0,0,1
1256599840395575296,0,1,0,0,1
1256888416471523328,0,1,0,0,1
1256619736768614400,0,1,0,0,1
1256630928945922048,1,0,0,0,1
1256635443766067200,0,1,0,0,1
1256642367697887232,0,1,0,0,1
1256645726605541376,0,1,0,0,1
1256650747820879872,0,1,0,0,1
1256663916521885696,0,1,0,0,1
1256858596291338240,0,1,0,0,1
1256862725709406208,0,1,0,0,1
1256892444827947008,0,1,0,0,1
1257198458630549504,1,0,0,0,1
1256925006849806336,1,0,0,0,1
1256951864211525632,1,0,0,0,1
1256958639040069632,0,1,0,0,1
1256993743158358016,0,1,0,0,1
1257000544633327616,0,1,0,0,1
1257073761226035200,0,1,0,0,1
1257119584706052096,0,1,0,0,1
1257152700464185344,0,0,1,0,1
1257164876193181696,0,1,0,0,1
1254799591725125632,0,1,0,0,1
1254763946294292480,0,1,0,0,1
1254734436979159040,0,1,0,0,1
1253059653753352192,0,1,0,0,1
1252838018605477888,0,1,0,0,1
1252869424308084736,0,1,0,0,1
1252907008266813440,0,1,0,0,1
1252908390520627200,0,0,0,1,1
1252916369785380864,0,1,0,0,1
1252918619350024192,0,1,0,0,1
1252964779062329344,1,0,0,0,1
1252977959289454592,0,1,0,0,1
1252978684581076992,1,0,0,0,1
1253106182467788800,0,1,0,0,1
1252721242009825280,0,1,0,0,1
1253185675207290880,1,0,0,0,1
1253283884294385664,0,1,0,0,1
1253301384528777216,0,1,0,0,1
1253349578662789120,0,1,0,0,1
1253435215277506560,1,0,0,0,1
1253465142844706816,0,1,0,0,1
1253524254290780160,0,1,0,0,1
1253554501115695104,1,0,0,0,1
1253584405932761088,0,1,0,0,1
1252794343024443392,0,1,0,0,1
1252703870616125440,0,1,0,0,1
1253613368470122496,1,0,0,0,1
1252474815836852224,0,1,0,0,1
1252260403683475456,0,1,0,0,1
1252310745599049728,0,1,0,0,1
1252325584710979584,0,1,0,0,1
1252331910405279744,0,1,0,0,1
1252350147754962944,0,1,0,0,1
1252376808219082752,1,0,0,0,1
1252386189052653568,0,1,0,0,1
1252397175142789120,0,1,0,0,1
1252466760948740096,1,0,0,0,1
1252491299627753472,0,1,0,0,1
1252675426847096832,0,1,0,0,1
1252527079146639360,0,1,0,0,1
1252541495598551040,0,1,0,0,1
1252563801389649920,0,1,0,0,1
1252607480393277440,0,1,0,0,1
1252615956876210176,0,1,0,0,1
1252623508951236608,0,1,0,0,1
1252641002994753536,0,1,0,0,1
1252647352122265600,0,1,0,0,1
1252648583721095168,0,1,0,0,1
1253593681883533312,0,1,0,0,1
1253666685006999552,0,0,0,1,1
1254728005479329792,0,1,0,0,1
1254526679579492352,0,1,0,0,1
1254376457544974336,1,0,0,0,1
1254386353896165376,1,0,0,0,1
1254396944530714624,0,1,0,0,1
1254428238488756224,0,0,1,0,1
1254440267912024064,1,0,0,0,1
1254444953180217344,0,1,0,0,1
1254469801935810560,0,1,0,0,1
1254473660917841920,0,1,0,0,1
1254476387836203008,1,0,0,0,1
1254546211161268224,1,0,0,0,1
1254364101767200768,0,1,0,0,1
1254563983761145856,0,1,0,0,1
1254581908731617280,0,1,0,0,1
1254626685661655040,0,1,0,0,1
1254661192758501376,0,1,0,0,1
1254669927253827584,0,1,0,0,1
1254694305542758400,0,1,0,0,1
1254695985038544896,1,0,0,0,1
1254707499955105792,0,1,0,0,1
1254723999927611392,0,1,0,0,1
1254373201028800512,0,1,0,0,1
1254296078784040960,0,1,0,0,1
1253679551881740288,0,1,0,0,1
1253984129160536064,0,1,0,0,1
1253703047114559488,0,1,0,0,1
1253708598019895296,0,1,0,0,1
1253750006848172032,0,1,0,0,1
1253809585502257152,0,1,0,0,1
1253813744414703616,0,1,0,0,1
1253921466971754496,0,1,0,0,1
1253943546593320960,0,1,0,0,1
1253956204566642688,0,1,0,0,1
1253965695668412416,0,1,0,0,1
1253994640325443584,1,0,0,0,1
1254258182790266880,0,1,0,0,1
1254010855626280960,0,1,0,0,1
1254053905098555392,0,1,0,0,1
1254063111599882240,1,0,0,0,1
1254066229020700672,0,1,0,0,1
1254116187115589632,0,1,0,0,1
1254122789361065984,0,1,0,0,1
1254123046715240448,0,1,0,0,1
1254160535261777920,0,1,0,0,1
1254180897596850176,0,1,0,0,1
1258023692858281984,0,1,0,0,1
1258077451604897792,0,1,0,0,1
1258078882265063424,0,1,0,0,1
1262307678275145728,0,1,0,0,1
1262014682484834304,0,1,0,0,1
1262025276583804928,0,1,0,0,1
1262026764785770496,0,1,0,0,1
1262052627241730048,1,0,0,0,1
1262063850310041600,0,1,0,0,1
1262088355904393216,0,1,0,0,1
1262089022412926976,0,1,0,0,1
1262219198069178368,0,1,0,0,1
1262273785899683840,1,0,0,0,1
1262318235325730816,0,1,0,0,1
1261985338777653248,0,1,0,0,1
1262359686717878272,0,1,0,0,1
1262570340028309504,1,0,0,0,1
1262609191862185984,0,1,0,0,1
1262610648179097600,1,0,0,0,1
1262639850961936384,1,0,0,0,1
1262673771246374912,0,0,1,0,1
1262685571820015616,0,1,0,0,1
1262739615775162368,0,1,0,0,1
1262799044587462656,0,1,0,0,1
1262010542128062464,1,0,0,0,1
1261985035269308416,0,1,0,0,1
1262845898096328704,0,1,0,0,1
1261376156844068864,0,1,0,0,1
1261157435600809984,0,1,0,0,1
1261170934414639104,0,1,0,0,1
1261200658427854848,1,0,0,0,1
1261213752847933440,0,1,0,0,1
1261251271383801856,0,1,0,0,1
1261258999149854720,0,1,0,0,1
1261264587619471360,0,1,0,0,1
1261342998400512000,0,1,0,0,1
1261375933644075008,0,1,0,0,1
1261382550523650048,0,1,0,0,1
1261960944818827264,0,1,0,0,1
1261468175691943936,0,1,0,0,1
1261513423029862400,1,0,0,0,1
1261531611780255744,0,1,0,0,1
1261663171657506816,1,0,0,0,1
1261728873621925888,1,0,0,0,1
1261856749323247616,0,1,0,0,1
1261906176628776960,1,0,0,0,1
1261940560274784256,0,1,0,0,1
1261950438573617152,0,1,0,0,1
1262803954796240896,1,0,0,0,1
1262906633333678080,0,0,0,1,1
1261151216463036416,0,1,0,0,1
1263699650474676224,0,1,0,0,1
1263461546396733440,1,0,0,0,1
1263500274829836288,1,0,0,0,1
1263509760244158464,0,1,0,0,1
1263540231875317760,0,1,0,0,1
1263552371940044800,0,1,0,0,1
1263580511277989888,0,1,0,0,1
1263642467921846272,0,1,0,0,1
1263667957902848000,0,1,0,0,1
1263672574573268992,0,0,1,0,1
1263714767803281408,1,0,0,0,1
1263436312260075520,0,1,0,0,1
1263732768300769280,0,1,0,0,1
1263740111059025920,0,1,0,0,1
1263749540076818432,1,0,0,0,1
1263811921007927296,0,1,0,0,1
1263813311759560704,0,1,0,0,1
1263865870205497344,1,0,0,0,1
1263955460148924416,0,1,0,0,1
1264061017362964480,0,1,0,0,1
1264090057096540160,0,1,0,0,1
1263444643967938560,0,1,0,0,1
1263434671712538624,0,1,0,0,1
1262972704023547904,1,0,0,0,1
1263211972079697920,1,0,0,0,1
1263017666123612160,0,1,0,0,1
1263021159270023168,0,1,0,0,1
1263039865169592320,1,0,0,0,1
1263039928063201280,0,1,0,0,1
1263084850564612096,0,1,0,0,1
1263119170926977024,0,1,0,0,1
1263158942395445248,0,1,0,0,1
1263196393121996800,0,1,0,0,1
1263209204023799808,1,0,0,0,1
1263232354400612352,0,1,0,0,1
1263422842055667712,1,0,0,0,1
1263256780601282560,0,1,0,0,1
1263296290714038272,0,1,0,0,1
1263349145026408448,1,0,0,0,1
1263363427768184832,0,1,0,0,1
1263367318945648640,0,1,0,0,1
1263371098151886848,0,1,0,0,1
1263379908102946816,0,1,0,0,1
1263395793999888384,0,1,0,0,1
1263415772723978240,0,1,0,0,1
1261152750525538304,0,1,0,0,1
1261141399451234304,0,1,0,0,1
1258084756484272128,0,1,0,0,1
1259088388986212352,0,1,0,0,1
1258973326145282048,1,0,0,0,1
1258994523193180160,0,1,0,0,1
1258999118241783808,0,1,0,0,1
1259029564740767744,0,1,0,0,1
1259049602701037568,0,1,0,0,1
1259076479377215488,0,1,0,0,1
1259076734160269312,0,1,0,0,1
1259079541441658880,0,1,0,0,1
1259086404182835200,1,0,0,0,1
1259156818573524992,0,1,0,0,1
1258811238441721856,0,1,0,0,1
1259218021756792832,1,0,0,0,1
1259232014936543232,0,1,0,0,1
1259274352924618752,0,0,0,1,1
1259294002857357312,0,1,0,0,1
1259351287713447936,0,1,0,0,1
1259394664332963840,0,1,0,0,1
1259415122268827648,0,1,0,0,1
1259415280238780416,1,0,0,0,1
1259448630949404672,0,1,0,0,1
1258845303693811712,0,1,0,0,1
1258778784972410880,0,1,0,0,1
1259481273984311296,0,1,0,0,1
1258378771666739200,1,0,0,0,1
1258088224624463872,0,1,0,0,1
1258132267618250752,0,0,0,1,1
1258153937007456256,0,1,0,0,1
1258194192792092672,0,1,0,0,1
1258259851630661632,0,1,0,0,1
1258276519673131008,1,0,0,0,1
1258282299315105792,0,1,0,0,1
1258346476708773888,0,1,0,0,1
1258364665953910784,0,1,0,0,1
1258381656030957568,0,1,0,0,1
1258778052823183360,1,0,0,0,1
1258429059593355264,0,1,0,0,1
1258453295569367040,0,1,0,0,1
1258487378295078912,0,1,0,0,1
1258581919702437888,0,1,0,0,1
1258588152756871168,0,1,0,0,1
1258604741296222208,0,1,0,0,1
1258611836326469632,0,1,0,0,1
1258671944507023360,0,1,0,0,1
1258737216098119680,0,1,0,0,1
1259452492091441152,0,1,0,0,1
1259507392649269248,0,1,0,0,1
1261126355074183168,0,1,0,0,1
1260692626296078336,0,1,0,0,1
1260446258021498880,0,1,0,0,1
1260478680570175488,1,0,0,0,1
1260493387154837504,0,1,0,0,1
1260527167462690816,0,1,0,0,1
1260547834815930368,0,1,0,0,1
1260559877723824128,0,1,0,0,1
1260590314194116608,1,0,0,0,1
1260606763637723136,1,0,0,0,1
1260608596020211712,0,1,0,0,1
1260733396583579648,0,1,0,0,1
1260337980897554432,0,1,0,0,1
1260780556771487744,1,0,0,0,1
1260804359203553280,0,0,1,0,1
1260848543960612864,0,1,0,0,1
1260916326903590912,1,0,0,0,1
1260954380028784640,1,0,0,0,1
1260961737639170048,0,1,0,0,1
1260982257965203456,0,1,0,0,1
1261023136343977984,0,0,0,1,1
1261050341447077888,0,1,0,0,1
1260364349178249216,0,1,0,0,1
1260285266692014080,0,1,0,0,1
1259515129592336384,0,1,0,0,1
1259802264081969152,0,1,0,0,1
1259516270342541312,0,1,0,0,1
1259565292981596160,0,1,0,0,1
1259598410904199168,0,1,0,0,1
1259613643072733184,1,0,0,0,1
1259642938054737920,0,1,0,0,1
1259672210018496512,0,1,0,0,1
1259687933529010176,1,0,0,0,1
1259755693982339072,1,0,0,0,1
1259797333467774976,0,0,0,1,1
1259807737749352448,0,0,0,1,1
1260247225139150848,0,1,0,0,1
1259824810189885440,0,1,0,0,1
1259829339270656000,0,1,0,0,1
1260034595329699840,1,0,0,0,1
1260084927401508864,1,0,0,0,1
1260173380294041600,1,0,0,0,1
1260174534243766272,0,0,1,0,1
1260182325343772672,0,1,0,0,1
1260206356415549440,0,1,0,0,1
1260246045164011520,0,0,0,1,1
1333365629114576896,0,1,0,0,1
1333394302513287168,0,1,0,0,1
939076969269936128,0,1,0,0,1
1467676691292049408,0,1,0,0,1
1462435752709476352,1,0,0,0,1
1462451935429210112,0,1,0,0,1
1462460557773225984,0,1,0,0,1
1462520193960361984,0,1,0,0,1
1462696683288993792,0,0,0,1,1
1462832264727998464,0,1,0,0,1
1462842774517166080,0,1,0,0,1
1462848075123286016,0,0,1,0,1
1462924004348645376,1,0,0,0,1
1463010149694541824,0,1,0,0,1
1463079834654064640,0,1,0,0,1
1463119294426845184,0,1,0,0,1
1463164154865283072,0,1,0,0,1
1463187229019238400,0,1,0,0,1
1463195541651668992,0,1,0,0,1
1463215700797845504,0,1,0,0,1
1463239511513579520,1,0,0,0,1
1463359767447957504,0,1,0,0,1
1463409469576994816,0,1,0,0,1
1463444765261762560,0,1,0,0,1
1463534211428720640,0,1,0,0,1
1462364360760774656,0,1,0,0,1
1462341149885181952,0,1,0,0,1
1462205011404935168,0,1,0,0,1
1461783856609177600,0,1,0,0,1
1461423018727686144,0,1,0,0,1
1461427752540774400,0,1,0,0,1
1461535059098308608,1,0,0,0,1
1461548429788602368,0,1,0,0,1
1461582635323461632,0,1,0,0,1
1461656356457308160,0,1,0,0,1
1461662952046612480,0,1,0,0,1
1461743965594599424,0,1,0,0,1
1461756131651596288,1,0,0,0,1
1461838236758659072,0,1,0,0,1
1462157914165202944,0,1,0,0,1
1461906177709592576,1,0,0,0,1
1461907820991987712,0,1,0,0,1
1461913118334980096,0,1,0,0,1
1461979265231044608,0,1,0,0,1
1461980148819902464,0,1,0,0,1
1462003548728737792,0,1,0,0,1
1462053589292101632,0,1,0,0,1
1462062934478180352,0,1,0,0,1
1462138665438793728,0,1,0,0,1
1463694112394260480,0,1,0,0,1
1463824509954400256,1,0,0,0,1
1463892280276754432,0,1,0,0,1
1466826941248454656,1,0,0,0,1
1465996421568798720,0,1,0,0,1
1466056537231740928,0,1,0,0,1
1466079519379537920,0,1,0,0,1
1466174284611653632,0,1,0,0,1
1466386237309267968,0,1,0,0,1
1466449144076144640,0,1,0,0,1
1466496305904168960,0,1,0,0,1
1466543078915907584,0,0,1,0,1
1466813797075755008,0,0,0,1,1
1466847173815980032,0,1,0,0,1
1465756642180481024,0,1,0,0,1
1466870369067929600,1,0,0,0,1
1467077618965098496,0,1,0,0,1
1467120099635040256,0,1,0,0,1
1467147013968080896,0,0,0,1,1
1467304697123979264,0,1,0,0,1
1467401897678196736,0,1,0,0,1
1467514790327341056,0,0,0,1,1
1467587489384828928,0,1,0,0,1
1467589112756461568,0,1,0,0,1
1465992608329703424,0,1,0,0,1
1465663795444002816,1,0,0,0,1
1463988213668790272,0,1,0,0,1
1464545493053329408,0,1,0,0,1
1464124032291598336,0,1,0,0,1
1464129334466252800,0,1,0,0,1
1464146751829467136,1,0,0,0,1
1464162878316224512,0,1,0,0,1
1464232094100508672,0,1,0,0,1
1464253188979437568,0,1,0,0,1
1464424909594112000,0,1,0,0,1
1464490162226880512,0,1,0,0,1
1464525115199270912,0,1,0,0,1
1464618434512277504,0,1,0,0,1
1465600517233524736,1,0,0,0,1
1464764525442437120,0,0,0,1,1
1464905027139506176,0,1,0,0,1
1464947609211076608,1,0,0,0,1
1464953676670324736,0,1,0,0,1
1465159396955095040,1,0,0,0,1
1465221637238837248,0,1,0,0,1
1465313841227743232,0,1,0,0,1
1465348339709493248,0,1,0,0,1
1465478841238016000,0,0,0,1,1
1461175974460940288,1,0,0,0,1
1461156020781264896,0,1,0,0,1
1461147616406917120,0,1,0,0,1
1457581419803422720,0,1,0,0,1
1457068211325874176,0,1,0,0,1
1457168943353942016,0,1,0,0,1
1457227697378119680,1,0,0,0,1
1457231468187451392,0,1,0,0,1
1457239561906450432,0,1,0,0,1
1457331984955551744,0,1,0,0,1
1457427770754371584,0,1,0,0,1
1457430204381601792,0,1,0,0,1
1457567133307703296,0,1,0,0,1
1457646059174330368,0,1,0,0,1
1456918447623864320,0,0,0,1,1
1457667199049650176,0,1,0,0,1
1457676232288772096,0,1,0,0,1
1457760559869227008,0,1,0,0,1
1457764719314411520,0,1,0,0,1
1457784221590769664,0,1,0,0,1
1457987138973224960,0,1,0,0,1
1457988129646944256,0,1,0,0,1
1458139688422686720,0,1,0,0,1
1458178557126000640,0,1,0,0,1
1456968825052835840,0,1,0,0,1
1456897133290958848,0,1,0,0,1
1458276866180075520,1,0,0,0,1
1456240136446832640,0,1,0,0,1
1455752768304648192,0,1,0,0,1
1455818260151107584,1,0,0,0,1
1455830703619383296,0,1,0,0,1
1455854026399096832,0,1,0,0,1
1455881495361490944,0,1,0,0,1
1456208553715380224,0,1,0,0,1
1456209324565487616,0,1,0,0,1
1456227355261816832,0,1,0,0,1
1456236486592892928,0,1,0,0,1
1456339646347026432,1,0,0,0,1
1456880673076154368,0,1,0,0,1
1456453771383304192,0,1,0,0,1
1456492582201020416,1,0,0,0,1
1456540235949563904,0,1,0,0,1
1456550558370836480,0,1,0,0,1
1456567859795177472,0,1,0,0,1
1456718551620927488,0,1,0,0,1
1456800421670961152,0,1,0,0,1
1456804212248137728,0,1,0,0,1
1456832102801059840,0,1,0,0,1
1458203933969686528,0,1,0,0,1
1458350929632182272,0,0,1,0,1
1461050767494819840,0,1,0,0,1
1460625605272252416,0,1,0,0,1
1459926405073207296,0,1,0,0,1
1459954277569417216,0,1,0,0,1
1459962558538928128,0,0,0,1,1
1460028578620264448,0,1,0,0,1
1460053559328718848,1,0,0,0,1
1460198645530181632,0,1,0,0,1
1460202753616228352,0,1,0,0,1
1460506264417366016,1,0,0,0,1
1460535627921833984,1,0,0,0,1
1460655146699042816,0,1,0,0,1
1459804668704563200,0,1,0,0,1
1460687863138459648,0,1,0,0,1
1460816370434719744,0,1,0,0,1
1460848042127642624,0,1,0,0,1
1460856338901262336,0,1,0,0,1
1460858713988898816,0,1,0,0,1
1460903331652456448,0,1,0,0,1
1460937760559173632,0,1,0,0,1
1460950506918924288,0,1,0,0,1
1461002553357783040,1,0,0,0,1
1459919372881858560,0,1,0,0,1
1459787159829811200,0,1,0,0,1
1458360428388491264,0,1,0,0,1
1458857739635998720,1,0,0,0,1
1458373911289245696,0,1,0,0,1
1458464754624712704,0,1,0,0,1
1458509257486254080,0,1,0,0,1
1458646498703339520,1,0,0,0,1
1458661056444698624,0,1,0,0,1
1458698134486503424,0,1,0,0,1
1458713325487992832,0,1,0,0,1
1458765147669889024,0,1,0,0,1
1458806030318686208,0,0,1,0,1
1458974836638814208,0,1,0,0,1
1459775942570786816,0,1,0,0,1
1459014186340659200,0,1,0,0,1
1459252720066465792,0,0,0,1,1
1459293939249434624,0,1,0,0,1
1459450630485991424,1,0,0,0,1
1459541379076530176,1,0,0,0,1
1459543875215708160,0,0,0,1,1
1459568597890736128,0,1,0,0,1
1459657429998780416,0,1,0,0,1
1459764061315514368,0,1,0,0,1
1467636879243706368,1,0,0,0,1
1467724986190381056,0,1,0,0,1
1455607742643716096,0,1,0,0,1
1467733429177487360,0,1,0,0,1
1475607000105033728,0,1,0,0,1
1475657891826831360,0,1,0,0,1
1475684298657173504,0,1,0,0,1
1475700167743459328,0,1,0,0,1
1475719393388630016,0,1,0,0,1
1475730155246997504,0,1,0,0,1
1475783127339470848,0,1,0,0,1
1475809273368121344,0,1,0,0,1
1475812873565716480,1,0,0,0,1
1475821107278073856,1,0,0,0,1
1475832160804384768,0,1,0,0,1
1475836997272948736,1,0,0,0,1
1475846784362717184,0,1,0,0,1
1475920447233564672,0,1,0,0,1
1476095273445244928,0,1,0,0,1
1476100211554484224,1,0,0,0,1
1476135074676436992,0,1,0,0,1
1476142891420434432,0,1,0,0,1
1476250401389350912,1,0,0,0,1
1476457445702922240,0,1,0,0,1
1476542441494827008,0,1,0,0,1
1475594824518615040,0,1,0,0,1
1475577282223816704,0,1,0,0,1
1475499239752888320,0,1,0,0,1
1474602025832759296,0,1,0,0,1
1474162773454168064,0,1,0,0,1
1474286153981440000,0,0,0,1,1
1474287218739011584,0,1,0,0,1
1474287397483724800,0,0,0,1,1
1474331111090274304,0,1,0,0,1
1474371197576089600,0,1,0,0,1
1474386524682784768,0,1,0,0,1
1474466374122627072,1,0,0,0,1
1474554835152240640,0,1,0,0,1
1474610039449079808,0,0,0,1,1
1475422275679571968,0,1,0,0,1
1474778241139310592,0,1,0,0,1
1474853500525834240,0,1,0,0,1
1474866329349881856,1,0,0,0,1
1474875908020264960,0,1,0,0,1
1474929309647208448,1,0,0,0,1
1475087447029547008,0,1,0,0,1
1475182476595122176,0,1,0,0,1
1475262985094549504,1,0,0,0,1
1475342117744562176,1,0,0,0,1
1476545568763748352,0,1,0,0,1
1476634126719627264,0,1,0,0,1
1476692204521463808,0,1,0,0,1
1478465433820876800,0,1,0,0,1
1478136419981869056,1,0,0,0,1
1478300113986596864,0,1,0,0,1
1478381803178242048,0,1,0,0,1
1478399136831614976,0,1,0,0,1
1478410742961520640,0,1,0,0,1
1478411860714029056,0,1,0,0,1
1478415937405603840,0,1,0,0,1
1478434504004059136,0,0,0,1,1
1478453065782943744,0,1,0,0,1
1478685015164682240,0,1,0,0,1
1478037390296035328,0,1,0,0,1
1478724822339362816,1,0,0,0,1
1478734257375924224,1,0,0,0,1
1478758043676549120,0,1,0,0,1
1478759063609647104,0,1,0,0,1
1478774040986750976,1,0,0,0,1
1478974825628684288,0,0,0,1,1
1478980266727116800,0,1,0,0,1
1479074273784479744,0,1,0,0,1
1479095548107837440,0,1,0,0,1
1478108201337954304,0,1,0,0,1
1477980318955155456,0,1,0,0,1
1476716934054002688,0,1,0,0,1
1477196276680691712,1,0,0,0,1
1476864424568754176,0,0,0,1,1
1476922088904867840,0,1,0,0,1
1476987467177893888,0,0,1,0,1
1476998814233944064,0,1,0,0,1
1477049277658505216,0,1,0,0,1
1477060134677450752,1,0,0,0,1
1477084758295433216,0,1,0,0,1
1477088090783113216,0,0,0,1,1
1477134724510326784,1,0,0,0,1
1477229847164375040,0,0,1,0,1
1477964091717160960,0,1,0,0,1
1477248621389271040,0,1,0,0,1
1477342661275262976,0,1,0,0,1
1477414826397745152,0,1,0,0,1
1477419763643072512,0,0,1,0,1
1477497283109216256,0,1,0,0,1
1477560290204008448,0,1,0,0,1
1477582272979259392,1,0,0,0,1
1477689889298993152,0,0,1,0,1
1477878056811302912,1,0,0,0,1
1474047499966943232,0,0,0,1,1
1473944947183087616,0,1,0,0,1
1473510095392698368,0,1,0,0,1
1470318597171912704,0,1,0,0,1
1469732294525136896,0,1,0,0,1
1469755184947605504,1,0,0,0,1
1469758787645063168,0,1,0,0,1
1470052707343998976,1,0,0,0,1
1470077725549506560,0,1,0,0,1
1470099026892959744,0,1,0,0,1
1470253700551610368,0,0,0,1,1
1470266828312264704,0,1,0,0,1
1470302725841719296,0,1,0,0,1
1470372567353630720,0,1,0,0,1
1469573268956979200,0,1,0,0,1
1470389558336389120,1,0,0,0,1
1470606558002253824,0,1,0,0,1
1470651201116987392,0,1,0,0,1
1470793306711932928,0,1,0,0,1
1470826264072278016,1,0,0,0,1
1470829115959701504,0,1,0,0,1
1470862544105578496,1,0,0,0,1
1470959802016804864,0,1,0,0,1
1470964568403099648,1,0,0,0,1
1469713202179022848,0,1,0,0,1
1469396830991519744,0,1,0,0,1
1471044545387261952,0,0,0,1,1
1468615232834924544,0,1,0,0,1
1468073797425106944,1,0,0,0,1
1468149730777739264,0,1,0,0,1
1468159229252931584,0,0,1,0,1
1468230628940337152,0,1,0,0,1
1468287854283735040,0,1,0,0,1
1468292541070331904,1,0,0,0,1
1468374741178535936,0,1,0,0,1
1468504480761401344,0,1,0,0,1
1468567489332510720,0,1,0,0,1
1468616959801831424,0,1,0,0,1
1469290153017552896,0,1,0,0,1
1468655448387584000,0,0,1,0,1
1468656936732266496,0,1,0,0,1
1468684246092943360,0,1,0,0,1
1468724179700641792,1,0,0,0,1
1468814832061276160,0,1,0,0,1
1468829042786799616,0,1,0,0,1
1468835814985457664,1,0,0,0,1
1469185169361805312,0,1,0,0,1
1469195178162286592,0,1,0,0,1
1471023856022429696,0,1,0,0,1
1471061644654432256,0,1,0,0,1
1473504889368203264,0,1,0,0,1
1472867710589562880,0,1,0,0,1
1472029043876937728,0,1,0,0,1
1472149960707633152,0,1,0,0,1
1472158142444232704,0,1,0,0,1
1472163087230726144,0,1,0,0,1
1472302418205437952,0,1,0,0,1
1472464023580987392,0,1,0,0,1
1472473620026998784,0,1,0,0,1
1472649779448590336,0,1,0,0,1
1472669848165502976,0,1,0,0,1
1472932524842229760,0,1,0,0,1
1471843141753835520,1,0,0,0,1
1472964477331165184,0,0,0,1,1
1472984476292562944,1,0,0,0,1
1473028629055492096,0,1,0,0,1
1473110633528934400,0,1,0,0,1
1473129181391343616,0,0,1,0,1
1473171785956802560,1,0,0,0,1
1473278214046990336,0,1,0,0,1
1473299999526043648,0,1,0,0,1
1473361544427753472,0,1,0,0,1
1471972057923657728,1,0,0,0,1
1471797483151900672,0,1,0,0,1
1471101908056264704,0,1,0,0,1
1471424946148556800,0,1,0,0,1
1471102555513966592,0,1,0,0,1
1471274449777397760,0,1,0,0,1
1471301582415400960,0,1,0,0,1
1471323779393486848,1,0,0,0,1
1471328180644597760,0,1,0,0,1
1471344263887826944,0,1,0,0,1
1471351552447184896,0,1,0,0,1
1471355533915418624,1,0,0,0,1
1471375062385053696,1,0,0,0,1
1471464212333477888,0,1,0,0,1
1471748767162327040,0,1,0,0,1
1471519963160596480,0,1,0,0,1
1471540577493782528,0,1,0,0,1
1471569279825084416,0,0,0,1,1
1471575996608520192,0,1,0,0,1
1471700646181367808,0,1,0,0,1
1471708785349562368,1,0,0,0,1
1471713797295513600,1,0,0,0,1
1471730172097347584,1,0,0,0,1
1471740121133326336,0,1,0,0,1
1455732540631707648,0,1,0,0,1
1455572160718651392,0,1,0,0,1
1333445264917614592,0,1,0,0,1
1440923441473937408,0,1,0,0,1
1436072686405529600,1,0,0,0,1
1436192143664685056,0,1,0,0,1
1436219839975153664,0,1,0,0,1
1436240831443312640,0,1,0,0,1
1436259804461289472,0,1,0,0,1
1436379100646629376,0,1,0,0,1
1436401590777225216,1,0,0,0,1
1436415272064196608,0,1,0,0,1
1436426725911511040,0,1,0,0,1
1436552546953437184,0,0,0,1,1
1436565108193431552,0,1,0,0,1
1436570179392126976,0,1,0,0,1
1436777107175223296,1,0,0,0,1
1436788487642968064,1,0,0,0,1
1436794858421686272,0,0,1,0,1
1436826735639678976,0,1,0,0,1
1436854582949335040,0,1,0,0,1
1436926139608485888,0,1,0,0,1
1436926544237244416,0,1,0,0,1
1436935226148605952,0,1,0,0,1
1436957087980994560,0,0,0,1,1
1436034374781132800,0,1,0,0,1
1435995797045358592,0,1,0,0,1
1435895246517411840,0,1,0,0,1
1435309124754018304,0,1,0,0,1
1434464826076639232,0,1,0,0,1
1434498739473891328,0,1,0,0,1
1434502531120615424,0,1,0,0,1
1434806992804225024,1,0,0,0,1
1434960263309144064,0,1,0,0,1
1435058364682211328,0,1,0,0,1
1435136135685099520,0,1,0,0,1
1435170902581329920,0,1,0,0,1
1435205799274496000,0,1,0,0,1
1435316491348480000,0,1,0,0,1
1435893522633093120,0,1,0,0,1
1435354428945600512,1,0,0,0,1
1435393494349144064,0,1,0,0,1
1435400267785113600,0,1,0,0,1
1435472324778762240,1,0,0,0,1
1435532857108099072,0,1,0,0,1
1435540466351554560,1,0,0,0,1
1435596436318547968,0,1,0,0,1
1435652823132164096,1,0,0,0,1
1435872344174649344,0,1,0,0,1
1436984897416179712,0,1,0,0,1
1437109757471440896,1,0,0,0,1
1437110317931130880,0,0,0,1,1
1439467936675254272,0,1,0,0,1
1438802254715359232,0,1,0,0,1
1438994414433624064,0,1,0,0,1
1439215797549797376,0,0,1,0,1
1439223348299382784,0,1,0,0,1
1439237388224585728,1,0,0,0,1
1439266209401278464,1,0,0,0,1
1439294435838332928,0,1,0,0,1
1439423828736700416,1,0,0,0,1
1439457206928281600,0,1,0,0,1
1439471008965070848,0,0,0,1,1
1438742246514470912,0,1,0,0,1
1439515498958532608,0,1,0,0,1
1439627052366405632,0,0,0,1,1
1439803446262071296,0,1,0,0,1
1440088332902469632,1,0,0,0,1
1440102849094946816,1,0,0,0,1
1440179893577216000,1,0,0,0,1
1440346287946166272,0,1,0,0,1
1440534641815920640,0,1,0,0,1
1440734948051152896,0,1,0,0,1
1438789257435488256,0,1,0,0,1
1438704003840360448,1,0,0,0,1
1437164508435320832,0,1,0,0,1
1437876272387051520,0,0,0,1,1
1437229729090727936,0,1,0,0,1
1437237398493020160,0,1,0,0,1
1437431301112532992,0,1,0,0,1
1437462030785515520,0,1,0,0,1
1437587381939363840,1,0,0,0,1
1437705358215159808,0,1,0,0,1
1437708165739548672,0,1,0,0,1
1437731784679174144,1,0,0,0,1
1437800350082387968,0,1,0,0,1
1437939469479522304,0,1,0,0,1
1438597019229200384,0,1,0,0,1
1437991434037071872,1,0,0,0,1
1438013536039366656,0,1,0,0,1
1438129175425175552,0,1,0,0,1
1438220250353311744,1,0,0,0,1
1438386995722604544,0,1,0,0,1
1438394703699976192,0,0,0,1,1
1438529906867064832,0,1,0,0,1
1438561842717024256,1,0,0,0,1
1438596997141860352,0,1,0,0,1
1434420522788528128,0,1,0,0,1
1434206043572080640,0,1,0,0,1
1434129906942844928,0,1,0,0,1
1430229386112815104,0,1,0,0,1
1429037816793735168,1,0,0,0,1
1429103057829343232,1,0,0,0,1
1429358356351889408,1,0,0,0,1
1429394095793922048,0,1,0,0,1
1429415819570606080,0,1,0,0,1
1429557334519525376,0,1,0,0,1
1429596825611292672,1,0,0,0,1
1429726703920766976,0,1,0,0,1
1429797501222195200,0,1,0,0,1
1430246424436908032,0,0,0,1,1
1428816975732609024,0,1,0,0,1
1430254534593548288,0,1,0,0,1
1430386007560450048,0,1,0,0,1
1430422188595859456,0,1,0,0,1
1430483069958377472,1,0,0,0,1
1430527937128898560,0,0,0,1,1
1430532070724489216,0,1,0,0,1
1430613035316617216,0,0,1,0,1
1430642183145758720,0,1,0,0,1
1430716120663826432,0,1,0,0,1
1428886293803671552,0,1,0,0,1
1428786082389270528,0,1,0,0,1
1430802464106708992,0,1,0,0,1
1428128060784537600,1,0,0,0,1
1427584730308874240,0,1,0,0,1
1427626444973301760,0,1,0,0,1
1427697326429200384,0,1,0,0,1
1427728205226684416,0,1,0,0,1
1427810801469956096,0,1,0,0,1
1427963862989647872,0,1,0,0,1
1428042413415845888,1,0,0,0,1
1428070161144287232,1,0,0,0,1
1428089120795074560,0,1,0,0,1
1428152568144924672,0,1,0,0,1
1428735790637633536,0,1,0,0,1
1428203171122450432,0,1,0,0,1
1428275112629911552,0,1,0,0,1
1428305363716222976,0,1,0,0,1
1428317620080611328,0,1,0,0,1
1428400295843962880,0,0,0,1,1
1428443201392857088,1,0,0,0,1
1428546241495973888,0,1,0,0,1
1428586375050366976,0,1,0,0,1
1428622420366221312,0,1,0,0,1
1430788109290115072,1,0,0,0,1
1430821843947065344,0,1,0,0,1
1433937060218368000,0,1,0,0,1
1433068658419449856,0,1,0,0,1
1432412293069869056,0,1,0,0,1
1432566004714917888,0,1,0,0,1
1432576876157935616,1,0,0,0,1
1432747984794660864,0,1,0,0,1
1432759971842703360,0,1,0,0,1
1432851175997648896,1,0,0,0,1
1432899286233124864,0,1,0,0,1
1432925356399345664,0,1,0,0,1
1433023241661026304,0,1,0,0,1
1433322144599994368,1,0,0,0,1
1431961729374773248,1,0,0,0,1
1433342011499859968,0,1,0,0,1
1433359735047217152,1,0,0,0,1
1433430916190195712,0,1,0,0,1
1433493736026107904,0,1,0,0,1
1433517005508943872,0,1,0,0,1
1433582301758304256,0,1,0,0,1
1433915485247062016,1,0,0,0,1
1433920796146110464,0,1,0,0,1
1433927161103228928,0,1,0,0,1
1432393669324193792,1,0,0,0,1
1431915247615594496,0,1,0,0,1
1430840041165803520,0,1,0,0,1
1431339711390371840,0,1,0,0,1
1430859791442796544,0,1,0,0,1
1430959040545308672,1,0,0,0,1
1430977082612404224,0,1,0,0,1
1431005900526047232,0,1,0,0,1
1431038424899796992,0,1,0,0,1
1431081186575536128,1,0,0,0,1
1431129555096334336,1,0,0,0,1
1431137043195777024,0,1,0,0,1
1431271089162887168,0,1,0,0,1
1431345029222748160,0,1,0,0,1
1431898798196989952,0,1,0,0,1
1431458572471308288,0,1,0,0,1
1431462179950055424,0,1,0,0,1
1431590678727958528,0,1,0,0,1
1431595767962157056,0,0,1,0,1
1431632302174572544,1,0,0,0,1
1431649587568201728,0,1,0,0,1
1431752989568548864,0,1,0,0,1
1431763221577224192,0,1,0,0,1
1431886984604160000,0,1,0,0,1
1440748560442544128,0,0,1,0,1
1440983231462100992,0,0,0,1,1
1455568539645972480,0,1,0,0,1
1440989072781086720,0,1,0,0,1
1450631225744367616,0,1,0,0,1
1450632745458225152,0,1,0,0,1
1450705530410971136,0,1,0,0,1
1450735751667191808,0,1,0,0,1
1450740036228370432,0,1,0,0,1
1450745962310344704,0,1,0,0,1
1450754425463529472,0,0,0,1,1
1450778075222917120,0,1,0,0,1
1450795091514335232,1,0,0,0,1
1450809716322545664,0,1,0,0,1
1450875485400059904,1,0,0,0,1
1450991243819945984,1,0,0,0,1
1451018649758744576,0,1,0,0,1
1451061231759069184,0,1,0,0,1
1451062150651420672,0,1,0,0,1
1451100159715299328,1,0,0,0,1
1451174418852495360,0,1,0,0,1
1451191949428330496,0,1,0,0,1
1451198323612798976,0,1,0,0,1
1451381549446881280,0,1,0,0,1
1451479029987434496,1,0,0,0,1
1450614806059311104,0,1,0,0,1
1450567759910350848,0,0,0,1,1
1450496632013791232,0,1,0,0,1
1449383305770590208,0,1,0,0,1
1448656438113357824,0,1,0,0,1
1448672479971581952,0,1,0,0,1
1448964104937426944,0,1,0,0,1
1449015946060959744,0,1,0,0,1
1449075283689099264,0,0,1,0,1
1449111705896816640,0,1,0,0,1
1449159603556605952,1,0,0,0,1
1449361615971827712,0,1,0,0,1
1449375930422632448,0,1,0,0,1
1449473447600566272,0,0,0,1,1
1450326507969208320,0,1,0,0,1
1449501111744966656,0,1,0,0,1
1449535939198345216,0,1,0,0,1
1449679933194870784,0,1,0,0,1
1449706547345383424,0,1,0,0,1
1449757742583799808,0,1,0,0,1
1449801479217467392,1,0,0,0,1
1449974922772553728,0,0,1,0,1
1450137823072305152,0,1,0,0,1
1450217314088099840,0,1,0,0,1
1451604823254708224,0,1,0,0,1
1451698531396296704,0,1,0,0,1
1451796351826628608,0,1,0,0,1
1454947945204301824,0,1,0,0,1
1453791503042506752,0,0,0,1,1
1453999614042853376,0,1,0,0,1
1454021409269710848,0,0,0,1,1
1454151943023120384,0,1,0,0,1
1454309738519437312,0,1,0,0,1
1454352275611193344,0,1,0,0,1
1454713518024839168,1,0,0,0,1
1454735084553220096,0,1,0,0,1
1454784023277056000,0,1,0,0,1
1455042948484190208,0,1,0,0,1
1453514465949925376,0,1,0,0,1
1455084549562454016,1,0,0,0,1
1455104034268860416,1,0,0,0,1
1455122802265059328,0,1,0,0,1
1455203799467905024,1,0,0,0,1
1455390879699456000,0,0,1,0,1
1455475757677953024,0,1,0,0,1
1455520332069187584,0,1,0,0,1
1455553022440972288,0,1,0,0,1
1455555886110420992,0,1,0,0,1
1453542924591853568,0,0,0,1,1
1453458468753580032,0,1,0,0,1
1451962867255857152,0,1,0,0,1
1452754853277704192,0,1,0,0,1
1452036178404913152,0,1,0,0,1
1452395620929458176,0,1,0,0,1
1452439816558104576,0,1,0,0,1
1452535191709224960,1,0,0,0,1
1452551227036749824,0,1,0,0,1
1452677306967736320,0,1,0,0,1
1452678699187277824,1,0,0,0,1
1452708565039284224,1,0,0,0,1
1452723626696790016,1,0,0,0,1
1452869260523540480,0,1,0,0,1
1453437407920107520,0,1,0,0,1
1452880766862389248,0,1,0,0,1
1452902774350385152,0,1,0,0,1
1452962897504583680,1,0,0,0,1
1453026586882723840,0,1,0,0,1
1453042147805048832,0,1,0,0,1
1453059019413856256,0,1,0,0,1
1453103548141539328,0,1,0,0,1
1453183240580259840,0,1,0,0,1
1453321042802401280,0,1,0,0,1
1448629349582790656,0,1,0,0,1
1448531418213199872,0,1,0,0,1
1448410496940449792,0,1,0,0,1
1443306772765331456,0,1,0,0,1
1442739010313539584,0,1,0,0,1
1442800448138735616,0,1,0,0,1
1442820885132582912,0,1,0,0,1
1442845928797442048,0,1,0,0,1
1442912228324356096,0,1,0,0,1
1442948567258251264,0,1,0,0,1
1443244412520173568,0,1,0,0,1
1443272251953061888,0,1,0,0,1
1443292831964020736,1,0,0,0,1
1443389368463511552,0,1,0,0,1
1442469524461129728,0,1,0,0,1
1443405220625666048,1,0,0,0,1
1443479944697368576,1,0,0,0,1
1443588120675377152,0,1,0,0,1
1443762632515743744,0,1,0,0,1
1443899942334963712,0,1,0,0,1
1443911754765856768,0,1,0,0,1
1443955013001351168,0,1,0,0,1
1443991597994201088,0,1,0,0,1
1444045321705820160,0,1,0,0,1
1442605014849974272,0,1,0,0,1
1442408775441289216,0,1,0,0,1
1444111508804276224,0,0,0,1,1
1441670345749008384,0,1,0,0,1
1441006411568328704,0,1,0,0,1
1441062332243734528,0,1,0,0,1
1441078242002145280,0,0,0,1,1
1441208543416184832,1,0,0,0,1
1441324820407357440,0,0,0,1,1
1441365846174011392,1,0,0,0,1
1441381985944064000,0,1,0,0,1
1441413448563318784,0,1,0,0,1
1441434210636546048,0,1,0,0,1
1441801155261001728,0,1,0,0,1
1442394655216136192,0,1,0,0,1
1441842771862581248,0,1,0,0,1
1441983719280021504,0,1,0,0,1
1442059972259422208,0,1,0,0,1
1442107224059355136,0,1,0,0,1
1442108215957680128,1,0,0,0,1
1442150398429515776,0,1,0,0,1
1442167044800008192,0,1,0,0,1
1442248782482067456,1,0,0,0,1
1442341947205586944,0,1,0,0,1
1444078130881196032,0,1,0,0,1
1444531996278108160,0,1,0,0,1
1448265487385825280,0,1,0,0,1
1447466531365994496,0,1,0,0,1
1446736326431285248,0,1,0,0,1
1446812326967975936,0,1,0,0,1
1446943307997851648,0,1,0,0,1
1447056513298804736,0,1,0,0,1
1447074974603243520,0,1,0,0,1
1447177679720099840,0,1,0,0,1
1447382372685697024,0,1,0,0,1
1447442010005192704,0,1,0,0,1
1447454569353527296,0,1,0,0,1
1447498718995906560,0,1,0,0,1
1446617508602056704,0,1,0,0,1
1447545031594635264,0,1,0,0,1
1447779727536795648,1,0,0,0,1
1447799228374339584,0,1,0,0,1
1447804590447992832,0,1,0,0,1
1447808023611707392,0,1,0,0,1
1447833491064774656,0,0,1,0,1
1447849552313077760,1,0,0,0,1
1448061893134913536,0,1,0,0,1
1448160576069271552,0,1,0,0,1
1446680781162745856,0,1,0,0,1
1446591068057784320,0,1,0,0,1
1444532390219501568,1,0,0,0,1
1445412379643179008,0,1,0,0,1
1444729651998375936,0,1,0,0,1
1444750682674892800,0,1,0,0,1
1444885352271974400,0,0,0,1,1
1444944663840919552,0,1,0,0,1
1445080544220532736,0,1,0,0,1
1445112695519391744,0,1,0,0,1
1445226897999159296,1,0,0,0,1
1445250133034094592,0,1,0,0,1
1445290233218613248,0,1,0,0,1
1445563486642180096,0,1,0,0,1
1446428487359733760,0,1,0,0,1
1445845087171203072,0,0,1,0,1
1445851950432489472,0,1,0,0,1
1445901048951017472,0,1,0,0,1
1445965397971247104,0,1,0,0,1
1445991923924094976,1,0,0,0,1
1445994879553716224,0,1,0,0,1
1446046658635177984,0,1,0,0,1
1446143498407661568,0,1,0,0,1
1446371794739359744,1,0,0,0,1
1479102892481024000,0,1,0,0,1
1479158841786961920,0,1,0,0,1
1479180412035514368,0,1,0,0,1
1499008260325711872,0,1,0,0,1
1497478843031900160,0,1,0,0,1
1497483501653876736,0,1,0,0,1
1497496511952809984,0,0,0,1,1
1497497222010843136,0,1,0,0,1
1497504557320097792,0,1,0,0,1
1497506110739255296,0,1,0,0,1
1497519632315523072,0,1,0,0,1
1497527710058434560,0,1,0,0,1
1497561806071549952,0,0,0,1,1
1497564637046337536,0,1,0,0,1
1497579836885319680,0,1,0,0,1
1497583505504624640,0,1,0,0,1
1497593074578378752,0,1,0,0,1
1497612348835737600,0,1,0,0,1
1497641979261423616,0,1,0,0,1
1497642606805020672,1,0,0,0,1
1497658702861860864,1,0,0,0,1
1497670117895073792,0,1,0,0,1
1497685915573309440,0,1,0,0,1
1497691033982971904,0,1,0,0,1
1497699036438142976,0,1,0,0,1
1497474460034560000,1,0,0,0,1
1497446322244358144,0,0,1,0,1
1497396297858678784,0,1,0,0,1
1497175639333478400,0,1,0,0,1
1496982913220583424,0,0,0,1,1
1496998921821896704,0,1,0,0,1
1497100247012904960,0,1,0,0,1
1497103155171102720,0,1,0,0,1
1497124080272744448,0,1,0,0,1
1497130288157233152,0,1,0,0,1
1497135064240603136,0,1,0,0,1
1497154425541914624,1,0,0,0,1
1497166137498419200,0,1,0,0,1
1497185694024101888,0,1,0,0,1
1497385454420774912,0,1,0,0,1
1497204004534710272,0,1,0,0,1
1497218551790256128,0,1,0,0,1
1497220499973230592,0,0,0,1,1
1497230793550311424,0,1,0,0,1
1497242584078761984,0,1,0,0,1
1497262208937787392,0,1,0,0,1
1497268449927888896,0,1,0,0,1
1497296856107212800,0,1,0,0,1
1497298985152917504,0,1,0,0,1
1497715592773582848,0,1,0,0,1
1497744126300860416,0,1,0,0,1
1497753745429766144,0,1,0,0,1
1498670489039998976,0,1,0,0,1
1498477019721515008,0,1,0,0,1
1498596289952423936,0,1,0,0,1
1498596763846193152,1,0,0,0,1
1498601498850504704,0,0,1,0,1
1498602401439395840,0,1,0,0,1
1498613898697744384,0,1,0,0,1
1498621012656951296,0,1,0,0,1
1498629929948360704,0,1,0,0,1
1498662100868251648,0,1,0,0,1
1498686056111218688,0,1,0,0,1
1498419269608308736,1,0,0,0,1
1498737919074443264,0,1,0,0,1
1498845749781872640,0,1,0,0,1
1498852337367977984,0,1,0,0,1
1498856639730008064,0,1,0,0,1
1498860691331108864,0,1,0,0,1
1498878433618989056,1,0,0,0,1
1498947330162438144,0,1,0,0,1
1498955673413238784,0,1,0,0,1
1498999126964551680,0,1,0,0,1
1498460000133525504,0,1,0,0,1
1498411480647147520,1,0,0,0,1
1497762928900063232,0,1,0,0,1
1498099470759862272,0,1,0,0,1
1497840493434224640,0,1,0,0,1
1497875695078293504,0,1,0,0,1
1497877272317272064,1,0,0,0,1
1497898265018134528,0,1,0,0,1
1497910965555318784,0,1,0,0,1
1498005367493902336,0,1,0,0,1
1498015616074194944,0,1,0,0,1
1498020710836731904,0,1,0,0,1
1498046786602156032,1,0,0,0,1
1498118891167313920,0,0,0,1,1
1498397470266896384,1,0,0,0,1
1498126783597756416,0,1,0,0,1
1498168949929701376,0,1,0,0,1
1498184940537593856,1,0,0,0,1
1498212731664674816,0,1,0,0,1
1498219162321457152,0,1,0,0,1
1498276134621827072,1,0,0,0,1
1498309757069070336,0,1,0,0,1
1498331428089905152,0,1,0,0,1
1498333146579972096,0,1,0,0,1
1496971545834827776,0,1,0,0,1
1496938852921282560,0,1,0,0,1
1496938326858907648,1,0,0,0,1
1495112066457288704,0,1,0,0,1
1494691751013097472,0,1,0,0,1
1494741163496071168,1,0,0,0,1
1494840641582366720,0,1,0,0,1
1494894362936832000,0,1,0,0,1
1494952417489997824,0,1,0,0,1
1494964013192597504,0,1,0,0,1
1494977891343507456,0,1,0,0,1
1495014957699809280,0,1,0,0,1
1495051612402126848,0,1,0,0,1
1495187463714791424,1,0,0,0,1
1494468720290369536,0,1,0,0,1
1495197141723226112,1,0,0,0,1
1495310914991824896,0,1,0,0,1
1495325821275357184,0,1,0,0,1
1495331417760632832,0,0,0,1,1
1495375687976316928,0,1,0,0,1
1495435221319262208,0,1,0,0,1
1495447830051246080,0,1,0,0,1
1495459865204084736,1,0,0,0,1
1495467624607539200,0,1,0,0,1
1494689651436761088,0,1,0,0,1
1494447489923100672,0,1,0,0,1
1495545254820429824,0,1,0,0,1
1494166401485058048,1,0,0,0,1
1493934106153000960,1,0,0,0,1
1493957075746975744,0,1,0,0,1
1493981181234360320,1,0,0,0,1
1493993094379089920,0,1,0,0,1
1494036055456165888,0,1,0,0,1
1494044894280568832,0,1,0,0,1
1494054777000394752,0,1,0,0,1
1494066096458309632,0,1,0,0,1
1494156234756341760,1,0,0,0,1
1494182232583548928,0,1,0,0,1
1494437673901207552,1,0,0,0,1
1494220341815693312,0,1,0,0,1
1494220413723090944,0,1,0,0,1
1494276023319339008,0,1,0,0,1
1494332153601003520,0,1,0,0,1
1494346181308207104,0,1,0,0,1
1494360510653173760,0,0,0,1,1
1494367284051476480,0,1,0,0,1
1494387040586452992,1,0,0,0,1
1494430244958318592,0,0,0,1,1
1495530471563931648,0,1,0,0,1
1495729599111888896,0,0,0,1,1
1496931063742054400,0,1,0,0,1
1496752741238157312,0,1,0,0,1
1496556178263920640,0,1,0,0,1
1496573296619446272,0,1,0,0,1
1496578625847631872,0,1,0,0,1
1496586907177742336,0,1,0,0,1
1496621404049256448,0,0,1,0,1
1496662164874018816,0,1,0,0,1
1496704799991283712,1,0,0,0,1
1496719906468995072,0,1,0,0,1
1496730293448974336,0,1,0,0,1
1496773900021080064,0,1,0,0,1
1496532666748915712,0,1,0,0,1
1496808410670460928,0,1,0,0,1
1496818480124993536,0,1,0,0,1
1496823741472514048,0,1,0,0,1
1496826680584937472,0,1,0,0,1
1496836839512100864,0,1,0,0,1
1496851888716890112,0,1,0,0,1
1496853150720049152,0,1,0,0,1
1496886303102750720,0,1,0,0,1
1496897579233464320,0,1,0,0,1
1496544902884339712,0,1,0,0,1
1496509072891432960,0,1,0,0,1
1495823829054083072,0,1,0,0,1
1496106396797923328,1,0,0,0,1
1495831688215404544,1,0,0,0,1
1495862714920583168,0,1,0,0,1
1495945725372354560,0,1,0,0,1
1495992864714608640,1,0,0,0,1
1495999192770043904,1,0,0,0,1
1496002706019864576,0,1,0,0,1
1496026685585584128,0,1,0,0,1
1496042103855529984,0,1,0,0,1
1496053905045610496,0,1,0,0,1
1496129974738112512,0,1,0,0,1
1496505004848562176,0,1,0,0,1
1496137936106098688,1,0,0,0,1
1496159245196304384,0,1,0,0,1
1496176064036425728,0,1,0,0,1
1496184943248297984,0,1,0,0,1
1496202491599331328,0,0,0,1,1
1496331885370355712,0,1,0,0,1
1496374424823599104,0,1,0,0,1
1496399024370323456,0,1,0,0,1
1496430583324549120,0,1,0,0,1
1498999684605804544,0,1,0,0,1
1499024066128191488,1,0,0,0,1
1479221848621604864,0,1,0,0,1
1499042830118969344,0,1,0,0,1
1520263787101708288,0,1,0,0,1
1520332118198472704,0,1,0,0,1
1520350726089760768,0,1,0,0,1
1520386401900060672,0,1,0,0,1
1520577251678507008,0,1,0,0,1
1520695184568340480,0,1,0,0,1
1520789332747038720,0,0,1,0,1
1520858324971167744,0,1,0,0,1
1521103957522845696,0,1,0,0,1
1521143187934433280,0,1,0,0,1
1521509083458809856,0,1,0,0,1
1521868371498786816,1,0,0,0,1
1521942148907962368,0,1,0,0,1
1522000359090429952,1,0,0,0,1
1522331678240395264,0,1,0,0,1
1522899915009146880,0,1,0,0,1
1522984619771146240,0,0,0,1,1
1523156080758599680,0,1,0,0,1
1523246028861837312,1,0,0,0,1
1523251468203085824,0,1,0,0,1
1523462985703837696,0,1,0,0,1
1520130074527293440,0,1,0,0,1
1520097973417521152,0,0,0,1,1
1520083488640225280,0,1,0,0,1
1519359895132250112,0,1,0,0,1
1518979879047413760,0,1,0,0,1
1519002452489555968,0,1,0,0,1
1519017509793726464,0,1,0,0,1
1519040043951738880,0,1,0,0,1
1519086161528258560,0,0,0,1,1
1519107125162635264,0,0,1,0,1
1519202789716631552,0,1,0,0,1
1519216654164672512,0,1,0,0,1
1519245633533530112,0,1,0,0,1
1519380201800622080,0,0,1,0,1
1520079849246892032,0,1,0,0,1
1519391179305099264,0,1,0,0,1
1519485848277901312,0,0,0,1,1
1519533455461462016,0,1,0,0,1
1519551710691086336,1,0,0,0,1
1519565763018960896,0,1,0,0,1
1519583120344989696,0,0,0,1,1
1519584062251409408,0,0,0,1,1
1519585603406417920,0,1,0,0,1
1519715794103324672,0,1,0,0,1
1523810531609657344,1,0,0,0,1
1524335303435370496,0,1,0,0,1
1524488626733973504,0,1,0,0,1
1543552639732011008,0,1,0,0,1
1534767898140491776,0,1,0,0,1
1536450383270203392,0,1,0,0,1
1536546014471110656,1,0,0,0,1
1536677864342491136,0,0,0,1,1
1539007949598777344,0,1,0,0,1
1539559536725577728,0,1,0,0,1
1540260377077944320,0,1,0,0,1
1543141967990870016,0,1,0,0,1
1543289475765338112,0,1,0,0,1
1543664066362851328,0,0,0,1,1
1534450512464171008,0,1,0,0,1
1544004123443486720,1,0,0,0,1
1544250119381475328,0,1,0,0,1
1544967741530054656,1,0,0,0,1
1545072912088064000,0,1,0,0,1
1545546618740539392,0,1,0,0,1
1545861506218213376,0,1,0,0,1
1546362419290718208,0,1,0,0,1
1548334793200349184,0,0,0,1,1
1549311260889649152,1,0,0,0,1
1534726171451338752,0,1,0,0,1
1533767352650563584,0,1,0,0,1
1525130743000834048,0,1,0,0,1
1528357536461619200,0,1,0,0,1
1525264698983292928,0,0,1,0,1
1525267658706280448,0,0,0,1,1
1525481138374193152,1,0,0,0,1
1526514858237186048,0,0,0,1,1
1526677017038659584,0,1,0,0,1
1526870365548335104,1,0,0,0,1
1527534620807512064,0,1,0,0,1
1527629252643930112,0,0,0,1,1
1527673310728839168,0,1,0,0,1
1528469939505442816,0,1,0,0,1
1533516920162500608,0,1,0,0,1
1529358027358363648,1,0,0,0,1
1530114094090575872,0,1,0,0,1
1530365381998698496,0,1,0,0,1
1530486649347620864,0,1,0,0,1
1531316042894413824,0,1,0,0,1
1531399388228206592,1,0,0,0,1
1532267291437682688,0,1,0,0,1
1533352178764480512,0,0,0,1,1
1533412524430921728,0,1,0,0,1
1518967501517897728,0,1,0,0,1
1518963509714948096,0,1,0,0,1
1518947491990806528,1,0,0,0,1
1501803545531670528,0,1,0,0,1
1500222603025334272,0,0,0,1,1
1500258752389390336,0,1,0,0,1
1500527318909001728,0,1,0,0,1
1500595434099724288,0,1,0,0,1
1500626195272110080,0,1,0,0,1
1501336922530136064,0,1,0,0,1
1501586409366372352,0,0,0,1,1
1501620604658716672,0,1,0,0,1
1501679752843001856,0,1,0,0,1
1502179888534634496,0,1,0,0,1
1500149025957457920,0,1,0,0,1
1502220671623086080,0,0,0,1,1
1502426425009266688,0,1,0,0,1
1502576747677896704,0,1,0,0,1
1502667507085156352,0,1,0,0,1
1502867531757133824,0,0,0,1,1
1503089693252063232,0,1,0,0,1
1503457300882726912,1,0,0,0,1
1503606045461164032,0,0,1,0,1
1503638691855667200,0,1,0,0,1
1500168019879899136,0,1,0,0,1
1500038810692108288,0,0,1,0,1
1504503686441099264,0,1,0,0,1
1499310782131347456,0,1,0,0,1
1499048530689855488,0,1,0,0,1
1499051234665418752,0,0,0,1,1
1499079561723715584,0,1,0,0,1
1499085994284310528,0,1,0,0,1
1499092859491954688,0,1,0,0,1
1499173733705166848,0,1,0,0,1
1499254021906862080,0,1,0,0,1
1499274695488819200,0,1,0,0,1
1499297959665897472,0,0,0,1,1
1499356771365933056,0,1,0,0,1
1499974767876927488,1,0,0,0,1
1499373788475109376,0,1,0,0,1
1499387612695461888,0,1,0,0,1
1499400957913800704,0,1,0,0,1
1499414371977469952,0,1,0,0,1
1499434585565765632,0,1,0,0,1
1499619129548025856,1,0,0,0,1
1499644151654141952,0,1,0,0,1
1499651303730987008,0,1,0,0,1
1499819362668085248,0,1,0,0,1
1504495212676198400,0,1,0,0,1
1504843864720687104,1,0,0,0,1
1518884837540651008,0,1,0,0,1
1517077528271552512,1,0,0,0,1
1513679222673494016,0,1,0,0,1
1513778132364406784,0,1,0,0,1
1514216787763728384,0,1,0,0,1
1514808930727174144,0,1,0,0,1
1514997648687865856,0,1,0,0,1
1515319429218906112,0,1,0,0,1
1515375775930802176,0,1,0,0,1
1515897540562067456,0,1,0,0,1
1516917091643052032,0,0,0,1,1
1517170748032679936,0,1,0,0,1
1512884863359238144,0,1,0,0,1
1517264191874375680,0,1,0,0,1
1517656276813025280,0,1,0,0,1
1517684938153373696,0,0,0,1,1
1518288770713505792,0,1,0,0,1
1518565483271839744,0,1,0,0,1
1518740024556064768,0,1,0,0,1
1518743327302107136,0,0,0,1,1
1518831765409783808,0,0,0,1,1
1518865922320216064,0,1,0,0,1
1513093993147609088,0,1,0,0,1
1512637432470163456,0,1,0,0,1
1504885876186402816,0,0,0,1,1
1508191482032922624,0,1,0,0,1
1505281874247127040,0,1,0,0,1
1505410728450273280,1,0,0,0,1
1505473062636036096,0,1,0,0,1
1505842673118236672,0,1,0,0,1
1506258384038899712,0,1,0,0,1
1506625793354612736,0,1,0,0,1
1507292972513120256,0,1,0,0,1
1507679910214602752,0,1,0,0,1
1508031875834695680,0,0,0,1,1
1508524383970676736,0,1,0,0,1
1512479613439684608,0,1,0,0,1
1508707118190559232,0,1,0,0,1
1509078691128782848,0,1,0,0,1
1509315341532504064,0,1,0,0,1
1509409825649745920,0,1,0,0,1
1510499357551906816,0,0,0,1,1
1511452213033504768,1,0,0,0,1
1511801372387254272,0,1,0,0,1
1511976482062704640,0,1,0,0,1
1512429236694523904,0,1,0,0,1
1493898275765817344,0,1,0,0,1
1493891624623124480,0,1,0,0,1
1493885272165171200,1,0,0,0,1
1493878702903644160,0,1,0,0,1
1484151105768542208,0,1,0,0,1
1484165237544828928,0,1,0,0,1
1484228047788474368,0,1,0,0,1
1484233739668439040,0,1,0,0,1
1484249049716908032,0,1,0,0,1
1484408707505360896,1,0,0,0,1
1484414392615968768,0,0,1,0,1
1484438212848537600,0,1,0,0,1
1484469207630811136,0,1,0,0,1
1484738776618389504,0,1,0,0,1
1484775473083478016,0,1,0,0,1
1484779371952959488,0,1,0,0,1
1484782589927960576,0,1,0,0,1
1484789921726533632,0,1,0,0,1
1484816222437126144,1,0,0,0,1
1484822156202676224,0,1,0,0,1
1484841923261210624,0,1,0,0,1
1484939029619429376,0,0,1,0,1
1484955599037411328,0,1,0,0,1
1484972347924877312,0,1,0,0,1
1485075847132626944,1,0,0,0,1
1484102463103852544,0,1,0,0,1
1484098624896499712,0,1,0,0,1
1484047847796400128,0,1,0,0,1
1483426718740525056,0,1,0,0,1
1482831075982585856,0,1,0,0,1
1482987468215492608,0,1,0,0,1
1483057888297848832,1,0,0,0,1
1483074766978564096,1,0,0,0,1
1483186044593971200,0,1,0,0,1
1483259525306191872,0,1,0,0,1
1483297099928244224,0,1,0,0,1
1483316788611846144,0,1,0,0,1
1483375863081095168,0,1,0,0,1
1483439556053839872,1,0,0,0,1
1484046125556727808,0,1,0,0,1
1483454228165283840,0,1,0,0,1
1483560395973566464,0,1,0,0,1
1483652355434610688,0,1,0,0,1
1483719450922733568,0,0,1,0,1
1483829679941431296,1,0,0,0,1
1483837019650691072,0,1,0,0,1
1483837093277466624,0,1,0,0,1
1483892349617188864,1,0,0,0,1
1483951299607482368,1,0,0,0,1
1485167621381279744,1,0,0,0,1
1485218979006357504,1,0,0,0,1
1485282662017376256,1,0,0,0,1
1486988176468353024,0,1,0,0,1
1486486320453062656,1,0,0,0,1
1486487443637694464,1,0,0,0,1
1486599399488716800,0,1,0,0,1
1486709418989436928,0,1,0,0,1
1486773339712536576,0,1,0,0,1
1486827697653301248,0,1,0,0,1
1486862139499466752,0,1,0,0,1
1486977447111266304,1,0,0,0,1
1486977842105794560,0,1,0,0,1
1487015769535774720,0,0,0,1,1
1486445898515288064,0,1,0,0,1
1487098896421724160,0,1,0,0,1
1487114582829248512,0,1,0,0,1
1487123546950275072,0,1,0,0,1
1487264758328102912,0,1,0,0,1
1487320631888826368,0,1,0,0,1
1487335141194219520,0,0,0,1,1
1487368092799877120,0,1,0,0,1
1487405834288209920,0,1,0,0,1
1487426047121694720,1,0,0,0,1
1486447577247666176,0,1,0,0,1
1486360577337266176,0,1,0,0,1
1485341635231858688,0,0,1,0,1
1485920347954237440,0,1,0,0,1
1485554474601091072,0,1,0,0,1
1485555262866038784,1,0,0,0,1
1485576083017809920,0,1,0,0,1
1485602666759688192,0,1,0,0,1
1485626247434874880,0,1,0,0,1
1485646470585987072,0,1,0,0,1
1485649823034667008,0,1,0,0,1
1485705289135501312,0,1,0,0,1
1485706709134094336,0,1,0,0,1
1485952812756258816,0,1,0,0,1
1486333611217358848,1,0,0,0,1
1486009680552148992,0,1,0,0,1
1486120541912186880,0,0,0,1,1
1486179434868928512,0,1,0,0,1
1486189246880751616,1,0,0,0,1
1486197397747339264,0,1,0,0,1
1486241894221086720,0,1,0,0,1
1486278690619428864,0,1,0,0,1
1486283701533224960,0,1,0,0,1
1486331764473802752,0,1,0,0,1
1482781147054678016,1,0,0,0,1
1482755106965803008,0,1,0,0,1
1482719944039141376,0,1,0,0,1
1480510711444955136,0,1,0,0,1
1480172100723695616,0,1,0,0,1
1480187699176767488,0,1,0,0,1
1480274813109243904,0,1,0,0,1
1480297970847256576,1,0,0,0,1
1480323556898656256,0,1,0,0,1
1480399548333834240,0,1,0,0,1
1480430001870848000,0,1,0,0,1
1480479408158756864,1,0,0,0,1
1480487749689823232,0,1,0,0,1
1480546050968797184,0,1,0,0,1
1480122087981215744,1,0,0,0,1
1480603225661353984,0,1,0,0,1
1480770585055555584,0,1,0,0,1
1480845015471443968,1,0,0,0,1
1480971130416545792,1,0,0,0,1
1480971951900278784,0,1,0,0,1
1481084857313038336,0,1,0,0,1
1481089308991934464,0,1,0,0,1
1481264477068738560,0,1,0,0,1
1481265917795643392,0,1,0,0,1
1480149905213562880,0,1,0,0,1
1480081346194202624,0,1,0,0,1
1481340262719045632,0,1,0,0,1
1479655862041919488,0,1,0,0,1
1479254791687651328,0,1,0,0,1
1479270088629006336,0,1,0,0,1
1479311765477363712,0,1,0,0,1
1479333805668601856,0,1,0,0,1
1479390386263109632,0,1,0,0,1
1479406897237307392,0,1,0,0,1
1479450943724736512,1,0,0,0,1
1479460254035415040,0,1,0,0,1
1479480939503706112,1,0,0,0,1
1479710057432559616,0,1,0,0,1
1480061185563119616,1,0,0,0,1
1479715470362116096,0,1,0,0,1
1479724765690703872,0,1,0,0,1
1479736412312383488,0,1,0,0,1
1479743889842003968,0,1,0,0,1
1479768376851550208,0,1,0,0,1
1479768379733037056,0,1,0,0,1
1479877271762599936,0,0,0,1,1
1479898959300767744,0,1,0,0,1
1480048835217010688,0,1,0,0,1
1481269666370760704,0,1,0,0,1
1481369428285849600,0,1,0,0,1
1482662751252226048,0,1,0,0,1
1482323811370692608,0,1,0,0,1
1481935518585827328,0,1,0,0,1
1481942391309619200,0,1,0,0,1
1482015831160672256,0,1,0,0,1
1482039435835367424,0,1,0,0,1
1482039663594549248,0,1,0,0,1
1482050912944332800,0,1,0,0,1
1482094290847346688,1,0,0,0,1
1482205629150547968,1,0,0,0,1
1482266071621156864,0,1,0,0,1
1482414150248808448,0,1,0,0,1
1481919291452583936,0,1,0,0,1
1482466656584708096,0,1,0,0,1
1482521989394927616,0,1,0,0,1
1482566533087907840,0,1,0,0,1
1482581609107058688,0,0,0,1,1
1482589424173072384,1,0,0,0,1
1482624196538687488,0,0,1,0,1
1482632039962664960,0,1,0,0,1
1482650393209450496,0,1,0,0,1
1482656967265034240,0,1,0,0,1
1481930318781501440,0,1,0,0,1
1481897193594241024,0,1,0,0,1
1481405583295418368,0,1,0,0,1
1481661279500709888,0,1,0,0,1
1481454365139513344,0,1,0,0,1
1481477339863306240,0,1,0,0,1
1481518180820557824,0,1,0,0,1
1481524523803594752,1,0,0,0,1
1481538337550839808,1,0,0,0,1
1481586790037340160,1,0,0,0,1
1481623723887185920,1,0,0,0,1
1481631754419113984,0,1,0,0,1
1481647751981002752,1,0,0,0,1
1481680486271442944,1,0,0,0,1
1481884645029470208,0,1,0,0,1
1481695877836451840,0,1,0,0,1
1481711751099998208,0,1,0,0,1
1481770797211557888,0,1,0,0,1
1481782699559903232,0,1,0,0,1
1481802042209411072,0,1,0,0,1
1481828738581118976,0,1,0,0,1
1481858047035248640,0,0,1,0,1
1481873272597671936,0,1,0,0,1
1481883183113191424,0,1,0,0,1
1487464835239526400,0,1,0,0,1
1487471015219417088,0,1,0,0,1
1487483176280891392,0,1,0,0,1
1492159679132487680,0,1,0,0,1
1491870959304949760,0,0,1,0,1
1491901415471599616,0,1,0,0,1
1491919614091141120,0,1,0,0,1
1491951596397383680,0,1,0,0,1
1492012985010704384,0,1,0,0,1
1492016349253718016,0,1,0,0,1
1492040592490057728,0,1,0,0,1
1492102516347179008,0,1,0,0,1
1492143987209162752,0,1,0,0,1
1492164031825661952,1,0,0,0,1
1491792514030125056,0,1,0,0,1
1492189395948036096,0,1,0,0,1
1492207780266065920,0,1,0,0,1
1492217770502725632,0,1,0,0,1
1492248053683793920,0,1,0,0,1
1492286668497465344,0,1,0,0,1
1492297503101755392,0,1,0,0,1
1492321595507019776,0,1,0,0,1
1492338990510395392,0,0,1,0,1
1492356286327197696,0,1,0,0,1
1491822953545478144,0,0,1,0,1
1491779417164550144,0,1,0,0,1
1492375889320951808,0,1,0,0,1
1491358341196623872,0,1,0,0,1
1491044785641369600,0,1,0,0,1
1491072318713389056,1,0,0,0,1
1491091036185182208,0,1,0,0,1
1491128266140569600,1,0,0,0,1
1491129822114115584,0,1,0,0,1
1491138265356898304,1,0,0,0,1
1491236601468710912,0,1,0,0,1
1491306635800850432,0,1,0,0,1
1491331964489633792,0,1,0,0,1
1491383019642494976,0,0,0,1,1
1491742553221308416,0,0,0,1,1
1491413216412725248,0,1,0,0,1
1491436324540276736,0,0,1,0,1
1491499982003789824,1,0,0,0,1
1491509256226578432,0,1,0,0,1
1491637244096036864,0,1,0,0,1
1491649201389785088,0,0,1,0,1
1491692376976502784,1,0,0,0,1
1491699273528135680,1,0,0,0,1
1491703317919309824,0,1,0,0,1
1492369007273381888,0,1,0,0,1
1492396358950535168,0,1,0,0,1
1490987367125168128,0,1,0,0,1
1493651220065656832,0,1,0,0,1
1493109860610629632,0,0,1,0,1
1493111637854896128,0,1,0,0,1
1493271434172399616,0,1,0,0,1
1493287003739275264,0,1,0,0,1
1493499866928005120,0,1,0,0,1
1493575702075092992,0,1,0,0,1
1493576819492065280,0,1,0,0,1
1493633015167139840,0,1,0,0,1
1493642221949960192,0,1,0,0,1
1493673289444900864,1,0,0,0,1
1493007711940018176,0,1,0,0,1
1493678374308384768,0,1,0,0,1
1493713958364188672,0,1,0,0,1
1493725303453073408,0,1,0,0,1
1493744998042333184,0,1,0,0,1
1493775033784623104,1,0,0,0,1
1493775727724216320,1,0,0,0,1
1493812228818042880,0,1,0,0,1
1493830732107730944,0,1,0,0,1
1493839029640605696,0,1,0,0,1
1493040759091523584,0,1,0,0,1
1492981571820953600,0,1,0,0,1
1492421708464398336,0,1,0,0,1
1492603776884219904,0,1,0,0,1
1492423160377057280,0,1,0,0,1
1492437547145961472,0,1,0,0,1
1492482105590362112,0,1,0,0,1
1492497411578683392,0,1,0,0,1
1492514295309078528,0,1,0,0,1
1492564011359121408,0,1,0,0,1
1492571350980042752,0,1,0,0,1
1492583805621837824,1,0,0,0,1
1492593394299850752,0,1,0,0,1
1492607319892443136,0,1,0,0,1
1492969627764375552,0,1,0,0,1
1492623742295588864,0,0,0,1,1
1492707024559300608,0,1,0,0,1
1492785317778452480,0,1,0,0,1
1492876144424939520,0,1,0,0,1
1492897615251390464,1,0,0,0,1
1492917286239354880,0,1,0,0,1
1492927091024842752,1,0,0,0,1
1492928364667039744,1,0,0,0,1
1492947274284027904,0,1,0,0,1
1490989384186826752,0,1,0,0,1
1490980369256042496,0,1,0,0,1
1487529413810229248,1,0,0,0,1
1488753742308589568,0,1,0,0,1
1488231885461344256,0,1,0,0,1
1488373385767710720,0,1,0,0,1
1488382001396822016,1,0,0,0,1
1488440827965755392,0,1,0,0,1
1488545068562722816,1,0,0,0,1
1488566125994598400,1,0,0,0,1
1488582343535345664,0,1,0,0,1
1488589278611488768,0,1,0,0,1
1488591891797090304,1,0,0,0,1
1488760817848033280,1,0,0,0,1
1488164298341826560,0,1,0,0,1
1488761387107352576,0,1,0,0,1
1488762156552175616,0,1,0,0,1
1488781718052290560,0,1,0,0,1
1488800209568432128,0,1,0,0,1
1488892081598873600,0,1,0,0,1
1488969733613694976,1,0,0,0,1
1488996858143784960,0,1,0,0,1
1489018195553832960,1,0,0,0,1
1489083707159896064,1,0,0,0,1
1488197119135657984,0,1,0,0,1
1488164222148165632,0,1,0,0,1
1489105905547624448,0,1,0,0,1
1487772003662635008,1,0,0,0,1
1487572250920374272,0,1,0,0,1
1487575411986886656,0,1,0,0,1
1487644765726416896,0,1,0,0,1
1487661250213564416,0,1,0,0,1
1487685914117951488,0,1,0,0,1
1487697499871539200,0,1,0,0,1
1487729766266736640,0,1,0,0,1
1487750162718105600,0,1,0,0,1
1487768655542857728,1,0,0,0,1
1487773704788471808,0,0,0,1,1
1488160079895580672,0,1,0,0,1
1487782853379248128,1,0,0,0,1
1487785993998585856,0,1,0,0,1
1487795945139892224,1,0,0,0,1
1487832745061539840,1,0,0,0,1
1487974973436276736,0,0,1,0,1
1488012072466087936,0,1,0,0,1
1488045566865338368,0,1,0,0,1
1488134056319590400,0,1,0,0,1
1488158980241338368,0,1,0,0,1
1489092829725233152,0,1,0,0,1
1489162376133939200,0,1,0,0,1
1490955485171826688,0,1,0,0,1
1490498382841921536,0,1,0,0,1
1490224746188853248,0,0,0,1,1
1490264685899255808,0,0,0,1,1
1490307992637427712,1,0,0,0,1
1490374994668445696,0,1,0,0,1
1490385771257565184,0,1,0,0,1
1490402814501269504,0,1,0,0,1
1490412546867986432,0,1,0,0,1
1490438925617631232,0,1,0,0,1
1490481035246661632,0,1,0,0,1
1490513240362975232,0,1,0,0,1
1490133024821981184,0,1,0,0,1
1490531727126986752,0,1,0,0,1
1490547902774538240,0,0,0,1,1
1490562230127325184,0,1,0,0,1
1490588315032117248,0,1,0,0,1
1490658269693718528,1,0,0,0,1
1490725720967954432,0,0,1,0,1
1490793034786693120,0,1,0,0,1
1490838798762184704,0,0,0,1,1
1490852851060510720,1,0,0,0,1
1490204813711142912,0,1,0,0,1
1490031333628080128,1,0,0,0,1
1489165160711393280,0,0,0,1,1
1489624509518917632,0,1,0,0,1
1489197115653951488,0,1,0,0,1
1489241591856390144,0,1,0,0,1
1489272072085729280,0,1,0,0,1
1489309102966964224,1,0,0,0,1
1489337315365629952,0,1,0,0,1
1489374535790911488,1,0,0,0,1
1489500235298607104,0,1,0,0,1
1489507839995428864,0,1,0,0,1
1489567591576502272,0,1,0,0,1
1489661757799145472,0,1,0,0,1
1489949574206742528,0,1,0,0,1
1489682023740362752,0,1,0,0,1
1489709873663299584,0,1,0,0,1
1489722484190584832,0,1,0,0,1
1489725765235134464,0,1,0,0,1
1489725807492669440,0,1,0,0,1
1489813891249229824,0,1,0,0,1
1489874138877820928,0,0,0,1,1
1489903118481506304,1,0,0,0,1
1489913502647128064,0,1,0,0,1
1427539299575209984,0,1,0,0,1
1427473360175321088,0,1,0,0,1
1427439313483141120,0,1,0,0,1
1357874765097271296,0,1,0,0,1
1354752613938585600,1,0,0,0,1
1354767575377448960,1,0,0,0,1
1354797920256552960,0,1,0,0,1
1354841830769176576,0,0,0,1,1
1354903661348962304,0,1,0,0,1
1355099259113189376,0,0,0,1,1
1355103158293426176,0,1,0,0,1
1355223883599785984,1,0,0,0,1
1355294955791642624,1,0,0,0,1
1355420534012571648,0,1,0,0,1
1355479182097047552,0,1,0,0,1
1355496065869508608,0,1,0,0,1
1355546598059732992,0,0,0,1,1
1355579667332345856,0,1,0,0,1
1355749636288303104,0,1,0,0,1
1355813231642746880,0,1,0,0,1
1355845072517025792,0,1,0,0,1
1355948855767019520,1,0,0,0,1
1356124331391258624,0,0,0,1,1
1356171737491271680,0,1,0,0,1
1356182102417362944,0,0,1,0,1
1354717525083303936,0,1,0,0,1
1354704407728971776,0,1,0,0,1
1354639955079921664,0,1,0,0,1
1354134001271902208,0,1,0,0,1
1353948538552659968,1,0,0,0,1
1353951310416998400,1,0,0,0,1
1353993629484732416,0,1,0,0,1
1353999850262638592,0,1,0,0,1
1354020729210236928,0,1,0,0,1
1354074602037772288,1,0,0,0,1
1354107617396797440,0,1,0,0,1
1354109797176631296,0,1,0,0,1
1354120210371006464,1,0,0,0,1
1354149889656164352,0,1,0,0,1
1354620750481784832,0,1,0,0,1
1354236170188763136,0,1,0,0,1
1354366281387016192,0,1,0,0,1
1354370043329576960,0,0,1,0,1
1354382159121846272,1,0,0,0,1
1354413796555714560,0,0,1,0,1
1354414879466258432,1,0,0,0,1
1354510615688007680,0,1,0,0,1
1354556617149317120,0,1,0,0,1
1354606353419915264,0,1,0,0,1
1356183912909832192,1,0,0,0,1
1356280359139344384,0,1,0,0,1
1356329989524910080,0,1,0,0,1
1357581342037450752,1,0,0,0,1
1357285900732952576,1,0,0,0,1
1357313286291783680,0,1,0,0,1
1357319286897967104,1,0,0,0,1
1357325357968416768,0,1,0,0,1
1357333759826165760,0,1,0,0,1
1357336339369218048,0,1,0,0,1
1357337084936081408,0,1,0,0,1
1357525215371161600,0,1,0,0,1
1357561638317031424,1,0,0,0,1
1357597709792862208,0,1,0,0,1
1357177525739397120,0,1,0,0,1
1357607389172813824,0,1,0,0,1
1357621363620646912,0,1,0,0,1
1357621791116591104,1,0,0,0,1
1357638184071438336,0,1,0,0,1
1357643316062519296,1,0,0,0,1
1357666741233582080,0,1,0,0,1
1357747410613637120,0,1,0,0,1
1357748742703702016,0,1,0,0,1
1357756304757039104,0,1,0,0,1
1357217936377667584,0,1,0,0,1
1357158908243058688,0,1,0,0,1
1356470658616619008,0,1,0,0,1
1356659227130007552,0,1,0,0,1
1356477369695932416,0,1,0,0,1
1356481345728352256,0,0,1,0,1
1356481990556540928,0,1,0,0,1
1356491536914132992,0,1,0,0,1
1356520807367852032,0,1,0,0,1
1356527425384022016,0,1,0,0,1
1356534240351932416,1,0,0,0,1
1356534738522157056,0,1,0,0,1
1356566087907880960,1,0,0,0,1
1356721108993650688,1,0,0,0,1
1357150416572669952,0,1,0,0,1
1356786906068103168,0,1,0,0,1
1356816367526293504,1,0,0,0,1
1356853795125227520,1,0,0,0,1
1356868735269703680,0,1,0,0,1
1356873786071674880,0,1,0,0,1
1356887963007918080,0,1,0,0,1
1356944085177823232,1,0,0,0,1
1357021444551696384,1,0,0,0,1
1357138280597188608,0,1,0,0,1
1353861931736518656,1,0,0,0,1
1353849433918754816,0,1,0,0,1
1353820829524643840,0,1,0,0,1
1351544422618435584,0,1,0,0,1
1350780470456410112,0,1,0,0,1
1350805310441549824,0,1,0,0,1
1350858870705500160,0,1,0,0,1
1351140417601998848,0,0,0,1,1
1351164201428000768,1,0,0,0,1
1351181839784939520,0,1,0,0,1
1351349974345256960,0,1,0,0,1
1351403124993482752,0,0,1,0,1
1351498138276818944,1,0,0,0,1
1351548257860665344,0,1,0,0,1
1350609563926425600,0,1,0,0,1
1351575034628812800,0,1,0,0,1
1351600864226549760,1,0,0,0,1
1351648704940408832,0,1,0,0,1
1351650564711587840,0,1,0,0,1
1351771722282840064,0,1,0,0,1
1351783766268624896,0,1,0,0,1
1351810452825640960,0,0,0,1,1
1351863177500385280,0,1,0,0,1
1351865159531208704,1,0,0,0,1
1350731460521635840,0,1,0,0,1
1350604996769849344,0,1,0,0,1
1351933073999454208,0,1,0,0,1
1349974609890783232,1,0,0,0,1
1349599099700596736,0,1,0,0,1
1349652113199165440,1,0,0,0,1
1349657556579446784,0,1,0,0,1
1349708980101197824,0,1,0,0,1
1349733519551983616,0,1,0,0,1
1349868458671042560,0,1,0,0,1
1349871897039650816,0,1,0,0,1
1349919478918758400,0,1,0,0,1
1349926165536935936,1,0,0,0,1
1350002228090687488,0,1,0,0,1
1350589034804912128,0,1,0,0,1
1350121998211547136,0,1,0,0,1
1350173006656647168,0,1,0,0,1
1350225358285582336,0,1,0,0,1
1350273414120935424,0,1,0,0,1
1350397008218124288,0,1,0,0,1
1350405653819392000,0,1,0,0,1
1350466810764734464,0,1,0,0,1
1350533334498226176,1,0,0,0,1
1350536836884664320,1,0,0,0,1
1351924783533993984,0,1,0,0,1
1351980446960201728,1,0,0,0,1
1353759658062786560,0,1,0,0,1
1353403523346567168,0,1,0,0,1
1352814661012344832,0,1,0,0,1
1352899066871631872,1,0,0,0,1
1352905740311293952,0,1,0,0,1
1352912617933684736,0,1,0,0,1
1352981517304295424,0,1,0,0,1
1353008341317017600,0,1,0,0,1
1353139840305528832,0,1,0,0,1
1353192566980632576,0,1,0,0,1
1353309173711216640,0,1,0,0,1
1353413295848361984,1,0,0,0,1
1352734380783898624,0,1,0,0,1
1353419392546168832,1,0,0,0,1
1353434666683015168,0,1,0,0,1
1353460806919315456,0,1,0,0,1
1353520348042506240,0,1,0,0,1
1353554246927605760,1,0,0,0,1
1353599800847962112,0,1,0,0,1
1353714870093549568,0,1,0,0,1
1353715234662440960,1,0,0,0,1
1353749835573243904,0,1,0,0,1
1352756698642059264,0,1,0,0,1
1352717049680850944,0,1,0,0,1
1352020242109763584,0,1,0,0,1
1352319058775924736,0,1,0,0,1
1352023328211546112,0,1,0,0,1
1352050768849719296,1,0,0,0,1
1352089171557560320,0,1,0,0,1
1352146205556539392,0,1,0,0,1
1352211244250521600,0,1,0,0,1
1352212328561975296,0,1,0,0,1
1352259511516602368,0,1,0,0,1
1352271702194053120,0,1,0,0,1
1352317237424742400,0,1,0,0,1
1352353283403296768,0,1,0,0,1
1352629569321381888,0,1,0,0,1
1352357567029256192,0,1,0,0,1
1352374700840632320,0,1,0,0,1
1352511379618598912,0,1,0,0,1
1352519343259734016,1,0,0,0,1
1352536566804205568,0,0,0,1,1
1352565376769536000,1,0,0,0,1
1352569655131594752,0,1,0,0,1
1352576753764610048,0,1,0,0,1
1352579714230214656,0,1,0,0,1
1357790413264945152,0,1,0,0,1
1357881909813026816,1,0,0,0,1
1373532038192631808,0,1,0,0,1
1357907786072399872,1,0,0,0,1
1366599412420608000,1,0,0,0,1
1366615677037998080,0,1,0,0,1
1366673521917714432,1,0,0,0,1
1366843382497173504,1,0,0,0,1
1367016445394190336,0,1,0,0,1
1367036172724293632,1,0,0,0,1
1367104913617154048,1,0,0,0,1
1367149938631671808,0,1,0,0,1
1367179964961857536,1,0,0,0,1
1367326188658696192,0,1,0,0,1
1367372356700696576,1,0,0,0,1
1367413602517417984,0,1,0,0,1
1367462213154398208,0,1,0,0,1
1367859651350458368,1,0,0,0,1
1367931712580292608,0,1,0,0,1
1367959269337796608,0,1,0,0,1
1367981424163233792,0,1,0,0,1
1368076966151262208,0,1,0,0,1
1368077538459721728,1,0,0,0,1
1368336949669400576,0,1,0,0,1
1368373197498806272,0,1,0,0,1
1366494814708064256,0,1,0,0,1
1366433673709449216,0,1,0,0,1
1366395810229886976,0,1,0,0,1
1364835618056904704,1,0,0,0,1
1364296562332024832,0,1,0,0,1
1364318572089122816,1,0,0,0,1
1364320441851146240,0,1,0,0,1
1364489803828506624,0,1,0,0,1
1364526508778213376,0,1,0,0,1
1364532870497394688,0,1,0,0,1
1364574314406772736,0,1,0,0,1
1364680043876790272,0,1,0,0,1
1364811789372772352,0,1,0,0,1
1364956597043290112,0,1,0,0,1
1366373629701677056,0,1,0,0,1
1364983538148376576,0,1,0,0,1
1364994163272347648,0,1,0,0,1
1365591269884444672,0,1,0,0,1
1365621139104362496,0,1,0,0,1
1365709298613899264,0,1,0,0,1
1365853609099886592,0,1,0,0,1
1365870550057431040,0,1,0,0,1
1365892531884597248,0,1,0,0,1
1366199377690263552,0,0,0,1,1
1368507465277403136,0,1,0,0,1
1368522308814569472,0,1,0,0,1
1368525780024586240,0,1,0,0,1
1372196523392565248,0,1,0,0,1
1371677176215576576,0,1,0,0,1
1371700434574876672,1,0,0,0,1
1371790696378736640,0,1,0,0,1
1371848307706847232,0,1,0,0,1
1371877780460171264,0,1,0,0,1
1372019406071599104,0,1,0,0,1
1372085824024678400,0,1,0,0,1
1372141649292316672,0,1,0,0,1
1372170913030967296,1,0,0,0,1
1372211900457488384,0,1,0,0,1
1371394173975330816,0,1,0,0,1
1372281255774056448,0,1,0,0,1
1372574445223739392,0,1,0,0,1
1372835190490431488,0,1,0,0,1
1372983760048828416,0,1,0,0,1
1372984036122009600,0,1,0,0,1
1373128896808374272,0,1,0,0,1
1373212193211232256,0,1,0,0,1
1373293126916395008,0,1,0,0,1
1373359895303577600,0,1,0,0,1
1371470936189325312,0,1,0,0,1
1371157096390127616,0,1,0,0,1
1368575287991144448,1,0,0,0,1
1369919036117680128,0,1,0,0,1
1368613107086589952,0,1,0,0,1
1368625189551042560,0,1,0,0,1
1368837216986750976,0,1,0,0,1
1368993386917597184,0,1,0,0,1
1369201049018363904,0,1,0,0,1
1369556817802575872,0,1,0,0,1
1369640371697942528,0,1,0,0,1
1369668257347739648,0,1,0,0,1
1369913706717581312,0,1,0,0,1
1370011242606125056,0,1,0,0,1
1370980008592875520,0,0,1,0,1
1370092230959104000,1,0,0,0,1
1370095086692880384,1,0,0,0,1
1370306690382393344,0,1,0,0,1
1370307081895575552,0,1,0,0,1
1370581228424953856,0,1,0,0,1
1370590301388214272,0,1,0,0,1
1370787584092295168,0,1,0,0,1
1370865154284523520,0,1,0,0,1
1370958995012292608,0,1,0,0,1
1364276715325968384,0,1,0,0,1
1364231544588562432,1,0,0,0,1
1364217202786922496,1,0,0,0,1
1360091700740423680,0,1,0,0,1
1359493957030395904,1,0,0,0,1
1359590080902434816,0,1,0,0,1
1359717728186171392,0,1,0,0,1
1359789463090515968,0,1,0,0,1
1359840628650164224,0,1,0,0,1
1359881983585705984,1,0,0,0,1
1359954885974835200,0,1,0,0,1
1359989484092334080,1,0,0,0,1
1360031871497760768,1,0,0,0,1
1360140114538725376,0,1,0,0,1
1359463348774002688,1,0,0,0,1
1360156943327891456,0,1,0,0,1
1360162956294684672,0,1,0,0,1
1360172330119495680,0,1,0,0,1
1360211703837777920,0,0,0,1,1
1360214575128449024,0,1,0,0,1
1360307111264100352,0,1,0,0,1
1360584295459532800,0,1,0,0,1
1360633828663037952,0,1,0,0,1
1360907998105903104,0,0,1,0,1
1359483130214834176,0,1,0,0,1
1359426124510416896,0,1,0,0,1
1360933395002368000,0,1,0,0,1
1358451131328966656,0,1,0,0,1
1357911833512792064,1,0,0,0,1
1357930152030728192,0,1,0,0,1
1358007720805191680,1,0,0,0,1
1358053547171012608,0,1,0,0,1
1358058948063088640,1,0,0,0,1
1358259121175281664,1,0,0,0,1
1358293131633000448,1,0,0,0,1
1358364124888104960,0,1,0,0,1
1358403021361790976,0,1,0,0,1
1358495012128870400,0,1,0,0,1
1359400376101974016,0,1,0,0,1
1358852978288046080,0,0,0,1,1
1358882976399052800,1,0,0,0,1
1358917395100893184,0,1,0,0,1
1359015558965047296,1,0,0,0,1
1359047135401037824,0,1,0,0,1
1359140297800835072,0,1,0,0,1
1359151394658344960,0,1,0,0,1
1359210929934761984,0,1,0,0,1
1359295911566966784,0,1,0,0,1
1360912812499902464,0,1,0,0,1
1360946598751195136,0,1,0,0,1
1364134948576186368,1,0,0,0,1
1363123082316173312,0,1,0,0,1
1362478117516947456,0,1,0,0,1
1362554329895370752,1,0,0,0,1
1362669196077920256,0,1,0,0,1
1362745352143609856,0,1,0,0,1
1362750168035164160,0,1,0,0,1
1362900418464948224,0,1,0,0,1
1362974964459188224,0,1,0,0,1
1363010819739500544,0,1,0,0,1
1363020534267736064,0,1,0,0,1
1363250605893054464,0,0,0,1,1
1362361396109918208,0,1,0,0,1
1363387617472106496,0,1,0,0,1
1363396391779897344,0,1,0,0,1
1363426418877685760,1,0,0,0,1
1363484279804747776,0,1,0,0,1
1363495483176603648,0,1,0,0,1
1363573171870334976,0,1,0,0,1
1363777548132392960,1,0,0,0,1
1363804300632223744,1,0,0,0,1
1364073902146793472,0,0,0,1,1
1362459944658767872,0,1,0,0,1
1362305278922788864,0,1,0,0,1
1361088477748727808,0,1,0,0,1
1361768552215240704,0,1,0,0,1
1361193379208470528,1,0,0,0,1
1361220693904429056,0,1,0,0,1
1361243621484158976,0,0,0,1,1
1361257623593566208,0,0,0,1,1
1361294464887660544,0,1,0,0,1
1361296955956207616,0,1,0,0,1
1361526260590141440,0,1,0,0,1
1361591610249801728,0,0,0,1,1
1361645121243148288,0,1,0,0,1
1361824129058562048,0,1,0,0,1
1362139757220880384,0,1,0,0,1
1361833717434638336,1,0,0,0,1
1361886052462526464,0,1,0,0,1
1361927366340091904,1,0,0,0,1
1361949863550803968,0,1,0,0,1
1362056747976859648,1,0,0,0,1
1362072024567353344,0,1,0,0,1
1362086296571711488,1,0,0,0,1
1362089834290900992,0,1,0,0,1
1362093232880979968,0,1,0,0,1
1349469238927400960,0,1,0,0,1
1349457842697351168,0,1,0,0,1
1349445444447985664,0,1,0,0,1
1349408327105609728,1,0,0,0,1
1339036844378353664,1,0,0,0,1
1339119856860471296,0,0,0,1,1
1339153337535528960,0,1,0,0,1
1339192108343848960,0,1,0,0,1
1339222046249775104,0,1,0,0,1
1339234800700252160,1,0,0,0,1
1339247093379182592,0,0,0,1,1
1339257856466554880,0,1,0,0,1
1339263000352415744,0,1,0,0,1
1339295416945266688,1,0,0,0,1
1339363344361381888,0,1,0,0,1
1339466336968220672,0,1,0,0,1
1339575386200367104,0,1,0,0,1
1339694730938966016,0,1,0,0,1
1339795974118465536,0,1,0,0,1
1339829287499649024,1,0,0,0,1
1339838162785497088,0,1,0,0,1
1339855148705669120,0,1,0,0,1
1339884734168514560,1,0,0,0,1
1339890149425958912,0,1,0,0,1
1339927859050246144,0,0,1,0,1
1338989089002020864,1,0,0,0,1
1338967737809383424,0,1,0,0,1
1338961332125757440,0,1,0,0,1
1338159055274065920,0,1,0,0,1
1337963219466371072,1,0,0,0,1
1337965563277156352,0,1,0,0,1
1337999228996562944,0,1,0,0,1
1338008633859301376,0,1,0,0,1
1338056998684930048,0,1,0,0,1
1338059061166792704,0,1,0,0,1
1338120264551428096,0,1,0,0,1
1338126151215149056,0,1,0,0,1
1338157937299230720,0,1,0,0,1
1338213606740144128,0,1,0,0,1
1338855992180703232,0,1,0,0,1
1338384333439164416,1,0,0,0,1
1338405856832983040,0,1,0,0,1
1338428366941110272,0,1,0,0,1
1338568479847362560,0,1,0,0,1
1338574002197995520,0,1,0,0,1
1338590379961065472,1,0,0,0,1
1338678214382665728,0,1,0,0,1
1338792541852844032,0,1,0,0,1
1338821090383032320,0,1,0,0,1
1339939099415896064,0,1,0,0,1
1339971421024489472,0,1,0,0,1
1340008321064046592,0,1,0,0,1
1341857453370032128,1,0,0,0,1
1341371192184344576,0,1,0,0,1
1341460921995051008,1,0,0,0,1
1341469487002832896,0,1,0,0,1
1341472083679711232,1,0,0,0,1
1341482868925579264,0,1,0,0,1
1341518908705148928,0,1,0,0,1
1341545297101524992,0,1,0,0,1
1341824892908445696,0,1,0,0,1
1341828168072777728,0,1,0,0,1
1341879698544947200,0,1,0,0,1
1341329833624817664,0,0,0,1,1
1341893012650078208,0,1,0,0,1
1341916558671679488,0,1,0,0,1
1342025875022360576,0,1,0,0,1
1342237602733314048,0,1,0,0,1
1342265016293068800,0,1,0,0,1
1342413402824708096,0,1,0,0,1
1342455973018030080,0,1,0,0,1
1342463311330217984,0,1,0,0,1
1342467295805902848,0,1,0,0,1
1341370439537344512,1,0,0,0,1
1341314072969678848,0,1,0,0,1
1340020159482834944,0,1,0,0,1
1340365769025187840,0,1,0,0,1
1340040030803415040,0,1,0,0,1
1340052817277575168,0,1,0,0,1
1340084525397913600,0,1,0,0,1
1340129133460860928,1,0,0,0,1
1340159433872011264,1,0,0,0,1
1340226302465298432,0,1,0,0,1
1340232386756407296,0,1,0,0,1
1340243855975845888,0,1,0,0,1
1340355881846902784,0,1,0,0,1
1340409764287827968,0,0,0,1,1
1341107590219096064,0,1,0,0,1
1340438451875946496,0,1,0,0,1
1340471464173203456,0,0,0,1,1
1340571337526415360,1,0,0,0,1
1340579206267359232,0,1,0,0,1
1340767469984628736,0,1,0,0,1
1340805749606330368,0,0,0,1,1
1340857119961010176,0,1,0,0,1
1340927494535467008,0,1,0,0,1
1341066630038634496,0,1,0,0,1
1337952693625757696,0,1,0,0,1
1337903214210019328,0,1,0,0,1
1337825704356925440,0,1,0,0,1
1334596478317162496,0,1,0,0,1
1334429736647450624,0,1,0,0,1
1334435989411028992,0,1,0,0,1
1334446264184803328,0,1,0,0,1
1334457970831179776,0,1,0,0,1
1334476661593698304,0,1,0,0,1
1334521041285046272,1,0,0,0,1
1334544129557139456,0,1,0,0,1
1334561185686020096,0,1,0,0,1
1334578951176347648,0,1,0,0,1
1334746389515882496,0,1,0,0,1
1334328998050971648,1,0,0,0,1
1334766886882430976,0,1,0,0,1
1334796911656591360,0,1,0,0,1
1334816749557080064,0,1,0,0,1
1334895325060853760,1,0,0,0,1
1334933427229962240,0,1,0,0,1
1334944563388063744,0,1,0,0,1
1334951168166916096,0,1,0,0,1
1334959076460036096,0,0,0,1,1
1335033484314898432,0,1,0,0,1
1334425058249326592,0,1,0,0,1
1334314887116283904,0,1,0,0,1
1335066282132168704,0,1,0,0,1
1333950558890123264,0,1,0,0,1
1333475572215930880,0,1,0,0,1
1333482356578119680,1,0,0,0,1
1333490131349680128,0,1,0,0,1
1333494277200965632,1,0,0,0,1
1333638661397737472,0,1,0,0,1
1333833601876701184,0,1,0,0,1
1333836618004774912,0,1,0,0,1
1333884715171000320,0,1,0,0,1
1333901048344317952,0,1,0,0,1
1334039236060868608,1,0,0,0,1
1334263254827274240,0,1,0,0,1
1334039918532726784,0,1,0,0,1
1334044670423302144,0,1,0,0,1
1334086463185620992,0,1,0,0,1
1334119415898640384,1,0,0,0,1
1334151352306388992,0,1,0,0,1
1334192999308292096,0,1,0,0,1
1334194026719838208,0,0,0,1,1
1334205069726683136,0,1,0,0,1
1334221578201083904,0,0,1,0,1
1335047260602830848,1,0,0,0,1
1335071318727938048,0,1,0,0,1
1337772039910928384,0,1,0,0,1
1337107241804161024,0,1,0,0,1
1336735937947185152,0,1,0,0,1
1336757624503750656,0,1,0,0,1
1336760779471728640,0,1,0,0,1
1336839529420951552,0,1,0,0,1
1336846157985746944,0,1,0,0,1
1336864554186207232,0,1,0,0,1
1336922772900024320,0,1,0,0,1
1337036287942004736,0,1,0,0,1
1337044196901990400,1,0,0,0,1
1337138399942217728,0,1,0,0,1
1336613312398651392,1,0,0,0,1
1337203611479265280,1,0,0,0,1
1337239678160941056,0,1,0,0,1
1337244725548638208,1,0,0,0,1
1337275583252684800,0,1,0,0,1
1337333646227877888,1,0,0,0,1
1337369173689712640,0,1,0,0,1
1337384352318156800,0,1,0,0,1
1337557338748817408,0,1,0,0,1
1337725493240586240,0,1,0,0,1
1336713518637228032,1,0,0,0,1
1336592633926463488,0,1,0,0,1
1335106664542969856,0,1,0,0,1
1335573289578610688,0,1,0,0,1
1335132220529528832,0,1,0,0,1
1335142948149846016,0,1,0,0,1
1335153524167090176,1,0,0,0,1
1335164059587637248,0,1,0,0,1
1335180890515910656,0,1,0,0,1
1335248536074481664,0,1,0,0,1
1335447218141085696,0,1,0,0,1
1335481709106622464,0,1,0,0,1
1335483066303852544,0,1,0,0,1
1335673712834535424,0,1,0,0,1
1336563442464006144,0,1,0,0,1
1335854719504445440,0,1,0,0,1
1335880844745998336,0,1,0,0,1
1335963376971812864,0,1,0,0,1
1335965353164345344,0,1,0,0,1
1336060418775724032,0,1,0,0,1
1336090951828246528,0,1,0,0,1
1336188237740605440,0,1,0,0,1
1336506076683005952,0,1,0,0,1
1336563363967508480,0,1,0,0,1
1342511286777597952,0,1,0,0,1
1342517963602202624,0,1,0,0,1
1342553730663796736,0,1,0,0,1
1347180762202656768,0,1,0,0,1
1346935864866205696,0,1,0,0,1
1346976808353353728,0,1,0,0,1
1346984541467115520,1,0,0,0,1
1346992091507920896,1,0,0,0,1
1347015553555202048,0,0,1,0,1
1347097656259129344,0,1,0,0,1
1347097759078363136,1,0,0,0,1
1347136730634342400,0,1,0,0,1
1347162618226733056,0,1,0,0,1
1347225947515219968,0,1,0,0,1
1346861766995660800,0,1,0,0,1
1347231457543122944,0,1,0,0,1
1347247225718493184,0,1,0,0,1
1347251559097274368,1,0,0,0,1
1347258987075481600,0,1,0,0,1
1347298465748037632,0,0,0,1,1
1347384639388848128,1,0,0,0,1
1347430701273133056,0,1,0,0,1
1347455049379831808,0,0,0,1,1
1347513920429416448,0,1,0,0,1
1346926391955083264,0,1,0,0,1
1346800285570764800,0,1,0,0,1
1347646134878027776,0,1,0,0,1
1346499736006582272,1,0,0,0,1
1346180273763995648,1,0,0,0,1
1346283311987978240,1,0,0,0,1
1346364452539490304,0,0,0,1,1
1346385116294221824,0,0,1,0,1
1346387281528168448,0,1,0,0,1
1346411056432902144,0,1,0,0,1
1346445585616830464,0,1,0,0,1
1346451297206226944,0,1,0,0,1
1346476461666914304,0,1,0,0,1
1346578866308046848,0,1,0,0,1
1346782202281996288,0,1,0,0,1
1346631442118242304,0,1,0,0,1
1346634517180723200,1,0,0,0,1
1346696077332897792,0,1,0,0,1
1346700688911343616,0,1,0,0,1
1346718355932270592,0,1,0,0,1
1346755422653472768,0,1,0,0,1
1346755528421203968,0,1,0,0,1
1346761837698682880,0,1,0,0,1
1346763544906199040,0,1,0,0,1
1347544102984962048,0,1,0,0,1
1347649291767017472,1,0,0,0,1
1346149442567725056,0,1,0,0,1
1348830860380938240,0,1,0,0,1
1348606337563959296,0,1,0,0,1
1348615277731315712,0,1,0,0,1
1348658529943638016,0,1,0,0,1
1348676855805710336,0,1,0,0,1
1348686860651003904,0,1,0,0,1
1348702984549638144,0,1,0,0,1
1348720861721858048,0,1,0,0,1
1348787949421301760,0,0,0,1,1
1348811144065126400,0,1,0,0,1
1348851344069832704,0,1,0,0,1
1348572741318959104,0,1,0,0,1
1348877832483700736,1,0,0,0,1
1348925032513351680,0,1,0,0,1
1348957020083392512,0,1,0,0,1
1349003045171027968,1,0,0,0,1
1349078493217304576,0,1,0,0,1
1349245938238427136,0,1,0,0,1
1349246887585570816,0,1,0,0,1
1349258645574447104,0,1,0,0,1
1349390102141816832,0,1,0,0,1
1348573675251970048,0,1,0,0,1
1348570311223107584,0,1,0,0,1
1347750981413564416,1,0,0,0,1
1348144467178618880,0,1,0,0,1
1347770466841354240,0,1,0,0,1
1347789190310801408,0,1,0,0,1
1347820736795336704,0,1,0,0,1
1347940061451583488,1,0,0,0,1
1347942262748143616,1,0,0,0,1
1347947382437122048,0,1,0,0,1
1347979457491988480,0,1,0,0,1
1348004891239788544,0,1,0,0,1
1348107150904733696,0,1,0,0,1
1348165364023062528,0,1,0,0,1
1348516060224360448,0,1,0,0,1
1348192889059373056,0,1,0,0,1
1348199637568671744,0,1,0,0,1
1348236163694407680,1,0,0,0,1
1348279117750415360,0,1,0,0,1
1348323745262276608,0,0,0,1,1
1348335979774533632,0,1,0,0,1
1348346115117211648,0,1,0,0,1
1348400983416725504,0,1,0,0,1
1348408265512607744,0,1,0,0,1
1346175768649474048,0,1,0,0,1
1346111887084318720,0,1,0,0,1
1342567771100610560,0,1,0,0,1
1344000963577847808,0,1,0,0,1
1343781575482290176,0,1,0,0,1
1343785340981506048,0,1,0,0,1
1343819384662482944,0,1,0,0,1
1343861230549790720,0,1,0,0,1
1343875739309977600,0,1,0,0,1
1343888614892171264,0,1,0,0,1
1343915278804144128,0,1,0,0,1
1343921101076901888,0,1,0,0,1
1343980167807512576,0,1,0,0,1
1344001486292975616,1,0,0,0,1
1343598758815281152,1,0,0,0,1
1344010525743730688,0,1,0,0,1
1344035237882458112,0,1,0,0,1
1344057884292866048,1,0,0,0,1
1344122300359036928,0,1,0,0,1
1344130266055507968,1,0,0,0,1
1344141883656732672,1,0,0,0,1
1344211070915907584,0,1,0,0,1
1344229899028971520,0,1,0,0,1
1344304590062301184,0,1,0,0,1
1343777350023061504,0,1,0,0,1
1343568323922030592,1,0,0,0,1
1344395640474767360,0,1,0,0,1
1343092627843985408,0,1,0,0,1
1342588942248534016,0,1,0,0,1
1342615965243068416,1,0,0,0,1
1342708947422044160,0,1,0,0,1
1342751329043804160,0,1,0,0,1
1342809884597878784,0,1,0,0,1
1342888378472091648,0,1,0,0,1
1342894236933488640,0,1,0,0,1
1343011617039032320,0,1,0,0,1
1343028674791092224,0,1,0,0,1
1343095264253366272,1,0,0,0,1
1343501129796087808,0,1,0,0,1
1343137294249652224,0,1,0,0,1
1343205534942560256,1,0,0,0,1
1343247203712774144,0,1,0,0,1
1343293289122979840,0,1,0,0,1
1343296524894183424,0,1,0,0,1
1343375719557021696,0,1,0,0,1
1343380854752473088,0,1,0,0,1
1343421070750011392,1,0,0,0,1
1343421782729121792,0,1,0,0,1
1344362586956042240,0,1,0,0,1
1344530855641886720,0,1,0,0,1
1346019061424037888,1,0,0,0,1
1345737385343152128,0,1,0,0,1
1345471207538384896,0,1,0,0,1
1345482577625407488,1,0,0,0,1
1345500969447124992,1,0,0,0,1
1345548403493650432,1,0,0,0,1
1345593890519265280,0,1,0,0,1
1345620477792944128,0,1,0,0,1
1345642763140796416,0,1,0,0,1
1345697060037689344,0,1,0,0,1
1345709709425315840,1,0,0,0,1
1345739556608475136,1,0,0,0,1
1345439155266973696,1,0,0,0,1
1345814208903061504,0,1,0,0,1
1345819283973173248,0,0,0,1,1
1345857733627695104,0,1,0,0,1
1345967745444286464,1,0,0,0,1
1345968881723088896,0,1,0,0,1
1345974904093634560,1,0,0,0,1
1345978637867212800,0,1,0,0,1
1345987514109050880,1,0,0,0,1
1345995417729839104,0,1,0,0,1
1345452697072226304,0,1,0,0,1
1345345218653118464,0,1,0,0,1
1344585191646502912,0,1,0,0,1
1344946294763245568,0,1,0,0,1
1344603593928798208,0,1,0,0,1
1344606840798154752,0,1,0,0,1
1344618189905252352,0,1,0,0,1
1344647075707846656,0,1,0,0,1
1344662251039461376,0,1,0,0,1
1344664915949330432,0,1,0,0,1
1344729626057302016,0,1,0,0,1
1344890883506798592,0,1,0,0,1
1344935802149732352,0,1,0,0,1
1344977238480064512,0,1,0,0,1
1345320003495751680,0,1,0,0,1
1345020983875350528,0,1,0,0,1
1345028094432841728,0,1,0,0,1
1345051900945682432,0,1,0,0,1
1345085671816499200,0,1,0,0,1
1345239482925244416,1,0,0,0,1
1345279047291592704,1,0,0,0,1
1345297084560384000,0,1,0,0,1
1345300069751382016,0,1,0,0,1
1345315675959676928,0,0,1,0,1
1373396810069336064,0,1,0,0,1
1373630040773115904,0,1,0,0,1
1427391621000204288,0,1,0,0,1
1413773923792080896,1,0,0,0,1
1408663960165945344,0,1,0,0,1
1408666063496175616,0,1,0,0,1
1408795464196050944,0,1,0,0,1
1408815901135323136,1,0,0,0,1
1408864545242820608,0,1,0,0,1
1408980917520007168,0,1,0,0,1
1409233609806860288,0,1,0,0,1
1409239464698916864,0,1,0,0,1
1409402604266811392,1,0,0,0,1
1409440125214347264,0,1,0,0,1
1409543794014490624,1,0,0,0,1
1409550101387919360,0,1,0,0,1
1409761972825042944,0,1,0,0,1
1409772660645634048,0,1,0,0,1
1409780156634390528,0,1,0,0,1
1410085942438793216,0,1,0,0,1
1410106032605614080,1,0,0,0,1
1410121282084089856,0,1,0,0,1
1410147249708056576,0,1,0,0,1
1410148186887389184,0,1,0,0,1
1410182535917707264,0,0,0,1,1
1408533155460435968,0,1,0,0,1
1408501123019853824,0,1,0,0,1
1408431248620638208,0,0,0,1,1
1407256717012971520,0,1,0,0,1
1406281439600164864,0,1,0,0,1
1406290046030909440,0,1,0,0,1
1406480529373896704,0,1,0,0,1
1406596848710737920,0,1,0,0,1
1406907473508769792,0,1,0,0,1
1406998987429892096,0,0,0,1,1
1407114376734199808,0,1,0,0,1
1407151756392468480,0,1,0,0,1
1407165613630529536,1,0,0,0,1
1407359697124880384,1,0,0,0,1
1408370398547177472,0,1,0,0,1
1407428355142696960,0,1,0,0,1
1407495302513238016,0,1,0,0,1
1407621115942510592,0,1,0,0,1
1407989349321371648,1,0,0,0,1
1408037111190757376,0,1,0,0,1
1408231316051709952,0,1,0,0,1
1408242864904097792,0,1,0,0,1
1408248009658355712,0,1,0,0,1
1408344017558020096,0,1,0,0,1
1410188291220062208,0,0,0,1,1
1410196956672970752,0,0,1,0,1
1410205582972358656,0,1,0,0,1
1413084394114453504,0,1,0,0,1
1412352870461149184,1,0,0,0,1
1412415402177708032,0,1,0,0,1
1412498113554784256,0,1,0,0,1
1412658164542152704,0,1,0,0,1
1412831298784174080,0,1,0,0,1
1412962704608931840,0,1,0,0,1
1412996291576188928,1,0,0,0,1
1413046644917080064,0,1,0,0,1
1413069352635559936,0,1,0,0,1
1413134459713597440,0,1,0,0,1
1412100372701736960,0,1,0,0,1
1413237427238539264,0,1,0,0,1
1413286695953436672,1,0,0,0,1
1413380870333861888,0,1,0,0,1
1413448656095698944,1,0,0,0,1
1413501582365405184,0,1,0,0,1
1413510246241161216,1,0,0,0,1
1413583165248217088,1,0,0,0,1
1413669159485902848,0,1,0,0,1
1413685468319846400,0,1,0,0,1
1412196177970270208,0,1,0,0,1
1412098058914078720,0,0,0,1,1
1410250907804127232,0,1,0,0,1
1410938707595591680,0,1,0,0,1
1410291163878199296,0,1,0,0,1
1410335012763750400,0,0,0,1,1
1410511094905405440,0,1,0,0,1
1410515933811023872,1,0,0,0,1
1410519086258216960,1,0,0,0,1
1410540285457805312,0,1,0,0,1
1410559458938339328,0,1,0,0,1
1410683283122409472,0,1,0,0,1
1410691562225373184,0,1,0,0,1
1411027050970894336,0,1,0,0,1
1412073710698131456,0,1,0,0,1
1411056181305647104,1,0,0,0,1
1411171320717484032,0,0,1,0,1
1411316855487156224,1,0,0,0,1
1411406770589683712,0,1,0,0,1
1411450433177112576,1,0,0,0,1
1411569707333742592,0,1,0,0,1
1411638186456010752,1,0,0,0,1
1411771455948218368,1,0,0,0,1
1411992759318183936,0,1,0,0,1
1406156755671920640,1,0,0,0,1
1406119353158750208,0,1,0,0,1
1406113599601348608,0,0,1,0,1
1400029049074765824,1,0,0,0,1
1399605146418507776,0,1,0,0,1
1399659852109025280,0,1,0,0,1
1399670622754590720,0,1,0,0,1
1399760639887872000,0,1,0,0,1
1399818534365061120,0,1,0,0,1
1399819597512126464,1,0,0,0,1
1399937783079178240,0,1,0,0,1
1399974469142204416,0,1,0,0,1
1399996203253657600,0,1,0,0,1
1400121956540747776,0,1,0,0,1
1399376958979330048,1,0,0,0,1
1400288520904744960,0,1,0,0,1
1400300906973908992,0,0,1,0,1
1400302221179248640,0,1,0,0,1
1400342922860666880,0,1,0,0,1
1400361891759898624,0,1,0,0,1
1400386901941514240,0,1,0,0,1
1400421015671410688,0,1,0,0,1
1400427758598070272,0,1,0,0,1
1400430368264761344,0,1,0,0,1
1399589181521862656,0,1,0,0,1
1399310890495877120,0,1,0,0,1
1400451575995273216,0,1,0,0,1
1398292883216777216,0,1,0,0,1
1397519154098294784,0,1,0,0,1
1397555264270716928,0,1,0,0,1
1397573087936356352,0,0,1,0,1
1397621338492309504,0,1,0,0,1
1397719971392860160,1,0,0,0,1
1397779858869133312,0,1,0,0,1
1397872967929909248,0,1,0,0,1
1398148807095771136,0,1,0,0,1
1398251227578867712,0,1,0,0,1
1398509440391946240,0,1,0,0,1
1399265931436519424,1,0,0,0,1
1398518702090293248,0,0,1,0,1
1398643307710922752,0,1,0,0,1
1398712712511643648,0,1,0,0,1
1398730753853194240,0,1,0,0,1
1398760737334599680,1,0,0,0,1
1398943872420663296,1,0,0,0,1
1398968383945781248,0,1,0,0,1
1399032054860353536,0,1,0,0,1
1399136281997762560,0,1,0,0,1
1400432667238207488,0,1,0,0,1
1400717040160182272,0,1,0,0,1
1405966052006133760,0,1,0,0,1
1404894051007139840,0,1,0,0,1
1404148929487376384,0,0,0,1,1
1404153677166694400,0,1,0,0,1
1404254648601497600,1,0,0,0,1
1404337740590632960,0,1,0,0,1
1404719310396956672,0,1,0,0,1
1404725540481863680,0,1,0,0,1
1404739581040369664,1,0,0,0,1
1404791140163985408,0,1,0,0,1
1404858516846809088,0,1,0,0,1
1404931277611061248,0,1,0,0,1
1403937947041157120,0,1,0,0,1
1405132846466019328,0,1,0,0,1
1405166536604725248,0,1,0,0,1
1405309555785883648,1,0,0,0,1
1405372029298036736,0,1,0,0,1
1405569985444040704,0,1,0,0,1
1405812345184657408,0,0,0,1,1
1405898510432571392,0,0,0,1,1
1405905362834837504,0,1,0,0,1
1405936134329225216,0,1,0,0,1
1404104876498604032,1,0,0,0,1
1403934562074251264,0,1,0,0,1
1400778044235665408,1,0,0,0,1
1401618675635933184,0,1,0,0,1
1400828066109157376,1,0,0,0,1
1401015246718914560,0,1,0,0,1
1401025603311124480,0,1,0,0,1
1401060458228973568,0,1,0,0,1
1401206032047742976,0,1,0,0,1
1401428527510081536,0,1,0,0,1
1401523131827822592,0,1,0,0,1
1401590562642444288,0,1,0,0,1
1401594575534309376,1,0,0,0,1
1401656836437254144,0,1,0,0,1
1403895121897136128,0,1,0,0,1
1401850391776710656,0,1,0,0,1
1402034899058561024,1,0,0,0,1
1402133810867802112,0,1,0,0,1
1402479024228638720,0,0,1,0,1
1402538559018573824,0,1,0,0,1
1403211278303199232,0,1,0,0,1
1403448419205713920,0,1,0,0,1
1403626437760983040,0,1,0,0,1
1403851713669443584,0,1,0,0,1
1413750899554537472,0,0,0,1,1
1414003302442979328,0,1,0,0,1
1373750950729498624,0,1,0,0,1
1414121119590674432,0,1,0,0,1
1422748596651315200,1,0,0,0,1
1422864230181752832,0,1,0,0,1
1422973169787363328,1,0,0,0,1
1422989129156005888,0,1,0,0,1
1423020509143388160,1,0,0,0,1
1423166823684509696,0,1,0,0,1
1423172317740425216,0,1,0,0,1
1423215912925102080,1,0,0,0,1
1423242864679473152,0,1,0,0,1
1423320686336954368,0,1,0,0,1
1423345423134171136,0,1,0,0,1
1423438963814043648,0,1,0,0,1
1423459056115757056,0,1,0,0,1
1423541701931581440,0,1,0,0,1
1423550580392448000,0,0,0,1,1
1423575606608896000,0,1,0,0,1
1423760320493989888,0,1,0,0,1
1423791375917649920,0,1,0,0,1
1423836083121446912,0,1,0,0,1
1423839559616372736,1,0,0,0,1
1423961746075787264,0,0,0,1,1
1422693944144670720,0,1,0,0,1
1422641981637890048,0,1,0,0,1
1422590032276303872,0,1,0,0,1
1421668399541743616,0,1,0,0,1
1421006410272448512,0,1,0,0,1
1421135441458352128,0,1,0,0,1
1421169728391847936,0,1,0,0,1
1421196306706468864,0,1,0,0,1
1421283847145025536,0,1,0,0,1
1421400469881114624,1,0,0,0,1
1421507582728957952,0,1,0,0,1
1421582089481199616,1,0,0,0,1
1421623586544963584,0,0,1,0,1
1421732184075997184,0,1,0,0,1
1422587572904022016,0,0,0,1,1
1421739214874492928,0,0,0,1,1
1421767424441929728,1,0,0,0,1
1421864153111797760,0,1,0,0,1
1421866632427675648,0,1,0,0,1
1421871810828595200,0,1,0,0,1
1421983178860892160,0,1,0,0,1
1422011780319023104,0,1,0,0,1
1422259161077739520,0,1,0,0,1
1422465633980231680,0,1,0,0,1
1423977155432751104,0,1,0,0,1
1424017726553563136,1,0,0,0,1
1424040486805905408,0,1,0,0,1
1427106251318702080,0,0,1,0,1
1426767295238402048,0,1,0,0,1
1426774889910964224,0,1,0,0,1
1426823304774565888,0,1,0,0,1
1426869893018918912,0,1,0,0,1
1426970674296287232,0,1,0,0,1
1426971834499612672,0,1,0,0,1
1427006941063225344,0,1,0,0,1
1427018223011000320,0,1,0,0,1
1427070476073914368,0,1,0,0,1
1427169509576749056,0,0,0,1,1
1426710872043393024,0,1,0,0,1
1427170181739073536,0,1,0,0,1
1427180434111275008,0,1,0,0,1
1427184505777963008,0,1,0,0,1
1427225693444743168,0,1,0,0,1
1427235717604941824,0,1,0,0,1
1427245411375398912,0,1,0,0,1
1427322757084295168,1,0,0,0,1
1427337491506475008,0,1,0,0,1
1427352753156890624,1,0,0,0,1
1426765596465659904,0,1,0,0,1
1426181386340286464,1,0,0,0,1
1424122433062141952,0,1,0,0,1
1425438996868513792,1,0,0,0,1
1424130427179225088,1,0,0,0,1
1424140948397694976,0,0,0,1,1
1424307800436613120,0,1,0,0,1
1424445678160433152,0,1,0,0,1
1424666998500376576,0,1,0,0,1
1425122304581722112,1,0,0,0,1
1425184356293758976,1,0,0,0,1
1425221478694506496,0,1,0,0,1
1425408209985101824,0,1,0,0,1
1425481526364540928,0,1,0,0,1
1426154111565799424,0,1,0,0,1
1425491789931286528,0,0,0,1,1
1425535554578522112,1,0,0,0,1
1425675256576962560,0,1,0,0,1
1425745145547329536,0,1,0,0,1
1425879152662654976,0,1,0,0,1
1425981020684365824,0,1,0,0,1
1426080240082821120,0,1,0,0,1
1426093852339888128,0,1,0,0,1
1426132425667719168,1,0,0,0,1
1420814037697314816,0,0,0,1,1
1420783336885215232,0,1,0,0,1
1420716452512944128,0,1,0,0,1
1416313491439357952,0,1,0,0,1
1416088958690160640,0,1,0,0,1
1416131312977580032,0,1,0,0,1
1416204537354989568,1,0,0,0,1
1416233232081772544,1,0,0,0,1
1416248791070617600,0,1,0,0,1
1416259614455341056,0,1,0,0,1
1416291816144580608,0,1,0,0,1
1416295435694592000,0,0,0,1,1
1416310973334437888,0,1,0,0,1
1416349680594735104,0,1,0,0,1
1415973756695195648,0,1,0,0,1
1416357081553068032,0,1,0,0,1
1416380715126730752,0,1,0,0,1
1416449961454043136,0,0,0,1,1
1416460929194094592,0,1,0,0,1
1416484730128719872,0,1,0,0,1
1416519124558172160,0,1,0,0,1
1416608558494351360,0,1,0,0,1
1416616178542276608,0,1,0,0,1
1416623607984312320,1,0,0,0,1
1416069169666269184,0,0,0,1,1
1415960686912442368,0,1,0,0,1
1416647483975901184,0,1,0,0,1
1415049238598373376,0,1,0,0,1
1414164357701722112,0,1,0,0,1
1414200409090969600,0,1,0,0,1
1414542276349546496,1,0,0,0,1
1414580041216929792,0,1,0,0,1
1414580463163879424,0,1,0,0,1
1414697823052910592,0,1,0,0,1
1414851595427266560,0,1,0,0,1
1414888340776759296,0,1,0,0,1
1415031961748340736,0,1,0,0,1
1415064735460958208,0,1,0,0,1
1415877988634271744,1,0,0,0,1
1415098211136593920,0,1,0,0,1
1415245698036023296,1,0,0,0,1
1415401703202033664,0,0,1,0,1
1415505037682528256,1,0,0,0,1
1415546385571713024,0,1,0,0,1
1415594487255023616,0,1,0,0,1
1415641219397390336,1,0,0,0,1
1415695345242214400,0,1,0,0,1
1415774047242178560,0,1,0,0,1
1416637036576972800,0,1,0,0,1
1416666245051551744,0,1,0,0,1
1420623351819636736,0,1,0,0,1
1419653850642931712,0,1,0,0,1
1418891999776845824,0,1,0,0,1
1419019863956369408,0,1,0,0,1
1419161867617030144,0,1,0,0,1
1419203744122683392,0,1,0,0,1
1419272211014246400,0,1,0,0,1
1419306879956656128,0,1,0,0,1
1419546950916050944,0,1,0,0,1
1419553621541326848,0,1,0,0,1
1419606024969986048,0,1,0,0,1
1419713174400602112,0,1,0,0,1
1418670890322038784,0,1,0,0,1
1419812037220175872,1,0,0,0,1
1419960396027367424,0,0,0,1,1
1419969116056834048,0,1,0,0,1
1420045415718834176,0,1,0,0,1
1420313608441925632,0,1,0,0,1
1420354939881070592,0,1,0,0,1
1420427511578599424,0,1,0,0,1
1420511297075089408,0,1,0,0,1
1420594588054482944,0,1,0,0,1
1418794718167769088,0,1,0,0,1
1418589906172092416,0,1,0,0,1
1416702758254612480,0,0,0,1,1
1417183270953840640,0,1,0,0,1
1416714566268899328,1,0,0,0,1
1416746779396165632,0,1,0,0,1
1416778005955874816,1,0,0,0,1
1416868746673676288,1,0,0,0,1
1417028839746592768,0,1,0,0,1
1417033632498307072,0,1,0,0,1
1417048939916894208,0,1,0,0,1
1417056998055727104,1,0,0,0,1
1417063592495562752,0,1,0,0,1
1417188926024994816,1,0,0,0,1
1418292566961926144,0,1,0,0,1
1417302311899181056,0,1,0,0,1
1417360524526854144,1,0,0,0,1
1417429485557850112,0,1,0,0,1
1417607420789002240,1,0,0,0,1
1417798242012745728,0,1,0,0,1
1417913810703327232,0,1,0,0,1
1418004365944573952,0,1,0,0,1
1418123086776324096,0,1,0,0,1
1418153554452389888,0,1,0,0,1
1397325118532202496,0,1,0,0,1
1397164626949857280,0,1,0,0,1
1397143126142197760,1,0,0,0,1
1397086473665581056,1,0,0,0,1
1382518468340113408,0,1,0,0,1
1382616650277523456,0,1,0,0,1
1382674406435078144,0,1,0,0,1
1382772285271003136,0,1,0,0,1
1383006312120909824,0,1,0,0,1
1383078253972258816,1,0,0,0,1
1383080589176270848,0,1,0,0,1
1383124699006271488,0,1,0,0,1
1383129443040964608,0,1,0,0,1
1383397004429074432,0,1,0,0,1
1383439614224994304,0,1,0,0,1
1383657672268943360,0,1,0,0,1
1383884762092228608,0,1,0,0,1
1383901283401179136,1,0,0,0,1
1384079988924719104,0,1,0,0,1
1384232868046540800,0,1,0,0,1
1384259259802652672,0,1,0,0,1
1384444989913042944,0,1,0,0,1
1384510027109650432,0,1,0,0,1
1384584193204793344,0,1,0,0,1
1384824957167931392,1,0,0,0,1
1382455747934613504,0,0,0,1,1
1382450978595729408,0,0,1,0,1
1382443076493402112,0,1,0,0,1
1381607361530322944,0,1,0,0,1
1381128965675393024,0,1,0,0,1
1381130663693258752,0,1,0,0,1
1381207692988051456,0,1,0,0,1
1381275488874795008,0,1,0,0,1
1381276005566971904,0,1,0,0,1
1381330495925968896,0,0,0,1,1
1381359451127578624,1,0,0,0,1
1381463517346205696,1,0,0,0,1
1381514720042131456,0,1,0,0,1
1381645918018146304,0,1,0,0,1
1382390841927294976,0,1,0,0,1
1381705703081963520,0,0,0,1,1
1381788426790301696,0,1,0,0,1
1381825502059630592,0,1,0,0,1
1381940386403393536,1,0,0,0,1
1381997683360038912,0,1,0,0,1
1382204135366393856,1,0,0,0,1
1382218331835420672,0,0,0,1,1
1382254968179154944,0,1,0,0,1
1382284579650822144,0,1,0,0,1
1384935761556951040,1,0,0,0,1
1384953696874897408,0,1,0,0,1
1384959480279015424,0,1,0,0,1
1387025707935617024,0,1,0,0,1
1386185861063192576,0,1,0,0,1
1386195939694612480,0,1,0,0,1
1386197860744458240,0,1,0,0,1
1386200941817339904,0,1,0,0,1
1386215928837386240,0,0,1,0,1
1386245416241541120,0,0,1,0,1
1386293479769317376,0,1,0,0,1
1386538567174967296,0,1,0,0,1
1386996503449948160,1,0,0,0,1
1387052092884348928,0,1,0,0,1
1386053522379231232,0,1,0,0,1
1387057845686833152,1,0,0,0,1
1387103629711118336,0,1,0,0,1
1387136478430605312,0,1,0,0,1
1387162501306101760,1,0,0,0,1
1387480483320135680,0,1,0,0,1
1387565856616419328,0,1,0,0,1
1387616833839063040,0,1,0,0,1
1387677289119244288,0,1,0,0,1
1387999401919107072,0,0,1,0,1
1386174430938689536,0,1,0,0,1
1386030791789056000,0,1,0,0,1
1385021239647817728,1,0,0,0,1
1385592342544060416,0,1,0,0,1
1385138744907468800,0,0,0,1,1
1385242676442779648,1,0,0,0,1
1385340015119568896,0,1,0,0,1
1385354944648077312,0,1,0,0,1
1385394083753914368,0,1,0,0,1
1385451305603371008,0,0,1,0,1
1385471938256990208,0,1,0,0,1
1385509720924901376,1,0,0,0,1
1385591342986838016,0,1,0,0,1
1385617587531358208,1,0,0,0,1
1386022693821059072,0,1,0,0,1
1385631762592763904,1,0,0,0,1
1385639309924044800,0,1,0,0,1
1385738878024355840,1,0,0,0,1
1385826024454230016,0,0,0,1,1
1385854062826967040,0,1,0,0,1
1385925479232856064,0,1,0,0,1
1385972054453854208,0,1,0,0,1
1385993255360290816,0,1,0,0,1
1386012312918798336,0,1,0,0,1
1380900671461842944,0,1,0,0,1
1380800466146234368,0,0,0,1,1
1380791401621901312,0,0,0,1,1
1376411694407225344,1,0,0,0,1
1376063463823319040,0,1,0,0,1
1376084903620644864,0,1,0,0,1
1376089691628335104,0,1,0,0,1
1376110664637370368,0,1,0,0,1
1376172782006992896,0,0,1,0,1
1376189582534868992,0,1,0,0,1
1376198804748214272,0,1,0,0,1
1376264129950941184,0,1,0,0,1
1376316918928445440,0,1,0,0,1
1376474491040190464,1,0,0,0,1
1375471839799959552,0,1,0,0,1
1376491404256509952,1,0,0,0,1
1376500436375506944,0,1,0,0,1
1376597539152011264,0,1,0,0,1
1376645446047821824,0,1,0,0,1
1376824136132087808,1,0,0,0,1
1376833215235768320,0,1,0,0,1
1376845644862681088,0,1,0,0,1
1376867210594025472,0,1,0,0,1
1377219800745836544,0,1,0,0,1
1375524729776377856,0,1,0,0,1
1375179180304916480,0,1,0,0,1
1377342033090637824,0,1,0,0,1
1374426806388846592,0,1,0,0,1
1373812507471663104,0,1,0,0,1
1373896604172754944,0,1,0,0,1
1373931714934931456,0,1,0,0,1
1374012644424871936,1,0,0,0,1
1374057486282465280,0,1,0,0,1
1374261783029030912,0,0,1,0,1
1374267302481432576,1,0,0,0,1
1374291417527422976,0,1,0,0,1
1374362582585344000,0,1,0,0,1
1374495187880189952,0,1,0,0,1
1375082073069920256,0,1,0,0,1
1374572814720626688,0,1,0,0,1
1374700683321036800,0,1,0,0,1
1374735206368808960,1,0,0,0,1
1374777725081165824,0,0,0,1,1
1374829266676940800,1,0,0,0,1
1374871384644583424,1,0,0,0,1
1374924991767121920,0,1,0,0,1
1374993628825784320,0,1,0,0,1
1375060622581194752,0,1,0,0,1
1377275251877367808,0,0,0,1,1
1377540093372739584,0,1,0,0,1
1380706215328575488,0,1,0,0,1
1379652899899387904,0,1,0,0,1
1379225302963003392,1,0,0,0,1
1379236477654102016,0,0,0,1,1
1379275975649861632,0,1,0,0,1
1379402428500619264,0,0,0,1,1
1379426619555770368,0,1,0,0,1
1379504682247335936,0,1,0,0,1
1379521637242957824,1,0,0,0,1
1379527351709564928,1,0,0,0,1
1379537825947910144,0,1,0,0,1
1379722869190631424,0,0,0,1,1
1379073588662263808,0,1,0,0,1
1379907122482188288,0,1,0,0,1
1379914269530148864,0,1,0,0,1
1379918107129475072,0,1,0,0,1
1380026449411809280,1,0,0,0,1
1380376415086989312,0,1,0,0,1
1380426617252679680,1,0,0,0,1
1380487810344312832,0,1,0,0,1
1380495752745586688,0,1,0,0,1
1380677252418048000,0,1,0,0,1
1379083157153046528,0,0,1,0,1
1379060936980504576,0,1,0,0,1
1377542042834759680,1,0,0,0,1
1378289035538542592,0,1,0,0,1
1377567474401607680,0,1,0,0,1
1377576041611399168,0,1,0,0,1
1377750852673409024,0,1,0,0,1
1377761386340696064,0,1,0,0,1
1377905502198366208,0,1,0,0,1
1377911119835189248,0,1,0,0,1
1378026703549792256,1,0,0,0,1
1378142349130399744,0,1,0,0,1
1378242319741120512,0,1,0,0,1
1378295848413564928,0,1,0,0,1
1378956695603310592,0,1,0,0,1
1378317368275824640,0,1,0,0,1
1378424009671516160,0,1,0,0,1
1378451053004386304,0,1,0,0,1
1378530575343087616,0,1,0,0,1
1378671206996484096,0,1,0,0,1
1378682743324876800,0,1,0,0,1
1378744593429245952,0,1,0,0,1
1378914275041943552,0,1,0,0,1
1378918366044422144,1,0,0,0,1
1388020223165440000,1,0,0,0,1
1388026924472098816,0,1,0,0,1
1388026971146231808,0,1,0,0,1
1393720387914108928,0,1,0,0,1
1393358675616550912,1,0,0,0,1
1393383114517274624,0,1,0,0,1
1393427815375196160,0,1,0,0,1
1393457109719683072,0,1,0,0,1
1393476290129375232,0,1,0,0,1
1393513913224925184,1,0,0,0,1
1393538258240512000,0,1,0,0,1
1393558237358829568,0,0,0,1,1
1393616789142065152,1,0,0,0,1
1393810496424333312,0,0,0,1,1
1393316819608346624,1,0,0,0,1
1393849223783780352,0,1,0,0,1
1393852660420202496,0,1,0,0,1
1393853368632811520,1,0,0,0,1
1393934455140544512,0,1,0,0,1
1393934484169363456,0,1,0,0,1
1393963273033175040,0,1,0,0,1
1394003414951026688,0,1,0,0,1
1394017221098283008,0,1,0,0,1
1394109853748981760,0,0,0,1,1
1393317272077230080,0,0,0,1,1
1393229305170173952,0,1,0,0,1
1394190365033484288,0,1,0,0,1
1392486274938949632,0,1,0,0,1
1392286834017906688,0,1,0,0,1
1392306934359810048,1,0,0,0,1
1392349893486792704,1,0,0,0,1
1392361578419290112,0,1,0,0,1
1392363320229908480,0,1,0,0,1
1392364528805969920,0,1,0,0,1
1392370031846166528,0,1,0,0,1
1392391628686512128,0,1,0,0,1
1392422007048859648,1,0,0,0,1
1392546522680680448,0,1,0,0,1
1393173084878802944,0,0,0,1,1
1392621424804700160,0,1,0,0,1
1392714182122999808,0,1,0,0,1
1392757875538337792,1,0,0,0,1
1392844974396514304,0,1,0,0,1
1392846291143585792,0,1,0,0,1
1392984377248948224,1,0,0,0,1
1393018656238358528,0,0,1,0,1
1393092842088812544,0,1,0,0,1
1393160199553290240,0,1,0,0,1
1394152747331633152,0,0,1,0,1
1394207664775782400,0,1,0,0,1
1392250498103726080,0,1,0,0,1
1396443027749605376,0,1,0,0,1
1395842737967140864,0,1,0,0,1
1395945800065294336,0,1,0,0,1
1396074945227145216,0,1,0,0,1
1396080382244704256,0,1,0,0,1
1396191637802520576,0,1,0,0,1
1396235152733478912,0,1,0,0,1
1396356052845621248,1,0,0,0,1
1396386264421634048,0,1,0,0,1
1396390058920488960,1,0,0,0,1
1396489702589480960,0,1,0,0,1
1395597097466957824,0,1,0,0,1
1396645501542420480,1,0,0,0,1
1396726602676031488,0,1,0,0,1
1396752391895228416,0,1,0,0,1
1396779645245083648,0,1,0,0,1
1396807047300194304,0,1,0,0,1
1396908861941026816,0,1,0,0,1
1396909351835783168,0,1,0,0,1
1396912627259887616,0,1,0,0,1
1396973790731591680,0,1,0,0,1
1395698318249021440,0,1,0,0,1
1395391208193671168,0,1,0,0,1
1394208687129047040,0,1,0,0,1
1394748746571730944,1,0,0,0,1
1394217663216459776,0,1,0,0,1
1394223786493349888,0,1,0,0,1
1394258580606439424,0,1,0,0,1
1394331313516302336,0,1,0,0,1
1394350672762478592,0,1,0,0,1
1394583664470618112,1,0,0,0,1
1394585499948433408,0,1,0,0,1
1394676069081432064,1,0,0,0,1
1394676599086329856,0,1,0,0,1
1394758843591233536,0,1,0,0,1
1395364555023261696,1,0,0,0,1
1394807664333492224,1,0,0,0,1
1394879030223060992,0,1,0,0,1
1395104864493993984,0,1,0,0,1
1395223248737083392,0,1,0,0,1
1395267582748499968,0,1,0,0,1
1395279377194233856,0,1,0,0,1
1395301149415071744,0,1,0,0,1
1395310564503552000,1,0,0,0,1
1395311481282039808,0,1,0,0,1
1392269562649841664,0,0,1,0,1
1392239126150361088,0,1,0,0,1
1388047350585716736,0,1,0,0,1
1389449613157965824,0,1,0,0,1
1389154583444959232,0,1,0,0,1
1389162860316700672,0,1,0,0,1
1389211047102406656,0,1,0,0,1
1389235188194975744,0,1,0,0,1
1389239520781033472,0,1,0,0,1
1389259852573143040,0,1,0,0,1
1389340963940696064,1,0,0,0,1
1389389924693065728,0,1,0,0,1
1389410110678568960,0,0,0,1,1
1389455564380512256,0,1,0,0,1
1389083577384509440,0,1,0,0,1
1389510139884019712,0,1,0,0,1
1389562877682532352,0,1,0,0,1
1389637625829548032,0,1,0,0,1
1389639473231765504,0,1,0,0,1
1389640985097904128,0,1,0,0,1
1389812353416404992,0,1,0,0,1
1389814780349853696,0,1,0,0,1
1389846281040900096,0,1,0,0,1
1389933505082118144,0,1,0,0,1
1389150069543378944,0,1,0,0,1
1389062943694680064,0,1,0,0,1
1390026759484149760,0,1,0,0,1
1388476325372043264,0,1,0,0,1
1388059651963457536,1,0,0,0,1
1388220306003660800,0,1,0,0,1
1388253098624356352,0,0,1,0,1
1388334410403966976,0,1,0,0,1
1388378971641896960,0,1,0,0,1
1388381422327566336,0,1,0,0,1
1388394603796066304,1,0,0,0,1
1388399507516264448,0,1,0,0,1
1388435922174332928,0,1,0,0,1
1388491169726881792,0,1,0,0,1
1388986913550372864,0,1,0,0,1
1388524901900902400,0,1,0,0,1
1388580670407053312,0,0,0,1,1
1388582840472850432,0,1,0,0,1
1388600424060567552,0,1,0,0,1
1388670576919683072,1,0,0,0,1
1388730078603874304,0,1,0,0,1
1388814815464935424,1,0,0,0,1
1388820948682424320,0,1,0,0,1
1388851968869683200,0,1,0,0,1
1390015849243680768,0,1,0,0,1
1390038058179842048,0,1,0,0,1
1392230741875040256,0,1,0,0,1
1391761267568873472,0,0,0,1,1
1391378450284482560,0,1,0,0,1
1391407963072565248,0,1,0,0,1
1391411735467237376,0,1,0,0,1
1391453863450791936,0,1,0,0,1
1391558033851830272,0,1,0,0,1
1391626399916511232,1,0,0,0,1
1391627114810691584,0,1,0,0,1
1391628347352895488,0,1,0,0,1
1391659692343107584,0,1,0,0,1
1391838182073794560,0,1,0,0,1
1391335197463879680,0,1,0,0,1
1391865456416346112,0,1,0,0,1
1391897333944791040,0,1,0,0,1
1391994735460458496,0,1,0,0,1
1392040140097212416,1,0,0,0,1
1392060098948870144,0,1,0,0,1
1392091648558080000,0,1,0,0,1
1392093416897630208,0,1,0,0,1
1392147350601277440,0,1,0,0,1
1392152373737443328,1,0,0,0,1
1391353110489042944,1,0,0,0,1
1391317811956436992,0,1,0,0,1
1390145924396167168,1,0,0,0,1
1390731919864733696,0,1,0,0,1
1390230082057162752,0,1,0,0,1
1390237254338158592,0,1,0,0,1
1390291609879728128,0,0,1,0,1
1390516162014949376,0,1,0,0,1
1390554909821521920,0,1,0,0,1
1390594660033351680,0,1,0,0,1
1390656233774911488,0,1,0,0,1
1390719012716359680,0,1,0,0,1
1390730608578490368,0,1,0,0,1
1390754199147778048,1,0,0,0,1
1391308681531334656,0,1,0,0,1
1390781010174824448,1,0,0,0,1
1390846744661880832,0,0,0,1,1
1390882615847051264,1,0,0,0,1
1390916307114074112,1,0,0,0,1
1390951273130778624,0,1,0,0,1
1391001597753319424,0,1,0,0,1
1391091478693400576,1,0,0,0,1
1391105128711684096,1,0,0,0,1
1391163133503410176,0,1,0,0,1
1226887752408543232,0,1,0,0,1
1226822742701477888,0,1,0,0,1
1226814269578194944,0,1,0,0,1
1052727929585786880,0,1,0,0,1
1048721150740557824,0,1,0,0,1
1048743479721873408,0,1,0,0,1
1048845509996290048,0,1,0,0,1
1048861054556680192,1,0,0,0,1
1048920431787425792,0,1,0,0,1
1048969071985872896,0,1,0,0,1
1048980538088816640,1,0,0,0,1
1049167528763654144,0,1,0,0,1
1049202853615550464,1,0,0,0,1
1049229060298170368,1,0,0,0,1
1049299086451650560,0,1,0,0,1
1049356400084705280,0,1,0,0,1
1049377010768891904,0,1,0,0,1
1049480788989771776,0,1,0,0,1
1049573240086106112,0,1,0,0,1
1049594252634849280,0,1,0,0,1
1049634076649562112,1,0,0,0,1
1049654470047621120,0,1,0,0,1
1049677106177814528,1,0,0,0,1
1049718703707869184,0,1,0,0,1
1049781222459752448,0,1,0,0,1
1048681137000894464,0,1,0,0,1
1048672575231021056,0,1,0,0,1
1048668855495737344,0,1,0,0,1
1047856431372931072,0,1,0,0,1
1047516140048699392,0,1,0,0,1
1047589725396246528,0,1,0,0,1
1047590473253236736,0,0,1,0,1
1047598811231739904,0,1,0,0,1
1047736306413887488,0,1,0,0,1
1047759386511380480,1,0,0,0,1
1047776155586031616,0,1,0,0,1
1047783111038185472,0,1,0,0,1
1047833920828579840,0,1,0,0,1
1047856719735529472,1,0,0,0,1
1048618725623005184,1,0,0,0,1
1047923403699761152,0,1,0,0,1
1047937537065463808,0,1,0,0,1
1048052657825431552,0,1,0,0,1
1048154353419337728,0,1,0,0,1
1048291894634192896,0,1,0,0,1
1048306847831273472,0,1,0,0,1
1048442338228555776,1,0,0,0,1
1048473333686308864,0,1,0,0,1
1048600345507758080,0,1,0,0,1
1049799233358958592,1,0,0,0,1
1049917962268880896,0,1,0,0,1
1049950950578896896,0,1,0,0,1
1052060661612732416,0,1,0,0,1
1051611623352238080,0,1,0,0,1
1051628406557814784,0,1,0,0,1
1051706699596234752,0,1,0,0,1
1051726842779058176,0,1,0,0,1
1051823345484873728,0,1,0,0,1
1051897377051664384,0,1,0,0,1
1051919799104679936,0,1,0,0,1
1052046721390403584,0,1,0,0,1
1052049619562024960,0,1,0,0,1
1052078428550254592,0,0,1,0,1
1051480076485709824,0,1,0,0,1
1052093253170933760,0,1,0,0,1
1052121410917883904,0,1,0,0,1
1052128154737893376,0,0,1,0,1
1052140255069888512,0,1,0,0,1
1052200348515885056,0,1,0,0,1
1052207322385317888,0,1,0,0,1
1052269785399087104,0,1,0,0,1
1052381800712925184,1,0,0,0,1
1052415363336597504,0,1,0,0,1
1051488714797531136,0,1,0,0,1
1051449734576185344,0,1,0,0,1
1049983762967252992,0,1,0,0,1
1050810622370144256,0,1,0,0,1
1049988519744040960,0,1,0,0,1
1050106151281577984,0,1,0,0,1
1050334244415922176,0,1,0,0,1
1050521657838895104,0,1,0,0,1
1050532171717496832,0,1,0,0,1
1050592971307905024,0,1,0,0,1
1050624025444016128,1,0,0,0,1
1050669512977047552,0,1,0,0,1
1050767624467038208,0,1,0,0,1
1050984294884237312,0,1,0,0,1
1051422625434603520,0,1,0,0,1
1051000032751542272,0,1,0,0,1
1051028525434716160,0,1,0,0,1
1051096737295691776,0,1,0,0,1
1051123683325071360,1,0,0,0,1
1051158772738154496,0,1,0,0,1
1051172647017566208,0,1,0,0,1
1051198734414082048,0,1,0,0,1
1051298710779506688,0,1,0,0,1
1051357769524269056,0,1,0,0,1
1047511620929249280,0,1,0,0,1
1047482327062994944,0,1,0,0,1
1047473209459855360,1,0,0,0,1
1043727079450259456,0,1,0,0,1
1043440489859620864,1,0,0,0,1
1043455997136826368,1,0,0,0,1
1043477835216752640,0,1,0,0,1
1043495367734697984,0,1,0,0,1
1043526475595624448,0,1,0,0,1
1043562345602142208,1,0,0,0,1
1043570190980603904,0,1,0,0,1
1043704659502743552,0,1,0,0,1
1043714836012589056,1,0,0,0,1
1043781929751973888,0,1,0,0,1
1043413084776357888,0,1,0,0,1
1043831682930003968,0,1,0,0,1
1043939822195417088,0,1,0,0,1
1044002800638791680,0,1,0,0,1
1044085316112519168,0,1,0,0,1
1044144304938266624,0,1,0,0,1
1044189972704759808,0,1,0,0,1
1044215098217308160,0,1,0,0,1
1044222506125676544,0,1,0,0,1
1044238601016537088,0,1,0,0,1
1043429156820869120,0,1,0,0,1
1043388594214391808,0,1,0,0,1
1044269232790233088,1,0,0,0,1
1042465938971471872,0,1,0,0,1
1041805620758708224,1,0,0,0,1
1041854264925192192,0,1,0,0,1
1041861700838809600,0,1,0,0,1
1041915389578362880,0,1,0,0,1
1041925485364686848,0,1,0,0,1
1042038648433205248,0,1,0,0,1
1042234462166118400,1,0,0,0,1
1042379166799355904,1,0,0,0,1
1042423022085447680,0,1,0,0,1
1042516977913344000,0,1,0,0,1
1043360055096225792,0,1,0,0,1
1042533060921761792,0,1,0,0,1
1042906497129361408,0,1,0,0,1
1042916029721178112,0,1,0,0,1
1042986985630052352,0,1,0,0,1
1043134020635320320,0,1,0,0,1
1043184757926977536,1,0,0,0,1
1043210077430341632,0,1,0,0,1
1043260262814572544,0,0,0,1,1
1043356747417702400,0,1,0,0,1
1044266445423558656,0,1,0,0,1
1044281909029883904,1,0,0,0,1
1047420342103363584,0,1,0,0,1
1047007398169403392,0,1,0,0,1
1046262769060708352,1,0,0,0,1
1046353520176373760,1,0,0,0,1
1046503980501622784,0,1,0,0,1
1046625415068938240,0,1,0,0,1
1046692411412566016,0,1,0,0,1
1046755759613202432,0,1,0,0,1
1046812047772725248,1,0,0,0,1
1046841017121427456,0,1,0,0,1
1046951569898557440,1,0,0,0,1
1047042524748107776,0,1,0,0,1
1045976220016553984,0,1,0,0,1
1047106834174304256,0,1,0,0,1
1047114559679414272,0,1,0,0,1
1047141996794503168,0,1,0,0,1
1047180257130889216,0,1,0,0,1
1047199051584757760,0,1,0,0,1
1047239200289038336,0,1,0,0,1
1047351378195222528,0,1,0,0,1
1047376823842230272,1,0,0,0,1
1047383038907301888,1,0,0,0,1
1046180959861829632,0,1,0,0,1
1045957294729519104,0,1,0,0,1
1044421982765248512,0,1,0,0,1
1044937263489134592,0,1,0,0,1
1044422417425281024,0,1,0,0,1
1044492180457443328,0,1,0,0,1
1044516764510490624,0,1,0,0,1
1044711566354960384,0,1,0,0,1
1044764900747284480,1,0,0,0,1
1044805558128300032,0,0,0,1,1
1044836348669165568,0,1,0,0,1
1044893486288269312,0,1,0,0,1
1044907355651993600,1,0,0,0,1
1045046918399684608,1,0,0,0,1
1045654865383313408,0,1,0,0,1
1045049865032454144,0,1,0,0,1
1045124724005597184,1,0,0,0,1
1045221050068471808,0,1,0,0,1
1045228165252231168,1,0,0,0,1
1045290190648922112,0,1,0,0,1
1045307823284981760,1,0,0,0,1
1045383149855936512,0,1,0,0,1
1045510271131938816,0,1,0,0,1
1045574293168345088,0,1,0,0,1
1052480703118622720,0,1,0,0,1
1052888191995383808,0,1,0,0,1
1041640546844860416,0,1,0,0,1
1052925286201798656,0,1,0,0,1
1059061486952288256,1,0,0,0,1
1059123993393819648,0,0,0,1,1
1059144535987634176,0,1,0,0,1
1059151849981386752,0,1,0,0,1
1059189397688631296,0,1,0,0,1
1059198172659138560,0,0,0,1,1
1059312852383813632,0,1,0,0,1
1059368768017784832,0,1,0,0,1
1059409788302442496,0,1,0,0,1
1059423272062894080,0,0,0,1,1
1059524617696616448,0,1,0,0,1
1059694249392963584,0,1,0,0,1
1059732809441513472,0,1,0,0,1
1059793482691342336,1,0,0,0,1
1059830180791894016,0,1,0,0,1
1059870062272831488,0,0,0,1,1
1059886730063552512,0,1,0,0,1
1060031877233434624,0,1,0,0,1
1060058485554077696,0,0,0,1,1
1060071405524414464,1,0,0,0,1
1060084453991636992,0,1,0,0,1
1059057551936053248,0,1,0,0,1
1059032426821967872,0,1,0,0,1
1058939427966246912,0,1,0,0,1
1058311356183728128,0,1,0,0,1
1058075872001953792,0,1,0,0,1
1058083420918702080,0,1,0,0,1
1058103177617248256,0,1,0,0,1
1058112341156487168,0,1,0,0,1
1058129643600011264,0,1,0,0,1
1058174548837888000,0,1,0,0,1
1058201476751912960,1,0,0,0,1
1058239599258923008,0,1,0,0,1
1058310071606595584,0,1,0,0,1
1058336254780235776,1,0,0,0,1
1058829907743199232,0,1,0,0,1
1058355369595023360,0,1,0,0,1
1058432544473923584,1,0,0,0,1
1058449458156003328,1,0,0,0,1
1058460748903579648,0,1,0,0,1
1058588628652150784,1,0,0,0,1
1058604713996894208,1,0,0,0,1
1058634770933039104,0,1,0,0,1
1058636930638848000,1,0,0,0,1
1058792810009247744,0,1,0,0,1
1060097761503272960,0,1,0,0,1
1060125689578434560,0,1,0,0,1
1060214454586105856,0,1,0,0,1
1062272100487041024,0,1,0,0,1
1061436018862276608,0,1,0,0,1
1061474978800062464,0,1,0,0,1
1061710595303583744,0,1,0,0,1
1061869864103493632,1,0,0,0,1
1061913853041229824,0,0,1,0,1
1062028567196778496,0,1,0,0,1
1062096274974040064,0,0,0,1,1
1062164381809680384,0,1,0,0,1
1062271529751363584,0,1,0,0,1
1062338863245524992,0,1,0,0,1
1061304932828176384,1,0,0,0,1
1062339537588969472,1,0,0,0,1
1062409403456983040,0,1,0,0,1
1062420267937480704,0,1,0,0,1
1062612386064957440,1,0,0,0,1
1062663117593821184,0,1,0,0,1
1062664825556398080,0,1,0,0,1
1062697785961660416,0,1,0,0,1
1062746769031905280,0,1,0,0,1
1062894114025496576,0,1,0,0,1
1061327404231204864,0,1,0,0,1
1061297161877352448,0,1,0,0,1
1060217543082827776,0,1,0,0,1
1060574622066733056,0,1,0,0,1
1060270301299294208,0,1,0,0,1
1060350393371189248,0,1,0,0,1
1060416583632269312,0,1,0,0,1
1060427292353032192,0,1,0,0,1
1060432010550816768,0,1,0,0,1
1060453574168195072,0,1,0,0,1
1060487946028105728,0,1,0,0,1
1060518370217521152,0,1,0,0,1
1060562347675258880,0,1,0,0,1
1060583780279214080,0,1,0,0,1
1061224490502369280,0,0,0,1,1
1060612044385177600,1,0,0,0,1
1060655140833763328,0,1,0,0,1
1060716005327036416,0,1,0,0,1
1060738013175652352,1,0,0,0,1
1060785326858223616,1,0,0,0,1
1060821111112294400,0,1,0,0,1
1060857299848314880,1,0,0,0,1
1060988270241308672,0,1,0,0,1
1061072038247497728,0,1,0,0,1
1057996921606991872,0,1,0,0,1
1057972352242368512,1,0,0,0,1
1057878997760139264,0,1,0,0,1
1054770447626178560,0,1,0,0,1
1054349728698138624,0,1,0,0,1
1054415217977896960,0,1,0,0,1
1054557293998596096,0,1,0,0,1
1054569313946939392,1,0,0,0,1
1054618805261938688,0,1,0,0,1
1054654584843616256,0,1,0,0,1
1054685377443889152,1,0,0,0,1
1054696804468568064,0,1,0,0,1
1054765465988296704,1,0,0,0,1
1054827079345139712,1,0,0,0,1
1054274871440695296,0,1,0,0,1
1054926351730393088,0,1,0,0,1
1054955772046643200,1,0,0,0,1
1055057868720889856,0,1,0,0,1
1055317980559462400,0,0,1,0,1
1055424387120271360,1,0,0,0,1
1055437152258064384,0,0,1,0,1
1055439745671725056,0,1,0,0,1
1055502304202444800,0,1,0,0,1
1055517788104769536,0,0,0,1,1
1054324795838554112,0,1,0,0,1
1054273964879609856,1,0,0,0,1
1055724574107729920,0,1,0,0,1
1053561969964400640,0,0,0,1,1
1053023828413206528,0,1,0,0,1
1053166509466546176,0,1,0,0,1
1053206051749879808,1,0,0,0,1
1053227268657430528,1,0,0,0,1
1053328924514480128,0,1,0,0,1
1053338852264423424,0,1,0,0,1
1053381401947578368,0,1,0,0,1
1053418566190387200,1,0,0,0,1
1053476710643978240,0,1,0,0,1
1053598245862207488,0,1,0,0,1
1054065861873545216,1,0,0,0,1
1053623085193220096,0,1,0,0,1
1053684896038821888,0,1,0,0,1
1053782659124658176,1,0,0,0,1
1053908368086237184,0,1,0,0,1
1053946989841387520,0,1,0,0,1
1053957298220134400,0,1,0,0,1
1053958864771735552,0,1,0,0,1
1054013819163275264,0,1,0,0,1
1054021078799015936,0,1,0,0,1
1055630615096188928,0,1,0,0,1
1055726747273101312,0,1,0,0,1
1057876209768546304,1,0,0,0,1
1057450671493079040,0,1,0,0,1
1057006205355216896,0,1,0,0,1
1057132702778839040,0,1,0,0,1
1057158234958630912,0,1,0,0,1
1057193672075288576,0,1,0,0,1
1057215438919266304,0,0,0,1,1
1057240445812596736,0,1,0,0,1
1057251884086558720,0,1,0,0,1
1057252382676058112,0,1,0,0,1
1057363004780695552,0,1,0,0,1
1057505738627653632,0,1,0,0,1
1056947525070934016,0,1,0,0,1
1057517008449949696,0,1,0,0,1
1057543954697240576,0,1,0,0,1
1057553692679958528,0,1,0,0,1
1057566666555580416,0,1,0,0,1
1057573021014097920,0,1,0,0,1
1057575754811297792,0,1,0,0,1
1057678354420260864,0,1,0,0,1
1057719921700978688,0,1,0,0,1
1057722220024225792,0,0,1,0,1
1056957976098017280,0,0,0,1,1
1056808313793531904,0,1,0,0,1
1055755866798866432,0,1,0,0,1
1056181932130795520,0,1,0,0,1
1055811313211973632,0,1,0,0,1
1055828215984459776,0,0,0,1,1
1055853748315144192,0,1,0,0,1
1055869375247466496,0,1,0,0,1
1056011072463925248,0,1,0,0,1
1056038407447683072,0,1,0,0,1
1056048458484850688,0,0,0,1,1
1056078895714369536,0,1,0,0,1
1056178498790965248,0,0,0,1,1
1056185940765487104,1,0,0,0,1
1056773752149762048,0,0,1,0,1
1056193029948633088,1,0,0,0,1
1056406463810232320,0,1,0,0,1
1056419923122098176,1,0,0,0,1
1056468743117791232,0,1,0,0,1
1056483139231670272,0,1,0,0,1
1056562740859494400,0,1,0,0,1
1056566784424210432,0,1,0,0,1
1056581223575965696,0,1,0,0,1
1056598950969597952,0,1,0,0,1
1041736723443724288,0,1,0,0,1
1041507810931081216,0,1,0,0,1
1226708307919998976,0,1,0,0,1
1032297031765819392,0,1,0,0,1
1028676208479875072,0,1,0,0,1
1028869538916564992,0,1,0,0,1
1028885123159212032,0,0,1,0,1
1029248442151960576,0,1,0,0,1
1029269772884566016,0,1,0,0,1
1029419129302908928,0,1,0,0,1
1029459333204127744,0,1,0,0,1
1029493996962426880,0,1,0,0,1
1029573292472987648,0,0,1,0,1
1029640086877548544,0,1,0,0,1
1029679160623591424,0,1,0,0,1
1029709980977557504,0,1,0,0,1
1029886001894707200,0,1,0,0,1
1029943301200171008,1,0,0,0,1
1029978827504533504,1,0,0,0,1
1029983462453850112,0,1,0,0,1
1030023119870803968,1,0,0,0,1
1030028049679572992,0,1,0,0,1
1030061446237966336,0,1,0,0,1
1030089951025590272,1,0,0,0,1
1030166941753909248,0,1,0,0,1
1028461558542741504,1,0,0,0,1
1028201396997382144,0,1,0,0,1
1028063556263194624,0,1,0,0,1
1027550842159882240,0,0,0,1,1
1027139045338632192,1,0,0,0,1
1027177210841636864,0,1,0,0,1
1027245241680715776,0,1,0,0,1
1027285564578394112,0,1,0,0,1
1027320024019525632,0,1,0,0,1
1027400280835407872,0,1,0,0,1
1027484746568347648,0,0,1,0,1
1027516326401560576,0,1,0,0,1
1027524926591447040,0,1,0,0,1
1027564728728645632,1,0,0,0,1
1028020987676250112,0,1,0,0,1
1027718013297012736,0,1,0,0,1
1027755713806852096,0,1,0,0,1
1027780533479063552,0,1,0,0,1
1027793764562157568,0,1,0,0,1
1027867346373828608,0,1,0,0,1
1027907725987065856,0,1,0,0,1
1027910947917066240,1,0,0,0,1
1027981309547872256,0,1,0,0,1
1027989663062089728,0,1,0,0,1
1030234033345769472,0,1,0,0,1
1030243533247193088,0,1,0,0,1
1030282973575368704,0,1,0,0,1
1031768554155270144,0,1,0,0,1
1031438736033243136,0,0,1,0,1
1031440179578331136,0,1,0,0,1
1031443456776986624,0,0,0,1,1
1031644328660230144,0,1,0,0,1
1031644456246599680,0,1,0,0,1
1031650263231328256,0,1,0,0,1
1031664639292129280,0,1,0,0,1
1031726053843075072,0,1,0,0,1
1031731295397732352,0,1,0,0,1
1031769611392442368,0,1,0,0,1
1031417519003713536,0,0,0,1,1
1031775831100731392,0,0,0,1,1
1031845265760813056,0,1,0,0,1
1031869400234827776,0,1,0,0,1
1031911334848356352,0,1,0,0,1
1031918987356106752,1,0,0,0,1
1032119590543929344,1,0,0,0,1
1032182087015645184,0,0,0,1,1
1032197449748803584,0,1,0,0,1
1032226186552729600,0,1,0,0,1
1031434814648283136,0,1,0,0,1
1031389685074014208,1,0,0,0,1
1030334804569534464,0,0,0,1,1
1030826623493435392,0,1,0,0,1
1030413303615549440,0,1,0,0,1
1030469850051821568,0,1,0,0,1
1030509921211756544,0,1,0,0,1
1030657644791398400,0,1,0,0,1
1030718497037463552,0,1,0,0,1
1030759394852712448,0,0,1,0,1
1030793084903325696,0,1,0,0,1
1030794609247637504,0,1,0,0,1
1030816183421816832,0,1,0,0,1
1030844795651010560,0,1,0,0,1
1031285335014043648,0,1,0,0,1
1030882588460810240,0,1,0,0,1
1030890414562103296,0,1,0,0,1
1030895929413517312,0,1,0,0,1
1030953917067218944,0,1,0,0,1
1031038991460646912,1,0,0,0,1
1031120657013071872,0,1,0,0,1
1031140028255293440,0,1,0,0,1
1031224105704611840,0,1,0,0,1
1031274139896578048,1,0,0,0,1
1027068377993543680,0,1,0,0,1
1027034676505051136,0,1,0,0,1
1027001755379236864,0,1,0,0,1
1022953122443022336,0,1,0,0,1
1022462344855674880,0,1,0,0,1
1022530467092787200,0,1,0,0,1
1022544803324719104,0,1,0,0,1
1022552045667147776,0,1,0,0,1
1022718481874276352,0,1,0,0,1
1022794288185442304,0,1,0,0,1
1022813835449778176,0,1,0,0,1
1022818022619275264,0,1,0,0,1
1022861233047842816,0,1,0,0,1
1023065549176287232,0,1,0,0,1
1022353734012162048,0,1,0,0,1
1023208096775196672,0,1,0,0,1
1023212966357999616,0,1,0,0,1
1023415455518781440,0,1,0,0,1
1023511483437723648,0,1,0,0,1
1023518012043714560,0,1,0,0,1
1023547713248522240,0,1,0,0,1
1023568489280200704,0,1,0,0,1
1023607797227945984,0,1,0,0,1
1023659705099583488,0,0,0,1,1
1022439557839638528,0,1,0,0,1
1022276422503739392,0,1,0,0,1
1023733060494213120,1,0,0,0,1
1021676137435594752,0,1,0,0,1
1020832220196622336,0,1,0,0,1
1021032289944440832,0,1,0,0,1
1021101011874865152,0,1,0,0,1
1021114600685699072,0,1,0,0,1
1021165655750586368,1,0,0,0,1
1021186473658265600,0,1,0,0,1
1021327113201373184,0,1,0,0,1
1021438922663038976,0,1,0,0,1
1021663916831780864,0,1,0,0,1
1021804601274707968,0,1,0,0,1
1022213468227809280,0,1,0,0,1
1021819322551947264,0,1,0,0,1
1021840066790993920,0,1,0,0,1
1021866516860436480,0,1,0,0,1
1021907388041900032,0,1,0,0,1
1021991356829495296,0,1,0,0,1
1022074105661550592,0,1,0,0,1
1022107246011076608,0,1,0,0,1
1022171793350643712,1,0,0,0,1
1022205175975616512,0,1,0,0,1
1023694476903149568,0,1,0,0,1
1023768630230577152,0,0,0,1,1
1026916456368238592,0,1,0,0,1
1026032866382241792,0,1,0,0,1
1025387393086644224,0,1,0,0,1
1025393126632914944,0,1,0,0,1
1025394773543329792,0,1,0,0,1
1025496103632941056,0,1,0,0,1
1025551630052159488,0,1,0,0,1
1025682225008918528,0,1,0,0,1
1025774369132478464,0,1,0,0,1
1025843895836520448,0,0,0,1,1
1025911485892112384,1,0,0,0,1
1026060016393089024,0,1,0,0,1
1025269964561940480,0,0,0,1,1
1026082189816094720,0,1,0,0,1
1026115015311540224,0,1,0,0,1
1026121759068745728,0,1,0,0,1
1026163617803038720,0,1,0,0,1
1026203798757244928,0,1,0,0,1
1026324493243830272,0,1,0,0,1
1026503563214647296,1,0,0,0,1
1026710678609035264,0,1,0,0,1
1026715014810480640,0,1,0,0,1
1025274418623377408,0,1,0,0,1
1025219310900277248,0,1,0,0,1
1023846844789444608,0,1,0,0,1
1024345642775334912,0,1,0,0,1
1023933066501337088,0,1,0,0,1
1023999750218100736,0,1,0,0,1
1024025804240506880,0,0,0,1,1
1024065971986870272,0,1,0,0,1
1024236773352894464,0,1,0,0,1
1024260054491582464,0,0,0,1,1
1024300507609935872,0,1,0,0,1
1024314395034361856,0,1,0,0,1
1024323518228385792,0,1,0,0,1
1024377464741670912,0,1,0,0,1
1025176932151975936,0,1,0,0,1
1024455102097182720,0,1,0,0,1
1024515611534262272,0,1,0,0,1
1024650625676705792,0,1,0,0,1
1024871077544124416,0,1,0,0,1
1024872636638289920,0,1,0,0,1
1024950767516569600,0,1,0,0,1
1025005185469427712,0,1,0,0,1
1025005454634545152,1,0,0,0,1
1025127025747652608,0,1,0,0,1
1032255430578393088,0,1,0,0,1
1032397195310518272,0,1,0,0,1
1041427661468381184,0,1,0,0,1
1032477142494453760,1,0,0,0,1
1038487917709193216,0,1,0,0,1
1038500180767789056,0,1,0,0,1
1038520384293941248,0,1,0,0,1
1038558956417769472,0,0,0,1,1
1038579620197670912,0,1,0,0,1
1038605661981032448,1,0,0,0,1
1038634003979493376,0,1,0,0,1
1038660467772870656,0,1,0,0,1
1038732081864605696,0,1,0,0,1
1038749373067341824,0,1,0,0,1
1038754863268675584,0,1,0,0,1
1038777888789680128,1,0,0,0,1
1038922717360214016,0,1,0,0,1
1039097713017716736,1,0,0,0,1
1039102611033677824,0,1,0,0,1
1039110120117035008,0,0,0,1,1
1039142322112479232,0,1,0,0,1
1039228081314189312,0,1,0,0,1
1039272053801504768,0,0,1,0,1
1039329921481539584,0,1,0,0,1
1039393365887000576,0,1,0,0,1
1038457581998628864,1,0,0,0,1
1038452773954768896,0,1,0,0,1
1038416066723172352,1,0,0,0,1
1037898169235976192,0,1,0,0,1
1037388008863883264,1,0,0,0,1
1037606778278572032,0,1,0,0,1
1037621008541339648,0,1,0,0,1
1037629423594262528,0,1,0,0,1
1037674513020923904,0,1,0,0,1
1037679388878225408,1,0,0,0,1
1037687828413444096,0,1,0,0,1
1037749060462104576,0,1,0,0,1
1037862958259478528,0,1,0,0,1
1037935181187829760,0,1,0,0,1
1038358505990680576,0,1,0,0,1
1037945225023389696,0,1,0,0,1
1037975465074597888,0,1,0,0,1
1038009438416850944,0,1,0,0,1
1038087721640714240,1,0,0,0,1
1038255887540994048,0,1,0,0,1
1038257136646672384,0,0,0,1,1
1038316549654884352,0,1,0,0,1
1038354712339394560,0,1,0,0,1
1038356700439433216,0,1,0,0,1
1039414985175248896,0,1,0,0,1
1039438803956580352,0,1,0,0,1
1039536755169419264,0,1,0,0,1
1041008241138757632,0,1,0,0,1
1040600156482269184,0,1,0,0,1
1040753983717961728,0,1,0,0,1
1040798996581806080,0,1,0,0,1
1040816586402095104,1,0,0,0,1
1040861804912672768,0,1,0,0,1
1040881753055870976,0,1,0,0,1
1040938142273073152,0,1,0,0,1
1040950703454384128,0,1,0,0,1
1040951456352886784,0,1,0,0,1
1041085458497916928,0,1,0,0,1
1040503048592711680,1,0,0,0,1
1041117342795673600,0,1,0,0,1
1041141336177405952,0,1,0,0,1
1041187929459122176,0,1,0,0,1
1041252970506190848,0,1,0,0,1
1041328022245257216,0,1,0,0,1
1041358557411766272,1,0,0,0,1
1041358863079944192,0,1,0,0,1
1041360996844138496,1,0,0,0,1
1041384188870443008,1,0,0,0,1
1040541097213284352,0,1,0,0,1
1040470821339160576,0,1,0,0,1
1039554192254427136,1,0,0,0,1
1040045972108148736,0,1,0,0,1
1039717553248116736,0,1,0,0,1
1039778941668614144,1,0,0,0,1
1039842746188668928,0,1,0,0,1
1039893415301763072,1,0,0,0,1
1039904116229562368,0,1,0,0,1
1039921338054582272,0,1,0,0,1
1039952782386548736,0,1,0,0,1
1039956377286791168,0,1,0,0,1
1039966822303322112,0,1,0,0,1
1040053076688875520,0,1,0,0,1
1040459389243727872,0,1,0,0,1
1040118273394855936,0,1,0,0,1
1040121571959078912,0,1,0,0,1
1040140500718837760,0,1,0,0,1
1040166006163943424,0,1,0,0,1
1040210153516294144,0,1,0,0,1
1040304474290642944,0,1,0,0,1
1040339387853283328,0,1,0,0,1
1040347080844292096,0,1,0,0,1
1040428124704595968,0,1,0,0,1
1037381984107016192,0,1,0,0,1
1037289684383105024,1,0,0,0,1
1037274405653569536,0,1,0,0,1
1034162134505144320,0,1,0,0,1
1033848467192393728,1,0,0,0,1
1033852081256390656,0,1,0,0,1
1033869060600209408,0,1,0,0,1
1033955025108647936,1,0,0,0,1
1033965114263777280,0,1,0,0,1
1034080123677499392,0,1,0,0,1
1034094866211528704,0,1,0,0,1
1034127398071980032,0,1,0,0,1
1034141167078834176,0,1,0,0,1
1034168411260166144,0,1,0,0,1
1033730527180681216,1,0,0,0,1
1034205233151438848,0,1,0,0,1
1034316921754275840,0,1,0,0,1
1034346894929977344,0,1,0,0,1
1034413986828103680,0,1,0,0,1
1034437284920057856,0,1,0,0,1
1034527768049008640,1,0,0,0,1
1034566579810385920,0,1,0,0,1
1034570149649473536,1,0,0,0,1
1034617087052922880,0,1,0,0,1
1033746984782516224,1,0,0,0,1
1033709903876182016,0,0,0,1,1
1034641561932378112,0,1,0,0,1
1033109559873875968,0,1,0,0,1
1032521732962299904,0,1,0,0,1
1032572448473063424,0,1,0,0,1
1032602335887978496,0,1,0,0,1
1032672329841737728,0,1,0,0,1
1032779064485003264,0,1,0,0,1
1032786377216151552,0,1,0,0,1
1032911153968627712,0,1,0,0,1
1033012655034957824,0,1,0,0,1
1033033759174610944,0,1,0,0,1
1033112461250052096,0,1,0,0,1
1033685104982478848,0,1,0,0,1
1033314506208882688,0,1,0,0,1
1033342175365361664,0,1,0,0,1
1033349932944646144,0,1,0,0,1
1033366677206048768,0,1,0,0,1
1033428629378793472,0,1,0,0,1
1033434100403773440,0,1,0,0,1
1033451017420062720,0,1,0,0,1
1033579280280821760,0,1,0,0,1
1033639774119112704,1,0,0,0,1
1034630615218442240,0,1,0,0,1
1034677750005682176,0,1,0,0,1
1037034887830818816,0,1,0,0,1
1036190413932122112,0,0,0,1,1
1035618938439196672,1,0,0,0,1
1035678992785924096,0,1,0,0,1
1035779528709365760,0,1,0,0,1
1035807521477468160,0,0,1,0,1
1035913403682959360,0,1,0,0,1
1035914791888420864,0,1,0,0,1
1035921043842637824,0,1,0,0,1
1036151869075148800,1,0,0,0,1
1036179177890820096,0,1,0,0,1
1036211429358096384,0,1,0,0,1
1035572762616778752,0,1,0,0,1
1036241008504266752,0,1,0,0,1
1036337905000738816,0,1,0,0,1
1036370253926809600,0,1,0,0,1
1036415077379923968,0,0,0,1,1
1036472885118992384,1,0,0,0,1
1036732738391486464,1,0,0,0,1
1036919530923147264,0,1,0,0,1
1036933516129259520,0,1,0,0,1
1036949804461502464,0,0,1,0,1
1035593023411957760,1,0,0,0,1
1035563472317304832,0,1,0,0,1
1034712784695685120,0,1,0,0,1
1035189379571101696,0,1,0,0,1
1034741397239357440,0,1,0,0,1
1034760132842999808,0,1,0,0,1
1034902942128791552,0,0,0,1,1
1034999642566492160,0,1,0,0,1
1035005695219748864,1,0,0,0,1
1035049194795331584,0,1,0,0,1
1035064139935358976,0,1,0,0,1
1035069562063020032,0,1,0,0,1
1035157440361361408,0,0,0,1,1
1035234557530959872,0,0,1,0,1
1035560905273233408,0,1,0,0,1
1035333126300618752,1,0,0,0,1
1035407830428180480,0,1,0,0,1
1035421758646640640,0,1,0,0,1
1035430217672740864,0,1,0,0,1
1035496352858423296,0,1,0,0,1
1035496869760323584,1,0,0,0,1
1035530989328625664,0,1,0,0,1
1035536849500921856,1,0,0,0,1
1035548909500854272,0,1,0,0,1
1062926386933813248,0,1,0,0,1
1062965734836445184,0,1,0,0,1
1063040768905043968,0,1,0,0,1
1090192728636485632,1,0,0,0,1
1086939578307674112,0,1,0,0,1
1086973158618476544,0,1,0,0,1
1086984555352023040,0,1,0,0,1
1087086225163456512,0,1,0,0,1
1087095754886402048,1,0,0,0,1
1087128923228430336,0,1,0,0,1
1087144899881914368,0,1,0,0,1
1087230017891983360,0,1,0,0,1
1087234636885962752,1,0,0,0,1
1087264296504049664,0,1,0,0,1
1087323630680358912,1,0,0,0,1
1087382893406629888,0,1,0,0,1
1087428276409241600,0,1,0,0,1
1087431518300053504,0,1,0,0,1
1087464614714109952,0,1,0,0,1
1087475162860142592,0,1,0,0,1
1087476792007495680,0,1,0,0,1
1087652922329047040,0,1,0,0,1
1087657736559566848,0,1,0,0,1
1087686003962204160,0,1,0,0,1
1087687970969268224,1,0,0,0,1
1086938874054619136,1,0,0,0,1
1086867720602378240,0,1,0,0,1
1086865088462483456,0,1,0,0,1
1086633759951257600,0,0,1,0,1
1086283926413422592,0,1,0,0,1
1086372864658493440,0,1,0,0,1
1086380833542426624,0,0,0,1,1
1086448083590885376,0,1,0,0,1
1086480940757479424,1,0,0,0,1
1086481751201898496,1,0,0,0,1
1086519436121653248,0,1,0,0,1
1086536070638911488,1,0,0,0,1
1086594685743689728,1,0,0,0,1
1086644275914334208,0,1,0,0,1
1086863521206292480,0,1,0,0,1
1086645154729979904,1,0,0,0,1
1086669975354572800,0,1,0,0,1
1086697030104350720,1,0,0,0,1
1086734555107741696,0,1,0,0,1
1086760783231504384,0,1,0,0,1
1086761220923895808,0,1,0,0,1
1086774289926369280,0,1,0,0,1
1086789882490417152,0,1,0,0,1
1086820684557402112,0,1,0,0,1
1087690314087874560,0,1,0,0,1
1087719618175815680,1,0,0,0,1
1087741420285411328,1,0,0,0,1
1089451301149331456,0,1,0,0,1
1089202501658779648,0,1,0,0,1
1089235290487586816,0,1,0,0,1
1089267002412355584,0,1,0,0,1
1089289050094268416,0,1,0,0,1
1089308229056847872,0,1,0,0,1
1089317892217233408,1,0,0,0,1
1089343335645564928,0,1,0,0,1
1089396315723911168,0,1,0,0,1
1089406047842840576,0,1,0,0,1
1089466518268792832,1,0,0,0,1
1089086565106761728,0,1,0,0,1
1089596540111503360,0,1,0,0,1
1089622249341038592,0,1,0,0,1
1089626902569017344,0,1,0,0,1
1089653832915636224,0,1,0,0,1
1089863497805193216,0,1,0,0,1
1089937698071162880,0,1,0,0,1
1090058489815359488,0,1,0,0,1
1090079300462686208,0,0,0,1,1
1090134597009108992,0,1,0,0,1
1089194029655515136,0,1,0,0,1
1089015743805616128,0,0,1,0,1
1087816414646415360,0,1,0,0,1
1088319501073035264,1,0,0,0,1
1087844571583778816,0,1,0,0,1
1087849336241905664,0,1,0,0,1
1088029631599575040,0,1,0,0,1
1088037294244876288,0,1,0,0,1
1088068650421096448,0,1,0,0,1
1088149477993656320,0,1,0,0,1
1088207662574198784,0,1,0,0,1
1088224714441535488,0,1,0,0,1
1088302544131182592,1,0,0,0,1
1088414501131685888,1,0,0,0,1
1088958801141612544,0,1,0,0,1
1088437985970929664,0,1,0,0,1
1088489911391526912,0,1,0,0,1
1088512998493294592,0,1,0,0,1
1088568702063108096,0,1,0,0,1
1088701053313388544,0,1,0,0,1
1088723040924590080,0,1,0,0,1
1088754621273853952,0,1,0,0,1
1088891932544253952,1,0,0,0,1
1088949091592167424,0,1,0,0,1
1086223319324602368,0,1,0,0,1
1086196461501669376,0,1,0,0,1
1086071247291637760,0,1,0,0,1
1083629018379898880,0,1,0,0,1
1083294187200507904,0,1,0,0,1
1083296849937793024,0,1,0,0,1
1083322655045050368,1,0,0,0,1
1083407532981276672,0,1,0,0,1
1083446138043355136,0,1,0,0,1
1083453861971423232,0,1,0,0,1
1083467815301115904,0,1,0,0,1
1083512054403735552,0,1,0,0,1
1083604697687109632,1,0,0,0,1
1083715670007836672,0,1,0,0,1
1083219906357792768,0,1,0,0,1
1083839187655315456,0,1,0,0,1
1083841695442239488,0,1,0,0,1
1083907601358716928,0,0,0,1,1
1083972339199401984,0,1,0,0,1
1083984400893730816,0,1,0,0,1
1084015742612369408,0,1,0,0,1
1084051127879024640,1,0,0,0,1
1084107410179002368,0,1,0,0,1
1084176549161648128,0,1,0,0,1
1083254035682115584,0,1,0,0,1
1083185513538994176,0,1,0,0,1
1084222275828645888,0,1,0,0,1
1082669122226401280,0,1,0,0,1
1082282660666503168,0,1,0,0,1
1082312482377617408,0,1,0,0,1
1082313435696807936,0,1,0,0,1
1082511041840537600,0,1,0,0,1
1082576689232785408,0,1,0,0,1
1082586239306412032,0,1,0,0,1
1082602341394731008,1,0,0,0,1
1082616578611523584,0,1,0,0,1
1082645002671607808,0,1,0,0,1
1082684290272555008,0,1,0,0,1
1083091718717784064,0,1,0,0,1
1082706323819638784,0,1,0,0,1
1082711230459060224,0,1,0,0,1
1082751821662187520,0,0,0,1,1
1082781700235644928,0,1,0,0,1
1082897481384501248,0,1,0,0,1
1082984324859863040,0,1,0,0,1
1082989841913131008,0,1,0,0,1
1083041909717827584,0,1,0,0,1
1083082107092496384,1,0,0,0,1
1084218828085706752,0,1,0,0,1
1084246155138088960,0,1,0,0,1
1086003756838412288,0,0,0,1,1
1085682014592872448,0,1,0,0,1
1085481824086867968,0,1,0,0,1
1085485121552244736,0,1,0,0,1
1085494159379697664,1,0,0,0,1
1085536568654290944,0,1,0,0,1
1085539864853000192,0,0,0,1,1
1085591505031622656,1,0,0,0,1
1085622334222929920,0,1,0,0,1
1085625753558024192,0,1,0,0,1
1085664009616011264,0,1,0,0,1
1085684953306750976,0,1,0,0,1
1085227574891069440,0,0,1,0,1
1085725526583500800,0,1,0,0,1
1085808191542358016,0,1,0,0,1
1085889058398711808,0,1,0,0,1
1085901788593643520,0,1,0,0,1
1085903921699262464,0,0,0,1,1
1085905955018149888,0,1,0,0,1
1085914153112489984,0,1,0,0,1
1085956947960975360,1,0,0,0,1
1085970818696429568,0,1,0,0,1
1085478641553891328,0,1,0,0,1
1085214229580472320,0,1,0,0,1
1084362662878867456,0,1,0,0,1
1084695806005923840,1,0,0,0,1
1084364535782408192,0,1,0,0,1
1084399035467816960,0,1,0,0,1
1084423067772903424,0,1,0,0,1
1084426043178532864,0,1,0,0,1
1084429240496472064,0,1,0,0,1
1084529228681375744,0,1,0,0,1
1084552853593698304,0,1,0,0,1
1084600768588582912,0,1,0,0,1
1084634025845616640,1,0,0,0,1
1084748701845708800,0,1,0,0,1
1085211730605629440,0,1,0,0,1
1084917229118996480,0,1,0,0,1
1084948614823108608,0,1,0,0,1
1084949343797432320,1,0,0,0,1
1084993818607476736,0,1,0,0,1
1085019360266207232,0,0,0,1,1
1085027646952624128,0,1,0,0,1
1085141086023139328,0,1,0,0,1
1085173857210773504,0,1,0,0,1
1085211702889717760,1,0,0,0,1
1090158380910546944,0,1,0,0,1
1090200484739248128,0,1,0,0,1
1063112853316603904,0,1,0,0,1
1090231240710590464,0,1,0,0,1
1095715674301833216,1,0,0,0,1
1095745184904761344,0,1,0,0,1
1095830136195305472,0,1,0,0,1
1095885295654973440,0,1,0,0,1
1095906811662741504,0,1,0,0,1
1096033132145328128,0,0,0,1,1
1096051365397364736,0,1,0,0,1
1096072612671864832,1,0,0,0,1
1096092615420928000,0,1,0,0,1
1096162279022710784,0,1,0,0,1
1096241480220340224,1,0,0,0,1
1096246779157381120,0,1,0,0,1
1096249232170909696,1,0,0,0,1
1096270741736026112,1,0,0,0,1
1096294969055293440,0,1,0,0,1
1096346033544724480,0,1,0,0,1
1096354729620234240,0,1,0,0,1
1096414124634824704,1,0,0,0,1
1096434159340404736,0,1,0,0,1
1096454976715587584,0,0,1,0,1
1096462707530715136,0,1,0,0,1
1095713272442044416,0,1,0,0,1
1095691419031953408,0,1,0,0,1
1095691183651807232,0,1,0,0,1
1095350366944796672,0,1,0,0,1
1094823664741175296,0,1,0,0,1
1094846847410151424,0,1,0,0,1
1094855879910965248,0,1,0,0,1
1094865900442796032,0,1,0,0,1
1095012779159740416,0,1,0,0,1
1095117270903209984,0,1,0,0,1
1095198179937734656,1,0,0,0,1
1095213633070452736,0,1,0,0,1
1095276094922674176,0,1,0,0,1
1095355530237931520,0,1,0,0,1
1095686544416034816,1,0,0,0,1
1095389382507462656,0,1,0,0,1
1095440003709030400,0,1,0,0,1
1095453492444123136,0,1,0,0,1
1095575436770209792,0,1,0,0,1
1095595713537355776,1,0,0,0,1
1095603219521331200,0,1,0,0,1
1095615126236024832,0,1,0,0,1
1095619099219165184,0,1,0,0,1
1095645693404864512,0,1,0,0,1
1096470800905859072,0,1,0,0,1
1096483124333154304,1,0,0,0,1
1096486182802915328,1,0,0,0,1
1097895698094272512,0,1,0,0,1
1097483360409210880,1,0,0,0,1
1097531759422566400,0,0,0,1,1
1097584449217331200,1,0,0,0,1
1097606138869280768,0,1,0,0,1
1097625544903065600,1,0,0,0,1
1097715410474917888,0,1,0,0,1
1097727487948206080,0,0,0,1,1
1097734729426718720,1,0,0,0,1
1097857110505865216,0,1,0,0,1
1097910096447758336,0,1,0,0,1
1097432759453261824,0,1,0,0,1
1098189684969168896,0,1,0,0,1
1098222935465111552,0,1,0,0,1
1098307916040491008,0,1,0,0,1
1098507605910134784,0,0,0,1,1
1098577140369539072,0,1,0,0,1
1098577790616641536,0,1,0,0,1
1098595963810316288,0,1,0,0,1
1098737291084877824,0,1,0,0,1
1098752668649091072,0,1,0,0,1
1097437199572893696,0,1,0,0,1
1097344090264334336,0,1,0,0,1
1096495962921553920,0,1,0,0,1
1096766022529486848,1,0,0,0,1
1096512404345753600,0,1,0,0,1
1096567204924088320,0,1,0,0,1
1096606788441432064,0,1,0,0,1
1096615247891349504,1,0,0,0,1
1096638410595463168,0,1,0,0,1
1096670893865136128,0,1,0,0,1
1096681527654510592,0,1,0,0,1
1096685377920921600,0,1,0,0,1
1096760617472573440,0,1,0,0,1
1096827092367335424,0,1,0,0,1
1097329797745659904,0,1,0,0,1
1096878472356605952,0,0,0,1,1
1096909483824111616,0,1,0,0,1
1097036941009342464,0,1,0,0,1
1097053015196856320,0,1,0,0,1
1097063712853188608,1,0,0,0,1
1097124355245363200,1,0,0,0,1
1097148392587710464,0,1,0,0,1
1097203348913168384,0,1,0,0,1
1097284254487273472,0,1,0,0,1
1094718444837265408,0,1,0,0,1
1094662800750923776,0,1,0,0,1
1094637731127455744,0,1,0,0,1
1092010549750235136,0,1,0,0,1
1091581276341952512,0,1,0,0,1
1091597841586417664,1,0,0,0,1
1091598120180428800,0,1,0,0,1
1091641523026972672,0,1,0,0,1
1091683849740767232,0,1,0,0,1
1091779001926979584,0,1,0,0,1
1091994707310321664,0,1,0,0,1
1092002721991778304,0,1,0,0,1
1092006130304409600,0,1,0,0,1
1092026734818541568,0,1,0,0,1
1091319470440759296,1,0,0,0,1
1092188670512238592,0,1,0,0,1
1092296921174233088,0,1,0,0,1
1092303774587203584,0,1,0,0,1
1092310483737198592,0,1,0,0,1
1092371936787812352,0,1,0,0,1
1092404686848700416,0,1,0,0,1
1092429551848878080,0,1,0,0,1
1092477020301393920,1,0,0,0,1
1092505889158979584,1,0,0,0,1
1091374457027989504,0,1,0,0,1
1091271327888084992,0,1,0,0,1
1092545699730939904,0,1,0,0,1
1090650930448683008,1,0,0,0,1
1090249928595697664,0,0,0,1,1
1090295135928119296,0,1,0,0,1
1090334254091911168,0,1,0,0,1
1090441815667355648,1,0,0,0,1
1090516271139962880,0,1,0,0,1
1090581171543724032,1,0,0,0,1
1090584001251864576,0,1,0,0,1
1090605889067864064,0,1,0,0,1
1090634682310377472,0,1,0,0,1
1090685735408005120,0,1,0,0,1
1091267585239203840,0,1,0,0,1
1090752568446369792,0,1,0,0,1
1090763236759293952,1,0,0,0,1
1090973824269590528,0,1,0,0,1
1091014386116972544,0,1,0,0,1
1091015181805780992,0,1,0,0,1
1091027059009380352,0,1,0,0,1
1091052136442531840,1,0,0,0,1
1091147433617342464,0,1,0,0,1
1091261165064327168,0,1,0,0,1
1092531764130729984,1,0,0,0,1
1092593702713864192,1,0,0,0,1
1094603893978218496,0,1,0,0,1
1094348418657460224,0,1,0,0,1
1093876195060563968,0,1,0,0,1
1093877841677168640,1,0,0,0,1
1093996216139112448,0,1,0,0,1
1093999439969173504,0,1,0,0,1
1094110094420254720,0,1,0,0,1
1094121428700454912,0,1,0,0,1
1094154650419372032,0,1,0,0,1
1094264011443654656,0,1,0,0,1
1094342038982664192,0,1,0,0,1
1094367407878098944,0,1,0,0,1
1093672213100691456,0,1,0,0,1
1094396285069807616,0,1,0,0,1
1094465314631417856,0,1,0,0,1
1094535902267953152,0,1,0,0,1
1094536464669597696,0,1,0,0,1
1094547609971236864,0,1,0,0,1
1094549596007817216,1,0,0,0,1
1094555405261377536,0,1,0,0,1
1094575607646687232,0,1,0,0,1
1094581233164668928,0,1,0,0,1
1093799964629700608,0,1,0,0,1
1093627976111947776,0,1,0,0,1
1092663732428128256,0,1,0,0,1
1092975079993077760,0,1,0,0,1
1092666387867127808,1,0,0,0,1
1092764427017957376,0,1,0,0,1
1092783487000682496,0,1,0,0,1
1092803796303007744,1,0,0,0,1
1092841545282215936,0,1,0,0,1
1092859322894299136,0,1,0,0,1
1092865520762798080,0,1,0,0,1
1092899406335168512,0,1,0,0,1
1092932237971152896,0,1,0,0,1
1092986631651356672,0,1,0,0,1
1093581142970851328,1,0,0,0,1
1093055552299716608,1,0,0,0,1
1093105214759075840,0,1,0,0,1
1093129514555768832,1,0,0,0,1
1093170837375479808,1,0,0,0,1
1093235247968411648,0,1,0,0,1
1093349465241632768,0,1,0,0,1
1093490796026826752,0,1,0,0,1
1093510526389444608,0,1,0,0,1
1093556148660301824,0,1,0,0,1
1082252996828901376,0,1,0,0,1
1082193166017744896,0,1,0,0,1
1082190027235282944,0,1,0,0,1
1082181766566293504,0,1,0,0,1
1069756804593319936,0,1,0,0,1
1069770230283583488,0,1,0,0,1
1069773283678150656,0,1,0,0,1
1069773419036598272,0,1,0,0,1
1069796640880500736,0,1,0,0,1
1069880770687229952,0,1,0,0,1
1069904844033572864,0,1,0,0,1
1069920146955878400,1,0,0,0,1
1069983495324360704,1,0,0,0,1
1069999022440615936,0,1,0,0,1
1070009849667293184,0,1,0,0,1
1070013516797509632,0,1,0,0,1
1070025262039855104,0,1,0,0,1
1070049583550607360,0,1,0,0,1
1070061690224603136,0,1,0,0,1
1070110250206941184,0,1,0,0,1
1070138237086126080,0,0,1,0,1
1070182122806218752,0,1,0,0,1
1070187943363518464,0,1,0,0,1
1070389267409575936,0,1,0,0,1
1070464792849145856,0,1,0,0,1
1069742422782078976,1,0,0,0,1
1069696446134403072,0,1,0,0,1
1069680102194196480,0,1,0,0,1
1069421156757880832,0,1,0,0,1
1068647277433114624,0,1,0,0,1
1068865148415344640,1,0,0,0,1
1068974588120379392,0,1,0,0,1
1069118990163869696,0,1,0,0,1
1069119912990273536,0,1,0,0,1
1069248990171095040,1,0,0,0,1
1069251988624293888,0,1,0,0,1
1069255691217465344,0,1,0,0,1
1069267172151779328,0,1,0,0,1
1069441612013539328,0,1,0,0,1
1069679724165763072,0,0,1,0,1
1069450159212371968,0,1,0,0,1
1069512487345639424,0,0,1,0,1
1069526322072993792,0,1,0,0,1
1069533466511831040,0,1,0,0,1
1069554197379645440,0,1,0,0,1
1069580433371877376,0,1,0,0,1
1069608115912495104,0,1,0,0,1
1069626645269614592,0,1,0,0,1
1069658596064063488,0,1,0,0,1
1070562867034808320,0,1,0,0,1
1070569506366312448,0,1,0,0,1
1070746263740710912,1,0,0,0,1
1072924990230683648,0,1,0,0,1
1072556974447968256,0,1,0,0,1
1072564028663156736,1,0,0,0,1
1072708895393632256,0,1,0,0,1
1072764971405045760,1,0,0,0,1
1072805828070125568,0,0,0,1,1
1072825062091317248,0,1,0,0,1
1072861585259917312,0,1,0,0,1
1072889769560965120,0,1,0,0,1
1072911525503848448,0,1,0,0,1
1072939905620205568,0,1,0,0,1
1072476945202454528,1,0,0,0,1
1073082080270143488,0,1,0,0,1
1073101233995448320,1,0,0,0,1
1073242844683530240,0,1,0,0,1
1073472832103800832,0,1,0,0,1
1073564133226938368,0,0,0,1,1
1073596432005898240,1,0,0,0,1
1073602974570696704,0,1,0,0,1
1073602987732492288,0,1,0,0,1
1073631997950640128,0,1,0,0,1
1072506397835714560,1,0,0,0,1
1072414742302605312,0,1,0,0,1
1070790595923361792,0,1,0,0,1
1071372691586867200,0,1,0,0,1
1070827892873949184,0,0,0,1,1
1070852042481156096,0,1,0,0,1
1070934668458029056,0,0,1,0,1
1071037084071129088,0,0,1,0,1
1071039797643354112,0,1,0,0,1
1071044227008626688,0,1,0,0,1
1071048413591019520,1,0,0,0,1
1071150043078508544,1,0,0,0,1
1071188813140148224,0,1,0,0,1
1071387476953063424,0,1,0,0,1
1072253528813568000,0,1,0,0,1
1071457658417233920,0,1,0,0,1
1071607219941191680,0,1,0,0,1
1071645880808284160,0,1,0,0,1
1071777281645916160,1,0,0,0,1
1071831980185133056,0,1,0,0,1
1071883645483401216,0,1,0,0,1
1072033741730648064,0,1,0,0,1
1072070072410259456,0,1,0,0,1
1072218807035420672,0,1,0,0,1
1068588469256110080,0,1,0,0,1
1068587096032595968,0,1,0,0,1
1068560475623952384,0,1,0,0,1
1064958707447095296,1,0,0,0,1
1064573086480007168,0,1,0,0,1
1064712458395361280,0,1,0,0,1
1064799146090086400,0,1,0,0,1
1064810313244176384,0,1,0,0,1
1064829378025177088,0,1,0,0,1
1064853641637568512,0,1,0,0,1
1064871511213965312,0,1,0,0,1
1064897252928425984,0,1,0,0,1
1064934217065394176,1,0,0,0,1
1065122678443466752,1,0,0,0,1
1064518473982857216,0,1,0,0,1
1065166252887498752,0,1,0,0,1
1065185078161100800,0,0,1,0,1
1065289448600915968,0,1,0,0,1
1065383760424652800,0,1,0,0,1
1065403227309555712,0,1,0,0,1
1065513890287677440,0,1,0,0,1
1065582862777208832,1,0,0,0,1
1065601400418287616,0,1,0,0,1
1065661406937264128,0,1,0,0,1
1064526213371359232,0,0,0,1,1
1064496518663675904,0,1,0,0,1
1065834514134548480,0,1,0,0,1
1063882365200527360,0,0,1,0,1
1063120117922435072,0,1,0,0,1
1063163637165105152,0,1,0,0,1
1063325523030548480,1,0,0,0,1
1063506552760369152,0,1,0,0,1
1063575318143762432,0,1,0,0,1
1063584006422310912,0,1,0,0,1
1063757650691858432,1,0,0,0,1
1063780399136952320,1,0,0,0,1
1063819026126770176,0,1,0,0,1
1063894538320834560,1,0,0,0,1
1064442898869940224,1,0,0,0,1
1063898405716426752,0,1,0,0,1
1063917650881974272,0,1,0,0,1
1064059194658209792,0,1,0,0,1
1064181727667605504,0,1,0,0,1
1064200848740245504,0,0,0,1,1
1064241618306256896,0,1,0,0,1
1064279806395719680,0,1,0,0,1
1064414902327099392,0,1,0,0,1
1064434567027834880,0,1,0,0,1
1065785418812014592,0,1,0,0,1
1065838560551460864,0,1,0,0,1
1068442616696631296,0,1,0,0,1
1067850382536310784,1,0,0,0,1
1067134318793887744,0,1,0,0,1
1067189652879273984,1,0,0,0,1
1067228983136272384,0,1,0,0,1
1067313593035689984,0,1,0,0,1
1067325404342599680,0,1,0,0,1
1067484029677641728,0,1,0,0,1
1067663550481608704,0,1,0,0,1
1067673354952413184,1,0,0,0,1
1067847479784349696,0,1,0,0,1
1067894750097887232,0,1,0,0,1
1067079168502960128,0,1,0,0,1
1067942875474780160,0,1,0,0,1
1067980145204461568,0,1,0,0,1
1068010607285129216,1,0,0,0,1
1068077453308915712,0,1,0,0,1
1068184020574527488,0,1,0,0,1
1068223658588553216,0,1,0,0,1
1068303930449453056,0,1,0,0,1
1068338276107464704,0,1,0,0,1
1068437700670382080,0,1,0,0,1
1067118107234365440,0,0,0,1,1
1066894156436525056,0,1,0,0,1
1065855822381674496,0,0,0,1,1
1066288491330453504,0,1,0,0,1
1065864387666354176,0,1,0,0,1
1065929025892245504,0,1,0,0,1
1065932228163764224,0,1,0,0,1
1066025730725662720,0,1,0,0,1
1066099312323584000,0,1,0,0,1
1066099795373277184,0,1,0,0,1
1066129605885607936,0,1,0,0,1
1066245214715740160,0,1,0,0,1
1066246067950370816,0,1,0,0,1
1066309263755141120,0,1,0,0,1
1066802207708704768,0,1,0,0,1
1066368680286662656,0,1,0,0,1
1066373847639744512,1,0,0,0,1
1066381870588444672,0,1,0,0,1
1066382704189554688,1,0,0,0,1
1066489002918846464,0,1,0,0,1
1066549681625296896,1,0,0,0,1
1066600362180669440,0,1,0,0,1
1066694663275343872,0,1,0,0,1
1066698333043847168,0,1,0,0,1
1073647835755749376,1,0,0,0,1
1073658046784696320,0,1,0,0,1
1073660045626392576,0,1,0,0,1
1079435476749160448,0,1,0,0,1
1079270099977203712,0,1,0,0,1
1079284195053223936,0,1,0,0,1
1079306833985261568,0,1,0,0,1
1079323654587121664,0,1,0,0,1
1079344026237587456,0,1,0,0,1
1079357424727814144,1,0,0,0,1
1079381936114552832,0,1,0,0,1
1079385866970296320,0,1,0,0,1
1079411912377581568,0,1,0,0,1
1079439170148491264,0,1,0,0,1
1079222106460749824,1,0,0,0,1
1079446335865176064,0,1,0,0,1
1079487525473931264,0,1,0,0,1
1079499812255551488,0,0,0,1,1
1079544093443833856,0,1,0,0,1
1079567082180636672,0,1,0,0,1
1079579818977484800,0,1,0,0,1
1079588934391422976,1,0,0,0,1
1079650772542017536,0,1,0,0,1
1079668132950634496,0,1,0,0,1
1079251602865905664,0,1,0,0,1
1079065093512544256,0,1,0,0,1
1079886606901956608,0,1,0,0,1
1078436007094222848,0,1,0,0,1
1078060797086130176,0,1,0,0,1
1078153977416556544,1,0,0,0,1
1078191540160380928,0,1,0,0,1
1078226538250862592,0,1,0,0,1
1078289096294965248,0,1,0,0,1
1078324210127290368,0,1,0,0,1
1078384968311689216,0,1,0,0,1
1078385662754197504,0,1,0,0,1
1078394265867354112,0,1,0,0,1
1078456915812864000,0,1,0,0,1
1078941129121452032,1,0,0,0,1
1078476645030342656,0,1,0,0,1
1078527165463957504,0,1,0,0,1
1078558890147495936,0,1,0,0,1
1078578892775047168,1,0,0,0,1
1078622800125022208,1,0,0,0,1
1078715494121852928,0,0,0,1,1
1078732759466680320,0,1,0,0,1
1078746656642920448,0,1,0,0,1
1078780581536718848,0,1,0,0,1
1079854687749169152,0,1,0,0,1
1079972522777591808,0,1,0,0,1
1078016479193432064,0,1,0,0,1
1081545001753030656,0,0,0,1,1
1081243853682692096,1,0,0,0,1
1081318850350759936,0,1,0,0,1
1081410643717017600,0,1,0,0,1
1081453920801574912,0,1,0,0,1
1081466783943544832,0,1,0,0,1
1081489053394976768,0,1,0,0,1
1081494686995496960,0,1,0,0,1
1081538453542789120,1,0,0,0,1
1081538900806365184,0,1,0,0,1
1081549416278966272,0,1,0,0,1
1081209015374274560,0,1,0,0,1
1081563554346659840,0,1,0,0,1
1081635035235663872,1,0,0,0,1
1081636782439976960,0,1,0,0,1
1081878230766968832,0,1,0,0,1
1081970143574573056,0,1,0,0,1
1082025704420720640,0,1,0,0,1
1082031642087227392,0,1,0,0,1
1082155004021092352,0,1,0,0,1
1082178740103319552,0,1,0,0,1
1081229860763250688,0,0,1,0,1
1081186660610727936,1,0,0,0,1
1079992554215653376,0,1,0,0,1
1080487736568537088,0,0,0,1,1
1080002653030150144,0,1,0,0,1
1080013011685801984,0,1,0,0,1
1080043635620675584,1,0,0,0,1
1080100222750113792,0,1,0,0,1
1080243965079764992,0,1,0,0,1
1080269330137268224,0,1,0,0,1
1080326052948303872,0,1,0,0,1
1080380842915102720,0,1,0,0,1
1080446285226934272,1,0,0,0,1
1080591523715129344,0,1,0,0,1
1081112656768106496,1,0,0,0,1
1080738845686001664,0,1,0,0,1
1080788122143809536,0,1,0,0,1
1080815484101103616,0,1,0,0,1
1080842770669916160,0,0,0,1,1
1080884963438776320,0,1,0,0,1
1080930322114584576,0,1,0,0,1
1081004780804366336,0,0,1,0,1
1081081572407824384,0,1,0,0,1
1081107127140339712,0,1,0,0,1
1078016798065332224,0,1,0,0,1
1077818800207212544,0,1,0,0,1
1073669498413244416,0,1,0,0,1
1075350126082867200,1,0,0,0,1
1074682959695884288,0,1,0,0,1
1074702136095723520,0,1,0,0,1
1074750094136786944,0,0,1,0,1
1074939178088103936,0,1,0,0,1
1074948839679811584,1,0,0,0,1
1075106716574994432,0,1,0,0,1
1075115257880825856,0,1,0,0,1
1075289416892063744,0,1,0,0,1
1075325372080840704,0,1,0,0,1
1075354092309016576,1,0,0,0,1
1074619433631531008,0,1,0,0,1
1075455942781751296,0,1,0,0,1
1075512690406129664,0,1,0,0,1
1075566926544363520,0,1,0,0,1
1075584739711438848,0,1,0,0,1
1075624959098142720,0,1,0,0,1
1075639710519840768,0,1,0,0,1
1075680446879551488,0,1,0,0,1
1075690582801043456,0,1,0,0,1
1075746504164417536,1,0,0,0,1
1074624966937796608,0,1,0,0,1
1074617961225338880,0,0,0,1,1
1075776993226977280,0,1,0,0,1
1074207269456363520,0,1,0,0,1
1073687827458744320,0,1,0,0,1
1073758942755463168,0,1,0,0,1
1073801113504284672,0,1,0,0,1
1073845218577932288,1,0,0,0,1
1073867084470247424,0,1,0,0,1
1073875703920291840,0,0,1,0,1
1073893108251877376,0,1,0,0,1
1073990540528705536,0,1,0,0,1
1074149483804585984,0,0,0,1,1
1074260118257238016,0,1,0,0,1
1074578613343707136,0,1,0,0,1
1074265539776794624,0,1,0,0,1
1074283551519064064,0,1,0,0,1
1074375281647992832,0,1,0,0,1
1074384037660246016,0,1,0,0,1
1074434424236859392,1,0,0,0,1
1074521480690581504,0,1,0,0,1
1074523116108304384,1,0,0,0,1
1074541624787591168,1,0,0,0,1
1074542963777105920,0,1,0,0,1
1075758848961589248,0,1,0,0,1
1075784641351565312,1,0,0,0,1
1077790405695946752,0,1,0,0,1
1077334735863468032,1,0,0,0,1
1076880353715982336,0,1,0,0,1
1076917899347062784,0,1,0,0,1
1077068860631597056,1,0,0,0,1
1077121261765943296,1,0,0,0,1
1077162042715295744,1,0,0,0,1
1077164279722315776,0,1,0,0,1
1077184222538883072,1,0,0,0,1
1077239562831912960,0,1,0,0,1
1077271841767636992,1,0,0,0,1
1077382242106785792,0,1,0,0,1
1076846142250512384,0,1,0,0,1
1077460960799907840,0,1,0,0,1
1077475280250392576,0,1,0,0,1
1077476468807090176,0,1,0,0,1
1077538959595659264,0,1,0,0,1
1077577497762512896,0,0,0,1,1
1077587295367319552,0,1,0,0,1
1077604659051880448,0,1,0,0,1
1077670052630024192,0,1,0,0,1
1077781091367346176,0,1,0,0,1
1076862170615435264,0,1,0,0,1
1076728614601789440,0,1,0,0,1
1075826220988854272,1,0,0,0,1
1076372407529754624,0,1,0,0,1
1075838987250601984,0,1,0,0,1
1076068826352099328,1,0,0,0,1
1076069987595493376,0,1,0,0,1
1076159677312970752,0,1,0,0,1
1076205538046763008,0,1,0,0,1
1076282567949598720,0,1,0,0,1
1076287321614532608,0,1,0,0,1
1076333749913165824,1,0,0,0,1
1076358338575826944,0,1,0,0,1
1076416907237052416,0,1,0,0,1
1076694900660260864,1,0,0,0,1
1076420402493181952,0,1,0,0,1
1076427619338543104,0,1,0,0,1
1076433997402652672,0,1,0,0,1
1076513640226803712,0,1,0,0,1
1076534151820374016,1,0,0,0,1
1076539778777169920,0,1,0,0,1
1076554829273673728,0,0,1,0,1
1076602119262797824,0,1,0,0,1
1076647948820406272,0,1,0,0,1
1020770375297269760,0,1,0,0,1
1020661788860436480,0,1,0,0,1
1020487503135092736,0,1,0,0,1
967000449671888896,0,1,0,0,1
964381501004460032,0,1,0,0,1
964392401388187648,0,1,0,0,1
964403088978100224,1,0,0,0,1
964450062167302144,0,1,0,0,1
964450653337800704,0,1,0,0,1
964457438677266432,0,1,0,0,1
964515897619701760,0,1,0,0,1
964564611323256832,0,1,0,0,1
964589339190681600,0,1,0,0,1
964591724503777280,0,1,0,0,1
964633043846729728,0,1,0,0,1
964696574017331200,1,0,0,0,1
964769556010012672,0,1,0,0,1
964775527545561088,0,1,0,0,1
964776751640535040,0,1,0,0,1
964858721129107456,0,1,0,0,1
964859056262471680,0,1,0,0,1
964887942580899840,1,0,0,0,1
964896424948355072,1,0,0,0,1
964919680598192128,0,1,0,0,1
964929798119313408,0,1,0,0,1
964378259772260352,0,0,0,1,1
964299521902759936,0,0,1,0,1
964254601380708352,1,0,0,0,1
963796807900958720,0,1,0,0,1
963405374505308160,0,1,0,0,1
963436412245807104,0,1,0,0,1
963445102701051904,1,0,0,0,1
963504858895650816,0,1,0,0,1
963524118535655424,0,1,0,0,1
963756095532621824,0,1,0,0,1
963767120499798016,0,1,0,0,1
963770038627926016,0,1,0,0,1
963796295948427264,0,1,0,0,1
963799983358083072,0,1,0,0,1
964220022137741312,1,0,0,0,1
963850929404596224,0,1,0,0,1
963934657929719808,1,0,0,0,1
963947202744913920,0,1,0,0,1
964068719885512704,1,0,0,0,1
964072126864134144,0,1,0,0,1
964117910036893696,0,1,0,0,1
964131615340482560,0,1,0,0,1
964151989281189888,0,1,0,0,1
964188072161304576,0,0,1,0,1
964974181493428224,0,0,1,0,1
965025423217364992,0,1,0,0,1
965039600354852864,0,1,0,0,1
966576146174406656,0,1,0,0,1
965999299837550592,0,1,0,0,1
966019804409860096,0,1,0,0,1
966055288435625984,0,1,0,0,1
966308442498617344,0,1,0,0,1
966318964178587648,0,1,0,0,1
966369822018715648,1,0,0,0,1
966399836605042688,0,1,0,0,1
966403551353241600,0,0,0,1,1
966506196457918464,0,1,0,0,1
966589833748430848,0,1,0,0,1
965983085417435136,0,1,0,0,1
966660689262710784,1,0,0,0,1
966720738861477888,0,1,0,0,1
966737094101127168,0,0,1,0,1
966774716596981760,0,1,0,0,1
966810578697125888,0,0,1,0,1
966887301606391808,0,1,0,0,1
966933772733173760,0,1,0,0,1
966943657688317952,0,1,0,0,1
966944096488251392,0,1,0,0,1
965984561611051008,0,1,0,0,1
965940483557126144,0,0,0,1,1
965107048131121152,0,1,0,0,1
965513960274452480,0,1,0,0,1
965140777335697408,0,1,0,0,1
965173143621926912,1,0,0,0,1
965190480970633216,0,1,0,0,1
965270880950525952,0,1,0,0,1
965270948399083520,0,1,0,0,1
965295363346305024,0,1,0,0,1
965451112395415552,0,1,0,0,1
965493666902102016,0,0,1,0,1
965504435978870784,0,1,0,0,1
965524701702483968,1,0,0,0,1
965926419149795328,0,1,0,0,1
965536895278243840,0,1,0,0,1
965559592099962880,0,1,0,0,1
965560075334115328,1,0,0,0,1
965592527410626560,0,1,0,0,1
965617700662861824,0,1,0,0,1
965622838601199616,1,0,0,0,1
965669649080881152,1,0,0,0,1
965732534314242048,0,1,0,0,1
965797789090410496,1,0,0,0,1
963367804731904000,0,1,0,0,1
963312149211811840,0,1,0,0,1
963160047491731456,0,1,0,0,1
959843341415350272,0,1,0,0,1
959472733234106368,0,1,0,0,1
959501518050418688,0,1,0,0,1
959550946887036928,0,1,0,0,1
959580053255401472,0,1,0,0,1
959696763920830464,0,1,0,0,1
959698614338707456,0,1,0,0,1
959702474558005248,0,1,0,0,1
959741279679721472,0,1,0,0,1
959766798630555648,0,1,0,0,1
959938730248327168,0,1,0,0,1
959324101302214656,0,1,0,0,1
959950173366554624,0,1,0,0,1
960001448552443904,0,1,0,0,1
960051368106057728,0,1,0,0,1
960115152266911744,0,1,0,0,1
960182147360358400,0,1,0,0,1
960186259179298816,0,1,0,0,1
960205852971028480,0,1,0,0,1
960232564480004096,0,1,0,0,1
960238349566038016,0,1,0,0,1
959466135132323840,0,1,0,0,1
959223662787342336,0,1,0,0,1
960240073617879040,0,1,0,0,1
958858826790457344,1,0,0,0,1
958403123026030592,0,1,0,0,1
958438375517708288,0,0,0,1,1
958514554056589312,0,1,0,0,1
958557711599308800,1,0,0,0,1
958605867921879040,0,1,0,0,1
958615526955249664,0,1,0,0,1
958661216880287744,0,1,0,0,1
958714034873864192,0,1,0,0,1
958824029384720384,0,1,0,0,1
958865926085951488,0,1,0,0,1
959188216426397696,0,1,0,0,1
958928899513114624,0,1,0,0,1
959038315075981312,0,1,0,0,1
959040224868347904,0,1,0,0,1
959051769342029824,0,1,0,0,1
959067893882327040,0,0,1,0,1
959072956922998784,1,0,0,0,1
959076277125832704,0,1,0,0,1
959080641349455872,0,1,0,0,1
959092299379732480,0,1,0,0,1
960239588357918720,0,1,0,0,1
960242133885054976,0,1,0,0,1
963141283379265536,0,1,0,0,1
962603834018320384,0,1,0,0,1
961934520202158080,0,1,0,0,1
961984625999572992,0,1,0,0,1
961984814835314688,0,1,0,0,1
962183878650793984,0,1,0,0,1
962213193060962304,0,1,0,0,1
962224063451148288,1,0,0,0,1
962305374740209664,0,1,0,0,1
962348632476233728,0,1,0,0,1
962603268424781824,0,1,0,0,1
962874933721337856,0,1,0,0,1
961899658481106944,0,1,0,0,1
962899858439815168,0,0,0,1,1
962960967079428096,0,1,0,0,1
962983866771402752,0,1,0,0,1
962992178049011712,0,1,0,0,1
963004820620824576,0,1,0,0,1
963020807495733248,0,1,0,0,1
963083596230782976,0,1,0,0,1
963109679357415424,1,0,0,0,1
963128828339122176,0,1,0,0,1
961910746266337280,0,1,0,0,1
961820649332269056,0,1,0,0,1
960293438779461632,0,1,0,0,1
961050514225090560,0,0,1,0,1
960444296875921408,0,1,0,0,1
960462142683205632,1,0,0,0,1
960578878023589888,1,0,0,0,1
960694759734919168,1,0,0,0,1
960769702539747328,0,1,0,0,1
960869897248092160,0,1,0,0,1
960874038347386880,1,0,0,0,1
960898647398535168,0,1,0,0,1
961000945181052928,1,0,0,0,1
961154971076096000,0,1,0,0,1
961773832896856064,1,0,0,0,1
961191305970946048,0,1,0,0,1
961210448652656640,0,1,0,0,1
961277868419448832,1,0,0,0,1
961333112587382784,0,1,0,0,1
961644385732644864,0,1,0,0,1
961648218667913216,0,1,0,0,1
961673055033614336,0,1,0,0,1
961693635644309504,0,1,0,0,1
961723638016872448,0,1,0,0,1
966990285166252032,0,0,1,0,1
967014980087361536,0,1,0,0,1
977626481160581120,1,0,0,0,1
967086300414308352,0,1,0,0,1
973858229972172800,0,1,0,0,1
973871525379149824,0,1,0,0,1
973887521133342720,0,1,0,0,1
973935163913601024,0,1,0,0,1
973974492895588352,0,1,0,0,1
973983424955461632,1,0,0,0,1
973993281213337600,1,0,0,0,1
974010356044632064,1,0,0,0,1
974095389073682432,0,1,0,0,1
974144034917756928,0,1,0,0,1
974173427958337536,0,1,0,0,1
974235683177955328,1,0,0,0,1
974371341620207616,0,1,0,0,1
974388566414503936,0,0,0,1,1
974399249273126912,0,1,0,0,1
974400810410012672,0,1,0,0,1
974409182928625664,0,1,0,0,1
974622996198551552,0,1,0,0,1
974715324674330624,0,1,0,0,1
974837954249142272,0,1,0,0,1
975211204284174336,1,0,0,0,1
973852456181518336,1,0,0,0,1
973809574561140736,0,1,0,0,1
973771264308465664,0,1,0,0,1
973134683071549440,0,0,0,1,1
972580530167443456,1,0,0,0,1
972607933807644672,0,1,0,0,1
972717154649874432,0,1,0,0,1
972770678557609984,0,1,0,0,1
972803665747693568,0,1,0,0,1
972810416580694016,0,1,0,0,1
972890381116411904,0,1,0,0,1
972891575855603712,0,1,0,0,1
973028498913636352,0,1,0,0,1
973182982000295936,0,1,0,0,1
973661582701056000,0,1,0,0,1
973185782142918656,1,0,0,0,1
973212435032272896,0,1,0,0,1
973227034280431616,0,1,0,0,1
973426140651147264,0,0,1,0,1
973476031620440064,0,1,0,0,1
973519850160185344,1,0,0,0,1
973521410525220864,0,1,0,0,1
973576498576846848,1,0,0,0,1
973585408255823872,0,1,0,0,1
975291677018611712,0,1,0,0,1
975296600221331456,0,1,0,0,1
975299658091323392,0,1,0,0,1
977002568671997952,0,1,0,0,1
976323750487580672,0,1,0,0,1
976424419202445312,0,1,0,0,1
976453096388907008,0,1,0,0,1
976621216395079680,0,1,0,0,1
976688498219634688,1,0,0,0,1
976747678217461760,0,1,0,0,1
976787592996933632,0,1,0,0,1
976802941851009024,0,1,0,0,1
976974425516986368,0,1,0,0,1
977045819583971328,0,1,0,0,1
976220266513747968,0,1,0,0,1
977135100910448640,0,1,0,0,1
977143254444539904,0,0,1,0,1
977178196343898112,0,1,0,0,1
977267678871212032,0,1,0,0,1
977313512241451008,0,1,0,0,1
977322700820463616,0,1,0,0,1
977456830564655104,0,1,0,0,1
977475861845651456,0,1,0,0,1
977478888078086144,1,0,0,0,1
976279862393614336,0,1,0,0,1
976190001456218112,0,1,0,0,1
975372817431658496,0,1,0,0,1
975862676705464320,0,1,0,0,1
975373799372726272,0,1,0,0,1
975462402853691392,0,1,0,0,1
975471349438337024,0,1,0,0,1
975655921878798336,0,1,0,0,1
975686885057220608,0,1,0,0,1
975712108385067008,1,0,0,0,1
975726416645033984,0,1,0,0,1
975746761821184000,1,0,0,0,1
975817567280488448,1,0,0,0,1
975932387396804608,0,1,0,0,1
976143354454073344,0,1,0,0,1
975970909780668416,1,0,0,0,1
975997162537467904,0,1,0,0,1
975999751354245120,0,1,0,0,1
976038484145262592,0,1,0,0,1
976051598161047552,0,0,0,1,1
976113865636368384,0,1,0,0,1
976116386207473664,0,1,0,0,1
976118812507504640,0,1,0,0,1
976132144203407360,0,1,0,0,1
972558836639895552,0,0,0,1,1
972481693163638784,0,1,0,0,1
972464839254781952,0,1,0,0,1
969082047754129408,0,1,0,0,1
968510589399019520,1,0,0,0,1
968640698642849792,0,1,0,0,1
968661532858044416,0,1,0,0,1
968714544838213632,0,1,0,0,1
968823368081428480,0,1,0,0,1
968846547344592896,1,0,0,0,1
968938279377629184,0,1,0,0,1
969042925119193088,0,1,0,0,1
969079818393477120,0,1,0,0,1
969113962150207488,0,1,0,0,1
968427630692315136,0,1,0,0,1
969143070217322496,0,1,0,0,1
969292348382355456,0,1,0,0,1
969303847112970240,0,1,0,0,1
969388678333087744,0,1,0,0,1
969450243275313152,0,1,0,0,1
969503436915036160,0,1,0,0,1
969504583885185024,0,1,0,0,1
969506602326876160,0,1,0,0,1
969519646448738304,0,1,0,0,1
968505921096835072,0,1,0,0,1
968178575252840448,1,0,0,0,1
969565632017653760,0,1,0,0,1
967704244974473216,0,1,0,0,1
967164043680256000,0,1,0,0,1
967217516836720640,0,1,0,0,1
967230367685009408,1,0,0,0,1
967363567707095040,0,1,0,0,1
967390678534811648,0,1,0,0,1
967473333477486592,0,1,0,0,1
967556124626087936,0,1,0,0,1
967652162502262784,1,0,0,0,1
967654525980106752,0,1,0,0,1
967717270469390336,0,1,0,0,1
968116034665435136,0,1,0,0,1
967745968140574720,0,1,0,0,1
967769284654108672,0,1,0,0,1
967801783048462336,0,1,0,0,1
968023199366729728,0,1,0,0,1
968029954666586112,0,1,0,0,1
968051101936300032,0,1,0,0,1
968055136000987136,1,0,0,0,1
968097649609134080,0,1,0,0,1
968104999485104128,0,1,0,0,1
969546514602315776,0,1,0,0,1
969612702690705408,0,1,0,0,1
972464241503588352,0,1,0,0,1
971790074546450432,0,1,0,0,1
971150864248262656,0,0,1,0,1
971259076679172096,1,0,0,0,1
971266128608727040,0,1,0,0,1
971292309458472960,0,1,0,0,1
971364711945023488,1,0,0,0,1
971424955425525760,0,1,0,0,1
971456990751936512,0,1,0,0,1
971650765684002816,0,1,0,0,1
971773373499002880,0,1,0,0,1
971806600825638912,0,1,0,0,1
970944478205939712,0,1,0,0,1
971903663168880640,1,0,0,0,1
972008862764228608,0,1,0,0,1
972019826490097664,0,1,0,0,1
972133095716610048,0,1,0,0,1
972207791053135872,1,0,0,0,1
972261573002776576,0,1,0,0,1
972387877102538752,0,1,0,0,1
972406778976718848,0,1,0,0,1
972443857823719424,0,1,0,0,1
971102637281218560,0,1,0,0,1
970924287149318144,1,0,0,0,1
969793292282949632,1,0,0,0,1
970272004808077312,0,1,0,0,1
969852615747129344,0,1,0,0,1
969907444141973504,1,0,0,0,1
969950059134685184,0,0,0,1,1
969964093380743168,0,1,0,0,1
970019632001122304,0,1,0,0,1
970022537076895744,0,1,0,0,1
970046461709901824,0,1,0,0,1
970191084239425536,1,0,0,0,1
970226402997014528,0,1,0,0,1
970289849025560576,0,1,0,0,1
970907051055550464,0,1,0,0,1
970296365820493824,0,0,0,1,1
970329641759191040,0,1,0,0,1
970409000104849408,1,0,0,0,1
970435340602433536,0,1,0,0,1
970447497557626880,0,1,0,0,1
970568248931553280,0,1,0,0,1
970589009176158208,0,1,0,0,1
970673204099534848,0,1,0,0,1
970701101338189824,0,1,0,0,1
958381753571295232,0,1,0,0,1
958342497071173632,0,1,0,0,1
958322710458716160,1,0,0,0,1
958300223259934720,0,1,0,0,1
945209402511863808,1,0,0,0,1
945331183956758528,0,0,0,1,1
945375274211954688,0,1,0,0,1
945631961506185216,0,1,0,0,1
945655401382424576,0,0,1,0,1
945667763661570048,0,1,0,0,1
945740346226593792,1,0,0,0,1
945818207566417920,0,1,0,0,1
945918900029440000,0,1,0,0,1
945984148547690496,0,1,0,0,1
946062026459303936,0,1,0,0,1
946090726357590016,0,1,0,0,1
946113717061656576,0,0,1,0,1
946226570041081856,0,1,0,0,1
946248802771509248,0,1,0,0,1
946277482080038912,1,0,0,0,1
946295358644133888,1,0,0,0,1
946339344184369152,0,0,0,1,1
946369040913780736,0,1,0,0,1
946392041851949056,0,1,0,0,1
946544655931510784,0,1,0,0,1
945198469014224896,0,1,0,0,1
945029021011775488,0,1,0,0,1
944994973686095872,0,1,0,0,1
944447748081889280,1,0,0,0,1
943815687914622976,0,1,0,0,1
943882956803682304,0,1,0,0,1
943899237971931136,0,1,0,0,1
943899871697866752,1,0,0,0,1
943907861553225728,0,0,0,1,1
943935260936556544,0,1,0,0,1
944092360039858176,0,1,0,0,1
944337992755290112,0,1,0,0,1
944401013200453632,1,0,0,0,1
944456611078311936,0,1,0,0,1
944987572505337856,1,0,0,0,1
944484195773976576,0,1,0,0,1
944512342032900096,0,1,0,0,1
944599030885216256,0,1,0,0,1
944603767558742016,0,1,0,0,1
944614875958951936,0,1,0,0,1
944656735687643136,1,0,0,0,1
944698685778165760,0,1,0,0,1
944931005353398272,0,1,0,0,1
944942053280112640,0,1,0,0,1
946685215912710144,0,1,0,0,1
946733697306329088,0,1,0,0,1
946765319766466560,0,1,0,0,1
948799068557455360,0,1,0,0,1
948428164803497984,0,1,0,0,1
948454810403123200,0,1,0,0,1
948462153350238208,0,1,0,0,1
948462262964043776,0,1,0,0,1
948488198937825280,0,1,0,0,1
948500337123627008,0,0,0,1,1
948594307904299008,0,1,0,0,1
948649092057587712,0,1,0,0,1
948664242907041792,0,1,0,0,1
948800566351642624,0,1,0,0,1
948158101957566464,0,1,0,0,1
948846394944598016,0,0,0,1,1
948862827267272704,0,1,0,0,1
948865966359875584,0,1,0,0,1
948868862245724160,0,1,0,0,1
948892766465155072,0,1,0,0,1
948932484149993472,0,1,0,0,1
949026103049445376,0,1,0,0,1
949061910351286272,0,1,0,0,1
949117393309114368,0,1,0,0,1
948270159650807808,0,1,0,0,1
947960652974325760,0,1,0,0,1
946785653580115968,0,1,0,0,1
947512194111066112,0,1,0,0,1
946845716348940288,0,1,0,0,1
946870853865758720,0,1,0,0,1
947091999370432512,0,1,0,0,1
947217272216702976,0,1,0,0,1
947372435128565760,0,1,0,0,1
947406661483864064,0,1,0,0,1
947412321835425792,0,1,0,0,1
947432040860934144,0,1,0,0,1
947473005147541504,0,1,0,0,1
947674105129549824,0,1,0,0,1
947942712933847040,0,1,0,0,1
947684761685843968,0,1,0,0,1
947732695655813120,0,1,0,0,1
947835333147631616,0,1,0,0,1
947851488478367744,1,0,0,0,1
947864714523979776,0,0,1,0,1
947916210259116032,0,1,0,0,1
947917370223415296,0,1,0,0,1
947934725271846912,0,1,0,0,1
947934747740790784,0,1,0,0,1
943751758295261184,0,1,0,0,1
943727702518800384,0,1,0,0,1
943611433320964096,0,1,0,0,1
940657015671676928,0,1,0,0,1
940331188270624768,0,1,0,0,1
940546361887518720,0,1,0,0,1
940547512653447168,0,1,0,0,1
940557475048177664,0,1,0,0,1
940581844751228928,0,1,0,0,1
940627205465542656,1,0,0,0,1
940647694200172544,0,1,0,0,1
940649837405659136,0,1,0,0,1
940653915825045504,0,1,0,0,1
940664413836730368,0,1,0,0,1
940263745250476032,0,1,0,0,1
940694998739226624,0,0,0,1,1
940720869479010304,0,1,0,0,1
940721195728625664,1,0,0,0,1
940802428190056448,0,1,0,0,1
940918543700414464,0,1,0,0,1
940921414848303104,0,1,0,0,1
941010102714273792,0,1,0,0,1
941048210084257792,0,1,0,0,1
941076830563553280,0,1,0,0,1
940303111566123008,0,1,0,0,1
940257986508812288,0,1,0,0,1
941165220143169536,0,1,0,0,1
939535988866584576,0,1,0,0,1
939103541112725504,0,1,0,0,1
939117962560196608,0,1,0,0,1
939123214130864128,0,1,0,0,1
939162175121211392,1,0,0,0,1
939179091659558912,1,0,0,0,1
939235864617549824,0,1,0,0,1
939280985857974272,0,1,0,0,1
939335315067736064,0,1,0,0,1
939419029818789888,0,1,0,0,1
939562640786862080,0,1,0,0,1
940252773387563008,0,1,0,0,1
939576178066710528,0,0,0,1,1
939590859988840448,0,1,0,0,1
939751987876331520,0,1,0,0,1
939820423642042368,0,1,0,0,1
939907866894401536,0,1,0,0,1
939920731680399360,0,0,0,1,1
940149767979626496,0,1,0,0,1
940153297805201408,0,1,0,0,1
940187134610300928,0,1,0,0,1
941077491682365440,0,1,0,0,1
941205188437721088,1,0,0,0,1
943608946044035072,1,0,0,0,1
943035945493893120,0,1,0,0,1
942559233706356736,0,1,0,0,1
942626217349603328,0,1,0,0,1
942676605088002048,0,1,0,0,1
942676731927732224,0,1,0,0,1
942738608791814144,1,0,0,0,1
942764289936338944,0,1,0,0,1
942784008852779008,0,1,0,0,1
942956252107280384,0,1,0,0,1
943032637496725504,0,1,0,0,1
943087192854888448,0,1,0,0,1
942436877776416768,0,1,0,0,1
943106531746336768,0,1,0,0,1
943154009334075392,0,1,0,0,1
943178269045686272,0,1,0,0,1
943197378005405696,1,0,0,0,1
943334860743233536,1,0,0,0,1
943352004382023680,0,1,0,0,1
943416162808889344,0,1,0,0,1
943505711677415424,1,0,0,0,1
943539296614494208,0,1,0,0,1
942449017589567488,0,1,0,0,1
942390085256749056,0,1,0,0,1
941302382880845824,0,1,0,0,1
941661761425551360,0,1,0,0,1
941303615133814784,0,1,0,0,1
941315859355639808,0,1,0,0,1
941330120937222144,1,0,0,0,1
941340214856908800,0,1,0,0,1
941343245606506496,1,0,0,0,1
941401092155359232,0,1,0,0,1
941469650705141760,0,1,0,0,1
941556402308333568,0,1,0,0,1
941601294690566144,1,0,0,0,1
941698908945833984,0,1,0,0,1
942380141715451904,1,0,0,0,1
941714939948957696,0,1,0,0,1
941736017475899392,1,0,0,0,1
941751738406723584,0,1,0,0,1
941814730716598272,0,1,0,0,1
941900020600598528,0,1,0,0,1
941981739446079488,0,1,0,0,1
942044491812364288,1,0,0,0,1
942165132393746432,0,1,0,0,1
942262204728008704,0,1,0,0,1
949127654090919936,0,1,0,0,1
949404060486004736,0,1,0,0,1
949406282854825984,0,1,0,0,1
955195551750021120,0,1,0,0,1
954772513669644288,0,1,0,0,1
954798586188857344,1,0,0,0,1
954888536699867136,0,1,0,0,1
954901008483831808,0,1,0,0,1
955021388418400256,0,1,0,0,1
955061248625913856,0,1,0,0,1
955073062986162176,0,1,0,0,1
955104495444287488,0,1,0,0,1
955121902418317312,0,0,0,1,1
955202299357487104,0,1,0,0,1
954725972103720960,0,1,0,0,1
955215405769003008,0,1,0,0,1
955243608822767616,0,1,0,0,1
955372949527318528,1,0,0,0,1
955374098951168000,0,1,0,0,1
955519549113294848,0,1,0,0,1
955620210593079296,0,1,0,0,1
955797869025427456,0,1,0,0,1
955864851175239680,0,1,0,0,1
955877310946856960,0,1,0,0,1
954761413213474816,0,1,0,0,1
954674614210367488,0,1,0,0,1
956114309410705408,1,0,0,0,1
954286460043067392,0,0,1,0,1
953884503658901504,0,1,0,0,1
953885916363239424,0,1,0,0,1
953897741788368896,0,1,0,0,1
953924011637043200,0,1,0,0,1
953946416719843328,0,0,1,0,1
954036579433054208,0,1,0,0,1
954045330294738944,0,1,0,0,1
954046010614927360,0,1,0,0,1
954053791581704192,0,1,0,0,1
954329939481911296,1,0,0,0,1
954668301564764160,0,1,0,0,1
954331300390932480,0,1,0,0,1
954414258640572416,1,0,0,0,1
954425541796405248,0,1,0,0,1
954443777095192576,0,1,0,0,1
954482637065859072,0,1,0,0,1
954496712554504192,0,0,1,0,1
954553878112034816,0,1,0,0,1
954571580142530560,0,1,0,0,1
954578908963250176,0,1,0,0,1
956075539411947520,0,1,0,0,1
956115161911349248,0,1,0,0,1
953760814292525056,0,1,0,0,1
957745607300567040,0,1,0,0,1
957410513104797696,1,0,0,0,1
957425442432040960,1,0,0,0,1
957467053987856384,0,1,0,0,1
957484712146202624,0,1,0,0,1
957543366249590784,0,1,0,0,1
957552595198988288,0,1,0,0,1
957575294604533760,0,1,0,0,1
957648795902324736,0,1,0,0,1
957735414156156928,0,1,0,0,1
957771459308457984,0,1,0,0,1
957198536881434624,0,1,0,0,1
957805686531948544,0,1,0,0,1
957829712772059136,0,1,0,0,1
957875773875998720,0,1,0,0,1
957923155309346816,0,1,0,0,1
957939782331412480,0,1,0,0,1
957970792867909632,0,1,0,0,1
958031999196737536,0,0,1,0,1
958054518666620928,0,1,0,0,1
958095809823653888,0,1,0,0,1
957296578569613312,0,1,0,0,1
957181289945337856,0,1,0,0,1
956213520261148672,0,1,0,0,1
956829188497043456,0,1,0,0,1
956229929594744832,0,1,0,0,1
956258507950641152,0,1,0,0,1
956373258525229056,0,0,0,1,1
956445818604568576,0,1,0,0,1
956523780335022080,0,1,0,0,1
956573496682754048,0,1,0,0,1
956591327713533952,0,1,0,0,1
956804559644610560,0,1,0,0,1
956826860566056960,1,0,0,0,1
956834048676069376,0,1,0,0,1
957170698560077824,0,1,0,0,1
956834078606667776,0,1,0,0,1
956856373828038656,0,1,0,0,1
956889236552105984,0,1,0,0,1
956914832191737856,0,1,0,0,1
956924217357824000,0,1,0,0,1
956938805746991104,0,0,0,1,1
957044525947486208,0,1,0,0,1
957155897758896128,0,1,0,0,1
957158445857173504,0,1,0,0,1
953775576346693632,0,1,0,0,1
953661436257030144,1,0,0,0,1
949441044097175552,0,1,0,0,1
951064045586714624,0,1,0,0,1
950607580140789760,0,1,0,0,1
950665710975545344,0,1,0,0,1
950757839458283520,0,1,0,0,1
950783139751874560,0,1,0,0,1
950807483454377984,0,1,0,0,1
950822483770462208,0,1,0,0,1
950874739689406464,0,1,0,0,1
950905774309629952,0,1,0,0,1
950952246812008448,0,0,1,0,1
951148199896592384,0,0,0,1,1
950469132813832192,0,1,0,0,1
951217004714909696,0,1,0,0,1
951271085923885056,0,1,0,0,1
951365445696835584,0,1,0,0,1
951369215163949056,0,1,0,0,1
951385061777203200,0,0,0,1,1
951393798235545600,1,0,0,0,1
951399374843731968,1,0,0,0,1
951405622662221824,0,1,0,0,1
951536651997732864,0,1,0,0,1
950528501832208384,1,0,0,0,1
950464335134056448,0,1,0,0,1
951655388683923456,0,0,1,0,1
949970686713516032,0,1,0,0,1
949474439133097984,0,1,0,0,1
949532846905069568,0,1,0,0,1
949593685263568896,0,1,0,0,1
949654917412741120,0,1,0,0,1
949670856774553600,1,0,0,0,1
949681690552754176,0,1,0,0,1
949701604202242048,1,0,0,0,1
949745288985698304,0,1,0,0,1
949821670533058560,0,1,0,0,1
950011632775847936,0,1,0,0,1
950430193528770560,0,1,0,0,1
950052198523789312,0,1,0,0,1
950072683764568064,0,1,0,0,1
950091704295706624,0,1,0,0,1
950093398848913408,0,1,0,0,1
950096960232525824,0,1,0,0,1
950314102060126208,0,1,0,0,1
950339922602479616,0,1,0,0,1
950384729131397120,0,1,0,0,1
950398988389318656,0,1,0,0,1
951577615944638464,0,1,0,0,1
951672335953727488,0,1,0,0,1
953602831893827584,1,0,0,0,1
953116639930744832,0,1,0,0,1
952622440533827584,0,1,0,0,1
952634781623308288,0,1,0,0,1
952636284060782592,0,1,0,0,1
952726288267005952,0,1,0,0,1
952799577844858880,0,1,0,0,1
952859985402384384,0,1,0,0,1
952926940599435264,0,1,0,0,1
953097053256716288,0,1,0,0,1
953099974857773056,1,0,0,0,1
953149423705624576,0,1,0,0,1
952582051022168064,0,1,0,0,1
953149606396772352,0,0,1,0,1
953185150711619584,0,1,0,0,1
953197157972049920,0,1,0,0,1
953203129272688640,0,1,0,0,1
953252964726079488,0,1,0,0,1
953264203263070208,0,1,0,0,1
953293173740134400,0,1,0,0,1
953506442203598848,0,1,0,0,1
953568698148818944,0,1,0,0,1
952597674284503040,1,0,0,0,1
952574526906236928,0,1,0,0,1
951694627224072192,0,0,0,1,1
951969594591334400,0,1,0,0,1
951698702074294272,0,1,0,0,1
951736897566490624,0,1,0,0,1
951737770308964352,0,1,0,0,1
951775084175339520,0,1,0,0,1
951821069626892288,0,1,0,0,1
951860884716097536,0,1,0,0,1
951863113875308544,0,1,0,0,1
951905948712419328,0,1,0,0,1
951945550672232448,0,1,0,0,1
952083147138543616,0,1,0,0,1
952533886952620032,0,1,0,0,1
952100980841119744,0,1,0,0,1
952143106958241792,0,1,0,0,1
952205297719959552,0,1,0,0,1
952243414183002112,0,1,0,0,1
952293233106800640,0,1,0,0,1
952294580095012864,0,1,0,0,1
952387557475549184,0,1,0,0,1
952527501796040704,0,1,0,0,1
952528632966254592,1,0,0,0,1
977531721808793600,0,1,0,0,1
977828535850029056,0,1,0,0,1
1020407855042531328,0,1,0,0,1
1008713405304328192,1,0,0,0,1
1005304513132036096,0,1,0,0,1
1005322853170810880,0,1,0,0,1
1005431747704737792,0,1,0,0,1
1005605253260050432,0,1,0,0,1
1005729270868692992,0,1,0,0,1
1005763398901096448,0,1,0,0,1
1005771607699279872,0,1,0,0,1
1005790812041547776,0,1,0,0,1
1005807368431656960,0,1,0,0,1
1005827943967477760,0,1,0,0,1
1005855966829694976,0,1,0,0,1
1005857018622758912,1,0,0,0,1
1005866574547386368,0,1,0,0,1
1005866724317544448,1,0,0,0,1
1005881833245102080,0,1,0,0,1
1005883529102872576,0,0,0,1,1
1005975332984360960,0,1,0,0,1
1006037121201655808,0,1,0,0,1
1006081814849576960,0,1,0,0,1
1006091448339587072,0,1,0,0,1
1006144069662371840,0,1,0,0,1
1005300728599142400,0,1,0,0,1
1005175674229936128,1,0,0,0,1
1005100998430511104,0,1,0,0,1
1004306422136430592,0,1,0,0,1
1003867733975445504,0,1,0,0,1
1003921770976403456,1,0,0,0,1
1003947418621300736,0,1,0,0,1
1003971455141470208,0,1,0,0,1
1003973569729236992,0,1,0,0,1
1004028465182490624,0,1,0,0,1
1004058049605062656,0,1,0,0,1
1004060819469094912,0,1,0,0,1
1004185762147991552,1,0,0,0,1
1004346266120278016,0,1,0,0,1
1004997014302744576,0,1,0,0,1
1004393828411985920,0,1,0,0,1
1004395181746065408,0,1,0,0,1
1004417248549797888,0,1,0,0,1
1004450549893300224,0,1,0,0,1
1004476582864404480,0,1,0,0,1
1004552229548851200,0,1,0,0,1
1004661215119970304,0,1,0,0,1
1004667678244696064,0,0,0,1,1
1004774666353799168,0,1,0,0,1
1006191437430566912,1,0,0,0,1
1006234589071904768,0,1,0,0,1
1006363012255526912,0,1,0,0,1
1007978710711001088,1,0,0,0,1
1007556840563986432,0,0,0,1,1
1007569532691546112,0,1,0,0,1
1007597193560248320,1,0,0,0,1
1007618375516815360,0,1,0,0,1
1007623724974174208,0,1,0,0,1
1007682640248541184,0,1,0,0,1
1007704254067269632,0,1,0,0,1
1007808431908982784,0,1,0,0,1
1007860701472256000,0,1,0,0,1
1007979743210242048,0,1,0,0,1
1007449601400541184,0,1,0,0,1
1008081194850902016,0,1,0,0,1
1008094225748189184,0,1,0,0,1
1008206688782991360,0,1,0,0,1
1008272501804290048,0,1,0,0,1
1008444833499877376,0,1,0,0,1
1008459450661949440,0,1,0,0,1
1008581944957964288,1,0,0,0,1
1008591621754146816,0,1,0,0,1
1008665027514007552,0,1,0,0,1
1007501728118239232,0,1,0,0,1
1007432139254755328,0,1,0,0,1
1006468385255936000,0,1,0,0,1
1006873884400988160,0,1,0,0,1
1006495139496251392,0,1,0,0,1
1006538078440304640,0,1,0,0,1
1006555295349395456,0,1,0,0,1
1006572368293257216,0,1,0,0,1
1006578733468278784,0,0,1,0,1
1006588872875225088,0,1,0,0,1
1006607665357869056,0,1,0,0,1
1006655921420828672,0,1,0,0,1
1006832556162076672,0,0,0,1,1
1006932353334169600,0,1,0,0,1
1007418020300390400,0,1,0,0,1
1006932811935244288,0,1,0,0,1
1006962567296835584,0,1,0,0,1
1006981482387267584,0,1,0,0,1
1007146360473300992,0,1,0,0,1
1007242979344388096,0,1,0,0,1
1007274088417693696,0,1,0,0,1
1007318405152759808,0,1,0,0,1
1007324923776421888,1,0,0,0,1
1007409428377849856,0,1,0,0,1
1003737026062094336,0,1,0,0,1
1003665382421475328,1,0,0,0,1
1003587428089782272,0,1,0,0,1
1000626260165480448,0,1,0,0,1
1000334289270198272,1,0,0,0,1
1000369006459617280,0,1,0,0,1
1000369671248412672,0,0,0,1,1
1000386521302798336,0,1,0,0,1
1000391909972566016,0,1,0,0,1
1000433127683248128,0,1,0,0,1
1000446257796734976,0,1,0,0,1
1000450321485791232,0,1,0,0,1
1000597364124540928,0,1,0,0,1
1000659278707949568,0,1,0,0,1
1000197925958553600,0,1,0,0,1
1000782788084355072,0,1,0,0,1
1000809642002452480,1,0,0,0,1
1000812679345397760,0,1,0,0,1
1000823557591625728,0,1,0,0,1
1001016615645925376,0,1,0,0,1
1001050561540739072,0,0,0,1,1
1001061562772209664,0,1,0,0,1
1001170647970705408,0,1,0,0,1
1001234411956981760,0,1,0,0,1
1000317689498341376,0,1,0,0,1
1000067469225082880,0,1,0,0,1
1001367540084375552,0,1,0,0,1
999313801538306048,0,1,0,0,1
998738356799508480,1,0,0,0,1
998812796363116544,0,1,0,0,1
998888649721659392,0,1,0,0,1
998903969413062656,0,1,0,0,1
998937061049630720,0,1,0,0,1
998997930508861440,0,1,0,0,1
999019154618363904,1,0,0,0,1
999040580125626368,0,1,0,0,1
999313298423103488,0,1,0,0,1
999341709119995904,0,1,0,0,1
1000066439313854464,0,1,0,0,1
999465582482223104,0,1,0,0,1
999501998264287232,1,0,0,0,1
999609690584645632,0,1,0,0,1
999685217207160832,1,0,0,0,1
999708117494587392,0,1,0,0,1
999888522222817280,1,0,0,0,1
999888852717391872,0,1,0,0,1
999909541763473408,0,1,0,0,1
999918672029388800,0,1,0,0,1
1001324039468716032,1,0,0,0,1
1001374561210847232,1,0,0,0,1
1003570405662130176,0,1,0,0,1
1003023967261609984,0,1,0,0,1
1002546861746597888,0,1,0,0,1
1002665506443268096,0,1,0,0,1
1002673633595150336,0,1,0,0,1
1002696450659282944,0,1,0,0,1
1002723494096928768,1,0,0,0,1
1002792372642541568,1,0,0,0,1
1002863585117261824,0,1,0,0,1
1002872327955083264,1,0,0,0,1
1003002262141075456,0,1,0,0,1
1003189634417872896,0,1,0,0,1
1002540988429058048,0,1,0,0,1
1003264247307161600,0,1,0,0,1
1003307183683932160,0,1,0,0,1
1003360097010143232,0,1,0,0,1
1003395955620827136,0,1,0,0,1
1003425511773786112,0,1,0,0,1
1003445142362222592,0,1,0,0,1
1003517442679885824,0,1,0,0,1
1003534285041733632,0,1,0,0,1
1003546026723115008,0,1,0,0,1
1002543646829371392,1,0,0,0,1
1002399856281903104,0,1,0,0,1
1001413151252983808,0,1,0,0,1
1001869978193354752,0,1,0,0,1
1001418773683998720,0,1,0,0,1
1001506244333481984,0,0,1,0,1
1001535747696902144,0,1,0,0,1
1001654823295451136,1,0,0,0,1
1001702103851655168,0,1,0,0,1
1001714682124783616,0,1,0,0,1
1001727912532496384,0,1,0,0,1
1001792328246284288,1,0,0,0,1
1001808117729030144,0,1,0,0,1
1001918967563374592,1,0,0,0,1
1002395817372803072,0,1,0,0,1
1001962615357169664,0,1,0,0,1
1001999622280241152,0,1,0,0,1
1002075257337991168,0,1,0,0,1
1002099273473970176,1,0,0,0,1
1002113778329309184,0,1,0,0,1
1002129280938205184,0,1,0,0,1
1002255069088223232,0,1,0,0,1
1002278177799135232,0,1,0,0,1
1002331049182056448,0,1,0,0,1
1008690731198885888,0,1,0,0,1
1008991850487861248,0,1,0,0,1
978196906206810112,0,1,0,0,1
1009011238938923008,0,1,0,0,1
1016358975976169472,0,1,0,0,1
1016368499764035584,0,0,1,0,1
1016516909024489472,0,1,0,0,1
1016678142239485952,0,1,0,0,1
1016732762601152512,0,1,0,0,1
1016750014289281024,0,1,0,0,1
1016753873313320960,0,1,0,0,1
1016779118275203072,0,1,0,0,1
1016841962836647936,1,0,0,0,1
1016891056393261056,0,1,0,0,1
1016923369789317120,0,0,1,0,1
1017020409592582144,1,0,0,0,1
1017059433547829248,0,1,0,0,1
1017067639036891136,0,1,0,0,1
1017091207170846720,1,0,0,0,1
1017130388823728128,0,1,0,0,1
1017150800865480704,0,1,0,0,1
1017169610620198912,0,1,0,0,1
1017208610634412032,0,1,0,0,1
1017288097715933184,0,1,0,0,1
1017307283632484352,0,1,0,0,1
1016039028427141120,0,1,0,0,1
1016025009142337536,0,1,0,0,1
1016005130091618304,0,1,0,0,1
1015703473738932224,0,1,0,0,1
1015316670208884736,1,0,0,0,1
1015322714805080064,0,1,0,0,1
1015563421847379968,0,1,0,0,1
1015567006739976192,1,0,0,0,1
1015576624811552768,0,0,0,1,1
1015580253849309184,0,1,0,0,1
1015588264986796032,0,1,0,0,1
1015608001951039488,0,1,0,0,1
1015693902031065088,0,1,0,0,1
1015707458235523072,0,1,0,0,1
1015945444264824832,0,1,0,0,1
1015733135147925504,0,1,0,0,1
1015808369263824896,0,1,0,0,1
1015818395713880064,0,1,0,0,1
1015846934697926656,0,1,0,0,1
1015853178343092224,0,1,0,0,1
1015855788907167744,0,1,0,0,1
1015856720298610688,0,1,0,0,1
1015899433588985856,0,1,0,0,1
1015905817827184640,0,1,0,0,1
1017393953904062464,1,0,0,0,1
1017637208126316544,1,0,0,0,1
1017707542066102272,0,1,0,0,1
1019844848285831168,0,0,1,0,1
1019493815642705920,0,1,0,0,1
1019504101472784384,0,1,0,0,1
1019541837432778752,0,1,0,0,1
1019594691459928064,0,1,0,0,1
1019595866846449664,0,1,0,0,1
1019598673406300160,0,0,0,1,1
1019704741717258240,0,1,0,0,1
1019757235445161984,0,1,0,0,1
1019842946194116608,1,0,0,0,1
1019885915337043968,0,1,0,0,1
1019459422035292160,0,1,0,0,1
1019996745827340288,0,1,0,0,1
1020180188712325120,1,0,0,0,1
1020193517040164864,0,1,0,0,1
1020214551206289408,1,0,0,0,1
1020219280850411520,0,1,0,0,1
1020223639629717504,0,1,0,0,1
1020288120246456320,0,1,0,0,1
1020306551746150400,1,0,0,0,1
1020325333931896832,0,1,0,0,1
1019466624938672128,0,1,0,0,1
1019446937634918400,1,0,0,0,1
1017743997467492352,0,1,0,0,1
1018442823794905088,0,1,0,0,1
1017828262859460608,0,1,0,0,1
1017851364284694528,0,1,0,0,1
1017937706393972736,0,1,0,0,1
1017991760927223808,1,0,0,0,1
1018144154445144064,0,1,0,0,1
1018207810612596736,0,1,0,0,1
1018270728842555392,0,1,0,0,1
1018293021568200704,1,0,0,0,1
1018364667918512128,0,0,1,0,1
1018538918474649600,0,1,0,0,1
1019284461077323776,0,1,0,0,1
1018587914907758592,0,1,0,0,1
1018665131369254912,0,1,0,0,1
1018742339056099328,0,1,0,0,1
1018963179404251136,0,1,0,0,1
1019003792858210304,0,1,0,0,1
1019043365634142208,0,1,0,0,1
1019089209561210880,1,0,0,0,1
1019163323403849728,0,1,0,0,1
1019179749606920192,0,1,0,0,1
1015312775197970432,0,1,0,0,1
1015295395319214080,0,1,0,0,1
1015292559604813824,1,0,0,0,1
1011285239140741120,1,0,0,0,1
1010698561535729664,0,1,0,0,1
1010804657407578112,0,1,0,0,1
1010864245242818560,0,1,0,0,1
1010907640136851456,1,0,0,0,1
1010940791907323904,0,1,0,0,1
1010974062699597824,0,1,0,0,1
1010983631437910016,0,1,0,0,1
1010988229934370816,1,0,0,0,1
1011056349856362496,0,1,0,0,1
1011313992822870016,0,1,0,0,1
1010540097819770880,0,1,0,0,1
1011320528915914752,0,1,0,0,1
1011520078146392064,0,1,0,0,1
1011609920540725248,0,1,0,0,1
1011656174700097536,0,1,0,0,1
1011734295143018496,1,0,0,0,1
1011872760778412032,1,0,0,0,1
1011892817524711424,1,0,0,0,1
1011919313597620224,1,0,0,0,1
1011996526254739456,0,1,0,0,1
1010582920744976384,0,0,1,0,1
1010406018986242048,0,1,0,0,1
1012015899253960704,1,0,0,0,1
1009443186173833216,1,0,0,0,1
1009025971771539456,0,1,0,0,1
1009066540472373248,0,1,0,0,1
1009080186745131008,0,0,1,0,1
1009098254829551616,0,1,0,0,1
1009126632450351104,0,1,0,0,1
1009267868528070656,0,1,0,0,1
1009383027796054016,0,1,0,0,1
1009406046920675328,0,1,0,0,1
1009431801046192128,0,1,0,0,1
1009480927809036288,0,1,0,0,1
1010383108082929664,0,1,0,0,1
1009561458458415104,0,1,0,0,1
1009739068996046848,0,1,0,0,1
1009835653834526720,0,1,0,0,1
1009842424934526976,0,1,0,0,1
1010008269128159232,0,1,0,0,1
1010216222150025216,0,1,0,0,1
1010222515640291328,0,1,0,0,1
1010279823401418752,0,1,0,0,1
1010302615031369728,0,1,0,0,1
1012010352010199040,0,1,0,0,1
1012160374098055168,0,1,0,0,1
1015132116630360064,0,1,0,0,1
1014381936125534208,1,0,0,0,1
1013665145061593088,0,1,0,0,1
1013677528719003648,0,1,0,0,1
1013707315831300096,1,0,0,0,1
1013807059211563008,1,0,0,0,1
1014053702741553152,1,0,0,0,1
1014077497028120576,0,1,0,0,1
1014100505109377024,0,1,0,0,1
1014265179138293760,0,1,0,0,1
1014345292819279872,0,1,0,0,1
1014500261463719936,0,1,0,0,1
1013506854528270336,0,1,0,0,1
1014519689509265408,0,1,0,0,1
1014822176791384064,0,1,0,0,1
1014834924313079808,0,1,0,0,1
1014859808632197120,0,1,0,0,1
1014888316976721920,0,1,0,0,1
1014895157039296512,0,1,0,0,1
1014924765105029120,0,1,0,0,1
1015043573698318336,0,1,0,0,1
1015044369278164992,0,1,0,0,1
1013604844614152192,1,0,0,0,1
1013468801629872128,0,0,1,0,1
1012220349184921600,0,1,0,0,1
1012936352688721920,0,1,0,0,1
1012234040273920000,0,1,0,0,1
1012274401134379008,0,1,0,0,1
1012355981953544192,0,1,0,0,1
1012360705369083904,0,1,0,0,1
1012461845922361344,0,1,0,0,1
1012523217284747264,0,1,0,0,1
1012705934571986944,0,1,0,0,1
1012779336439681024,0,1,0,0,1
1012903379113205760,0,0,0,1,1
1013024588610097152,0,1,0,0,1
1013432980516175872,0,1,0,0,1
1013077469522472960,0,1,0,0,1
1013136210016047104,1,0,0,0,1
1013192318428598272,0,1,0,0,1
1013291259560103936,0,1,0,0,1
1013328128595386368,0,1,0,0,1
1013345585850658816,0,1,0,0,1
1013363202812534784,0,1,0,0,1
1013377154179100672,1,0,0,0,1
1013393051421691904,1,0,0,0,1
998680653792194560,0,1,0,0,1
998637297498144768,0,1,0,0,1
998550308795174912,0,1,0,0,1
998522772396691456,0,1,0,0,1
984703915550748672,0,1,0,0,1
984726970872287232,0,1,0,0,1
984802919542329344,0,0,1,0,1
984828040235683840,0,1,0,0,1
984841422082924544,0,1,0,0,1
984866410726940672,0,1,0,0,1
984936922869936128,1,0,0,0,1
985036824241364992,0,1,0,0,1
985044890550767616,1,0,0,0,1
985068982544879616,0,1,0,0,1
985074339547615232,0,1,0,0,1
985077170895753216,0,1,0,0,1
985080657876541440,0,0,0,1,1
985083566035034112,0,1,0,0,1
985086569076977664,0,1,0,0,1
985093563502309376,0,1,0,0,1
985166751682977792,1,0,0,0,1
985224902847488000,0,1,0,0,1
985246577580273664,0,1,0,0,1
985266164786974720,1,0,0,0,1
985320572598083584,0,1,0,0,1
984520967253909504,0,1,0,0,1
984465179604856832,1,0,0,0,1
984435082252386304,0,1,0,0,1
983440223307640832,0,1,0,0,1
982829025314922496,0,1,0,0,1
982972609213095936,0,1,0,0,1
983057906932338688,0,1,0,0,1
983091710409478144,0,1,0,0,1
983205545023823872,1,0,0,0,1
983304419944095744,0,0,0,1,1
983367468306653184,1,0,0,0,1
983382199696265216,0,1,0,0,1
983432614479613952,0,1,0,0,1
983645355966386176,0,0,0,1,1
984377203264634880,0,1,0,0,1
983675641873731584,0,0,0,1,1
983684563045175296,0,1,0,0,1
983715588626374656,0,1,0,0,1
983763496679555072,0,1,0,0,1
983787929695698944,0,1,0,0,1
983789948590583808,0,1,0,0,1
983793578752094208,0,1,0,0,1
983851209122607104,0,1,0,0,1
984001309656436736,0,1,0,0,1
985336299505799168,0,0,1,0,1
985385369825890304,0,1,0,0,1
985423935859757056,0,1,0,0,1
986878170438742016,0,0,1,0,1
986285257862377472,0,1,0,0,1
986440664719097856,0,1,0,0,1
986491891712774144,1,0,0,0,1
986510782312534016,0,1,0,0,1
986540313031290880,0,1,0,0,1
986593201606701056,0,1,0,0,1
986663401228263424,0,1,0,0,1
986665758016057344,0,0,0,1,1
986758848512962560,0,1,0,0,1
986913252872458240,0,1,0,0,1
986203165514194944,0,1,0,0,1
986967676449730560,0,1,0,0,1
987008906735112192,1,0,0,0,1
987059944057864192,1,0,0,0,1
987071511143034880,0,1,0,0,1
987185335682691072,0,0,0,1,1
987279600488083456,0,1,0,0,1
987295272958091264,0,1,0,0,1
987335450632179712,1,0,0,0,1
987392988966830080,0,1,0,0,1
986212771812577280,0,1,0,0,1
986156259710730240,0,1,0,0,1
985433628078477312,0,1,0,0,1
985606305535709184,0,1,0,0,1
985461675716481024,0,1,0,0,1
985478752774819840,0,1,0,0,1
985488113916137472,0,1,0,0,1
985558180058030080,0,0,0,1,1
985567113300525056,0,1,0,0,1
985588784547872768,0,1,0,0,1
985588929582661632,0,1,0,0,1
985590396720898048,0,1,0,0,1
985593859840380928,1,0,0,0,1
985649152553037824,0,1,0,0,1
986151489499312128,0,1,0,0,1
985671737160368128,0,1,0,0,1
985705893672247296,1,0,0,0,1
985729429447036928,0,1,0,0,1
985763521597231104,0,1,0,0,1
985828273597886464,0,1,0,0,1
985884920420667392,0,1,0,0,1
985887201027346432,1,0,0,0,1
985919230884417536,0,1,0,0,1
986004211073716224,1,0,0,0,1
982823003120529408,0,1,0,0,1
982780028839591936,0,1,0,0,1
982657328066379776,0,1,0,0,1
979789540968640512,1,0,0,0,1
979282007997014016,0,1,0,0,1
979336618711703552,0,1,0,0,1
979351060706938880,0,1,0,0,1
979372534159368192,0,1,0,0,1
979405807719661568,0,0,0,1,1
979629554850521088,0,1,0,0,1
979653672924860416,1,0,0,0,1
979674490702651392,1,0,0,0,1
979786658018156544,0,1,0,0,1
979824252881948672,0,1,0,0,1
979277435672784896,0,1,0,0,1
979957384356524032,1,0,0,0,1
980016859549401088,1,0,0,0,1
980052164893650944,0,1,0,0,1
980070862878633984,0,1,0,0,1
980072439270002688,1,0,0,0,1
980108111527776256,0,1,0,0,1
980134779227115520,0,1,0,0,1
980172012403482624,0,1,0,0,1
980195042076905472,0,1,0,0,1
979278511826489344,0,1,0,0,1
979242148540354560,0,1,0,0,1
980365196496547840,0,1,0,0,1
978640667583897600,1,0,0,0,1
978198680485486592,0,1,0,0,1
978287425041698816,0,1,0,0,1
978329727172784128,0,1,0,0,1
978444614632951808,0,1,0,0,1
978446786112077824,0,1,0,0,1
978470003413434368,0,1,0,0,1
978536685528059904,0,1,0,0,1
978580366616182784,0,1,0,0,1
978608388744519680,1,0,0,0,1
978640845535670272,0,0,0,1,1
979238858582736896,0,1,0,0,1
978649860760129536,0,1,0,0,1
978685967539224576,1,0,0,0,1
978844008133922816,0,1,0,0,1
978907512702492672,0,1,0,0,1
978964844224438272,0,1,0,0,1
978990568461291520,0,1,0,0,1
979042679223922688,1,0,0,0,1
979108621958156288,0,1,0,0,1
979170791412654080,1,0,0,0,1
980288206103916544,1,0,0,0,1
980382602589646848,0,1,0,0,1
982638478331645952,0,1,0,0,1
982104573782315008,0,1,0,0,1
981720117326307328,0,1,0,0,1
981748048958140416,0,1,0,0,1
981872243167739904,0,0,1,0,1
981897899498848256,1,0,0,0,1
981905193188118528,1,0,0,0,1
981978397634068480,0,1,0,0,1
982022698753839104,0,0,1,0,1
982039845496344576,0,1,0,0,1
982039994016681984,0,1,0,0,1
982170606308241408,0,1,0,0,1
981595655167717376,0,1,0,0,1
982213622129606656,0,1,0,0,1
982237023330222080,0,1,0,0,1
982308128539758592,0,1,0,0,1
982453577456193536,0,1,0,0,1
982482158865465344,0,1,0,0,1
982533320843190272,0,1,0,0,1
982538740571795456,0,1,0,0,1
982597037685465088,1,0,0,0,1
982620853295697920,1,0,0,0,1
981625642847371264,0,1,0,0,1
981580209727029248,0,1,0,0,1
980464934449504256,0,1,0,0,1
981240810279641088,1,0,0,0,1
980496381063389184,1,0,0,0,1
980817985668550656,0,1,0,0,1
980860079380496384,0,1,0,0,1
980886199169683456,0,1,0,0,1
980897893321232384,0,1,0,0,1
981068418534330368,0,1,0,0,1
981091211300753408,0,1,0,0,1
981148530541846528,0,1,0,0,1
981171072509779968,0,1,0,0,1
981260135111712768,0,1,0,0,1
981505034117697536,0,1,0,0,1
981262013509795840,0,1,0,0,1
981289451661021184,0,1,0,0,1
981298411445145600,0,1,0,0,1
981328683406430208,0,1,0,0,1
981370132185296896,0,1,0,0,1
981451484071153664,0,1,0,0,1
981464453513330688,0,1,0,0,1
981485011043016704,0,0,1,0,1
981497368259461120,0,1,0,0,1
987465635360854016,0,0,0,1,1
987539018471563264,1,0,0,0,1
987608877255376896,0,1,0,0,1
994653517007728640,0,1,0,0,1
994250653626122240,1,0,0,0,1
994292355795734528,0,1,0,0,1
994328762442506240,0,1,0,0,1
994436705514999808,0,1,0,0,1
994451361965248512,0,1,0,0,1
994469584316092416,0,1,0,0,1
994524203591389184,0,1,0,0,1
994539041734516736,0,1,0,0,1
994634086873518080,0,1,0,0,1
994746018062217216,0,1,0,0,1
994221768402526208,0,1,0,0,1
994920856340975616,0,1,0,0,1
995221701192368128,0,1,0,0,1
995235059098701824,0,1,0,0,1
995264412691845120,0,1,0,0,1
995280714303180800,1,0,0,0,1
995330435075850240,1,0,0,0,1
995450585275973632,0,1,0,0,1
995478427078553600,0,1,0,0,1
995580744826155008,1,0,0,0,1
994248893473865728,0,0,0,1,1
994184939317932032,0,1,0,0,1
995774358818877440,0,0,0,1,1
993174678507347968,0,1,0,0,1
992796089546952704,0,1,0,0,1
992815833482080256,1,0,0,0,1
992879946950434816,0,0,0,1,1
993018162525409280,0,1,0,0,1
993046515592593408,0,1,0,0,1
993085923901497344,0,1,0,0,1
993098238730305536,0,1,0,0,1
993116677196931072,0,1,0,0,1
993119417369284608,0,1,0,0,1
993245086212292608,1,0,0,0,1
994149823195512832,0,1,0,0,1
993357906128056320,0,1,0,0,1
993472700428554240,1,0,0,0,1
993543097677242368,0,1,0,0,1
993564565106446336,0,1,0,0,1
993575115802796032,0,1,0,0,1
993731941508628480,1,0,0,0,1
993841497702387712,0,1,0,0,1
993855427359268864,0,1,0,0,1
994014047904391168,0,1,0,0,1
995717513471127552,0,1,0,0,1
995865786911731712,0,1,0,0,1
992663404291780608,0,1,0,0,1
997947322989457408,1,0,0,0,1
997421257900556288,0,1,0,0,1
997460702456696832,1,0,0,0,1
997533936342437888,0,0,1,0,1
997550070940815360,0,1,0,0,1
997621815756361728,0,1,0,0,1
997670053255491584,0,1,0,0,1
997811989769580544,0,1,0,0,1
997829661873852416,0,1,0,0,1
997939157962981376,0,1,0,0,1
997959062636687360,0,1,0,0,1
997369140326395904,0,1,0,0,1
998142242492702720,0,1,0,0,1
998196783502299136,0,1,0,0,1
998219516428652544,0,1,0,0,1
998290960080662528,1,0,0,0,1
998335397351559168,1,0,0,0,1
998411157806501888,0,1,0,0,1
998441856726851584,0,1,0,0,1
998443123293458432,0,1,0,0,1
998516656715452416,1,0,0,0,1
997419352616939520,0,1,0,0,1
997303926549557248,1,0,0,0,1
995902564704112640,1,0,0,0,1
996505647943315456,0,1,0,0,1
995927777261039616,0,1,0,0,1
996186219317997568,0,1,0,0,1
996300890901565440,1,0,0,0,1
996309779701116928,0,1,0,0,1
996316261473771520,0,1,0,0,1
996320013022777344,0,1,0,0,1
996322794890706944,0,1,0,0,1
996427168388296704,0,1,0,0,1
996458382876803072,0,1,0,0,1
996506728647847936,1,0,0,0,1
997204296386084864,1,0,0,0,1
996612577357717504,0,1,0,0,1
996730548369477632,0,1,0,0,1
996731838679977984,0,1,0,0,1
996748512640536576,0,1,0,0,1
996794584549216256,0,1,0,0,1
996904992027107328,0,1,0,0,1
997150325436903424,1,0,0,0,1
997157700340350976,1,0,0,0,1
997185168145354752,1,0,0,0,1
992736127902613504,0,1,0,0,1
992513174342529024,0,1,0,0,1
987611402897473536,1,0,0,0,1
988842515435610112,0,1,0,0,1
988669171750715392,0,1,0,0,1
988719122912628736,0,1,0,0,1
988762168328884224,1,0,0,0,1
988768354797281280,1,0,0,0,1
988771839169187840,0,1,0,0,1
988802545899442176,0,1,0,0,1
988823056448675840,0,1,0,0,1
988824435011485696,0,1,0,0,1
988836010493652992,0,1,0,0,1
988928356241629184,0,1,0,0,1
988637540155568128,0,1,0,0,1
989005956729188352,0,1,0,0,1
989015539061219328,0,1,0,0,1
989027728136515584,0,0,0,1,1
989149438865108992,1,0,0,0,1
989195002373910528,0,1,0,0,1
989307625631240192,0,1,0,0,1
989340204845723648,0,1,0,0,1
989424770369417216,0,1,0,0,1
989527649251971072,1,0,0,0,1
988662404421578752,0,1,0,0,1
988477893566222336,0,1,0,0,1
989602402402615296,1,0,0,0,1
988210076283539456,1,0,0,0,1
987643977603207168,0,1,0,0,1
987721851362250752,0,1,0,0,1
987852000527290368,0,1,0,0,1
987899876431286272,0,1,0,0,1
987948516248047616,1,0,0,0,1
987989126220795904,0,1,0,0,1
988000741225844736,0,0,0,1,1
988064759768633344,0,1,0,0,1
988177062337957888,0,1,0,0,1
988223608148373504,0,1,0,0,1
988438867291320320,0,1,0,0,1
988251034786054144,0,1,0,0,1
988256832547323904,0,1,0,0,1
988277286204932096,0,1,0,0,1
988290843109986304,0,1,0,0,1
988352999033581568,0,1,0,0,1
988362148647665664,0,1,0,0,1
988380837233266688,1,0,0,0,1
988397320030081024,0,1,0,0,1
988437442591150080,1,0,0,0,1
989601488476532736,0,1,0,0,1
989825777721008128,0,1,0,0,1
992315836072329216,0,1,0,0,1
991748028938809344,0,1,0,0,1
991376111312482304,0,1,0,0,1
991391499949690880,0,1,0,0,1
991569759811420160,1,0,0,0,1
991604170808594432,1,0,0,0,1
991614341257494528,0,1,0,0,1
991634761922830336,0,1,0,0,1
991637629555953664,0,1,0,0,1
991680897211658240,0,1,0,0,1
991741755463680000,0,1,0,0,1
991771824802422784,1,0,0,0,1
991285550995812352,0,1,0,0,1
991835559298351104,0,1,0,0,1
991925109383249920,0,1,0,0,1
991981774426255360,0,1,0,0,1
991985059417780224,0,1,0,0,1
992035954679566336,1,0,0,0,1
992147019673296896,1,0,0,0,1
992149270399725568,1,0,0,0,1
992179110821625856,1,0,0,0,1
992271672785842176,0,1,0,0,1
991306073083645952,1,0,0,0,1
991168424423325696,0,1,0,0,1
989836907294199808,0,1,0,0,1
990422937621745664,1,0,0,0,1
989875831815180288,0,1,0,0,1
989886471850127360,0,1,0,0,1
989889607167815680,0,1,0,0,1
989932181458956288,0,1,0,0,1
990090605463310336,1,0,0,0,1
990134989839847424,0,1,0,0,1
990141189973135360,0,0,0,1,1
990242146174332928,0,1,0,0,1
990288868825092096,0,1,0,0,1
990506570843815936,0,1,0,0,1
991159625360723968,0,1,0,0,1
990689997509545984,0,1,0,0,1
990699553178509312,0,1,0,0,1
990774304559304704,0,1,0,0,1
990965171765108736,1,0,0,0,1
990978595492384768,0,1,0,0,1
991013619285577728,0,1,0,0,1
991049534641000448,0,1,0,0,1
991060641480835072,0,1,0,0,1
991086799672954880,1,0,0,0,1
1098766215843962880,0,0,1,0,1
1098789571955838976,0,1,0,0,1
1098820178287177728,0,1,0,0,1
1191744058491670528,0,1,0,0,1
1189205962562785280,0,0,0,1,1
1189249672751308800,0,1,0,0,1
1189273902930776064,0,1,0,0,1
1189282027423649792,0,1,0,0,1
1189307291264311296,0,1,0,0,1
1189357687408074752,0,1,0,0,1
1189407300412497920,0,1,0,0,1
1189408558380650496,0,1,0,0,1
1189411668859768832,0,1,0,0,1
1189439461924491264,0,1,0,0,1
1189480506657689600,1,0,0,0,1
1189561961169731584,0,1,0,0,1
1189607897501749248,0,1,0,0,1
1189620996891766784,0,1,0,0,1
1189629550675800064,1,0,0,0,1
1189716780551458816,0,1,0,0,1
1189837083763982336,0,1,0,0,1
1189883479741349888,0,0,1,0,1
1189883768317845504,0,1,0,0,1
1189910045359689728,0,1,0,0,1
1189910189216022528,1,0,0,0,1
1188914965962473472,0,1,0,0,1
1188897635274514432,0,1,0,0,1
1188768950236205056,0,1,0,0,1
1187962569107148800,0,1,0,0,1
1187629048677195776,0,1,0,0,1
1187665028960473088,0,1,0,0,1
1187735824525398016,0,1,0,0,1
1187848639349231616,0,1,0,0,1
1187852117156851712,0,1,0,0,1
1187857185440698368,0,1,0,0,1
1187866525589475328,0,1,0,0,1
1187906295568982016,0,1,0,0,1
1187913676155584512,0,1,0,0,1
1188099746763886592,0,0,1,0,1
1188760096639029248,1,0,0,0,1
1188332497047871488,0,1,0,0,1
1188348328976801792,0,1,0,0,1
1188385097717825536,0,1,0,0,1
1188440348751732736,0,1,0,0,1
1188472036735291392,0,1,0,0,1
1188554121026117632,1,0,0,0,1
1188651251874979840,0,1,0,0,1
1188719300535820288,0,1,0,0,1
1188732070455103488,0,1,0,0,1
1189918620857573376,0,1,0,0,1
1189931570796224512,0,1,0,0,1
1189941067765952512,1,0,0,0,1
1191260228542779392,0,1,0,0,1
1190816829058568192,0,1,0,0,1
1190888649451331584,0,1,0,0,1
1190943546595053568,1,0,0,0,1
1191005843791241216,0,1,0,0,1
1191026259305943040,0,1,0,0,1
1191168809354375168,0,1,0,0,1
1191196766894514176,0,1,0,0,1
1191200270212055040,0,1,0,0,1
1191227004118396928,0,1,0,0,1
1191277079754608640,0,1,0,0,1
1190721875380494336,0,1,0,0,1
1191341559872184320,0,1,0,0,1
1191366389728206848,0,1,0,0,1
1191446278254628864,0,1,0,0,1
1191591627023716352,0,1,0,0,1
1191616510743240704,0,1,0,0,1
1191622150160961536,0,1,0,0,1
1191654904915472384,0,1,0,0,1
1191700430935470080,0,1,0,0,1
1191741645202571264,0,0,0,1,1
1190781570384306176,0,1,0,0,1
1190702753221423104,0,1,0,0,1
1189958302613901312,0,1,0,0,1
1190184746057375744,0,1,0,0,1
1189977459715907584,0,1,0,0,1
1189981634529054720,0,1,0,0,1
1190004511911362560,0,1,0,0,1
1190068810541387776,0,0,0,1,1
1190110626590461952,0,1,0,0,1
1190136842043064320,0,1,0,0,1
1190153698338574336,1,0,0,0,1
1190157848275144704,0,1,0,0,1
1190167426165424128,0,1,0,0,1
1190206924525989888,0,1,0,0,1
1190672773183500288,0,1,0,0,1
1190236805129371648,0,1,0,0,1
1190278092633395200,1,0,0,0,1
1190282861825417216,0,1,0,0,1
1190472780447223808,1,0,0,0,1
1190480280143843328,1,0,0,0,1
1190578167498579968,0,1,0,0,1
1190630531894898688,1,0,0,0,1
1190659435603083264,0,1,0,0,1
1190667476377325568,0,1,0,0,1
1187598912867061760,0,0,1,0,1
1187489331793092608,0,0,0,1,1
1187302554696159232,0,1,0,0,1
1185344409111425024,0,1,0,0,1
1185037699423490048,0,1,0,0,1
1185046630690689024,0,1,0,0,1
1185069634434691072,0,0,0,1,1
1185104972116938752,0,1,0,0,1
1185118175333011456,0,1,0,0,1
1185120184413184000,0,1,0,0,1
1185190526640898048,0,1,0,0,1
1185214996344496128,0,1,0,0,1
1185297311561334784,0,1,0,0,1
1185375667073892352,0,1,0,0,1
1185005725476634624,0,1,0,0,1
1185386921247141888,0,1,0,0,1
1185486400461967360,0,1,0,0,1
1185527253553299456,0,1,0,0,1
1185531560302448640,0,1,0,0,1
1185572365977214976,0,1,0,0,1
1185588511983984640,0,1,0,0,1
1185596772049129472,0,1,0,0,1
1185634037391675392,1,0,0,0,1
1185752812321476608,0,1,0,0,1
1185015990859362304,0,1,0,0,1
1184950038478360576,0,1,0,0,1
1185824067800260608,0,1,0,0,1
1184298622910980096,0,0,0,1,1
1184062530567704576,0,1,0,0,1
1184126855055642624,0,1,0,0,1
1184144724900405248,1,0,0,0,1
1184160093354549248,0,0,1,0,1
1184161584261877760,0,1,0,0,1
1184185035458564096,0,1,0,0,1
1184202346227744768,0,1,0,0,1
1184228587995574272,0,1,0,0,1
1184290591816990720,1,0,0,0,1
1184339117594808320,0,1,0,0,1
1184820286899683328,1,0,0,0,1
1184356460479864832,0,1,0,0,1
1184373169848803328,1,0,0,0,1
1184391134895919104,0,0,0,1,1
1184399851473326080,0,1,0,0,1
1184404353215619072,0,1,0,0,1
1184675856419086336,1,0,0,0,1
1184697834332753920,0,1,0,0,1
1184767857437171712,1,0,0,0,1
1184770887029002240,0,1,0,0,1
1185795248716255232,0,1,0,0,1
1185833684668039168,0,1,0,0,1
1187173258476638208,0,1,0,0,1
1186883549565276160,1,0,0,0,1
1186492227784069120,0,1,0,0,1
1186506819088203776,0,1,0,0,1
1186562920261570560,0,1,0,0,1
1186566157983047680,0,1,0,0,1
1186569539615543296,0,1,0,0,1
1186584652523462656,1,0,0,0,1
1186677602573942784,0,1,0,0,1
1186722378350563328,1,0,0,0,1
1186861311512043520,1,0,0,0,1
1186901067591815168,0,1,0,0,1
1186406615676678144,0,1,0,0,1
1186911791470780416,0,1,0,0,1
1186912867179741184,0,1,0,0,1
1186939380667052032,0,1,0,0,1
1186943907306692608,0,1,0,0,1
1186947378160570368,0,1,0,0,1
1186973849964822528,0,1,0,0,1
1187006731034996736,0,1,0,0,1
1187027027637014528,0,1,0,0,1
1187115574951694336,0,1,0,0,1
1186460018905882624,0,1,0,0,1
1186385273401303040,0,0,1,0,1
1185841869659361280,1,0,0,0,1
1185965343052746752,0,1,0,0,1
1185855251569696768,0,1,0,0,1
1185867434999156736,0,0,1,0,1
1185875582489260032,0,1,0,0,1
1185888216181694464,0,1,0,0,1
1185897722311692288,0,1,0,0,1
1185901821463793664,0,1,0,0,1
1185907494327066624,0,1,0,0,1
1185915226673373184,0,1,0,0,1
1185948033709694976,0,1,0,0,1
1186000374357839872,0,1,0,0,1
1186365604497969152,0,0,1,0,1
1186068108949315584,0,1,0,0,1
1186078374642507776,0,1,0,0,1
1186094623313121280,0,1,0,0,1
1186115510565519360,0,1,0,0,1
1186152221295046656,0,1,0,0,1
1186201411807301632,0,0,0,1,1
1186250901318709248,0,1,0,0,1
1186266693703741440,0,1,0,0,1
1186276854661111808,0,1,0,0,1
1191743730665033728,0,1,0,0,1
1191791292054818816,1,0,0,0,1
1199777816578949120,1,0,0,0,1
1191791684142673920,1,0,0,0,1
1196402456650866688,0,1,0,0,1
1196431602873753600,0,1,0,0,1
1196431696549285888,0,1,0,0,1
1196456020010078208,0,1,0,0,1
1196502338443202560,1,0,0,0,1
1196574672130912256,0,1,0,0,1
1196650383533363200,0,1,0,0,1
1196694110649778176,1,0,0,0,1
1196719447353905152,0,1,0,0,1
1196751662100176896,1,0,0,0,1
1196879730877747200,0,1,0,0,1
1196891990736035840,0,1,0,0,1
1196975783920599040,1,0,0,0,1
1197054658247897088,0,1,0,0,1
1197068490601054208,0,1,0,0,1
1197149811780259840,1,0,0,0,1
1197149926116880384,0,1,0,0,1
1197152177762054144,0,1,0,0,1
1197152814109057024,0,1,0,0,1
1197472341187391488,0,1,0,0,1
1197597441698058240,0,1,0,0,1
1196380735155904512,0,1,0,0,1
1196377881833877504,1,0,0,0,1
1196324051494391808,1,0,0,0,1
1195832745911435264,1,0,0,0,1
1195193053453176832,0,1,0,0,1
1195202842673311744,0,0,0,1,1
1195279957045514240,0,1,0,0,1
1195456647738429440,0,1,0,0,1
1195499594689470464,0,1,0,0,1
1195548081724379136,1,0,0,0,1
1195646310562484224,0,1,0,0,1
1195685200262574080,0,1,0,0,1
1195809117790756864,0,1,0,0,1
1195881222787874816,0,1,0,0,1
1196184277400117248,0,0,0,1,1
1195945754285621248,1,0,0,0,1
1196007296419028992,0,1,0,0,1
1196012702222520320,1,0,0,0,1
1196053993761464320,0,1,0,0,1
1196072123304947712,0,0,1,0,1
1196076990224224256,0,1,0,0,1
1196163796399722496,0,1,0,0,1
1196165731538223104,0,1,0,0,1
1196176900777029632,0,1,0,0,1
1197607137184227328,0,1,0,0,1
1197667017639284736,0,1,0,0,1
1197741152570490880,0,1,0,0,1
1199141268963708928,0,0,1,0,1
1198884875484434432,0,1,0,0,1
1198922167318122496,0,1,0,0,1
1198995869305069568,0,1,0,0,1
1199022717330018304,0,1,0,0,1
1199070288010514432,0,1,0,0,1
1199070896121618432,0,1,0,0,1
1199124078508019712,0,1,0,0,1
1199131859650637824,0,1,0,0,1
1199138773348605952,0,0,1,0,1
1199191479094304768,0,1,0,0,1
1198761477466968064,0,1,0,0,1
1199227475282317312,0,1,0,0,1
1199287199625285632,1,0,0,0,1
1199289579825717248,1,0,0,0,1
1199359939115798528,1,0,0,0,1
1199409343034056704,1,0,0,0,1
1199568588471984128,0,0,0,1,1
1199682384658128896,0,1,0,0,1
1199764552239345664,0,1,0,0,1
1199765945276780544,0,1,0,0,1
1198840050257158144,0,1,0,0,1
1198689100905140224,0,1,0,0,1
1197777689375117312,0,1,0,0,1
1198302784170409984,0,1,0,0,1
1197927286240137216,0,1,0,0,1
1197931393767985152,0,0,0,1,1
1198017422009290752,0,1,0,0,1
1198051446148628480,0,1,0,0,1
1198154652065370112,0,1,0,0,1
1198173368748560384,0,1,0,0,1
1198182050106396672,1,0,0,0,1
1198182791957102592,0,1,0,0,1
1198226627362246656,0,1,0,0,1
1198332278679592960,1,0,0,0,1
1198682038192279552,0,1,0,0,1
1198355954678616064,0,1,0,0,1
1198378251737030656,0,1,0,0,1
1198510648004694016,0,1,0,0,1
1198532825705852928,1,0,0,0,1
1198581600629350400,0,1,0,0,1
1198594114008293376,0,1,0,0,1
1198646259789131776,0,1,0,0,1
1198660289106853888,1,0,0,0,1
1198681032494596096,0,1,0,0,1
1195183058216898560,0,1,0,0,1
1194999227694419968,0,1,0,0,1
1194991599647891456,0,1,0,0,1
1192882207817289728,1,0,0,0,1
1192649981552996352,0,1,0,0,1
1192754616049504256,0,1,0,0,1
1192774883077283840,0,1,0,0,1
1192780801932443648,0,1,0,0,1
1192816699227148288,0,1,0,0,1
1192835064997924864,0,1,0,0,1
1192846338234470400,0,1,0,0,1
1192855800575930368,0,1,0,0,1
1192856311081271296,0,1,0,0,1
1192883958280667136,0,1,0,0,1
1192535294794293248,0,1,0,0,1
1192889882877796352,0,1,0,0,1
1192912904087113728,0,1,0,0,1
1192913597518753792,0,1,0,0,1
1193036503229714432,0,1,0,0,1
1193066731352268800,1,0,0,0,1
1193096648332701696,1,0,0,0,1
1193117624659513344,0,1,0,0,1
1193175446734725120,1,0,0,0,1
1193205738115608576,0,1,0,0,1
1192580227735654400,0,1,0,0,1
1192533462294683648,0,1,0,0,1
1193432052626022400,0,1,0,0,1
1192165555354185728,0,0,0,1,1
1191840852487888896,0,1,0,0,1
1191875791837179904,0,1,0,0,1
1191940179159928832,0,1,0,0,1
1192082842819280896,0,1,0,0,1
1192093010798010368,0,1,0,0,1
1192103658705608704,0,1,0,0,1
1192110229762105344,0,1,0,0,1
1192114310660657152,0,1,0,0,1
1192122446327009280,1,0,0,0,1
1192171064002064384,0,1,0,0,1
1192522886797545472,0,1,0,0,1
1192279293654487040,0,1,0,0,1
1192309616346062848,0,1,0,0,1
1192324309051674624,0,1,0,0,1
1192331783448268800,1,0,0,0,1
1192343650887520256,0,1,0,0,1
1192367736464101376,0,1,0,0,1
1192391196171292672,0,1,0,0,1
1192441921110790144,1,0,0,0,1
1192507893179772928,1,0,0,0,1
1193419532628627456,1,0,0,0,1
1193568089272672256,0,1,0,0,1
1194925963961700352,0,1,0,0,1
1194519558981378048,0,1,0,0,1
1194252576818188288,0,1,0,0,1
1194253725822603264,0,1,0,0,1
1194298848035921920,0,0,0,1,1
1194332433686106112,0,0,0,1,1
1194348852326875136,0,1,0,0,1
1194414159661846528,0,1,0,0,1
1194426153156505600,0,0,1,0,1
1194479947936620544,0,1,0,0,1
1194486128033878016,0,1,0,0,1
1194524537125142528,1,0,0,0,1
1194205971784065024,0,1,0,0,1
1194539361536266240,0,1,0,0,1
1194573436183613440,0,1,0,0,1
1194693252479213568,0,1,0,0,1
1194720234017558528,0,1,0,0,1
1194844167236718592,0,1,0,0,1
1194850475839049728,0,1,0,0,1
1194871161139544064,1,0,0,0,1
1194872811900280832,0,1,0,0,1
1194902057230069760,0,1,0,0,1
1194229339409309696,0,1,0,0,1
1194142449310011392,0,1,0,0,1
1193580958794100736,0,1,0,0,1
1193862365701427200,1,0,0,0,1
1193632287683940352,0,1,0,0,1
1193645670231629824,0,1,0,0,1
1193710602453045248,0,1,0,0,1
1193720151918727168,0,1,0,0,1
1193724579568443392,0,1,0,0,1
1193734104212287488,0,1,0,0,1
1193735879472189440,0,1,0,0,1
1193792889056313344,0,1,0,0,1
1193793959778308096,0,1,0,0,1
1193910939898109952,1,0,0,0,1
1194081888752652288,1,0,0,0,1
1193929980952100864,0,0,1,0,1
1193972548263788544,0,0,0,1,1
1193997693904809984,0,1,0,0,1
1193999351284162560,0,1,0,0,1
1194015692808437760,0,1,0,0,1
1194030818961870848,0,1,0,0,1
1194058022164803584,0,1,0,0,1
1194071077355491328,1,0,0,0,1
1194073176273309696,1,0,0,0,1
1184039267154067456,0,1,0,0,1
1183923615152164864,0,1,0,0,1
1183802928487981056,0,1,0,0,1
1183774736947400704,1,0,0,0,1
1173259934412107776,0,1,0,0,1
1173340855459110912,0,1,0,0,1
1173364504370921472,0,1,0,0,1
1173394094317436928,0,1,0,0,1
1173456980922400768,0,0,1,0,1
1173457732579418112,0,1,0,0,1
1173483296598175744,0,1,0,0,1
1173501470345445376,0,1,0,0,1
1173565674402328576,0,1,0,0,1
1173584413298515968,0,1,0,0,1
1173592103059951616,0,0,0,1,1
1173619794366685184,0,1,0,0,1
1173641431585570816,1,0,0,0,1
1173669284582711296,0,1,0,0,1
1173698293332881408,0,1,0,0,1
1173771421186527232,0,1,0,0,1
1173776127296507904,0,1,0,0,1
1173904786971930624,0,0,0,1,1
1173927625355608064,0,1,0,0,1
1173951987764908032,0,1,0,0,1
1174026369036169216,0,1,0,0,1
1173206348923842560,0,1,0,0,1
1173159511697215488,0,1,0,0,1
1173150331892637696,0,1,0,0,1
1172787373551357952,0,1,0,0,1
1172397632284545024,0,1,0,0,1
1172449280063238144,0,0,0,1,1
1172517449494929408,0,1,0,0,1
1172599974158315520,0,1,0,0,1
1172652616863629312,0,1,0,0,1
1172659186372620288,0,1,0,0,1
1172682640673202176,0,1,0,0,1
1172685184392675328,0,0,0,1,1
1172698502519869440,1,0,0,0,1
1172797622014357504,1,0,0,0,1
1173141722924224512,0,1,0,0,1
1172800545788055552,0,1,0,0,1
1172807467098681344,0,1,0,0,1
1172869645273116672,0,0,1,0,1
1172895267332358144,0,1,0,0,1
1172900353228062720,0,1,0,0,1
1172952130652557312,0,1,0,0,1
1172958941623595008,1,0,0,0,1
1173063237501239296,0,1,0,0,1
1173084702535606272,0,1,0,0,1
1174212314670743552,0,1,0,0,1
1174244593178697728,0,1,0,0,1
1174246228281954304,0,1,0,0,1
1175669992106450944,0,1,0,0,1
1175436367746093056,1,0,0,0,1
1175462008583577600,1,0,0,0,1
1175463633112854528,1,0,0,0,1
1175489837362831360,0,1,0,0,1
1175557456644247552,0,1,0,0,1
1175575790424997888,0,1,0,0,1
1175600244287049728,0,1,0,0,1
1175643323085795328,0,0,0,1,1
1175649954351763456,0,1,0,0,1
1175736939938344960,0,1,0,0,1
1175373969643323392,0,1,0,0,1
1175752175164809216,1,0,0,0,1
1175761915240488960,0,1,0,0,1
1175809297311092736,0,1,0,0,1
1175821298204692480,0,1,0,0,1
1175849486524063744,0,1,0,0,1
1175897186296401920,0,1,0,0,1
1175911390307135488,0,1,0,0,1
1175989319267487744,1,0,0,0,1
1176048154774507520,0,1,0,0,1
1175406686804332544,0,1,0,0,1
1175342365944569856,0,1,0,0,1
1174251279226478592,0,1,0,0,1
1174684377126703104,0,1,0,0,1
1174271281736429568,0,1,0,0,1
1174273891306496000,0,1,0,0,1
1174276448481361920,0,1,0,0,1
1174293059435151360,0,1,0,0,1
1174409669453869056,0,1,0,0,1
1174449215306682368,1,0,0,0,1
1174618675464364032,0,0,0,1,1
1174641884314165248,0,0,0,1,1
1174643411711868928,0,1,0,0,1
1174696246419832832,0,1,0,0,1
1175333925335588864,0,1,0,0,1
1174760381581078528,1,0,0,0,1
1174866942592782336,0,1,0,0,1
1174889637212512256,0,1,0,0,1
1174922753566101504,0,1,0,0,1
1174961287261876224,0,1,0,0,1
1174984858688479232,0,1,0,0,1
1175013261219155968,0,1,0,0,1
1175034890892533760,1,0,0,0,1
1175228785656029184,0,1,0,0,1
1172344157207191552,0,1,0,0,1
1172247617386029056,0,1,0,0,1
1172174882760736768,0,0,1,0,1
1170077856589897728,0,1,0,0,1
1169621582182064128,0,1,0,0,1
1169696790402207744,0,1,0,0,1
1169810915644116992,0,1,0,0,1
1169913610359005184,0,1,0,0,1
1169923671521136640,0,1,0,0,1
1169924558205288448,0,1,0,0,1
1169940083975307264,0,1,0,0,1
1170009000710197248,0,1,0,0,1
1170012125491863552,1,0,0,0,1
1170081565923147776,1,0,0,0,1
1169565800774197248,0,1,0,0,1
1170100566296367104,0,1,0,0,1
1170122994888429568,0,1,0,0,1
1170159399697969152,0,0,1,0,1
1170190811876581376,1,0,0,0,1
1170194771190661120,0,1,0,0,1
1170224088872357888,1,0,0,0,1
1170232036113567744,0,0,1,0,1
1170311470674063360,1,0,0,0,1
1170335965271011328,0,1,0,0,1
1169589077357867008,0,1,0,0,1
1169557962760839168,0,1,0,0,1
1170462349393838080,0,1,0,0,1
1169158328481542144,1,0,0,0,1
1168836651348611072,1,0,0,0,1
1168870973031895040,0,1,0,0,1
1168914461434044416,0,1,0,0,1
1168974387468480512,0,1,0,0,1
1168982449667416064,0,1,0,0,1
1169007447190757376,0,1,0,0,1
1169087339659849728,0,1,0,0,1
1169149772374192128,0,1,0,0,1
1169156578324504576,0,1,0,0,1
1169162026838626304,0,1,0,0,1
1169516544898084864,0,1,0,0,1
1169166931133435904,0,1,0,0,1
1169171438151954432,0,1,0,0,1
1169174599885611008,0,1,0,0,1
1169188232753483776,1,0,0,0,1
1169208348828475392,0,1,0,0,1
1169284104136855552,0,1,0,0,1
1169311144810561536,0,1,0,0,1
1169501641206390784,0,1,0,0,1
1169515723791618048,0,1,0,0,1
1170444152074584064,0,1,0,0,1
1170531134112858112,0,1,0,0,1
1172163891557806080,0,1,0,0,1
1171768915787038720,0,1,0,0,1
1171328336364285952,0,1,0,0,1
1171329892547473408,0,1,0,0,1
1171374805666414592,0,1,0,0,1
1171383266810744832,0,1,0,0,1
1171439089481994240,0,0,1,0,1
1171443072753909760,0,1,0,0,1
1171706265447198720,1,0,0,0,1
1171760284605779968,0,1,0,0,1
1171768395886235648,1,0,0,0,1
1171774748373737472,1,0,0,0,1
1171309322627952640,0,0,0,1,1
1171875044630380544,0,1,0,0,1
1171887029862273024,0,0,1,0,1
1171965974360150016,0,1,0,0,1
1171970504011304960,0,1,0,0,1
1171996796895289344,0,1,0,0,1
1172026770062753792,0,1,0,0,1
1172038723015512064,1,0,0,0,1
1172073897258340352,1,0,0,0,1
1172095796965203968,0,1,0,0,1
1171318874102517760,0,1,0,0,1
1171296752156073984,0,0,0,1,1
1170567121471860736,1,0,0,0,1
1170940643671203840,0,0,0,1,1
1170567655641640960,0,1,0,0,1
1170579320244510720,0,1,0,0,1
1170587479214153728,0,1,0,0,1
1170640655867097088,0,1,0,0,1
1170658708050862080,1,0,0,0,1
1170672407570370560,1,0,0,0,1
1170761029430763520,0,1,0,0,1
1170813388064206848,0,1,0,0,1
1170896244484407296,0,0,0,1,1
1170947237897277440,1,0,0,0,1
1171242009023123456,1,0,0,0,1
1170955363706970112,0,1,0,0,1
1171065809801756672,0,1,0,0,1
1171080325394509824,1,0,0,0,1
1171095411307753472,0,1,0,0,1
1171136795595010048,1,0,0,0,1
1171152274518892544,0,1,0,0,1
1171191348583686144,0,1,0,0,1
1171195087742808064,0,1,0,0,1
1171232012306456576,1,0,0,0,1
1176069935866552320,0,1,0,0,1
1176070363605864448,0,1,0,0,1
1176091166514790400,1,0,0,0,1
1181777132797620224,0,0,0,1,1
1181451148370354176,0,1,0,0,1
1181451851046240256,0,0,1,0,1
1181477900463333376,0,1,0,0,1
1181480361273880576,0,1,0,0,1
1181502396356317184,0,1,0,0,1
1181544490273853440,0,1,0,0,1
1181614732383571968,0,1,0,0,1
1181629367870525440,0,1,0,0,1
1181720851244294144,0,1,0,0,1
1181839056319025152,1,0,0,0,1
1181348607938699264,0,1,0,0,1
1181934781220696064,1,0,0,0,1
1181962704518553600,0,1,0,0,1
1181964499160424448,0,1,0,0,1
1182045285389934592,1,0,0,0,1
1182051658714505216,0,0,0,1,1
1182079422255398912,0,1,0,0,1
1182107665364852736,0,1,0,0,1
1182145607416209408,0,1,0,0,1
1182166740408700928,0,1,0,0,1
1181448699894882304,1,0,0,0,1
1181345824053301248,0,1,0,0,1
1182196450966425600,1,0,0,0,1
1180701045967732736,0,1,0,0,1
1180063250442080256,0,1,0,0,1
1180101269698031616,0,1,0,0,1
1180151439957647360,0,1,0,0,1
1180407034853953536,1,0,0,0,1
1180560518047764480,0,1,0,0,1
1180583837316911104,1,0,0,0,1
1180626639979450368,0,1,0,0,1
1180666133415743488,0,0,1,0,1
1180685858992578560,0,1,0,0,1
1180753985499811840,0,1,0,0,1
1181271719442386944,1,0,0,0,1
1180806306845708288,1,0,0,0,1
1180882767678066688,1,0,0,0,1
1180897029221957632,0,1,0,0,1
1180923338950135808,0,1,0,0,1
1180991940042661888,0,1,0,0,1
1181089614859079680,0,0,1,0,1
1181121129412546560,0,0,1,0,1
1181204047363100672,0,1,0,0,1
1181208286504390656,0,1,0,0,1
1182192719118176256,0,1,0,0,1
1182204458203324416,0,1,0,0,1
1180029898804482048,1,0,0,0,1
1183454677825925120,0,1,0,0,1
1183075777669189632,0,1,0,0,1
1183101195230924800,1,0,0,0,1
1183110078896803840,1,0,0,0,1
1183225486081757184,0,1,0,0,1
1183299180762001408,0,1,0,0,1
1183304596778733568,0,1,0,0,1
1183323823778738176,0,1,0,0,1
1183383590136090624,0,1,0,0,1
1183421073003601920,0,1,0,0,1
1183460109382537216,0,1,0,0,1
1183013653173473280,0,1,0,0,1
1183460340903956480,1,0,0,0,1
1183464777202524160,0,1,0,0,1
1183541822095876096,0,1,0,0,1
1183553943625981952,0,1,0,0,1
1183583965120204800,0,1,0,0,1
1183613797434564608,1,0,0,0,1
1183645169230503936,1,0,0,0,1
1183651050231861248,1,0,0,0,1
1183698060968366080,0,1,0,0,1
1183062639875907584,0,1,0,0,1
1182983801313456128,0,0,1,0,1
1182319323102269440,0,1,0,0,1
1182645209684959232,0,1,0,0,1
1182326716418707456,0,1,0,0,1
1182343562232520704,0,1,0,0,1
1182355748359155712,0,1,0,0,1
1182468827889561600,0,1,0,0,1
1182471723708534784,0,0,0,1,1
1182559082248433664,1,0,0,0,1
1182567714700906496,0,1,0,0,1
1182569704684175360,0,1,0,0,1
1182634291408392192,1,0,0,0,1
1182687179409186816,0,1,0,0,1
1182872259016429568,0,1,0,0,1
1182702636488888320,0,0,1,0,1
1182705860063252480,0,1,0,0,1
1182715257824993280,0,1,0,0,1
1182722588025544704,0,1,0,0,1
1182726116303429632,0,1,0,0,1
1182785200851435520,0,1,0,0,1
1182791550511833088,0,1,0,0,1
1182807428234203136,0,1,0,0,1
1182859332289024000,0,1,0,0,1
1180030945795067904,0,1,0,0,1
1179960921277509632,1,0,0,0,1
1176174524544499712,0,1,0,0,1
1177616895123578880,0,1,0,0,1
1177209271878111232,0,1,0,0,1
1177213239379152896,0,1,0,0,1
1177237108152365056,1,0,0,0,1
1177271454431371264,0,1,0,0,1
1177291323059113984,1,0,0,0,1
1177292998524186624,0,1,0,0,1
1177341509261123584,1,0,0,0,1
1177354346956300288,0,1,0,0,1
1177429122680852480,0,1,0,0,1
1177621836034695168,0,1,0,0,1
1177193797312233472,0,1,0,0,1
1177633417522892800,0,1,0,0,1
1177645709409099776,0,1,0,0,1
1177687863988822016,0,1,0,0,1
1177791992308408320,0,1,0,0,1
1177840447085010944,1,0,0,0,1
1177861736269074432,1,0,0,0,1
1177870922335870976,0,1,0,0,1
1177919328995422208,0,1,0,0,1
1177953067494281216,0,1,0,0,1
1177206240612638720,0,1,0,0,1
1177147136107958272,0,1,0,0,1
1178004405452279808,0,1,0,0,1
1176487544545935360,1,0,0,0,1
1176196834672427008,0,1,0,0,1
1176209234842853376,1,0,0,0,1
1176255237805486080,0,1,0,0,1
1176270219867643904,0,1,0,0,1
1176282984783257600,1,0,0,0,1
1176283973791682560,0,1,0,0,1
1176301237266001920,1,0,0,0,1
1176440066719092736,0,1,0,0,1
1176444599306465280,0,1,0,0,1
1176491100405583872,0,1,0,0,1
1177129657268723712,1,0,0,0,1
1176564601862807552,0,1,0,0,1
1176638142121750528,0,1,0,0,1
1176707232844660736,1,0,0,0,1
1176732436035788800,0,1,0,0,1
1176819017547505664,0,1,0,0,1
1177055755666460672,1,0,0,0,1
1177060776265170944,0,1,0,0,1
1177121017518407680,1,0,0,0,1
1177124136801300480,0,1,0,0,1
1177989768220741632,0,1,0,0,1
1178016470476959744,0,1,0,0,1
1179948486197989376,0,1,0,0,1
1179177611563618304,1,0,0,0,1
1178828007521374208,0,1,0,0,1
1178940559072776192,1,0,0,0,1
1178963083038998528,0,1,0,0,1
1178964959872598016,0,0,1,0,1
1179019283071979520,0,1,0,0,1
1179030579263807488,0,1,0,0,1
1179090983436181504,0,1,0,0,1
1179114663482576896,0,1,0,0,1
1179163697262088192,1,0,0,0,1
1179200465550086144,0,1,0,0,1
1178769530031460352,0,1,0,0,1
1179233423573041152,0,1,0,0,1
1179274006001782784,0,1,0,0,1
1179320219036258304,0,1,0,0,1
1179403128388476928,0,1,0,0,1
1179470850006761472,0,1,0,0,1
1179605658737377280,0,1,0,0,1
1179611709658533888,0,1,0,0,1
1179783395104174080,0,1,0,0,1
1179879303623905280,0,1,0,0,1
1178786218416361472,0,1,0,0,1
1178764594363486208,0,1,0,0,1
1178022762411184128,0,1,0,0,1
1178327030842187776,0,1,0,0,1
1178051592261644288,0,1,0,0,1
1178063282508324864,0,1,0,0,1
1178129069805834240,1,0,0,0,1
1178213122362023936,0,1,0,0,1
1178234666735697920,1,0,0,0,1
1178239491934306304,0,1,0,0,1
1178239711388868608,1,0,0,0,1
1178279939088556032,0,1,0,0,1
1178298262073118720,0,1,0,0,1
1178378292321144832,0,1,0,0,1
1178745627158749184,0,1,0,0,1
1178435687634239488,0,0,0,1,1
1178462875792207872,0,1,0,0,1
1178562376645431296,0,1,0,0,1
1178567554396065792,0,1,0,0,1
1178572321247748096,0,1,0,0,1
1178585764667514880,0,1,0,0,1
1178592181378002944,0,1,0,0,1
1178595336316755968,0,1,0,0,1
1178725123555090432,0,1,0,0,1
1199774949067677696,0,1,0,0,1
1199795378398347264,0,1,0,0,1
1168796389746200576,0,1,0,0,1
1219625215346401280,0,1,0,0,1
1216280958900543488,0,1,0,0,1
1216296984828612608,0,1,0,0,1
1216312057676681216,0,1,0,0,1
1216316271639191552,0,1,0,0,1
1216365294110666752,0,1,0,0,1
1216425569614794752,0,1,0,0,1
1216444001290768384,0,1,0,0,1
1216653005057069056,0,1,0,0,1
1216665300319588352,0,1,0,0,1
1216674445793746944,0,1,0,0,1
1216691811474952192,0,0,0,1,1
1216697728018866176,0,1,0,0,1
1216698296078495744,1,0,0,0,1
1216718207773544448,0,1,0,0,1
1216723608657002496,1,0,0,0,1
1216750123822256128,0,1,0,0,1
1216859852447932416,1,0,0,0,1
1216889055645982720,0,0,1,0,1
1216915070539698176,0,1,0,0,1
1216968801628999680,0,1,0,0,1
1216987661593825280,0,1,0,0,1
1216222555385868288,0,1,0,0,1
1216213514748035072,0,1,0,0,1
1216211202163920896,0,1,0,0,1
1215737162408308736,0,1,0,0,1
1215589198721429504,1,0,0,0,1
1215589218996629504,0,1,0,0,1
1215602290763206656,0,1,0,0,1
1215606067830255616,0,1,0,0,1
1215680090648072192,1,0,0,0,1
1215688201378992128,1,0,0,0,1
1215692429908680704,0,1,0,0,1
1215694936160587776,0,1,0,0,1
1215727954107469824,0,1,0,0,1
1215915537986936832,0,1,0,0,1
1216201192834920448,0,1,0,0,1
1215928355712880640,0,1,0,0,1
1215941572614815744,0,1,0,0,1
1215943234935017472,0,0,0,1,1
1215943631112003584,1,0,0,0,1
1215971054537117696,1,0,0,0,1
1216054330131746816,1,0,0,0,1
1216114503965913088,0,1,0,0,1
1216191095857532928,0,1,0,0,1
1216198298064822272,0,1,0,0,1
1217179997804224512,0,1,0,0,1
1217282175852257280,0,1,0,0,1
1217494433261735936,0,1,0,0,1
1218962147431964672,0,1,0,0,1
1218645028383395840,0,0,0,1,1
1218654165351763968,0,1,0,0,1
1218694593916612608,0,1,0,0,1
1218748641931747328,0,1,0,0,1
1218795407465205760,0,1,0,0,1
1218814127537258496,0,1,0,0,1
1218833234219425792,0,1,0,0,1
1218886743920791552,0,1,0,0,1
1218890262962982912,1,0,0,0,1
1218979986620801024,0,1,0,0,1
1218604977763094528,1,0,0,0,1
1219122979008696320,0,1,0,0,1
1219149939327897600,1,0,0,0,1
1219158197535035392,0,1,0,0,1
1219206456484028416,0,1,0,0,1
1219236196158791680,0,1,0,0,1
1219303621042548736,0,0,0,1,1
1219348315843842048,0,1,0,0,1
1219419324361789440,0,1,0,0,1
1219523080437084160,0,1,0,0,1
1218627992890609664,0,1,0,0,1
1218535432415215616,0,1,0,0,1
1217531924840878080,0,1,0,0,1
1217861957526736896,1,0,0,0,1
1217562485005438976,0,1,0,0,1
1217649062368833536,0,1,0,0,1
1217652824286195712,1,0,0,0,1
1217690829692772352,0,1,0,0,1
1217757238535892992,0,1,0,0,1
1217780578302513152,1,0,0,0,1
1217789317571137536,1,0,0,0,1
1217798986234580992,0,1,0,0,1
1217829498160402432,0,1,0,0,1
1217894560367546368,0,1,0,0,1
1218524020519256064,0,1,0,0,1
1218154056939642880,0,1,0,0,1
1218223529013010432,0,1,0,0,1
1218251481188589568,0,1,0,0,1
1218275669970386944,0,1,0,0,1
1218296602357460992,1,0,0,0,1
1218387191526617088,0,1,0,0,1
1218438430620819456,0,1,0,0,1
1218497573922705408,0,1,0,0,1
1218515721891667968,1,0,0,0,1
1215544590746443776,0,1,0,0,1
1215542038189563904,0,1,0,0,1
1215541273907597312,0,1,0,0,1
1213973628653465600,0,1,0,0,1
1213838536052338688,0,1,0,0,1
1213871291532337152,0,1,0,0,1
1213872952657100800,0,1,0,0,1
1213881673470726144,1,0,0,0,1
1213885926159446016,0,1,0,0,1
1213933116454129664,1,0,0,0,1
1213939658905620480,0,1,0,0,1
1213954715660083200,1,0,0,0,1
1213963545836056576,0,1,0,0,1
1214001560985817088,1,0,0,0,1
1213824354045186048,0,1,0,0,1
1214002516150501376,0,1,0,0,1
1214005209208258560,1,0,0,0,1
1214056761264496640,1,0,0,0,1
1214085199916437504,0,1,0,0,1
1214134731081543680,0,0,1,0,1
1214164361385635840,0,1,0,0,1
1214165847389786112,0,1,0,0,1
1214193819710713856,0,1,0,0,1
1214226979915882496,0,1,0,0,1
1213836192472432640,0,1,0,0,1
1213788044282646528,0,1,0,0,1
1214359223049609216,0,1,0,0,1
1213526988280885248,0,1,0,0,1
1213272658952912896,0,0,1,0,1
1213286421101854720,0,1,0,0,1
1213361717842825216,0,1,0,0,1
1213363698594545664,0,1,0,0,1
1213463054823780352,0,1,0,0,1
1213469887424675840,0,1,0,0,1
1213480469880164352,0,1,0,0,1
1213490326905610240,0,1,0,0,1
1213524298872184832,0,1,0,0,1
1213530845392207872,0,1,0,0,1
1213783004595683328,0,1,0,0,1
1213605874876342272,0,1,0,0,1
1213627941650714624,0,1,0,0,1
1213644206255656960,1,0,0,0,1
1213657161328283648,0,1,0,0,1
1213685038128087040,0,1,0,0,1
1213700054474616832,0,1,0,0,1
1213741322034565120,0,0,1,0,1
1213774967554199552,0,1,0,0,1
1213781429479301120,0,1,0,0,1
1214271163150430208,0,0,0,1,1
1214436624051904512,0,1,0,0,1
1215509026995236864,0,1,0,0,1
1215278989071175680,0,1,0,0,1
1215152153209294848,1,0,0,0,1
1215171176902709248,0,1,0,0,1
1215202087958564864,0,1,0,0,1
1215208093593866240,0,1,0,0,1
1215226527723524096,0,1,0,0,1
1215234655034789888,0,1,0,0,1
1215248465850257408,0,1,0,0,1
1215264191797506048,0,1,0,0,1
1215268209231892480,0,1,0,0,1
1215282450076663808,0,1,0,0,1
1215074968217645056,1,0,0,0,1
1215305146952904704,0,1,0,0,1
1215311723005169664,0,1,0,0,1
1215321347888427008,1,0,0,0,1
1215322716997398528,1,0,0,0,1
1215328345400975360,0,1,0,0,1
1215393877210943488,1,0,0,0,1
1215401231801376768,1,0,0,0,1
1215411457548070912,0,1,0,0,1
1215505100682059776,0,1,0,0,1
1215096448024563712,0,1,0,0,1
1215069187607027712,0,1,0,0,1
1214458062620282880,0,1,0,0,1
1214697743374880768,1,0,0,0,1
1214468160272756736,1,0,0,0,1
1214496293000765440,0,1,0,0,1
1214516447625351168,0,1,0,0,1
1214553735721959424,0,1,0,0,1
1214571921393639424,0,1,0,0,1
1214576051851915264,0,1,0,0,1
1214638449371811840,0,1,0,0,1
1214649625904373760,0,0,1,0,1
1214673689792393216,0,1,0,0,1
1214708596606459904,0,0,1,0,1
1215040594873126912,0,1,0,0,1
1214757709339189248,1,0,0,0,1
1214793628213641216,0,1,0,0,1
1214861916339720192,0,1,0,0,1
1214868063612555264,0,1,0,0,1
1214906336032514048,0,1,0,0,1
1214942645614723072,0,1,0,0,1
1214969956229664768,0,1,0,0,1
1214982267065552896,0,1,0,0,1
1214996786378674176,0,1,0,0,1
1219548999205539840,0,1,0,0,1
1219637069120565248,0,1,0,0,1
1199882686644596736,1,0,0,0,1
1219649054180704256,0,1,0,0,1
1223915539728257024,0,0,0,1,1
1223927541024612352,1,0,0,0,1
1223943146075082752,1,0,0,0,1
1223943216061472768,0,1,0,0,1
1223952080953466880,0,1,0,0,1
1223973287740477440,0,1,0,0,1
1224035676594688000,1,0,0,0,1
1224042297127579648,0,1,0,0,1
1224042341448568832,1,0,0,0,1
1224097066617409536,0,0,0,1,1
1224213773373673472,0,1,0,0,1
1224285477676544000,0,1,0,0,1
1224382052188880896,1,0,0,0,1
1224450168403234816,1,0,0,0,1
1224455119112196096,0,1,0,0,1
1224456299045322752,0,1,0,0,1
1224532297598238720,1,0,0,0,1
1224565693242195968,0,1,0,0,1
1224579515906695168,0,1,0,0,1
1224634066433126400,0,1,0,0,1
1224649183833051136,0,1,0,0,1
1223846331086708736,1,0,0,0,1
1223758850505027584,0,1,0,0,1
1223645595857907712,0,1,0,0,1
1223283866682580992,0,1,0,0,1
1222879768946737152,0,1,0,0,1
1222882475531231232,1,0,0,0,1
1222921016294494208,0,1,0,0,1
1222969842937917440,1,0,0,0,1
1223138984705921024,0,1,0,0,1
1223158053903749120,1,0,0,0,1
1223202762126655488,0,1,0,0,1
1223270488773922816,1,0,0,0,1
1223275317692915712,0,1,0,0,1
1223324399580983296,0,1,0,0,1
1223639662230568960,0,1,0,0,1
1223339786418708480,0,1,0,0,1
1223379206106701824,0,1,0,0,1
1223439054869368832,0,1,0,0,1
1223489409359630336,0,1,0,0,1
1223490333415104512,0,1,0,0,1
1223567740641980416,0,0,1,0,1
1223583617886179328,0,1,0,0,1
1223584157361676288,0,1,0,0,1
1223601670971633664,1,0,0,0,1
1224659047334412288,1,0,0,0,1
1224724012435214336,0,1,0,0,1
1224768102774140928,0,1,0,0,1
1226399636686090240,1,0,0,0,1
1226023901697839104,0,1,0,0,1
1226052668885389312,0,1,0,0,1
1226063882264834048,0,1,0,0,1
1226099369822298112,0,1,0,0,1
1226100708811796480,0,1,0,0,1
1226124998601052160,0,1,0,0,1
1226193319010668544,0,1,0,0,1
1226281043344470016,1,0,0,0,1
1226346737062727680,0,1,0,0,1
1226420069829369856,0,1,0,0,1
1225890433986895872,0,1,0,0,1
1226431063335018496,0,1,0,0,1
1226469344873414656,0,1,0,0,1
1226473363050291200,0,1,0,0,1
1226474375597240320,0,1,0,0,1
1226512346685804544,0,1,0,0,1
1226515940558462976,0,1,0,0,1
1226559151771279360,0,1,0,0,1
1226579044340129792,0,0,1,0,1
1226617277275136000,1,0,0,0,1
1225902980211314688,0,1,0,0,1
1225815271740497920,0,1,0,0,1
1224782238618918912,0,1,0,0,1
1225257385893208064,1,0,0,0,1
1224783004922458112,0,1,0,0,1
1224817270767026176,1,0,0,0,1
1224919661243961344,0,1,0,0,1
1224999374159106048,0,1,0,0,1
1225045203154694144,1,0,0,0,1
1225058783346425856,1,0,0,0,1
1225104797587726336,1,0,0,0,1
1225113880898211840,0,1,0,0,1
1225131559268864000,0,1,0,0,1
1225297895877959680,0,1,0,0,1
1225779017195950080,0,1,0,0,1
1225345849670225920,0,1,0,0,1
1225389321819054080,0,1,0,0,1
1225398909247291392,0,0,0,1,1
1225401234057596928,1,0,0,0,1
1225474561275236352,0,1,0,0,1
1225696938827251712,0,0,0,1,1
1225714101751554048,0,1,0,0,1
1225745891782516736,1,0,0,0,1
1225767401406418944,0,1,0,0,1
1222845303922933760,0,1,0,0,1
1222824195853295616,0,1,0,0,1
1222768986187878400,1,0,0,0,1
1220671426262253568,0,1,0,0,1
1220359828591112192,0,1,0,0,1
1220363210324353024,0,1,0,0,1
1220487431427960832,0,1,0,0,1
1220509340462985216,0,1,0,0,1
1220529220989980672,0,1,0,0,1
1220560425806262272,1,0,0,0,1
1220604388818866176,0,1,0,0,1
1220632953124016128,0,1,0,0,1
1220656548382412800,0,1,0,0,1
1220680369873260544,0,1,0,0,1
1220281562857713664,0,1,0,0,1
1220689180163899392,0,0,1,0,1
1220714757487038464,1,0,0,0,1
1220755062936391680,0,0,1,0,1
1220879958073053184,0,1,0,0,1
1220921241151905792,1,0,0,0,1
1220940043813965824,0,1,0,0,1
1221045313466781696,0,1,0,0,1
1221053351363862528,0,1,0,0,1
1221061031398645760,0,1,0,0,1
1220313484652662784,0,1,0,0,1
1220280061632434176,0,0,0,1,1
1221135489891258368,0,1,0,0,1
1219831669055787008,0,1,0,0,1
1219678468268490752,0,0,0,1,1
1219680277527744512,1,0,0,0,1
1219681270667628544,0,1,0,0,1
1219695903315046400,0,1,0,0,1
1219696140565778432,0,1,0,0,1
1219716445329874944,0,1,0,0,1
1219721288564035584,0,1,0,0,1
1219746008483020800,0,1,0,0,1
1219801643253936128,0,1,0,0,1
1219917168781021184,0,1,0,0,1
1220193863928700928,0,1,0,0,1
1219945735526875136,1,0,0,0,1
1219990202690785280,0,1,0,0,1
1220007531063455744,0,1,0,0,1
1220008442376728576,1,0,0,0,1
1220041301350969344,0,1,0,0,1
1220050532582117376,0,1,0,0,1
1220064137897750528,0,1,0,0,1
1220083986774548480,0,1,0,0,1
1220176154025328640,0,1,0,0,1
1221086565981507584,0,1,0,0,1
1221139978769485824,0,1,0,0,1
1222766201983635456,0,1,0,0,1
1222224599917768704,0,1,0,0,1
1222087290417295360,0,1,0,0,1
1222102175624527872,0,1,0,0,1
1222106165842194432,0,1,0,0,1
1222108018923450368,0,0,1,0,1
1222149683092578304,1,0,0,0,1
1222181436473708544,1,0,0,0,1
1222196905947680768,0,1,0,0,1
1222208760426434560,0,0,1,0,1
1222220392799952896,1,0,0,0,1
1222363808577929216,0,1,0,0,1
1222022853274619904,0,1,0,0,1
1222477424560156672,0,1,0,0,1
1222538818391289856,0,1,0,0,1
1222541286017769472,0,1,0,0,1
1222628480472449024,0,1,0,0,1
1222682587690360832,0,1,0,0,1
1222718507206483968,0,1,0,0,1
1222731285371600896,0,1,0,0,1
1222753737879408640,0,1,0,0,1
1222765073279737856,0,1,0,0,1
1222060467318861824,0,1,0,0,1
1221990349075144704,0,1,0,0,1
1221146313263284224,0,1,0,0,1
1221469355877158912,0,0,1,0,1
1221238560281460736,0,1,0,0,1
1221241842752278528,0,1,0,0,1
1221299719885901824,0,1,0,0,1
1221325683822972928,0,0,1,0,1
1221389752311508992,0,1,0,0,1
1221409453121118208,0,1,0,0,1
1221431006361575424,0,1,0,0,1
1221437863306260480,0,1,0,0,1
1221446131407900672,0,1,0,0,1
1221480899721646080,0,1,0,0,1
1221892087735558144,0,1,0,0,1
1221495805875376128,0,1,0,0,1
1221498331417006080,0,1,0,0,1
1221528869611692032,0,1,0,0,1
1221529782669565952,0,1,0,0,1
1221608501665050624,0,1,0,0,1
1221737275358240768,1,0,0,0,1
1221810401077342208,0,1,0,0,1
1221843006644420608,0,1,0,0,1
1221876613526118400,0,1,0,0,1
1213200610461245440,1,0,0,0,1
1213194064553627648,0,1,0,0,1
1213182381726683136,0,1,0,0,1
1213172235780780032,0,1,0,0,1
1204688437590278144,0,1,0,0,1
1204783175895044096,0,1,0,0,1
1204797762610458624,0,1,0,0,1
1204809731887509504,0,1,0,0,1
1204828541919080448,0,1,0,0,1
1204831301099896832,0,1,0,0,1
1204841211909038080,0,1,0,0,1
1204924155629592576,1,0,0,0,1
1204939571215028224,0,0,1,0,1
1204950069788626944,1,0,0,0,1
1205021639710261248,0,1,0,0,1
1205046352788512768,1,0,0,0,1
1205056794864828416,0,1,0,0,1
1205108498234826752,0,1,0,0,1
1205121130656387072,0,1,0,0,1
1205147554502991872,0,1,0,0,1
1205335630554619904,0,1,0,0,1
1205347320151367680,0,1,0,0,1
1205379895951593472,0,1,0,0,1
1205382621351596032,0,1,0,0,1
1205478772302131200,0,1,0,0,1
1204646008849698816,0,1,0,0,1
1204620329936535552,0,1,0,0,1
1204469943863037952,1,0,0,0,1
1204039055756976128,0,1,0,0,1
1203662079493890048,0,1,0,0,1
1203668237612769280,0,1,0,0,1
1203734799279521792,1,0,0,0,1
1203758259636752384,0,1,0,0,1
1203762871986987008,0,1,0,0,1
1203948831680991232,0,1,0,0,1
1203969992607162368,0,1,0,0,1
1203990155578761216,0,1,0,0,1
1204014573050830848,0,1,0,0,1
1204052758430511104,0,1,0,0,1
1204456270075482112,1,0,0,0,1
1204113411879178240,0,1,0,0,1
1204132562605613056,0,1,0,0,1
1204200381259100160,0,1,0,0,1
1204206086737162240,0,1,0,0,1
1204246558666944512,0,1,0,0,1
1204260541809774592,0,1,0,0,1
1204311515119128576,0,1,0,0,1
1204358327364227072,0,1,0,0,1
1204453407475429376,1,0,0,0,1
1205500399844777984,0,1,0,0,1
1205520054286090240,1,0,0,0,1
1205536201991741440,0,1,0,0,1
1206624277212127232,0,0,1,0,1
1206495252984614912,0,1,0,0,1
1206503061038026752,0,1,0,0,1
1206503972527206400,0,1,0,0,1
1206506444687839232,1,0,0,0,1
1206520141636395008,0,1,0,0,1
1206542950177689600,0,1,0,0,1
1206592626956394496,0,1,0,0,1
1206594702880858112,0,1,0,0,1
1206611061756973056,0,1,0,0,1
1206637056274788352,0,1,0,0,1
1206470737416146944,0,0,1,0,1
1206643064439287808,0,1,0,0,1
1206645139575320576,0,1,0,0,1
1206645140514848768,0,1,0,0,1
1206653471174230016,1,0,0,0,1
1206770396273553408,0,1,0,0,1
1206817036535357440,0,1,0,0,1
1206828536373370880,0,1,0,0,1
1206919272561201152,0,1,0,0,1
1206989411004514304,0,1,0,0,1
1206476524888743936,0,1,0,0,1
1206389665739235328,0,1,0,0,1
1205554533889400832,0,1,0,0,1
1206014499712634880,0,1,0,0,1
1205710629341978624,0,1,0,0,1
1205726603893968896,1,0,0,0,1
1205760217964785664,1,0,0,0,1
1205761746746707968,0,1,0,0,1
1205845314818760704,0,1,0,0,1
1205852225408585728,0,1,0,0,1
1205875595487465472,0,1,0,0,1
1205878434242523136,0,1,0,0,1
1205966457282203648,0,1,0,0,1
1206025628497203200,0,1,0,0,1
1206297939225628672,0,1,0,0,1
1206031516888788992,0,1,0,0,1
1206034948991455232,0,1,0,0,1
1206073593001652224,0,1,0,0,1
1206110555800588288,0,1,0,0,1
1206164735823142912,0,1,0,0,1
1206215669437648896,0,1,0,0,1
1206216633754300416,0,0,1,0,1
1206249433983139840,1,0,0,0,1
1206279965081292800,0,1,0,0,1
1203654417360154624,1,0,0,0,1
1203648261980119040,0,1,0,0,1
1203645868148248576,0,1,0,0,1
1201204449378590720,0,1,0,0,1
1201078210248658944,0,1,0,0,1
1201102930708852736,0,1,0,0,1
1201107338519863296,0,1,0,0,1
1201142246780919808,0,1,0,0,1
1201153053228822528,0,1,0,0,1
1201159993032097792,0,0,0,1,1
1201170675278503936,1,0,0,0,1
1201185241408376832,0,1,0,0,1
1201198069590740992,0,0,0,1,1
1201229530561597440,0,1,0,0,1
1200942101317459968,0,1,0,0,1
1201253896426930176,1,0,0,0,1
1201257810840969216,0,1,0,0,1
1201373091701628928,1,0,0,0,1
1201420060822257664,0,1,0,0,1
1201427794795859968,0,1,0,0,1
1201435497479979008,0,1,0,0,1
1201437641738203136,0,1,0,0,1
1201447649733488640,1,0,0,0,1
1201453182200795136,0,1,0,0,1
1201052782511312896,1,0,0,0,1
1200883832297144320,0,1,0,0,1
1201528614677860352,0,1,0,0,1
1200154223570292736,0,1,0,0,1
1199886500512460800,1,0,0,0,1
1199901428191354880,0,1,0,0,1
1199906561512103936,0,1,0,0,1
1199909438053912576,0,1,0,0,1
1199973716161187840,0,0,1,0,1
1200014999290179584,0,1,0,0,1
1200033970353774592,0,1,0,0,1
1200060060484984832,1,0,0,0,1
1200093501368782848,1,0,0,0,1
1200209421936332800,0,1,0,0,1
1200860357625044992,0,1,0,0,1
1200325294655201280,0,1,0,0,1
1200363849003786240,0,1,0,0,1
1200400951745667072,0,1,0,0,1
1200402695162454016,1,0,0,0,1
1200472690198495232,0,1,0,0,1
1200516056554647552,0,1,0,0,1
1200522735346049024,1,0,0,0,1
1200729854024527872,0,1,0,0,1
1200810138564616192,0,1,0,0,1
1201462671683420160,1,0,0,0,1
1201610793671806976,0,1,0,0,1
1203620743638073344,0,1,0,0,1
1203046004922159104,0,1,0,0,1
1202789087872212992,0,1,0,0,1
1202802547054071808,0,1,0,0,1
1202833064403099648,0,1,0,0,1
1202860408849059840,1,0,0,0,1
1202862800143470592,0,1,0,0,1
1202911770102374400,0,1,0,0,1
1202921774691815424,0,1,0,0,1
1202941324745465856,0,1,0,0,1
1202998795899998208,0,1,0,0,1
1203065169556971520,1,0,0,0,1
1202737381276880896,0,1,0,0,1
1203090569477660672,1,0,0,0,1
1203185060167467008,0,1,0,0,1
1203187023479279616,0,1,0,0,1
1203251154672607232,0,1,0,0,1
1203281598373711872,0,0,0,1,1
1203296495899836416,0,1,0,0,1
1203395848761233408,0,1,0,0,1
1203588551830581248,0,1,0,0,1
1203616533546774528,0,1,0,0,1
1202762610388680704,1,0,0,0,1
1202646758410653696,0,1,0,0,1
1201770234887098368,0,1,0,0,1
1202131284212015104,0,1,0,0,1
1201779131693834240,0,1,0,0,1
1201801577306214400,0,1,0,0,1
1201859655430856704,0,1,0,0,1
1201886622611959808,0,1,0,0,1
1201955964381024256,0,1,0,0,1
1202007359876456448,0,1,0,0,1
1202063674615226368,0,0,0,1,1
1202082577416368128,0,1,0,0,1
1202103943406460928,0,1,0,0,1
1202197705973469184,0,1,0,0,1
1202639917656006656,0,0,0,1,1
1202213799333421056,0,0,0,1,1
1202225472198696960,1,0,0,0,1
1202258515303075840,1,0,0,0,1
1202325964497178624,0,1,0,0,1
1202414645019066368,0,1,0,0,1
1202434654588096512,0,1,0,0,1
1202524757112979456,0,1,0,0,1
1202554060446023680,1,0,0,0,1
1202596215172431872,0,1,0,0,1
1206991719113248768,1,0,0,0,1
1207018688412438528,0,1,0,0,1
1207140539256193024,0,1,0,0,1
1211688365524783104,0,1,0,0,1
1211373519897972736,0,1,0,0,1
1211415541421760512,0,1,0,0,1
1211515818564935680,0,1,0,0,1
1211543831448932352,1,0,0,0,1
1211551137985220608,1,0,0,0,1
1211571032550604800,0,1,0,0,1
1211599301178036224,0,1,0,0,1
1211620257179156480,0,1,0,0,1
1211683174620651520,0,1,0,0,1
1211735546235473920,0,1,0,0,1
1211289171798589440,0,1,0,0,1
1211749591474819072,1,0,0,0,1
1211785242245091328,0,1,0,0,1
1211792136422580224,0,1,0,0,1
1211823565172948992,0,1,0,0,1
1211879572007833600,0,1,0,0,1
1211880455164686336,1,0,0,0,1
1211943539120070656,0,1,0,0,1
1211976975020986368,1,0,0,0,1
1212024416353128448,0,1,0,0,1
1211303210222096384,0,0,0,1,1
1211230147082276864,0,1,0,0,1
1212062554438025216,0,1,0,0,1
1210909767821955072,0,1,0,0,1
1210615679654580224,0,1,0,0,1
1210618145922150400,0,1,0,0,1
1210632749079564288,0,1,0,0,1
1210634709446713344,0,1,0,0,1
1210716694840262656,0,1,0,0,1
1210744232207691776,0,1,0,0,1
1210807410480168960,0,1,0,0,1
1210828830316744704,0,1,0,0,1
1210852500309307392,0,1,0,0,1
1210933983275470848,0,1,0,0,1
1211229150310064128,0,1,0,0,1
1210969140824965120,0,1,0,0,1
1210969167953715200,0,1,0,0,1
1211066099673919488,0,1,0,0,1
1211089690540965888,0,1,0,0,1
1211114139923279872,0,0,0,1,1
1211156393874427904,0,1,0,0,1
1211196876990468096,0,1,0,0,1
1211201568978042880,0,1,0,0,1
1211218446156881920,0,0,1,0,1
1212031777126006784,0,1,0,0,1
1212070310721142784,1,0,0,0,1
1210513083850010624,0,1,0,0,1
1213010566660255744,1,0,0,0,1
1212720594401148928,0,1,0,0,1
1212743312894857216,0,1,0,0,1
1212790765581062144,0,1,0,0,1
1212823773914652672,0,1,0,0,1
1212825449958539264,0,1,0,0,1
1212854634307473408,1,0,0,0,1
1212870282714574848,0,1,0,0,1
1212949820819640320,0,1,0,0,1
1212992962835042304,0,1,0,0,1
1213019418428489728,0,0,1,0,1
1212599034969391104,0,1,0,0,1
1213021966493347840,0,1,0,0,1
1213022519084515328,0,0,0,1,1
1213037823529381888,0,1,0,0,1
1213054899501404160,1,0,0,0,1
1213096662626779136,0,0,0,1,1
1213108182471458816,0,1,0,0,1
1213122178524184576,0,1,0,0,1
1213152654718750720,1,0,0,0,1
1213165925257531392,0,1,0,0,1
1212629272965206016,0,1,0,0,1
1212584806350913536,0,1,0,0,1
1212088299566690304,0,1,0,0,1
1212376333033984000,1,0,0,0,1
1212134272426864640,0,1,0,0,1
1212139641110876160,1,0,0,0,1
1212161849799528448,0,1,0,0,1
1212179191635963904,0,1,0,0,1
1212218293328609280,0,1,0,0,1
1212237760318201856,0,1,0,0,1
1212238319808962560,0,1,0,0,1
1212282591119757312,1,0,0,0,1
1212374963782438912,0,0,0,1,1
1212376744092520448,0,1,0,0,1
1212535202452393984,0,0,0,1,1
1212376771024150528,1,0,0,0,1
1212381928017367040,0,1,0,0,1
1212457270950256640,0,1,0,0,1
1212461274539286528,0,0,1,0,1
1212462469580374016,0,1,0,0,1
1212466262619541504,0,1,0,0,1
1212468333242507264,0,1,0,0,1
1212513772851449856,0,1,0,0,1
1212525988346679296,0,1,0,0,1
1210585886854922240,0,0,0,1,1
1210504177027145728,0,1,0,0,1
1207156453020033024,1,0,0,0,1
1208265638768267264,0,1,0,0,1
1207680646845353984,0,1,0,0,1
1207715539109515264,0,1,0,0,1
1207817132375003136,0,1,0,0,1
1207860348864389120,0,1,0,0,1
1207898701223608320,0,1,0,0,1
1207937875284647936,0,0,0,1,1
1207983560583454720,0,1,0,0,1
1208035934790471680,1,0,0,0,1
1208109836673658880,0,0,1,0,1
1208329147900022784,0,0,0,1,1
1207637196280385536,0,1,0,0,1
1208392661364805632,0,0,1,0,1
1208428400576286720,0,1,0,0,1
1208449938197139456,0,1,0,0,1
1208464496836132864,0,1,0,0,1
1208487702498357248,0,1,0,0,1
1208519449856348160,0,1,0,0,1
1208539766729445376,0,1,0,0,1
1208541190754390016,0,1,0,0,1
1208573718412365824,0,1,0,0,1
1207659775871373312,0,1,0,0,1
1207597544303259648,0,1,0,0,1
1208651924859305984,1,0,0,0,1
1207390275670118400,1,0,0,0,1
1207169398928228352,0,1,0,0,1
1207193308444930048,1,0,0,0,1
1207210383439810560,0,1,0,0,1
1207274631566020608,0,1,0,0,1
1207282506954752000,1,0,0,0,1
1207311195092373504,0,1,0,0,1
1207320123654189056,1,0,0,0,1
1207362197812203520,1,0,0,0,1
1207368766713159680,0,1,0,0,1
1207390815112163328,0,1,0,0,1
1207590679477706752,0,1,0,0,1
1207416133898440704,0,1,0,0,1
1207424487647518720,0,1,0,0,1
1207446343238791168,0,1,0,0,1
1207467774966206464,0,1,0,0,1
1207491630632058880,0,1,0,0,1
1207523556482895872,1,0,0,0,1
1207555018188083200,0,1,0,0,1
1207574916876210176,1,0,0,0,1
1207584546197327872,0,1,0,0,1
1208650826140409856,0,1,0,0,1
1208671309145747456,0,1,0,0,1
1210474652952338432,0,0,1,0,1
1210033434384572416,0,1,0,0,1
1209489788203462656,0,1,0,0,1
1209498383867613184,1,0,0,0,1
1209580334691561472,0,1,0,0,1
1209664201901215744,0,1,0,0,1
1209693241190354944,0,1,0,0,1
1209760502676480000,0,1,0,0,1
1209801692230955008,0,1,0,0,1
1209860599569514496,1,0,0,0,1
1209911095072157696,0,1,0,0,1
1210049868296867840,0,1,0,0,1
1209461178109317120,0,1,0,0,1
1210073391341936640,0,1,0,0,1
1210181697360166912,1,0,0,0,1
1210186513343897600,0,1,0,0,1
1210222996465405952,0,0,0,1,1
1210233926049943552,0,0,0,1,1
1210332449441320960,0,1,0,0,1
1210441996286005248,1,0,0,0,1
1210455137195614208,0,1,0,0,1
1210460785303932928,0,1,0,0,1
1209469838084562944,0,1,0,0,1
1209438458181230592,0,1,0,0,1
1208724727612575744,0,1,0,0,1
1209040603037753344,0,1,0,0,1
1208790226698678272,0,1,0,0,1
1208844703493439488,0,1,0,0,1
1208866915957035008,0,1,0,0,1
1208906518650859520,0,0,1,0,1
1208908579350007808,0,1,0,0,1
1208968845861564416,0,1,0,0,1
1209000770865180672,0,1,0,0,1
1209029914609029120,0,1,0,0,1
1209033519134961664,0,1,0,0,1
1209065774796754944,0,1,0,0,1
1209432645127589888,0,1,0,0,1
1209068555741908992,0,1,0,0,1
1209125837418577920,0,0,1,0,1
1209131506859294720,0,1,0,0,1
1209209863496196096,0,1,0,0,1
1209301812215459840,0,1,0,0,1
1209327368948637696,1,0,0,0,1
1209328808005787648,1,0,0,0,1
1209368659816091648,1,0,0,0,1
1209378861621948416,1,0,0,0,1
1168825041967964160,0,1,0,0,1
1168715864968810496,0,1,0,0,1
1098843282963136512,0,1,0,0,1
1127131719398711296,0,1,0,0,1
1123950766094454784,0,1,0,0,1
1123966483011383296,0,1,0,0,1
1123967825184546816,0,1,0,0,1
1123974141198073856,0,1,0,0,1
1123988039884333056,1,0,0,0,1
1124097507850706944,1,0,0,0,1
1124119300439252992,0,1,0,0,1
1124144998797021184,0,1,0,0,1
1124240417363460096,0,1,0,0,1
1124257785573670912,0,0,1,0,1
1124264665746477056,0,1,0,0,1
1124264769022844928,1,0,0,0,1
1124286535547879424,1,0,0,0,1
1124373056246431744,0,1,0,0,1
1124461183837151232,0,1,0,0,1
1124473201789153280,1,0,0,0,1
1124575402205241344,0,1,0,0,1
1124659875550679040,0,0,0,1,1
1124687555360907264,0,0,0,1,1
1124723381016854528,0,1,0,0,1
1124732903991255040,0,1,0,0,1
1123892439679426560,0,0,0,1,1
1123853594397159424,1,0,0,0,1
1123850121408593920,0,1,0,0,1
1123022332593831936,0,1,0,0,1
1122581572056768512,0,1,0,0,1
1122606748429422592,0,0,1,0,1
1122725308992491520,0,1,0,0,1
1122760539090956288,0,1,0,0,1
1122846700165529600,1,0,0,0,1
1122877167057158144,0,1,0,0,1
1122897558051926016,0,1,0,0,1
1122901482313932800,0,0,0,1,1
1122958247441334272,0,1,0,0,1
1123028807332581376,0,1,0,0,1
1123740211337474048,0,1,0,0,1
1123179962247327744,0,1,0,0,1
1123233088161579008,0,1,0,0,1
1123237160193335296,0,1,0,0,1
1123450639609147392,0,1,0,0,1
1123492088014942208,1,0,0,0,1
1123514112703512576,0,1,0,0,1
1123611063814062080,0,1,0,0,1
1123623452387078144,0,1,0,0,1
1123717656262119424,0,1,0,0,1
1124850664037699584,0,1,0,0,1
1124904582054703104,1,0,0,0,1
1124910953479516160,0,1,0,0,1
1126470406062452736,0,1,0,0,1
1126010793231650816,0,1,0,0,1
1126074012742881280,0,1,0,0,1
1126078633456623616,0,1,0,0,1
1126089918684385280,0,1,0,0,1
1126155876203671552,0,1,0,0,1
1126188112990883840,0,1,0,0,1
1126210020448903168,0,1,0,0,1
1126330301691629568,1,0,0,0,1
1126416892556607488,0,1,0,0,1
1126510048048558080,0,1,0,0,1
1125836468297977856,1,0,0,0,1
1126526443465379840,0,1,0,0,1
1126574679941160960,0,1,0,0,1
1126577286671503360,0,1,0,0,1
1126786263346868224,0,1,0,0,1
1126837850945667072,0,1,0,0,1
1126841205562671104,0,1,0,0,1
1126843245064085504,0,1,0,0,1
1126896134545240064,0,1,0,0,1
1126969219562786816,0,0,0,1,1
1125838493119320064,0,1,0,0,1
1125813745987522560,0,1,0,0,1
1124921871110000640,0,1,0,0,1
1125238872915374080,1,0,0,0,1
1124960412867465216,0,1,0,0,1
1124995181730615296,0,1,0,0,1
1125049389402079232,0,1,0,0,1
1125057974177689600,1,0,0,0,1
1125075010274701312,0,1,0,0,1
1125115681765093376,0,1,0,0,1
1125117609408716800,1,0,0,0,1
1125220683057958912,0,1,0,0,1
1125230849329324032,1,0,0,0,1
1125254744811769856,0,1,0,0,1
1125735174728118272,0,1,0,0,1
1125272871176065024,0,1,0,0,1
1125290591347077120,0,1,0,0,1
1125300501556260864,0,1,0,0,1
1125340029377818624,0,1,0,0,1
1125418890656247808,1,0,0,0,1
1125530411512123392,0,1,0,0,1
1125654094000074752,0,1,0,0,1
1125692387672633344,0,0,0,1,1
1125731691643826176,1,0,0,0,1
1122526589852557312,0,1,0,0,1
1122463821694754816,0,1,0,0,1
1122399562147045376,0,1,0,0,1
1119198929067945984,0,1,0,0,1
1118422070520680448,1,0,0,0,1
1118434188464517120,0,1,0,0,1
1118512806393835520,0,1,0,0,1
1118782683050459136,0,1,0,0,1
1118859093417037824,0,1,0,0,1
1118954912103182336,0,1,0,0,1
1119027195454713856,0,1,0,0,1
1119139984416501760,0,1,0,0,1
1119148043238948864,0,1,0,0,1
1119203317962424320,0,1,0,0,1
1118316357865627648,0,1,0,0,1
1119275736664354816,0,1,0,0,1
1119350085920358400,0,1,0,0,1
1119390311212388352,0,1,0,0,1
1119450598259085312,0,1,0,0,1
1119581606950461440,1,0,0,0,1
1119629118570672128,1,0,0,0,1
1119683125766914048,0,1,0,0,1
1119725813954379776,0,1,0,0,1
1119778451588833280,0,1,0,0,1
1118389672043057152,1,0,0,0,1
1118184922504749056,0,1,0,0,1
1119848793158168576,0,1,0,0,1
1117339214604111872,0,1,0,0,1
1116713884662943744,0,1,0,0,1
1116744041411035136,0,1,0,0,1
1116955378783334400,0,1,0,0,1
1116998812218875904,0,1,0,0,1
1117050501890076672,0,1,0,0,1
1117084755491577856,0,1,0,0,1
1117110591187894272,1,0,0,0,1
1117134692514508800,0,1,0,0,1
1117222598805532672,0,1,0,0,1
1117388471851724800,0,1,0,0,1
1118051471193329664,1,0,0,0,1
1117544513143226368,1,0,0,0,1
1117618242376409088,0,1,0,0,1
1117633079051374592,0,1,0,0,1
1117674236720635904,0,0,1,0,1
1117732538041036800,1,0,0,0,1
1117785900077989888,1,0,0,0,1
1117848588128800768,0,1,0,0,1
1117923047967584256,0,0,0,1,1
1117999134454292480,0,1,0,0,1
1119810803484495872,0,1,0,0,1
1119850125847719936,1,0,0,0,1
1122373763381780480,0,1,0,0,1
1121751558360903680,0,1,0,0,1
1121330769358729216,0,1,0,0,1
1121347970484641792,0,1,0,0,1
1121378126334918656,0,1,0,0,1
1121431473012260864,0,1,0,0,1
1121500182716137472,0,1,0,0,1
1121605948345286656,0,1,0,0,1
1121640108698902528,0,1,0,0,1
1121698971284643840,1,0,0,0,1
1121744112288509952,1,0,0,0,1
1121811728667500544,0,1,0,0,1
1121281779678060544,0,1,0,0,1
1121904179520446464,0,1,0,0,1
1121934515780210688,0,1,0,0,1
1122113384780943360,1,0,0,0,1
1122143225622429696,0,1,0,0,1
1122166097363574784,0,1,0,0,1
1122223224727724032,0,1,0,0,1
1122250352311578624,0,1,0,0,1
1122351952187265024,1,0,0,0,1
1122352411706830848,0,1,0,0,1
1121286509225816064,1,0,0,0,1
1121261304059027456,0,1,0,0,1
1119874445823356928,0,1,0,0,1
1120400011848749056,0,1,0,0,1
1119876141391724544,1,0,0,0,1
1119931878151049216,1,0,0,0,1
1120001857433194496,0,1,0,0,1
1120138357147701248,0,1,0,0,1
1120210869558939648,0,1,0,0,1
1120221356237312000,0,1,0,0,1
1120264813962235904,1,0,0,0,1
1120363418245128192,0,1,0,0,1
1120365999784648704,0,1,0,0,1
1120608057950658560,0,1,0,0,1
1121122115246284800,0,1,0,0,1
1120645856426889216,1,0,0,0,1
1120731891768930304,0,1,0,0,1
1120735721919270912,0,0,0,1,1
1120758470020685824,1,0,0,0,1
1120900572784287744,0,1,0,0,1
1120917697510957056,0,1,0,0,1
1120940073674055680,0,1,0,0,1
1120990490579566592,0,1,0,0,1
1121004453245616128,1,0,0,0,1
1127057432503517184,0,1,0,0,1
1127215668791840768,0,0,0,1,1
1135800099064504320,0,1,0,0,1
1127280934951239680,0,1,0,0,1
1132750799040339968,0,1,0,0,1
1132833500925714432,0,0,1,0,1
1132892112729436160,0,1,0,0,1
1132938953374388224,1,0,0,0,1
1132980716096983040,0,1,0,0,1
1133041947994542080,0,1,0,0,1
1133045247112556544,1,0,0,0,1
1133070098607087616,0,1,0,0,1
1133106656345067520,0,1,0,0,1
1133237690957275136,0,1,0,0,1
1133306917529559040,0,1,0,0,1
1133327443400413184,1,0,0,0,1
1133353256590159872,1,0,0,0,1
1133415158276136960,0,1,0,0,1
1133503974970220544,0,1,0,0,1
1133615412153868288,0,1,0,0,1
1133650174872555520,0,1,0,0,1
1133650285325365248,0,1,0,0,1
1133696746813628416,0,1,0,0,1
1133962466558222336,0,1,0,0,1
1133971236885676032,0,1,0,0,1
1132734602655617024,0,1,0,0,1
1132726458458226688,0,1,0,0,1
1132711413988909056,0,0,0,1,1
1132181168865071104,0,0,0,1,1
1131860106428198912,0,0,0,1,1
1131867324431118336,0,1,0,0,1
1131881063909924864,1,0,0,0,1
1131951910926217216,0,1,0,0,1
1131966236776992768,1,0,0,0,1
1131997988493168640,0,1,0,0,1
1132041676023713792,0,1,0,0,1
1132062118591762432,0,1,0,0,1
1132119352436641792,0,1,0,0,1
1132199452758831104,0,1,0,0,1
1132695662418702336,0,1,0,0,1
1132210567173644288,0,1,0,0,1
1132229634135920640,0,1,0,0,1
1132375632472629248,1,0,0,0,1
1132581169990578176,0,1,0,0,1
1132621088339324928,1,0,0,0,1
1132627432081637376,0,1,0,0,1
1132638310545756160,1,0,0,0,1
1132667068682260480,0,1,0,0,1
1132679278380888064,1,0,0,0,1
1134061468817809408,0,1,0,0,1
1134124136559665152,1,0,0,0,1
1134132707951304704,0,1,0,0,1
1135536096467652608,0,1,0,0,1
1135224516320251904,0,1,0,0,1
1135247524631990272,0,1,0,0,1
1135372563713024000,0,1,0,0,1
1135440311637987328,0,1,0,0,1
1135459246701719552,0,1,0,0,1
1135461799359389696,0,1,0,0,1
1135493329049804800,0,1,0,0,1
1135496208808419328,0,1,0,0,1
1135518368797093888,0,1,0,0,1
1135577840844283904,0,1,0,0,1
1135167700244844544,0,1,0,0,1
1135580678538448896,1,0,0,0,1
1135598162574372864,0,1,0,0,1
1135605070509334528,0,1,0,0,1
1135639141780267008,0,1,0,0,1
1135670000436559872,0,1,0,0,1
1135677993467174912,0,1,0,0,1
1135680379069829120,0,1,0,0,1
1135684051694772224,0,1,0,0,1
1135706058461188096,0,1,0,0,1
1135201121880854528,1,0,0,0,1
1135100195912527872,0,1,0,0,1
1134136671002406912,1,0,0,0,1
1134483680062300160,0,1,0,0,1
1134199747999350784,1,0,0,0,1
1134231867828232192,0,1,0,0,1
1134241118273593344,0,1,0,0,1
1134339124347826176,0,1,0,0,1
1134363743930863616,0,1,0,0,1
1134364663343280128,0,1,0,0,1
1134382977247457280,0,1,0,0,1
1134472705674162176,0,1,0,0,1
1134474300587683840,0,1,0,0,1
1134498802562244608,0,1,0,0,1
1134926346151497728,0,1,0,0,1
1134524172783112192,0,1,0,0,1
1134562438756655104,0,1,0,0,1
1134580735757565952,0,1,0,0,1
1134622552729538560,0,0,0,1,1
1134628433336528896,0,1,0,0,1
1134726477906415616,0,1,0,0,1
1134784663099236352,0,1,0,0,1
1134875442501103616,0,1,0,0,1
1134925826208731136,1,0,0,0,1
1131815288633085952,1,0,0,0,1
1131809501735215104,0,1,0,0,1
1131713690598805504,0,1,0,0,1
1129279529166360576,0,1,0,0,1
1128438873019654144,0,1,0,0,1
1128506315729510400,0,1,0,0,1
1128569430017957888,0,1,0,0,1
1128593647795089408,1,0,0,0,1
1128601970867167232,0,1,0,0,1
1128644996138016768,0,1,0,0,1
1128702640706195456,0,1,0,0,1
1128705328806232064,0,1,0,0,1
1128905460667469824,0,1,0,0,1
1129298979496308736,0,1,0,0,1
1128316951812628480,0,1,0,0,1
1129346657823449088,0,1,0,0,1
1129372808583057408,0,1,0,0,1
1129455209590034432,0,1,0,0,1
1129465217258278912,1,0,0,0,1
1129506301770371072,0,0,0,1,1
1129520186145607680,0,1,0,0,1
1129572550785343488,1,0,0,0,1
1129625217993715712,0,1,0,0,1
1129662593805643776,0,1,0,0,1
1128342032714424320,1,0,0,0,1
1128238015346823168,0,1,0,0,1
1129729103710642176,0,1,0,0,1
1127593938691481600,0,1,0,0,1
1127292759218348032,0,1,0,0,1
1127301211827384320,0,1,0,0,1
1127362558946574336,0,1,0,0,1
1127437693632294912,0,1,0,0,1
1127439258749480960,0,1,0,0,1
1127460305355698176,0,1,0,0,1
1127471213977141248,0,1,0,0,1
1127535330737950720,0,1,0,0,1
1127546280589365248,0,1,0,0,1
1127643093627310080,0,1,0,0,1
1128205779025256448,0,1,0,0,1
1127803419278790656,0,1,0,0,1
1127821308929224704,0,1,0,0,1
1127885267325661184,1,0,0,0,1
1127938568603746304,0,1,0,0,1
1128080954071900160,0,1,0,0,1
1128087501065687040,0,1,0,0,1
1128133735516233728,1,0,0,0,1
1128139955031691264,0,1,0,0,1
1128144947507486720,1,0,0,0,1
1129715494888648704,0,1,0,0,1
1129746149198295040,0,1,0,0,1
1131631274718666752,0,1,0,0,1
1131185784839655424,1,0,0,0,1
1130771113741627392,0,1,0,0,1
1130809829360979968,1,0,0,0,1
1130830208695586816,0,1,0,0,1
1131099699803561984,0,1,0,0,1
1131102093392130048,0,1,0,0,1
1131123483688218624,0,1,0,0,1
1131132948298604544,1,0,0,0,1
1131159997096779776,0,1,0,0,1
1131179548400185344,0,1,0,0,1
1131237635861573632,0,1,0,0,1
1130740231504900096,0,1,0,0,1
1131276046324699136,0,1,0,0,1
1131390240604794880,0,1,0,0,1
1131399882772799488,0,1,0,0,1
1131426076494913536,0,1,0,0,1
1131431460618084352,0,0,0,1,1
1131438948268498944,1,0,0,0,1
1131490377448476672,0,1,0,0,1
1131540512098308096,1,0,0,0,1
1131544206676115456,1,0,0,0,1
1130771019885666304,1,0,0,0,1
1130738452818026496,0,1,0,0,1
1129796857352343552,0,1,0,0,1
1130141531174854656,0,1,0,0,1
1129845127395119104,0,1,0,0,1
1129849293039214592,0,0,1,0,1
1129926678367490048,1,0,0,0,1
1130057734517395456,0,1,0,0,1
1130063235032453120,0,1,0,0,1
1130070495469154304,0,1,0,0,1
1130088073344241664,0,1,0,0,1
1130095258551836672,0,1,0,0,1
1130098390056996864,0,1,0,0,1
1130146804761223168,0,1,0,0,1
1130691435152302080,0,1,0,0,1
1130171260812636160,0,1,0,0,1
1130188152705036288,0,1,0,0,1
1130341811967238144,0,1,0,0,1
1130351374728814592,0,1,0,0,1
1130387588781674496,0,1,0,0,1
1130406992885846016,0,1,0,0,1
1130461446511452160,0,1,0,0,1
1130487148908466176,0,1,0,0,1
1130506224833712128,0,1,0,0,1
1116661635291201536,0,1,0,0,1
1116624693492998144,0,1,0,0,1
1116611460170301440,1,0,0,0,1
1116489239531704320,0,1,0,0,1
1103102087976624128,0,1,0,0,1
1103399167005741056,0,1,0,0,1
1103411380781232128,0,1,0,0,1
1103412700128968704,0,1,0,0,1
1103413739456548864,0,1,0,0,1
1103419360574562304,0,1,0,0,1
1103542765810380800,0,1,0,0,1
1103573716099911680,0,1,0,0,1
1103641276128391168,0,1,0,0,1
1103660270201856000,0,1,0,0,1
1103717210030329856,0,1,0,0,1
1103747253049614336,1,0,0,0,1
1103750441966411776,1,0,0,0,1
1103954004575436800,0,1,0,0,1
1104011891800793088,1,0,0,0,1
1104073626926673920,1,0,0,0,1
1104115978361860096,0,1,0,0,1
1104203109612441600,0,1,0,0,1
1104361507322761216,0,1,0,0,1
1104385386527232000,1,0,0,0,1
1104405275451187200,0,1,0,0,1
1102980959652270080,0,1,0,0,1
1102971931244949504,1,0,0,0,1
1102878324618117120,0,1,0,0,1
1102292955761704960,0,1,0,0,1
1101957592878891008,0,1,0,0,1
1101961648342892544,0,1,0,0,1
1101997772172025856,0,0,1,0,1
1102061649505083392,0,1,0,0,1
1102125090408402944,1,0,0,0,1
1102158307588890624,0,1,0,0,1
1102179082362601472,1,0,0,0,1
1102222138247909376,0,1,0,0,1
1102290093442809856,0,1,0,0,1
1102347362704478208,0,1,0,0,1
1102773540741275648,0,1,0,0,1
1102371986125324288,0,0,0,1,1
1102379717234253824,0,1,0,0,1
1102453577769984000,1,0,0,0,1
1102543073341526016,0,1,0,0,1
1102543728441470976,0,1,0,0,1
1102591931102576640,0,1,0,0,1
1102609746702553088,0,1,0,0,1
1102645628390252544,0,1,0,0,1
1102698602520969216,0,1,0,0,1
1104463695395069952,0,1,0,0,1
1104466989764947968,0,1,0,0,1
1104521280487809024,0,1,0,0,1
1106181092237819904,0,1,0,0,1
1105871962012827648,0,1,0,0,1
1105941473189597184,0,1,0,0,1
1106067181123571712,0,1,0,0,1
1106117060088733696,0,1,0,0,1
1106122904994041856,0,1,0,0,1
1106123256174505984,0,0,0,1,1
1106142464849534976,0,1,0,0,1
1106143264749559808,0,0,0,1,1
1106149463008182272,1,0,0,0,1
1106198710168498176,1,0,0,0,1
1105484526246072320,0,1,0,0,1
4146653715,1,0,0,0,1
1106293041185386496,0,1,0,0,1
1106323665845653504,0,1,0,0,1
1106344958091554816,0,1,0,0,1
1106489976072663040,0,1,0,0,1
1106540346433929216,0,0,0,1,1
1106565872443944960,0,1,0,0,1
1106580301520744448,0,1,0,0,1
1106648710119940096,0,0,1,0,1
1105769545212542976,0,1,0,0,1
1105465396579192832,0,1,0,0,1
1104600230689943552,0,1,0,0,1
1105140280678768640,1,0,0,0,1
1104721216848437248,0,1,0,0,1
1104734730052952064,0,1,0,0,1
1104792966944702464,0,1,0,0,1
1104805935451701248,0,1,0,0,1
1104815576365629440,0,1,0,0,1
1104871857520443392,0,1,0,0,1
1104976468810051584,0,1,0,0,1
1105031543435788288,0,1,0,0,1
1105086356747898880,0,1,0,0,1
1105211247102963712,1,0,0,0,1
1105444976115281920,0,1,0,0,1
1105259984068268032,1,0,0,0,1
1105260565440708608,0,1,0,0,1
1105267746403688448,0,1,0,0,1
1105280761014423552,0,1,0,0,1
1105292596396654592,0,1,0,0,1
1105341180651470848,0,1,0,0,1
1105423112332632064,1,0,0,0,1
1105423415282941952,0,1,0,0,1
1105434581782720512,0,1,0,0,1
1101916019575218176,0,1,0,0,1
1101868574107406336,0,1,0,0,1
1101797932645343232,0,1,0,0,1
1100291091687968768,1,0,0,0,1
1100085928184340480,0,0,0,1,1
1100089702760280064,0,0,0,1,1
1100090238075129856,0,1,0,0,1
1100099068863365120,0,1,0,0,1
1100144665808953344,0,1,0,0,1
1100156794247303168,0,1,0,0,1
1100243393278431232,0,1,0,0,1
1100277753864105984,1,0,0,0,1
1100283278458867712,1,0,0,0,1
1100296176719593472,0,1,0,0,1
1100017331995115520,1,0,0,0,1
1100298267810844672,0,1,0,0,1
1100298445989072896,0,1,0,0,1
1100395625517076480,1,0,0,0,1
1100466355717976064,0,1,0,0,1
1100479492840026112,1,0,0,0,1
1100594406908940288,0,1,0,0,1
1100600550473764864,1,0,0,0,1
1100606924087791616,0,1,0,0,1
1100625364244709376,1,0,0,0,1
1100041095101075456,0,1,0,0,1
1099961978880249856,1,0,0,0,1
1100657404595916800,0,1,0,0,1
1099158232201715712,1,0,0,0,1
1098954855979409408,0,1,0,0,1
1098957598517280768,0,1,0,0,1
1098980946550902784,0,1,0,0,1
1099004002539356160,0,1,0,0,1
1099014800225591296,0,1,0,0,1
1099022101258883072,0,1,0,0,1
1099040274435715072,0,1,0,0,1
1099106190905303040,0,1,0,0,1
1099131479940988928,1,0,0,0,1
1099160655905677312,0,1,0,0,1
1099927110838374400,0,1,0,0,1
1099230520922202112,1,0,0,0,1
1099274762419867648,0,1,0,0,1
1099283422621487104,0,1,0,0,1
1099419073836969984,0,1,0,0,1
1099640410643877888,0,1,0,0,1
1099722196904218624,0,1,0,0,1
1099888679462555648,1,0,0,0,1
1099891835042971648,0,1,0,0,1
1099915211409186816,0,1,0,0,1
1100648506199629824,0,1,0,0,1
1100687649617203200,1,0,0,0,1
1101786976167096320,0,1,0,0,1
1101438770317021184,1,0,0,0,1
1101123010721923072,0,1,0,0,1
1101141127695159296,1,0,0,0,1
1101145821381312512,0,1,0,0,1
1101151731612876800,0,1,0,0,1
1101177328317722624,0,1,0,0,1
1101337178171416576,0,1,0,0,1
1101372866749231104,0,1,0,0,1
1101388150981705728,0,1,0,0,1
1101394009212227584,0,1,0,0,1
1101486794074451968,0,1,0,0,1
1101107824845819904,0,1,0,0,1
1101492090796675072,1,0,0,0,1
1101517981585207296,0,1,0,0,1
1101518872212004864,1,0,0,0,1
1101560670829588480,0,1,0,0,1
1101574145127694336,0,1,0,0,1
1101669929852592128,0,1,0,0,1
1101705778518523904,0,1,0,0,1
1101719044238073856,0,0,1,0,1
1101761756173602816,0,1,0,0,1
1101112499942932480,0,1,0,0,1
1101101869793976320,0,1,0,0,1
1100688671257387008,0,1,0,0,1
1100889248478257152,0,1,0,0,1
1100694515223007232,0,1,0,0,1
1100705450259935232,0,1,0,0,1
1100711098377007104,0,0,1,0,1
1100721576281100288,0,1,0,0,1
1100745483834871808,0,1,0,0,1
1100790586783817728,0,1,0,0,1
1100805501896585216,0,1,0,0,1
1100832227024355328,0,1,0,0,1
1100864134160306176,0,1,0,0,1
1100982999800111104,0,1,0,0,1
1101083702795354112,0,1,0,0,1
1101002710965411840,0,1,0,0,1
1101016137486065664,0,1,0,0,1
1101025009089368064,0,1,0,0,1
1101036987610468352,1,0,0,0,1
1101049192330477568,0,1,0,0,1
1101054344043085824,0,0,0,1,1
1101056519397756928,1,0,0,0,1
1101065931541819392,0,1,0,0,1
1101081886808567808,0,1,0,0,1
1106676077416640512,0,1,0,0,1
1106815722586439680,0,1,0,0,1
1106864830512840704,0,1,0,0,1
1113689491837992960,0,1,0,0,1
1112625436427776000,1,0,0,0,1
1112642544549199872,0,1,0,0,1
1112712899766771712,0,1,0,0,1
1112866687869698048,0,1,0,0,1
1113016732409622528,0,1,0,0,1
1113142109735800832,1,0,0,0,1
1113155672936513536,0,1,0,0,1
1113266504127139840,0,1,0,0,1
1113397649531658240,0,1,0,0,1
1113691196562575360,0,1,0,0,1
1112522754929000448,0,1,0,0,1
1113723067979706368,0,1,0,0,1
1113741407905300480,0,1,0,0,1
1113762702789419008,0,1,0,0,1
1113860036327923712,0,1,0,0,1
1113899904206819328,1,0,0,0,1
1113976436619206656,0,1,0,0,1
1114012714718978048,1,0,0,0,1
1114154120263475200,0,1,0,0,1
1114180090714382336,0,1,0,0,1
1112578049977937920,1,0,0,0,1
1112513958949195776,0,1,0,0,1
1114243106331877376,0,1,0,0,1
1111743665058316288,0,1,0,0,1
1111242425312464896,1,0,0,0,1
1111292532720308224,0,1,0,0,1
1111320399583731712,0,1,0,0,1
1111329862311133184,0,1,0,0,1
1111365744741240832,0,1,0,0,1
1111407926546219008,0,1,0,0,1
1111536280062562304,1,0,0,0,1
1111570959268528128,0,1,0,0,1
1111666350357803008,1,0,0,0,1
1111996978072862720,0,1,0,0,1
1112486109819404288,0,1,0,0,1
1112005674135928832,0,1,0,0,1
1112051782329331712,1,0,0,0,1
1112071974598135808,1,0,0,0,1
1112150261978546176,0,1,0,0,1
1112183338926661632,0,1,0,0,1
1112277908503056384,0,1,0,0,1
1112277937166970880,0,1,0,0,1
1112292775947628544,0,1,0,0,1
1112426090453184512,0,1,0,0,1
1114239849257631744,0,1,0,0,1
1114255734730977280,0,1,0,0,1
1111147452701335552,0,0,0,1,1
1116163120194625536,0,1,0,0,1
1115736285308526592,0,1,0,0,1
1115832862530523136,0,1,0,0,1
1115907445451304960,0,1,0,0,1
1115918265547673600,0,1,0,0,1
1115937051277496320,0,1,0,0,1
1115975409848340480,0,1,0,0,1
1115991745219710976,1,0,0,0,1
1116062385779798016,0,1,0,0,1
1116081588117417984,0,1,0,0,1
1116225255582814208,1,0,0,0,1
1115706271045259264,0,1,0,0,1
1116262353891360768,0,1,0,0,1
1116322850389004288,0,1,0,0,1
1116327930605342720,0,1,0,0,1
1116342647814275072,0,1,0,0,1
1116355732327284736,1,0,0,0,1
1116369989152301056,1,0,0,0,1
1116391635087130624,1,0,0,0,1
1116414806624538624,0,1,0,0,1
1116433995762368512,0,1,0,0,1
1115719641668567040,1,0,0,0,1
1115690297919336448,0,1,0,0,1
1114270491743797248,0,1,0,0,1
1114986381963616256,0,1,0,0,1
1114323649706610688,0,1,0,0,1
1114327793553346560,0,1,0,0,1
1114524046140555264,1,0,0,0,1
1114553315256410112,0,1,0,0,1
1114569079870906368,0,1,0,0,1
1114650832006459392,0,1,0,0,1
1114807233857097728,0,0,0,1,1
1114823488546779136,1,0,0,0,1
1114980532863942656,1,0,0,0,1
1115176496459464704,0,1,0,0,1
1115583836811812864,0,1,0,0,1
1115204826651136000,0,1,0,0,1
1115213281268879360,0,1,0,0,1
1115263043850530816,0,0,1,0,1
1115282851262533632,0,1,0,0,1
1115311501932474368,0,0,1,0,1
1115317407634075648,0,1,0,0,1
1115320889355264000,0,1,0,0,1
1115502084416266240,0,1,0,0,1
1115567942840848384,0,0,0,1,1
1111170839947296768,0,1,0,0,1
1111018297078763520,0,1,0,0,1
1106922885828874240,1,0,0,0,1
1108059711549562880,0,1,0,0,1
1107914129354997760,0,1,0,0,1
1107928578614837248,0,1,0,0,1
1107959293549207552,0,1,0,0,1
1107968051255738368,0,1,0,0,1
1107987080725098496,1,0,0,0,1
1108005567308587008,0,1,0,0,1
1108036321329594368,0,1,0,0,1
1108051983489892352,0,1,0,0,1
1108059313095012352,0,1,0,0,1
1108162040915349504,0,1,0,0,1
1107843837609730048,0,1,0,0,1
1108183195009179648,0,1,0,0,1
1108198624058441728,1,0,0,0,1
1108217104996724736,0,1,0,0,1
1108235572349288448,0,1,0,0,1
1108304260700229632,0,1,0,0,1
1108380841661456384,0,1,0,0,1
1108396368027156480,0,1,0,0,1
1108404378937942016,0,0,1,0,1
1108427071716417536,1,0,0,0,1
1107899677108826112,0,1,0,0,1
1107796605690920960,0,1,0,0,1
1108491774937333760,0,1,0,0,1
1107237409639395328,0,1,0,0,1
1106977633127010304,0,1,0,0,1
1106983064431984640,0,1,0,0,1
1107071937380057088,0,1,0,0,1
1107105194674925568,1,0,0,0,1
1107121943499759616,0,1,0,0,1
1107147706005377024,0,1,0,0,1
1107158778992955392,0,1,0,0,1
1107162987616501760,0,0,1,0,1
1107175653957206016,1,0,0,0,1
1107311280380145664,0,1,0,0,1
1107748105544359936,0,1,0,0,1
1107384495320137728,0,1,0,0,1
1107399584920281088,0,1,0,0,1
1107439906522124288,0,1,0,0,1
1107453760098336768,1,0,0,0,1
1107521351395479552,0,1,0,0,1
1107527195021332480,0,1,0,0,1
1107540107148419072,0,1,0,0,1
1107725201481961472,0,1,0,0,1
1107744316787707904,1,0,0,0,1
1108466904434442240,1,0,0,0,1
1108593531608854528,1,0,0,0,1
1110996268128579584,0,1,0,0,1
1110278996959346688,0,1,0,0,1
1109822552434577408,0,1,0,0,1
1109869193883725824,1,0,0,0,1
1109905112338591744,0,1,0,0,1
1110047999130914816,0,1,0,0,1
1110090140465197056,0,1,0,0,1
1110138592163188736,1,0,0,0,1
1110186881029947392,0,1,0,0,1
1110208482878214144,0,1,0,0,1
1110212685730406400,0,1,0,0,1
1110470103336972288,0,1,0,0,1
1109709208260214784,0,1,0,0,1
1110482762178461696,0,1,0,0,1
1110525525536182272,0,1,0,0,1
1110528432084054016,1,0,0,0,1
1110637293797298176,0,1,0,0,1
1110732858769833984,1,0,0,0,1
1110789897160404992,1,0,0,0,1
1110790998509027328,0,1,0,0,1
1110836788711571456,1,0,0,0,1
1110908134737014784,0,1,0,0,1
1109777309685301248,1,0,0,0,1
1109669727415095296,0,0,1,0,1
1108623894364094464,0,1,0,0,1
1109143279973605376,1,0,0,0,1
1108623946809835520,0,0,1,0,1
1108658056584290304,0,1,0,0,1
1108802895246512128,1,0,0,0,1
1108871677050531840,0,1,0,0,1
1108897448825491456,0,1,0,0,1
1108998759147425792,0,1,0,0,1
1109066659401216000,0,1,0,0,1
1109092860266074112,0,1,0,0,1
1109123087323275264,0,1,0,0,1
1109156651209314304,0,1,0,0,1
1109553492547563520,0,1,0,0,1
1109290311484760064,0,1,0,0,1
1109318025159868416,0,1,0,0,1
1109335821025341440,0,1,0,0,1
1109415018272043008,0,1,0,0,1
1109431259082776576,0,1,0,0,1
1109455258340728832,0,1,0,0,1
1109461342111571968,0,1,0,0,1
1109494521249697792,0,1,0,0,1
1109545609395089408,1,0,0,0,1
1135789623928426496,1,0,0,0,1
1135869155159216128,0,1,0,0,1
1168593490252447744,0,1,0,0,1
1160555066606026752,0,1,0,0,1
1158139840866791424,1,0,0,0,1
1158149507030237184,0,1,0,0,1
1158158401941266432,0,1,0,0,1
1158192361475887104,1,0,0,0,1
1158294024953851904,0,1,0,0,1
1158302456650043392,0,1,0,0,1
1158319025832833024,1,0,0,0,1
1158338193277640704,0,1,0,0,1
1158363585615159296,0,1,0,0,1
1158384123184058368,0,1,0,0,1
1158448370924609536,0,1,0,0,1
1158453639595401216,0,1,0,0,1
1158474591943221248,0,1,0,0,1
1158538998010093568,1,0,0,0,1
1158544686757416960,1,0,0,0,1
1158546643697823744,1,0,0,0,1
1158548202158612480,0,1,0,0,1
1158589727169232896,0,1,0,0,1
1158630906355228672,0,1,0,0,1
1158642143587700736,0,1,0,0,1
1158672722735403008,0,1,0,0,1
1158121671724847104,0,1,0,0,1
1158110591745007616,0,0,1,0,1
1158104313916297216,0,1,0,0,1
1157866310270738432,0,1,0,0,1
1157665862951718912,0,0,0,1,1
1157692069957083136,0,1,0,0,1
1157696277196369920,0,1,0,0,1
1157710198762610688,0,1,0,0,1
1157760517731168256,0,1,0,0,1
1157807229757734912,0,1,0,0,1
1157832291554451456,0,1,0,0,1
1157843664267169792,0,1,0,0,1
1157856576667103232,0,1,0,0,1
1157873437420871680,1,0,0,0,1
1158060077858738176,0,1,0,0,1
1157875384160927744,0,1,0,0,1
1157882041355997184,1,0,0,0,1
1157950227040653312,0,1,0,0,1
1157961286342389760,0,1,0,0,1
1157984670421643264,0,1,0,0,1
1157991755767115776,0,1,0,0,1
1157999369934823424,0,1,0,0,1
1158012130030960640,1,0,0,0,1
1158023779731288064,0,1,0,0,1
1158790565963505664,0,0,0,1,1
1158878809044783104,0,1,0,0,1
1158958558945447936,0,1,0,0,1
1160319651278139392,0,1,0,0,1
1159853921227198464,0,1,0,0,1
1159897988854140928,0,1,0,0,1
1159979601696833536,0,1,0,0,1
1160046008350457856,0,1,0,0,1
1160065002021122048,0,1,0,0,1
1160196692135821312,0,1,0,0,1
1160232335968747520,0,1,0,0,1
1160250179167096832,1,0,0,0,1
1160274026977267712,0,1,0,0,1
1160335674224128000,0,1,0,0,1
1159793201491955712,1,0,0,0,1
1160430312326721536,1,0,0,0,1
1160460829134872576,0,1,0,0,1
1160470590370848768,0,1,0,0,1
1160472546585694208,0,1,0,0,1
1160495189930258432,0,1,0,0,1
1160497328127655936,1,0,0,0,1
1160515234194317312,0,1,0,0,1
1160523452605980672,0,0,0,1,1
1160553350724771840,0,1,0,0,1
1159851900071817216,1,0,0,0,1
1159770843271983104,1,0,0,0,1
1159012793254682624,0,1,0,0,1
1159406185465950208,0,1,0,0,1
1159042556186918912,0,1,0,0,1
1159047256093409280,0,1,0,0,1
1159196356751351808,0,1,0,0,1
1159292425761939456,0,1,0,0,1
1159329950274449408,0,1,0,0,1
1159340499892920320,0,1,0,0,1
1159359005262667776,0,1,0,0,1
1159362307534852096,0,0,0,1,1
1159404649759330304,0,1,0,0,1
1159475975479910400,1,0,0,0,1
1159766863242506240,1,0,0,0,1
1159562622124974080,0,1,0,0,1
1159564279743307776,0,1,0,0,1
1159614002361720832,1,0,0,0,1
1159669329312403456,0,1,0,0,1
1159678566440660992,0,1,0,0,1
1159683090458955776,0,1,0,0,1
1159688754459660288,1,0,0,0,1
1159734199672287232,0,1,0,0,1
1159753224741642240,0,1,0,0,1
1157623571046371328,0,1,0,0,1
1157509205617758208,0,1,0,0,1
1157475981491261440,0,1,0,0,1
1155043260127207424,0,1,0,0,1
1154720851758944256,0,1,0,0,1
1154728688996556800,0,1,0,0,1
1154752118533869568,0,1,0,0,1
1154928598031065088,0,1,0,0,1
1154952324823076864,0,1,0,0,1
1154986265109884928,0,1,0,0,1
1154987298800324608,0,1,0,0,1
1155003723329855488,1,0,0,0,1
1155025927144988672,0,1,0,0,1
1155059056710602752,0,1,0,0,1
1154639487420555264,1,0,0,0,1
1155088422819659776,0,1,0,0,1
1155132075126640640,0,1,0,0,1
1155261415420256256,0,1,0,0,1
1155279019295813632,0,1,0,0,1
1155366254389137408,0,1,0,0,1
1155431279816581120,0,1,0,0,1
1155438387643502592,0,1,0,0,1
1155452283234213888,0,1,0,0,1
1155457649485459456,0,1,0,0,1
1154718576085032960,0,1,0,0,1
1154626651805880320,1,0,0,0,1
1155614454886862848,0,1,0,0,1
1154087114415464448,0,1,0,0,1
1153704060580536320,1,0,0,0,1
1153804824858812416,1,0,0,0,1
1153834516101902336,0,1,0,0,1
1153877422388994048,0,0,1,0,1
1153900586523353088,0,1,0,0,1
1153918852104933376,0,1,0,0,1
1154018139413405696,0,1,0,0,1
1154071473272827904,0,1,0,0,1
1154077136837156864,0,1,0,0,1
1154124396052791296,0,1,0,0,1
1154584863099351040,0,0,1,0,1
1154161692433158144,0,1,0,0,1
1154210570176016384,0,1,0,0,1
1154274220680966144,0,1,0,0,1
1154276967589601280,0,1,0,0,1
1154299723454570496,0,1,0,0,1
1154315370292867072,1,0,0,0,1
1154363417714556928,1,0,0,0,1
1154363477047353344,0,1,0,0,1
1154472230014861312,0,1,0,0,1
1155542116946382848,0,1,0,0,1
1155729136201162752,0,1,0,0,1
1157467977744359424,1,0,0,0,1
1156917896947388416,0,1,0,0,1
1156683015558320128,1,0,0,0,1
1156708385997221888,0,0,0,1,1
1156742522938564608,0,1,0,0,1
1156768563136303104,0,1,0,0,1
1156805186356043776,0,1,0,0,1
1156877383904854016,0,1,0,0,1
1156877863980806144,1,0,0,0,1
1156886445027545088,0,0,1,0,1
1156908490960646144,1,0,0,0,1
1157188501416415232,0,1,0,0,1
1156646929087905792,0,1,0,0,1
1157206918982586368,1,0,0,0,1
1157207535587213312,0,1,0,0,1
1157256561946955776,0,1,0,0,1
1157282884778115072,0,1,0,0,1
1157283951674707968,0,1,0,0,1
1157309112553746432,0,1,0,0,1
1157343812643106816,0,1,0,0,1
1157404355567529984,0,1,0,0,1
1157404381991641088,1,0,0,0,1
1156676592061624320,0,1,0,0,1
1156611170486378496,0,1,0,0,1
1155862125778264064,0,1,0,0,1
1156249472613212160,0,1,0,0,1
1155878146987757568,0,1,0,0,1
1155954896010711040,0,1,0,0,1
1155964268623335424,0,1,0,0,1
1155978158987980800,0,1,0,0,1
1155988453026234368,1,0,0,0,1
1156167550071451648,0,1,0,0,1
1156178659968987136,0,1,0,0,1
1156190869642498048,0,1,0,0,1
1156212326615474176,0,1,0,0,1
1156268521346805760,0,1,0,0,1
1156596824154808320,1,0,0,0,1
1156289813974097920,1,0,0,0,1
1156296403053940736,0,0,0,1,1
1156314423730081792,0,1,0,0,1
1156378929323638784,1,0,0,0,1
1156426110311260160,0,1,0,0,1
1156441469349068800,1,0,0,0,1
1156443293456261120,1,0,0,0,1
1156515267540897792,0,1,0,0,1
1156545079768690688,1,0,0,0,1
1160554395999731712,0,1,0,0,1
1160680308146130944,0,1,0,0,1
1136065885456740352,0,1,0,0,1
1160757704006066176,0,1,0,0,1
1165260235734433792,0,1,0,0,1
1165287088457207808,1,0,0,0,1
1165333096545361920,0,1,0,0,1
1165342268192153600,0,1,0,0,1
1165347489119186944,0,1,0,0,1
1165351979171770368,0,1,0,0,1
1165509192318238720,0,1,0,0,1
1165566683936960512,0,1,0,0,1
1165567269583372288,0,0,1,0,1
1165639611932119040,0,1,0,0,1
1165675670216876032,0,1,0,0,1
1165852901929029632,0,1,0,0,1
1165947769569382400,0,1,0,0,1
1166012613429534720,0,1,0,0,1
1166018778473402368,0,1,0,0,1
1166086297754263552,0,1,0,0,1
1166216039710912512,0,1,0,0,1
1166254308704358400,0,1,0,0,1
1166335287917608960,0,1,0,0,1
1166373763216105472,0,1,0,0,1
1166389489637482496,0,1,0,0,1
1165252639132659712,0,1,0,0,1
1165248248769994752,0,1,0,0,1
1165238265487745024,0,1,0,0,1
1164828882760953856,0,1,0,0,1
1164534122498465792,0,1,0,0,1
1164542864245714944,1,0,0,0,1
1164545454316539904,0,1,0,0,1
1164561857832599552,0,1,0,0,1
1164567864700837888,0,1,0,0,1
1164584236843556864,0,1,0,0,1
1164599786571522048,1,0,0,0,1
1164608578226970624,0,1,0,0,1
1164816794332172288,0,1,0,0,1
1164896810583941120,0,1,0,0,1
1165231042103513088,0,1,0,0,1
1164902235245088768,0,1,0,0,1
1164913459097587712,1,0,0,0,1
1164964437838553088,0,1,0,0,1
1164990045779968000,1,0,0,0,1
1165133049035546624,1,0,0,0,1
1165142757532479488,0,1,0,0,1
1165165577209622528,0,1,0,0,1
1165200056212971520,0,1,0,0,1
1165217495625547776,0,1,0,0,1
1166400933183545344,0,1,0,0,1
1166452030103281664,0,1,0,0,1
1166597941118820352,0,1,0,0,1
1168274626184699904,0,1,0,0,1
1167767978747879424,0,1,0,0,1
1167803592369000448,1,0,0,0,1
1167822408759140352,0,1,0,0,1
1167832418159595520,0,1,0,0,1
1167879324759986176,0,1,0,0,1
1167976291431325696,0,1,0,0,1
1168064868886425600,0,1,0,0,1
1168167356020867072,0,1,0,0,1
1168183983068209152,1,0,0,0,1
1168295686187737088,0,1,0,0,1
1167726883854852096,0,1,0,0,1
1168310342407118848,0,1,0,0,1
1168337228906582016,0,1,0,0,1
1168393821513646080,0,0,0,1,1
1168439884924764160,0,1,0,0,1
1168473327389880320,0,1,0,0,1
1168497930803777536,0,1,0,0,1
1168501791677407232,0,0,1,0,1
1168505980734365696,0,1,0,0,1
1168526291227820032,0,1,0,0,1
1167762658457718784,0,1,0,0,1
1167604043859935232,1,0,0,0,1
1166698198800506880,0,1,0,0,1
1167161671313440768,1,0,0,0,1
1166707317301227520,0,0,0,1,1
1166854722281791488,0,1,0,0,1
1166984122310504448,0,1,0,0,1
1167020872110092288,0,1,0,0,1
1167070572955799552,0,1,0,0,1
1167072786885464064,0,1,0,0,1
1167119086112800768,0,1,0,0,1
1167134481658068992,0,1,0,0,1
1167160370756116480,0,1,0,0,1
1167171649365368832,0,1,0,0,1
1167596558688423936,1,0,0,0,1
1167296480593362944,0,1,0,0,1
1167317339324313600,0,1,0,0,1
1167340712276328448,0,0,0,1,1
1167349911748317184,0,1,0,0,1
1167382817971548160,0,0,0,1,1
1167470807376945152,0,1,0,0,1
1167492377126133760,0,1,0,0,1
1167498414793404416,0,1,0,0,1
1167513531471847424,1,0,0,0,1
1164525371586486272,0,1,0,0,1
1164427092974612480,1,0,0,0,1
1164384041665093632,0,1,0,0,1
1161940291093520384,0,1,0,0,1
1161689238565531648,0,1,0,0,1
1161756872338104320,0,1,0,0,1
1161777698706006016,0,1,0,0,1
1161808503947833344,0,1,0,0,1
1161854011869409280,0,1,0,0,1
1161862753113350144,0,1,0,0,1
1161923413621051392,0,0,1,0,1
1161924136383369216,0,0,0,1,1
1161937864336257024,0,1,0,0,1
1161977615906983936,0,1,0,0,1
1161651985160056832,0,1,0,0,1
1161986110085586944,0,1,0,0,1
1161999969282166784,0,1,0,0,1
1162039126599884800,0,1,0,0,1
1162061310659448832,0,1,0,0,1
1162134511611723776,0,1,0,0,1
1162163838885613568,0,1,0,0,1
1162259294219165696,0,1,0,0,1
1162264537690566656,1,0,0,0,1
1162348307030712320,0,1,0,0,1
1161654142051463168,0,1,0,0,1
1161640414119714816,0,1,0,0,1
1162365605741121536,1,0,0,0,1
1161217833855938560,0,1,0,0,1
1160800901189255168,0,1,0,0,1
1160813439767461888,0,1,0,0,1
1160818946515165184,1,0,0,0,1
1160826462351581184,0,1,0,0,1
1160874566518001664,0,1,0,0,1
1160877601214345216,0,1,0,0,1
1160927508285599744,0,1,0,0,1
1160993741638967296,0,1,0,0,1
1161041482083635200,0,1,0,0,1
1161272344330948608,1,0,0,0,1
1161639460326367232,0,1,0,0,1
1161341919605035008,1,0,0,0,1
1161352371341070336,0,1,0,0,1
1161355132141015040,1,0,0,0,1
1161365415903289344,1,0,0,0,1
1161387278104707072,0,1,0,0,1
1161580762476494848,0,1,0,0,1
1161601124253806592,0,1,0,0,1
1161610592412561408,1,0,0,0,1
1161621291662741504,0,1,0,0,1
1162349670888280064,0,1,0,0,1
1162398428661465088,0,1,0,0,1
1164364356383105024,1,0,0,0,1
1164051389548564480,0,1,0,0,1
1163564062145470464,0,1,0,0,1
1163595241590415360,0,1,0,0,1
1163639151222296576,0,1,0,0,1
1163750290803187712,0,0,1,0,1
1163797811588153344,0,1,0,0,1
1163801435999559680,0,1,0,0,1
1163893460945891328,0,1,0,0,1
1163917765842837504,1,0,0,0,1
1163923626682454016,0,0,1,0,1
1164070862317850624,0,1,0,0,1
1163519522873233408,0,1,0,0,1
1164097528737910784,0,1,0,0,1
1164117416118554624,0,1,0,0,1
1164125278228140032,1,0,0,0,1
1164152813720604672,0,1,0,0,1
1164193675368439808,0,1,0,0,1
1164195905920208896,0,1,0,0,1
1164241660638687232,0,1,0,0,1
1164250966968999936,0,1,0,0,1
1164314082146603008,0,1,0,0,1
1163554169548095488,0,1,0,0,1
1163466682045612032,0,0,1,0,1
1162403596434137088,0,0,0,1,1
1162771559787839488,1,0,0,0,1
1162441321598128128,0,1,0,0,1
1162443165904670720,1,0,0,0,1
1162576216391446528,0,1,0,0,1
1162612230048878592,0,1,0,0,1
1162643026948370432,0,1,0,0,1
1162660747626909696,0,0,0,1,1
1162668912925917184,0,1,0,0,1
1162763064275558400,1,0,0,0,1
1162765502302830592,1,0,0,0,1
1162794411396386816,0,1,0,0,1
1163455132182257664,1,0,0,0,1
1162794972157890560,0,1,0,0,1
1163018123772977152,0,1,0,0,1
1163026746154766336,1,0,0,0,1
1163034664170381312,0,0,0,1,1
1163065616552607744,0,1,0,0,1
1163289695511601152,0,1,0,0,1
1163331495991357440,1,0,0,0,1
1163385451287212032,0,1,0,0,1
1163403792001458176,0,1,0,0,1
1153684033039151104,0,1,0,0,1
1153627174689112064,0,1,0,0,1
1153595295344877568,0,1,0,0,1
1153588286822240256,0,1,0,0,1
1141562187116212224,0,1,0,0,1
1141618067895533568,0,1,0,0,1
1141624062256566272,0,1,0,0,1
1141645094585585664,0,1,0,0,1
1141736028178452480,0,1,0,0,1
1141793699615117312,0,1,0,0,1
1141886059199885312,0,1,0,0,1
1141924747036336128,0,1,0,0,1
1141964173259280384,0,1,0,0,1
1142088978658746368,0,1,0,0,1
1142097255077490688,1,0,0,0,1
1142240457688322048,1,0,0,0,1
1142314093937926144,0,1,0,0,1
1142329122666024960,0,1,0,0,1
1142373492224122880,0,1,0,0,1
1142408484924907520,0,1,0,0,1
1142416600953491456,1,0,0,0,1
1142531295064416256,0,1,0,0,1
1142728768043323392,0,1,0,0,1
1142735688590397440,0,1,0,0,1
1142739533869592576,0,0,0,1,1
1141537663926886400,0,1,0,0,1
1141391424392482816,0,1,0,0,1
1141362055057948672,1,0,0,0,1
1140901154488037376,0,1,0,0,1
1140488922721423360,0,1,0,0,1
1140531487579791360,1,0,0,0,1
1140536379828527104,1,0,0,0,1
1140553040778240000,0,1,0,0,1
1140652630483644416,1,0,0,0,1
1140715216042364928,0,1,0,0,1
1140842561889886208,0,1,0,0,1
1140847778286821376,0,1,0,0,1
1140896894031409152,0,1,0,0,1
1141042360631123968,0,1,0,0,1
1141328166105026560,0,1,0,0,1
1141042845639434240,0,1,0,0,1
1141055785033711616,1,0,0,0,1
1141062612974809088,0,1,0,0,1
1141118501953736704,0,1,0,0,1
1141128272874487808,0,1,0,0,1
1141205592918376448,0,1,0,0,1
1141211044075003904,0,1,0,0,1
1141261482392313856,0,1,0,0,1
1141265753573691392,1,0,0,0,1
1142823403826532352,1,0,0,0,1
1142882025247895552,0,0,0,1,1
1142988218687619072,1,0,0,0,1
1144791143357587456,0,1,0,0,1
1144205527565656064,0,1,0,0,1
1144210681228603392,0,1,0,0,1
1144219899507511296,0,1,0,0,1
1144306290203774976,0,1,0,0,1
1144368566252314624,0,1,0,0,1
1144635877861163008,1,0,0,0,1
1144712681141755904,0,1,0,0,1
1144716342785957888,0,1,0,0,1
1144770913344221184,1,0,0,0,1
1144850581514670080,1,0,0,0,1
1144162942478274560,0,1,0,0,1
1145026476841943040,0,1,0,0,1
1145062445615947776,0,1,0,0,1
1145065768373161984,0,1,0,0,1
1145101678431154176,1,0,0,0,1
1145148245519159296,1,0,0,0,1
1145178968708067328,1,0,0,0,1
1145187289682759680,0,1,0,0,1
1145311145378635776,0,1,0,0,1
1145367281318486016,0,1,0,0,1
1144165314818523136,0,1,0,0,1
1144134672311439360,0,1,0,0,1
1142998031450726400,1,0,0,0,1
1143591891692400640,0,0,1,0,1
1143017053202374656,1,0,0,0,1
1143210869582520320,0,1,0,0,1
1143214066736873472,0,1,0,0,1
1143225143142961152,1,0,0,0,1
1143339438287646720,0,1,0,0,1
1143386381202481152,0,1,0,0,1
1143401252186812416,0,1,0,0,1
1143565757978238976,0,1,0,0,1
1143575597970591744,0,1,0,0,1
1143736722569621504,0,1,0,0,1
1144029358337609728,0,1,0,0,1
1143748225628803072,0,1,0,0,1
1143767570652323840,0,1,0,0,1
1143777878439428096,0,1,0,0,1
1143783024187838464,1,0,0,0,1
1143787128595374080,0,1,0,0,1
1143825249148035072,1,0,0,0,1
1143867473957138432,0,1,0,0,1
1143874116249722880,0,1,0,0,1
1143876957211430912,0,1,0,0,1
1140448556463087616,0,1,0,0,1
1140264357965660160,1,0,0,0,1
1140259922946535424,0,0,1,0,1
1137594824805064704,0,1,0,0,1
1137284157254582272,0,1,0,0,1
1137291320853258240,0,1,0,0,1
1137315361097998336,0,1,0,0,1
1137322439640256512,0,1,0,0,1
1137381356013535232,0,1,0,0,1
1137405138740613120,0,1,0,0,1
1137429036488044544,0,1,0,0,1
1137536480375558144,1,0,0,0,1
1137575156333862912,0,1,0,0,1
1137647205899046912,1,0,0,0,1
1137249953141551104,1,0,0,0,1
1137653397241442304,0,1,0,0,1
1137668832514850816,0,1,0,0,1
1137700871897268224,0,1,0,0,1
1137702197167239168,0,1,0,0,1
1137712820064346112,0,0,1,0,1
1137741783797026816,0,1,0,0,1
1137794794795589632,0,1,0,0,1
1137828400230350848,0,1,0,0,1
1137841071046742016,0,1,0,0,1
1137283978484785152,0,1,0,0,1
1137248960245055488,0,1,0,0,1
1138055039698722816,0,1,0,0,1
1136630148084764672,0,1,0,0,1
1136078995039117312,1,0,0,0,1
1136135250084581376,0,1,0,0,1
1136241694423150592,0,1,0,0,1
1136283551605829632,0,1,0,0,1
1136291607295082496,0,1,0,0,1
1136415373618753536,1,0,0,0,1
1136480903872442368,0,1,0,0,1
1136489182199783424,0,1,0,0,1
1136598002913685504,0,1,0,0,1
1136648606772027392,0,1,0,0,1
1137230202164133888,0,1,0,0,1
1136665737144274944,0,1,0,0,1
1136743177472413696,0,1,0,0,1
1136860920540323840,0,1,0,0,1
1136877465111015424,0,1,0,0,1
1136901582371676160,0,1,0,0,1
1136911104502882304,0,1,0,0,1
1136997482259517440,0,1,0,0,1
1137141078488997888,0,1,0,0,1
1137193135950270464,0,1,0,0,1
1138008810356785152,0,1,0,0,1
1138077424875450368,0,1,0,0,1
1140214830252613632,0,1,0,0,1
1139781597874593792,0,1,0,0,1
1139466724665729024,0,0,1,0,1
1139513471786192896,0,1,0,0,1
1139513551935213568,0,1,0,0,1
1139522419788517376,1,0,0,0,1
1139557269912338432,0,1,0,0,1
1139590434336829440,1,0,0,0,1
1139594936263880704,0,1,0,0,1
1139653093946118144,0,1,0,0,1
1139747780660871168,0,1,0,0,1
1139789537607970816,0,1,0,0,1
1139366476245114880,0,1,0,0,1
1139900838749581312,0,1,0,0,1
1139907366957309952,0,1,0,0,1
1139940813297897472,0,1,0,0,1
1139959200908492800,0,1,0,0,1
1139966606920970240,0,1,0,0,1
1139995265484709888,0,0,1,0,1
1140027995429752832,0,1,0,0,1
1140079135282384896,0,1,0,0,1
1140161099259686912,0,0,0,1,1
1139445163418406912,0,1,0,0,1
1139270163830890496,0,1,0,0,1
1138085984388751360,0,1,0,0,1
1138565756558462976,0,1,0,0,1
1138120588180901888,0,1,0,0,1
1138196577997283328,0,1,0,0,1
1138205061069148160,0,1,0,0,1
1138349682256728064,0,1,0,0,1
1138351619542835200,0,1,0,0,1
1138458267108163584,0,1,0,0,1
1138461801803395072,0,1,0,0,1
1138480032316309504,0,1,0,0,1
1138513293041995776,0,1,0,0,1
1138588680212422656,0,1,0,0,1
1139166821955919872,1,0,0,0,1
1138619811326509056,0,0,1,0,1
1138687459967918080,1,0,0,0,1
1138716264929681408,0,1,0,0,1
1138757376692097024,0,1,0,0,1
1138872715715272704,0,1,0,0,1
1139061320886734848,0,1,0,0,1
1139084733869121536,0,0,0,1,1
1139123137671569408,1,0,0,0,1
1139146394113957888,1,0,0,0,1
1145383034885201920,0,1,0,0,1
1145437287842553856,0,1,0,0,1
1145629330447437824,0,1,0,0,1
1150975186855813120,1,0,0,0,1
1150428213987938304,0,1,0,0,1
1150620132470771712,1,0,0,0,1
1150684395566784512,0,1,0,0,1
1150688410320941056,0,1,0,0,1
1150735053099556864,0,1,0,0,1
1150760110601281536,0,1,0,0,1
1150764854673911808,0,1,0,0,1
1150889540812529664,1,0,0,0,1
1150918397108133888,0,1,0,0,1
1151050062333485056,0,1,0,0,1
1150348996851802112,0,1,0,0,1
1151118101234274304,0,1,0,0,1
1151138901819457536,1,0,0,0,1
1151155577264824320,1,0,0,0,1
1151159232147931136,0,1,0,0,1
1151179270095593472,0,1,0,0,1
1151396331031805952,0,1,0,0,1
1151424488757702656,0,0,0,1,1
1151429754060464128,0,1,0,0,1
1151454362767523840,0,1,0,0,1
1150402165669847040,0,1,0,0,1
1150346737598509056,0,1,0,0,1
1151533023546003456,0,1,0,0,1
1149916193874165760,0,1,0,0,1
1149647721331953664,0,1,0,0,1
1149655751780196352,0,1,0,0,1
1149660575141638144,0,1,0,0,1
1149662651661848576,0,1,0,0,1
1149683985888493568,0,1,0,0,1
1149704365193748480,0,1,0,0,1
1149774353522933760,0,1,0,0,1
1149814984190259200,0,1,0,0,1
1149847886919696384,0,1,0,0,1
1149924761457135616,1,0,0,0,1
1150329789699350528,0,1,0,0,1
1149985393170964480,0,1,0,0,1
1149992027989446656,0,1,0,0,1
1150035264187899904,0,1,0,0,1
1150061646695432192,0,1,0,0,1
1150126908195135488,0,1,0,0,1
1150171508540620800,0,1,0,0,1
1150215415785644032,0,0,0,1,1
1150246839456862208,0,1,0,0,1
1150280908601081856,0,1,0,0,1
1151492286867333120,0,1,0,0,1
1151558208357449728,1,0,0,0,1
1149594200154836992,0,1,0,0,1
1153185377944924160,0,0,0,1,1
1152526455152226304,0,1,0,0,1
1152556173914021888,0,1,0,0,1
1152626533845966848,0,1,0,0,1
1152824105231499264,0,1,0,0,1
1152848443259281408,0,1,0,0,1
1152977022068465664,0,1,0,0,1
1153050652014260224,0,1,0,0,1
1153150165525471232,0,1,0,0,1
1153180340212707328,0,1,0,0,1
1153209291752574976,0,1,0,0,1
1152496630211518464,0,1,0,0,1
1153213406318649344,1,0,0,0,1
1153221292109324288,0,1,0,0,1
1153252292075896832,0,1,0,0,1
1153312145372676096,0,1,0,0,1
1153446152420937728,0,1,0,0,1
1153509385605435392,0,1,0,0,1
1153538355268857856,1,0,0,0,1
1153543186725269504,1,0,0,0,1
1153562732161097728,1,0,0,0,1
1152502507647709184,0,1,0,0,1
1152381478321512448,0,1,0,0,1
1151582868298092544,0,1,0,0,1
1151931301127176192,0,1,0,0,1
1151589010260799488,0,1,0,0,1
1151620395746897920,0,1,0,0,1
1151635412991000576,0,1,0,0,1
1151646661963370496,0,1,0,0,1
1151756595346509824,0,1,0,0,1
1151765026220511232,0,1,0,0,1
1151778153213386752,0,1,0,0,1
1151800029776097280,0,1,0,0,1
1151874434409664512,1,0,0,0,1
1152091859218358272,1,0,0,0,1
1152348175761465344,0,1,0,0,1
1152126316038250496,1,0,0,0,1
1152146368737304576,0,1,0,0,1
1152220550816849920,0,1,0,0,1
1152242741469777920,0,1,0,0,1
1152253920544284672,0,1,0,0,1
1152287144439877632,0,1,0,0,1
1152309517834735616,0,1,0,0,1
1152336157356822528,0,1,0,0,1
1152347402050736128,0,1,0,0,1
1149604936142823424,0,0,0,1,1
1149583296524775424,0,0,1,0,1
1145638178495352832,0,1,0,0,1
1146952263795171328,1,0,0,0,1
1146549672539901952,0,1,0,0,1
1146593591072088064,0,1,0,0,1
1146609515833507840,0,1,0,0,1
1146629355990159360,1,0,0,0,1
1146721421575577600,0,1,0,0,1
1146818675460231168,0,1,0,0,1
1146823398997123072,0,1,0,0,1
1146866750623047680,0,1,0,0,1
1146902835361136640,0,1,0,0,1
1147013909494284288,0,1,0,0,1
1146489391445172224,0,1,0,0,1
1147029794250547200,0,1,0,0,1
1147035080843333632,1,0,0,0,1
1147059940697223168,0,1,0,0,1
1147146865944727552,1,0,0,0,1
1147201132755902464,0,1,0,0,1
1147219846356185088,0,1,0,0,1
1147284129786007552,1,0,0,0,1
1147312172134854656,0,1,0,0,1
1147403702543589376,1,0,0,0,1
1146495739813670912,0,1,0,0,1
1146480313972994048,0,1,0,0,1
1147488610826014720,0,1,0,0,1
1146287445702512640,0,1,0,0,1
1145690169632276480,1,0,0,0,1
1145735905929396224,0,1,0,0,1
1145757419298910208,0,1,0,0,1
1145775837225947136,0,1,0,0,1
1145800699139239936,0,1,0,0,1
1145844445021179904,0,1,0,0,1
1146132676853714944,0,1,0,0,1
1146160299667525632,0,1,0,0,1
1146257647815073792,0,1,0,0,1
1146300388645060608,0,1,0,0,1
1146477790369181696,0,1,0,0,1
1146301076309729280,0,1,0,0,1
1146343835976364032,0,1,0,0,1
1146344359006298112,0,1,0,0,1
1146372033665753088,0,1,0,0,1
1146378793415667712,0,1,0,0,1
1146388742724177920,0,1,0,0,1
1146392145957457920,0,1,0,0,1
1146397573453963264,0,1,0,0,1
1146450931233353728,0,1,0,0,1
1147406616448258048,0,1,0,0,1
1147613125706997760,0,1,0,0,1
1149474281878781952,0,1,0,0,1
1149026282920914944,0,1,0,0,1
1148664834663288832,0,1,0,0,1
1148750544082804736,0,1,0,0,1
1148751050884734976,1,0,0,0,1
1148826151357440000,0,0,0,1,1
1148877348533493760,0,1,0,0,1
1148901116756672512,0,1,0,0,1
1148920570529976320,1,0,0,0,1
1148962221248176128,1,0,0,0,1
1148986892110696448,0,1,0,0,1
1149050958149836800,0,1,0,0,1
1148639434520190976,0,0,0,1,1
1149225832768053248,0,1,0,0,1
1149253721374617600,0,1,0,0,1
1149261060618240000,0,0,1,0,1
1149289378071678976,0,1,0,0,1
1149328230563950592,0,1,0,0,1
1149374737451237376,0,1,0,0,1
1149410983930204160,0,0,1,0,1
1149448039184175104,0,1,0,0,1
1149457738164056064,0,1,0,0,1
1148651988042702848,0,1,0,0,1
1148621799736803328,0,0,0,1,1
1147628442902507520,0,1,0,0,1
1148131158850301952,0,1,0,0,1
1147643190712897536,0,1,0,0,1
1147771740271140864,0,1,0,0,1
1147787505670000640,0,1,0,0,1
1147816137100599296,0,1,0,0,1
1147822081062637568,0,1,0,0,1
1147858346856341504,0,1,0,0,1
1147931883621081088,1,0,0,0,1
1147938704863956992,1,0,0,0,1
1148124194200178688,0,1,0,0,1
1148157413469511680,0,1,0,0,1
1148620121654435840,0,1,0,0,1
1148182506027409408,0,1,0,0,1
1148230061654499328,0,1,0,0,1
1148316970997170176,0,1,0,0,1
1148369878165811200,0,1,0,0,1
1148527920153092096,0,1,0,0,1
1148535987657682944,0,1,0,0,1
1148537196972007424,0,1,0,0,1
1148545209489383424,0,1,0,0,1
1148582754357043200,0,1,0,0,1
4146752234,0,0,0,1,1
2794224719,0,1,0,0,1
4144805410,0,1,0,0,1
279247467,0,1,0,0,1
279342158,0,1,0,0,1
279392943,1,0,0,0,1
279404473,0,1,0,0,1
279534835,0,1,0,0,1
279569852,0,1,0,0,1
279570417,0,1,0,0,1
279677353,0,1,0,0,1
279696514,0,1,0,0,1
279709956,0,1,0,0,1
279721295,0,1,0,0,1
279863727,0,1,0,0,1
279886540,0,1,0,0,1
279923042,0,1,0,0,1
279983524,0,1,0,0,1
279984544,0,1,0,0,1
279995886,0,1,0,0,1
280013232,0,1,0,0,1
280030300,0,1,0,0,1
280034372,0,1,0,0,1
280047036,0,1,0,0,1
280074856,0,1,0,0,1
280086969,0,1,0,0,1
280211853,0,1,0,0,1
279280830,0,1,0,0,1
279110925,0,1,0,0,1
278313187,0,1,0,0,1
279109540,0,1,0,0,1
278388814,0,1,0,0,1
278417777,1,0,0,0,1
278436814,0,1,0,0,1
278439536,0,1,0,0,1
278465388,0,1,0,0,1
278507945,0,1,0,0,1
278533593,0,1,0,0,1
278657678,1,0,0,0,1
278661882,0,1,0,0,1
278662788,0,1,0,0,1
278693491,0,1,0,0,1
278797678,0,1,0,0,1
278828626,0,1,0,0,1
278875361,0,1,0,0,1
278894544,0,1,0,0,1
278904556,1,0,0,0,1
278949070,0,1,0,0,1
278953023,0,1,0,0,1
278981270,0,1,0,0,1
279008431,0,1,0,0,1
279053787,1,0,0,0,1
279081868,0,0,1,0,1
279100535,0,1,0,0,1
280259719,0,1,0,0,1
280291421,1,0,0,0,1
280296013,0,1,0,0,1
280471566,0,1,0,0,1
281545743,0,1,0,0,1
281647101,0,1,0,0,1
281666544,0,1,0,0,1
281698957,0,1,0,0,1
281702589,1,0,0,0,1
281896592,0,1,0,0,1
281901625,0,1,0,0,1
281906784,0,1,0,0,1
281935646,0,0,0,1,1
281942605,0,1,0,0,1
281981255,0,1,0,0,1
281981376,0,1,0,0,1
281984047,0,1,0,0,1
282080570,0,1,0,0,1
282106863,0,1,0,0,1
282124195,0,1,0,0,1
282133428,0,0,0,1,1
282135623,0,1,0,0,1
282195350,0,1,0,0,1
282230249,0,1,0,0,1
282242777,0,1,0,0,1
282243866,0,1,0,0,1
282350129,0,1,0,0,1
281474186,0,0,0,1,1
281158007,0,0,0,1,1
281157434,0,1,0,0,1
280882920,0,1,0,0,1
280476522,0,1,0,0,1
280479778,0,1,0,0,1
280484057,0,1,0,0,1
280522892,0,1,0,0,1
280534144,0,1,0,0,1
280542373,0,1,0,0,1
280575894,0,1,0,0,1
280579405,0,1,0,0,1
280628872,0,0,1,0,1
280660217,0,1,0,0,1
280887246,0,1,0,0,1
281115330,0,1,0,0,1
280901046,0,1,0,0,1
280918611,1,0,0,0,1
280931096,0,1,0,0,1
280995147,1,0,0,0,1
280999269,0,1,0,0,1
281054869,0,1,0,0,1
281056763,0,1,0,0,1
281061344,1,0,0,0,1
281066496,0,1,0,0,1
281104177,0,1,0,0,1
278367765,0,1,0,0,1
278306153,0,1,0,0,1
255666485,0,1,0,0,1
274419949,1,0,0,0,1
274426734,0,0,0,1,1
274441934,1,0,0,0,1
274607351,0,1,0,0,1
274619734,0,1,0,0,1
274637463,0,1,0,0,1
274786373,0,0,1,0,1
274789737,0,1,0,0,1
274803389,0,1,0,0,1
274816731,0,1,0,0,1
274850640,0,1,0,0,1
274868347,0,1,0,0,1
274872967,0,1,0,0,1
274881471,0,1,0,0,1
274901135,0,1,0,0,1
274911857,0,1,0,0,1
274959478,1,0,0,0,1
275008164,0,1,0,0,1
275170735,0,1,0,0,1
275262651,0,1,0,0,1
275271639,1,0,0,0,1
275340576,0,1,0,0,1
275387521,0,1,0,0,1
275463407,0,1,0,0,1
274421693,0,1,0,0,1
274415326,0,1,0,0,1
278254485,0,1,0,0,1
274390780,0,1,0,0,1
273535615,0,1,0,0,1
273561109,0,1,0,0,1
273590297,0,1,0,0,1
273601847,0,1,0,0,1
273616004,0,1,0,0,1
273651218,0,1,0,0,1
273675945,0,1,0,0,1
273705116,0,1,0,0,1
273764586,0,1,0,0,1
273843063,0,1,0,0,1
273895039,0,1,0,0,1
273897097,0,1,0,0,1
273917740,0,1,0,0,1
273918819,0,1,0,0,1
274021448,0,1,0,0,1
274128928,0,1,0,0,1
274237445,0,1,0,0,1
274260490,0,1,0,0,1
274293745,0,1,0,0,1
274307052,0,1,0,0,1
274327563,0,1,0,0,1
274366077,0,1,0,0,1
274382597,0,1,0,0,1
275526940,0,1,0,0,1
275605400,0,0,1,0,1
275637202,0,1,0,0,1
275895426,0,1,0,0,1
277124500,0,1,0,0,1
277132286,0,1,0,0,1
277154493,0,1,0,0,1
277315794,1,0,0,0,1
277336305,0,1,0,0,1
277369414,1,0,0,0,1
277407479,0,1,0,0,1
277417430,0,1,0,0,1
277423834,0,0,0,1,1
277429728,0,1,0,0,1
277448522,1,0,0,0,1
277478140,1,0,0,0,1
277569109,0,1,0,0,1
277645599,0,1,0,0,1
277647642,1,0,0,0,1
277735256,0,1,0,0,1
277746704,0,1,0,0,1
277969727,0,1,0,0,1
277977270,0,1,0,0,1
278017676,0,1,0,0,1
278104211,0,1,0,0,1
278177328,0,0,1,0,1
278243377,0,1,0,0,1
277123894,0,1,0,0,1
277114886,1,0,0,0,1
277084588,0,1,0,0,1
276196149,0,1,0,0,1
275927402,1,0,0,0,1
275994941,0,1,0,0,1
275996606,1,0,0,0,1
276013117,0,1,0,0,1
276038918,1,0,0,0,1
276052767,0,1,0,0,1
276085691,1,0,0,0,1
276122092,0,0,1,0,1
276136623,0,0,0,1,1
276176046,0,1,0,0,1
276382669,1,0,0,0,1
277074699,0,1,0,0,1
276437267,0,1,0,0,1
276453013,0,1,0,0,1
276599726,0,1,0,0,1
276620561,1,0,0,0,1
276652642,0,1,0,0,1
276724785,0,1,0,0,1
276941651,0,1,0,0,1
276981122,0,1,0,0,1
277008431,0,1,0,0,1
277017869,0,1,0,0,1
282361657,0,1,0,0,1
282429189,0,1,0,0,1
282438174,0,1,0,0,1
287781791,0,1,0,0,1
287828467,0,1,0,0,1
287830240,0,1,0,0,1
287830776,0,1,0,0,1
287921070,0,0,0,1,1
288014926,0,1,0,0,1
288019305,0,0,0,1,1
288129081,0,1,0,0,1
288190043,0,0,0,1,1
288209969,0,1,0,0,1
288212562,0,1,0,0,1
288260157,0,1,0,0,1
288292745,0,1,0,0,1
288332624,0,1,0,0,1
288461478,0,1,0,0,1
288663448,0,1,0,0,1
288666322,0,1,0,0,1
288738161,0,1,0,0,1
288753070,0,1,0,0,1
288777134,0,1,0,0,1
288860572,1,0,0,0,1
288876751,0,1,0,0,1
288907208,0,1,0,0,1
289037934,0,1,0,0,1
287817412,0,1,0,0,1
287770340,0,1,0,0,1
282453421,0,1,0,0,1
287591032,0,1,0,0,1
286576967,0,1,0,0,1
286623632,0,1,0,0,1
286634699,0,1,0,0,1
286676739,0,1,0,0,1
286714796,0,1,0,0,1
286756456,0,1,0,0,1
286778765,0,1,0,0,1
286826703,0,1,0,0,1
286839697,0,1,0,0,1
286945350,0,0,0,1,1
286953869,0,1,0,0,1
287049514,0,1,0,0,1
287104526,0,1,0,0,1
287159164,0,1,0,0,1
287199006,0,1,0,0,1
287218995,0,1,0,0,1
287222962,0,1,0,0,1
287276438,0,1,0,0,1
287401862,0,1,0,0,1
287529912,0,1,0,0,1
287534004,0,1,0,0,1
287557798,0,1,0,0,1
287575527,1,0,0,0,1
289047795,0,1,0,0,1
289099928,0,1,0,0,1
289117335,0,1,0,0,1
289147160,0,1,0,0,1
290362175,0,1,0,0,1
290381188,0,1,0,0,1
290413034,1,0,0,0,1
290477263,0,1,0,0,1
290480804,0,1,0,0,1
290517621,1,0,0,0,1
290532768,0,1,0,0,1
290607389,0,1,0,0,1
290623636,0,1,0,0,1
290626806,1,0,0,0,1
290729486,0,1,0,0,1
290763093,1,0,0,0,1
290904917,1,0,0,0,1
290972094,1,0,0,0,1
290984869,1,0,0,0,1
291019620,0,1,0,0,1
291034605,0,1,0,0,1
291082284,0,1,0,0,1
291085118,0,0,0,1,1
291114052,1,0,0,0,1
291168933,0,1,0,0,1
291233742,0,1,0,0,1
291323391,0,1,0,0,1
290194975,0,1,0,0,1
290026326,0,1,0,0,1
289970343,0,1,0,0,1
289510473,0,1,0,0,1
289280797,0,1,0,0,1
289299293,0,1,0,0,1
289366028,0,1,0,0,1
289386959,0,1,0,0,1
289392432,0,1,0,0,1
289400483,0,1,0,0,1
289414354,0,1,0,0,1
289443555,1,0,0,0,1
289450365,0,1,0,0,1
289458652,1,0,0,0,1
289514830,0,1,0,0,1
289967800,0,1,0,0,1
289578398,0,1,0,0,1
289711108,0,1,0,0,1
289721966,0,1,0,0,1
289740746,0,1,0,0,1
289747289,0,1,0,0,1
289766372,0,1,0,0,1
289858685,0,1,0,0,1
289858769,0,1,0,0,1
289883627,0,1,0,0,1
289952622,0,1,0,0,1
286563807,0,1,0,0,1
286544519,0,1,0,0,1
286380042,0,1,0,0,1
283989520,0,1,0,0,1
283368301,0,1,0,0,1
283402871,0,1,0,0,1
283407421,0,1,0,0,1
283473302,0,1,0,0,1
283474794,0,1,0,0,1
283512386,0,1,0,0,1
283538154,0,1,0,0,1
283559695,0,1,0,0,1
283566645,0,1,0,0,1
283575095,0,1,0,0,1
283613990,0,1,0,0,1
283618117,0,1,0,0,1
283685299,0,1,0,0,1
283708433,0,1,0,0,1
283714036,0,1,0,0,1
283722194,0,1,0,0,1
283811983,0,1,0,0,1
283839404,0,1,0,0,1
283880216,0,0,0,1,1
283890539,0,1,0,0,1
283900044,0,1,0,0,1
283904509,1,0,0,0,1
283945602,0,1,0,0,1
283269831,0,1,0,0,1
283246957,0,1,0,0,1
283149393,0,1,0,0,1
282778153,0,1,0,0,1
282460602,0,1,0,0,1
282463598,1,0,0,0,1
282486535,0,1,0,0,1
282488180,0,1,0,0,1
282517524,0,1,0,0,1
282519159,0,1,0,0,1
282523827,0,1,0,0,1
282575436,0,1,0,0,1
282587437,1,0,0,0,1
282635196,0,1,0,0,1
282803801,0,1,0,0,1
283143147,0,1,0,0,1
282853105,0,1,0,0,1
282855077,1,0,0,0,1
282860069,0,1,0,0,1
282903227,0,1,0,0,1
282929316,0,1,0,0,1
282955722,0,0,0,1,1
283030492,0,1,0,0,1
283066467,0,1,0,0,1
283105652,0,1,0,0,1
283131287,0,1,0,0,1
283964630,0,1,0,0,1
284048978,1,0,0,0,1
286229362,0,1,0,0,1
284082877,1,0,0,0,1
285165839,0,1,0,0,1
285178343,0,1,0,0,1
285194812,0,0,1,0,1
285217775,0,1,0,0,1
285237810,0,1,0,0,1
285280375,0,1,0,0,1
285312648,0,1,0,0,1
285390358,0,1,0,0,1
285508003,1,0,0,0,1
285553086,1,0,0,0,1
285559193,0,1,0,0,1
285639240,0,1,0,0,1
285719381,0,1,0,0,1
285858668,0,1,0,0,1
285906646,0,1,0,0,1
286038450,0,1,0,0,1
286076676,1,0,0,0,1
286098603,1,0,0,0,1
286119367,1,0,0,0,1
286120341,1,0,0,0,1
286166105,1,0,0,0,1
286211090,0,1,0,0,1
286217515,0,1,0,0,1
285132974,0,1,0,0,1
285111291,0,1,0,0,1
284873662,0,1,0,0,1
284466787,0,0,1,0,1
284137344,0,1,0,0,1
284182005,0,1,0,0,1
284197767,1,0,0,0,1
284205584,0,1,0,0,1
284244856,1,0,0,0,1
284305762,0,1,0,0,1
284329187,1,0,0,0,1
284379232,0,1,0,0,1
284396126,0,1,0,0,1
284428368,0,1,0,0,1
284501865,0,0,1,0,1
284865787,0,1,0,0,1
284505743,0,1,0,0,1
284580467,0,1,0,0,1
284592099,0,1,0,0,1
284615851,0,1,0,0,1
284620156,0,1,0,0,1
284702711,0,1,0,0,1
284716077,0,1,0,0,1
284737215,0,1,0,0,1
284798695,0,1,0,0,1
284825253,0,1,0,0,1
273510782,0,1,0,0,1
273505424,1,0,0,0,1
273471585,1,0,0,0,1
261052437,0,1,0,0,1
261068895,0,1,0,0,1
261144796,0,1,0,0,1
261154149,0,1,0,0,1
261174847,0,0,0,1,1
261183264,1,0,0,0,1
261297206,0,1,0,0,1
261309625,0,1,0,0,1
261313105,0,0,0,1,1
261335752,0,1,0,0,1
261342161,0,1,0,0,1
261372795,1,0,0,0,1
261387194,0,1,0,0,1
261434036,0,1,0,0,1
261481213,0,1,0,0,1
261498009,0,1,0,0,1
261523090,0,1,0,0,1
261581317,1,0,0,0,1
261780905,0,1,0,0,1
261808527,0,1,0,0,1
261824496,0,1,0,0,1
261851037,0,1,0,0,1
262017494,0,1,0,0,1
262027899,0,0,1,0,1
261066988,0,1,0,0,1
260928627,0,1,0,0,1
263997248,0,1,0,0,1
260911380,0,1,0,0,1
260157834,0,1,0,0,1
260160153,0,1,0,0,1
260161428,0,1,0,0,1
260163827,0,1,0,0,1
260183169,1,0,0,0,1
260196527,0,1,0,0,1
260232946,0,1,0,0,1
260245776,0,1,0,0,1
260360978,0,1,0,0,1
260367497,0,1,0,0,1
260374791,0,1,0,0,1
260376774,0,1,0,0,1
260509754,0,1,0,0,1
260515848,0,1,0,0,1
260526690,0,1,0,0,1
260566586,0,1,0,0,1
260616980,0,1,0,0,1
260678941,0,1,0,0,1
260695221,1,0,0,0,1
260702525,0,1,0,0,1
260753718,0,1,0,0,1
260788757,0,1,0,0,1
260842060,0,1,0,0,1
262062791,0,1,0,0,1
262069265,0,1,0,0,1
262095203,0,1,0,0,1
262105003,0,1,0,0,1
263170460,0,1,0,0,1
263244426,1,0,0,0,1
263290085,0,1,0,0,1
263291440,0,1,0,0,1
263312727,1,0,0,0,1
263491535,0,1,0,0,1
263498648,0,1,0,0,1
263519006,0,1,0,0,1
263551366,0,1,0,0,1
263559782,1,0,0,0,1
263597870,0,1,0,0,1
263602520,0,1,0,0,1
263609457,0,1,0,0,1
263618687,0,1,0,0,1
263626938,0,1,0,0,1
263651058,0,1,0,0,1
263653221,1,0,0,0,1
263655450,0,1,0,0,1
263737759,0,1,0,0,1
263763124,0,1,0,0,1
263775143,1,0,0,0,1
263832478,0,1,0,0,1
263862097,0,0,0,1,1
263099490,0,1,0,0,1
263078595,1,0,0,0,1
263071871,0,1,0,0,1
262675787,0,1,0,0,1
262110236,0,1,0,0,1
262118611,0,1,0,0,1
262142048,1,0,0,0,1
262197881,0,1,0,0,1
262264109,0,1,0,0,1
262289964,1,0,0,0,1
262414861,0,1,0,0,1
262444385,0,1,0,0,1
262516467,0,1,0,0,1
262522211,0,1,0,0,1
262710048,0,1,0,0,1
263032796,0,1,0,0,1
262728565,0,1,0,0,1
262755165,0,1,0,0,1
262778255,0,1,0,0,1
262846087,0,1,0,0,1
262858147,0,1,0,0,1
262900743,0,1,0,0,1
262913720,0,1,0,0,1
262971394,0,1,0,0,1
263002782,0,1,0,0,1
263023980,0,1,0,0,1
260151453,0,1,0,0,1
260109581,0,1,0,0,1
260107185,1,0,0,0,1
257660261,0,0,0,1,1
256691597,0,1,0,0,1
256700131,0,1,0,0,1
256705538,1,0,0,0,1
256748501,0,1,0,0,1
256748505,0,1,0,0,1
256771805,0,1,0,0,1
256902898,0,1,0,0,1
256965060,0,1,0,0,1
256966988,0,1,0,0,1
257006352,1,0,0,0,1
257086575,1,0,0,0,1
257123996,0,1,0,0,1
257135605,0,1,0,0,1
257138939,0,1,0,0,1
257181941,0,1,0,0,1
257377625,0,1,0,0,1
257424954,0,1,0,0,1
257452039,0,1,0,0,1
257474204,0,1,0,0,1
257531689,0,0,0,1,1
257534544,0,1,0,0,1
257604006,0,1,0,0,1
257610699,0,1,0,0,1
256643687,0,1,0,0,1
256572562,0,1,0,0,1
256571760,0,1,0,0,1
255945378,1,0,0,0,1
255667704,0,1,0,0,1
255675243,0,1,0,0,1
255731429,1,0,0,0,1
255767431,0,1,0,0,1
255804172,1,0,0,0,1
255819246,0,1,0,0,1
255844418,0,1,0,0,1
255876728,1,0,0,0,1
255883250,0,1,0,0,1
255888164,0,1,0,0,1
255984009,0,1,0,0,1
256543090,0,1,0,0,1
256024378,0,1,0,0,1
256032589,0,1,0,0,1
256041804,0,1,0,0,1
256087496,0,1,0,0,1
256112180,0,1,0,0,1
256124395,0,1,0,0,1
256299100,0,1,0,0,1
256415196,0,1,0,0,1
256432652,0,1,0,0,1
256450448,0,1,0,0,1
257634317,0,1,0,0,1
257873088,1,0,0,0,1
260044880,1,0,0,0,1
257876325,1,0,0,0,1
259249514,0,1,0,0,1
259257341,0,1,0,0,1
259286568,0,1,0,0,1
259316586,0,1,0,0,1
259359950,0,1,0,0,1
259361321,0,1,0,0,1
259389485,0,1,0,0,1
259419321,0,1,0,0,1
259457046,0,1,0,0,1
259500240,0,1,0,0,1
259507709,0,1,0,0,1
259583146,0,1,0,0,1
259626743,1,0,0,0,1
259627785,0,1,0,0,1
259665239,0,1,0,0,1
259674954,1,0,0,0,1
259762811,0,1,0,0,1
259825843,1,0,0,0,1
259905536,0,1,0,0,1
259917510,0,1,0,0,1
259940179,0,1,0,0,1
260020605,0,1,0,0,1
260026769,0,1,0,0,1
259197760,0,1,0,0,1
259196123,1,0,0,0,1
259189382,0,1,0,0,1
258450358,0,1,0,0,1
257943213,1,0,0,0,1
257974565,1,0,0,0,1
258003493,0,1,0,0,1
258251266,0,1,0,0,1
258299086,0,1,0,0,1
258330767,0,1,0,0,1
258365544,0,1,0,0,1
258424709,0,1,0,0,1
258441735,0,1,0,0,1
258443164,0,1,0,0,1
258530074,0,1,0,0,1
259146905,0,1,0,0,1
258534149,0,1,0,0,1
258562415,0,1,0,0,1
258607951,1,0,0,0,1
258610596,0,0,0,1,1
258698852,1,0,0,0,1
258710092,0,1,0,0,1
258722207,1,0,0,0,1
258948008,0,1,0,0,1
258965300,0,1,0,0,1
259133706,0,1,0,0,1
263982175,0,1,0,0,1
264023990,0,1,0,0,1
273462851,0,1,0,0,1
269684549,0,1,0,0,1
269735227,1,0,0,0,1
269791228,0,1,0,0,1
269855467,0,1,0,0,1
269978761,1,0,0,0,1
269997972,1,0,0,0,1
270056523,0,1,0,0,1
270152253,0,1,0,0,1
270173799,0,1,0,0,1
270192005,0,1,0,0,1
270254973,0,0,0,1,1
270272869,1,0,0,0,1
270277620,0,1,0,0,1
270313008,0,1,0,0,1
270343236,0,1,0,0,1
270383285,1,0,0,0,1
270456078,1,0,0,0,1
270458711,0,1,0,0,1
270630692,0,1,0,0,1
270725238,0,1,0,0,1
270729410,0,1,0,0,1
270764074,0,1,0,0,1
270839678,0,1,0,0,1
270855321,0,1,0,0,1
269728575,0,1,0,0,1
269663160,0,1,0,0,1
264065886,0,1,0,0,1
269597671,0,0,1,0,1
268720826,0,1,0,0,1
268752214,0,1,0,0,1
268770905,0,1,0,0,1
268773741,0,1,0,0,1
268859974,1,0,0,0,1
268960597,0,1,0,0,1
268975038,0,1,0,0,1
268981596,0,1,0,0,1
268985872,0,1,0,0,1
269123684,0,1,0,0,1
269145372,0,1,0,0,1
269149221,0,1,0,0,1
269185215,0,1,0,0,1
269249684,1,0,0,0,1
269273119,0,1,0,0,1
269282699,0,1,0,0,1
269283361,0,1,0,0,1
269316906,0,1,0,0,1
269331951,0,1,0,0,1
269381806,0,1,0,0,1
269420311,0,1,0,0,1
269536769,0,1,0,0,1
269571121,0,1,0,0,1
270904787,0,1,0,0,1
270940712,0,1,0,0,1
270948033,1,0,0,0,1
270955314,0,1,0,0,1
272785154,0,1,0,0,1
272790998,0,1,0,0,1
272797398,0,1,0,0,1
272859351,1,0,0,0,1
272863440,0,1,0,0,1
272865604,0,1,0,0,1
272883410,0,1,0,0,1
272900004,0,1,0,0,1
272906542,0,1,0,0,1
272913569,0,1,0,0,1
272918214,0,1,0,0,1
272941547,1,0,0,0,1
273017798,0,1,0,0,1
273028161,1,0,0,0,1
273054582,0,1,0,0,1
273069893,0,1,0,0,1
273105100,0,1,0,0,1
273131934,0,1,0,0,1
273172949,0,1,0,0,1
273268823,0,1,0,0,1
273319938,0,1,0,0,1
273336740,0,1,0,0,1
273421695,0,1,0,0,1
272740304,0,1,0,0,1
272731298,1,0,0,0,1
272656321,0,1,0,0,1
271669361,1,0,0,0,1
270974623,0,1,0,0,1
271045372,0,1,0,0,1
271138622,0,1,0,0,1
271358835,0,1,0,0,1
271365071,0,1,0,0,1
271390346,0,1,0,0,1
271390399,0,1,0,0,1
271489389,0,1,0,0,1
271573450,0,1,0,0,1
271667471,0,1,0,0,1
271759339,0,1,0,0,1
272413167,1,0,0,0,1
271931493,0,1,0,0,1
271966446,0,0,1,0,1
272004776,0,1,0,0,1
272102834,0,1,0,0,1
272137926,0,1,0,0,1
272219085,0,1,0,0,1
272222970,0,0,0,1,1
272353489,0,1,0,0,1
272375818,1,0,0,0,1
272377731,0,1,0,0,1
268702334,1,0,0,0,1
268693713,1,0,0,0,1
268690920,1,0,0,0,1
265965847,0,1,0,0,1
264712270,0,1,0,0,1
264777639,0,0,1,0,1
264781838,0,1,0,0,1
264788807,0,1,0,0,1
264846751,0,1,0,0,1
264850057,1,0,0,0,1
264944313,0,1,0,0,1
264979622,1,0,0,0,1
265001354,0,1,0,0,1
265252243,0,1,0,0,1
265284067,0,1,0,0,1
265307837,0,1,0,0,1
265317666,0,1,0,0,1
265345303,0,1,0,0,1
265440715,0,1,0,0,1
265514380,0,1,0,0,1
265520722,0,1,0,0,1
265534473,0,1,0,0,1
265553029,0,1,0,0,1
265588231,0,1,0,0,1
265830644,0,1,0,0,1
265861907,0,1,0,0,1
265869070,0,1,0,0,1
264710134,1,0,0,0,1
264670908,0,1,0,0,1
264637031,0,1,0,0,1
264359201,0,1,0,0,1
264079450,0,0,1,0,1
264118753,0,1,0,0,1
264123592,0,1,0,0,1
264134386,0,1,0,0,1
264196423,0,1,0,0,1
264223925,0,1,0,0,1
264255020,0,1,0,0,1
264284216,0,1,0,0,1
264295758,0,1,0,0,1
264329994,1,0,0,0,1
264370589,0,1,0,0,1
264615319,0,1,0,0,1
264387077,0,1,0,0,1
264398246,0,1,0,0,1
264423727,0,1,0,0,1
264425583,0,1,0,0,1
264480421,0,1,0,0,1
264497768,0,1,0,0,1
264528327,0,0,0,1,1
264589023,0,1,0,0,1
264598439,0,0,1,0,1
264614699,0,1,0,0,1
265922642,0,1,0,0,1
265992895,1,0,0,0,1
268614947,0,1,0,0,1
266110657,1,0,0,0,1
267752981,0,1,0,0,1
267756483,0,1,0,0,1
267782837,0,1,0,0,1
267845152,0,1,0,0,1
267860210,1,0,0,0,1
267872173,0,1,0,0,1
267902492,0,1,0,0,1
267934228,0,1,0,0,1
268091340,0,1,0,0,1
268108969,0,1,0,0,1
268118234,1,0,0,0,1
268119882,0,1,0,0,1
268175330,0,1,0,0,1
268189299,0,0,0,1,1
268193650,0,1,0,0,1
268251677,1,0,0,0,1
268299686,0,1,0,0,1
268355479,0,1,0,0,1
268435590,0,1,0,0,1
268452474,0,1,0,0,1
268513602,1,0,0,0,1
268597552,0,1,0,0,1
268609318,0,1,0,0,1
267736279,0,1,0,0,1
267698050,0,1,0,0,1
267671290,1,0,0,0,1
266738120,0,1,0,0,1
266144764,0,1,0,0,1
266169380,1,0,0,0,1
266206583,0,1,0,0,1
266395802,0,1,0,0,1
266405526,0,1,0,0,1
266548176,0,1,0,0,1
266553441,1,0,0,0,1
266688011,1,0,0,0,1
266690815,0,1,0,0,1
266733808,0,1,0,0,1
266820951,0,1,0,0,1
267666940,0,1,0,0,1
266840345,1,0,0,0,1
266867464,1,0,0,0,1
266945066,0,1,0,0,1
267042285,0,1,0,0,1
267090808,0,1,0,0,1
267105326,0,1,0,0,1
267212564,0,1,0,0,1
267259252,0,1,0,0,1
267273039,0,1,0,0,1
267313351,0,1,0,0,1
291325397,0,1,0,0,1
291341583,0,1,0,0,1
291425726,0,1,0,0,1
315729571,0,1,0,0,1
315840811,0,1,0,0,1
315892455,0,1,0,0,1
315940985,0,1,0,0,1
315970503,1,0,0,0,1
315984481,0,1,0,0,1
316001469,1,0,0,0,1
316091049,0,1,0,0,1
316130208,0,1,0,0,1
316195435,1,0,0,0,1
316247141,0,1,0,0,1
316281435,1,0,0,0,1
316283748,0,1,0,0,1
316307531,0,1,0,0,1
316422171,0,1,0,0,1
316486778,0,1,0,0,1
316517634,0,1,0,0,1
316653826,0,1,0,0,1
316694769,1,0,0,0,1
316728137,0,1,0,0,1
316757985,0,1,0,0,1
316823138,0,1,0,0,1
316859297,0,0,1,0,1
317040759,1,0,0,0,1
315785177,0,1,0,0,1
315723048,0,1,0,0,1
319324902,0,0,0,1,1
315706302,0,1,0,0,1
314848751,0,1,0,0,1
314937259,0,1,0,0,1
314983614,1,0,0,0,1
315026666,0,1,0,0,1
315034633,0,1,0,0,1
315080933,0,1,0,0,1
315081245,1,0,0,0,1
315201400,0,1,0,0,1
315217244,0,1,0,0,1
315258150,0,1,0,0,1
315314744,0,1,0,0,1
315336984,0,1,0,0,1
315369808,0,1,0,0,1
315413065,0,1,0,0,1
315461934,0,1,0,0,1
315489625,0,1,0,0,1
315570165,1,0,0,0,1
315651138,1,0,0,0,1
315656415,0,1,0,0,1
315660529,1,0,0,0,1
315678601,0,1,0,0,1
315683770,0,1,0,0,1
315690250,1,0,0,0,1
317055217,0,1,0,0,1
317062338,0,1,0,0,1
317076074,1,0,0,0,1
317081222,0,1,0,0,1
318366780,0,1,0,0,1
318369987,0,1,0,0,1
318378299,0,1,0,0,1
318396856,0,1,0,0,1
318450797,0,1,0,0,1
318535052,0,1,0,0,1
318536192,0,1,0,0,1
318560413,0,1,0,0,1
318618279,0,1,0,0,1
318634220,0,0,0,1,1
318743282,1,0,0,0,1
318812419,0,1,0,0,1
318897829,1,0,0,0,1
318958537,0,1,0,0,1
318961669,0,1,0,0,1
319007142,0,1,0,0,1
319008360,0,1,0,0,1
319016405,0,0,1,0,1
319043970,1,0,0,0,1
319048081,0,1,0,0,1
319087173,0,1,0,0,1
319131265,0,1,0,0,1
319201196,1,0,0,0,1
318353782,0,1,0,0,1
318326518,1,0,0,0,1
318308102,0,1,0,0,1
317787275,0,1,0,0,1
317102568,1,0,0,0,1
317114485,0,1,0,0,1
317303675,1,0,0,0,1
317377922,0,1,0,0,1
317396828,0,1,0,0,1
317545421,0,1,0,0,1
317589429,0,1,0,0,1
317630825,0,1,0,0,1
317667936,0,1,0,0,1
317785570,0,1,0,0,1
317805433,0,1,0,0,1
318240030,0,1,0,0,1
317807791,0,1,0,0,1
317833648,1,0,0,0,1
317903232,0,1,0,0,1
317927128,0,0,0,1,1
317969002,0,1,0,0,1
318031592,0,1,0,0,1
318060176,0,1,0,0,1
318082986,0,1,0,0,1
318086666,0,1,0,0,1
318113615,0,1,0,0,1
314775984,0,1,0,0,1
314735166,0,1,0,0,1
314733031,0,1,0,0,1
311938631,0,1,0,0,1
311092045,0,1,0,0,1
311128675,0,1,0,0,1
311243724,0,1,0,0,1
311267833,0,1,0,0,1
311267986,0,1,0,0,1
311282110,0,1,0,0,1
311354967,0,1,0,0,1
311367013,0,1,0,0,1
311394118,0,1,0,0,1
311395462,0,1,0,0,1
311418865,0,1,0,0,1
311465042,0,1,0,0,1
311466554,0,0,0,1,1
311496513,0,1,0,0,1
311510202,1,0,0,0,1
311608751,0,1,0,0,1
311614578,0,1,0,0,1
311618496,1,0,0,0,1
311638161,0,1,0,0,1
311822811,0,1,0,0,1
311835072,0,1,0,0,1
311856795,1,0,0,0,1
311901670,0,1,0,0,1
311071591,0,1,0,0,1
311045157,0,1,0,0,1
311033525,0,1,0,0,1
310510296,0,1,0,0,1
309518307,1,0,0,0,1
309565001,0,0,0,1,1
309639874,0,1,0,0,1
309662359,0,1,0,0,1
309774282,0,1,0,0,1
309781060,0,0,1,0,1
310031002,0,1,0,0,1
310178081,0,1,0,0,1
310310325,0,1,0,0,1
310402774,0,1,0,0,1
310564797,0,1,0,0,1
311011135,0,1,0,0,1
310609292,0,1,0,0,1
310654621,0,1,0,0,1
310813265,0,1,0,0,1
310814744,0,1,0,0,1
310824561,0,1,0,0,1
310828139,1,0,0,0,1
310838078,1,0,0,0,1
310921697,0,1,0,0,1
310932415,0,1,0,0,1
310956423,1,0,0,0,1
311912478,0,1,0,0,1
311956816,0,1,0,0,1
314719682,0,1,0,0,1
312041749,0,1,0,0,1
313586557,0,1,0,0,1
313643987,0,1,0,0,1
313648273,0,1,0,0,1
313661588,0,1,0,0,1
313728802,1,0,0,0,1
313762793,0,1,0,0,1
313802110,0,1,0,0,1
313849099,0,1,0,0,1
313867955,0,1,0,0,1
313871999,0,1,0,0,1
313879451,1,0,0,0,1
313885569,0,1,0,0,1
313929176,0,1,0,0,1
313938487,0,1,0,0,1
314114415,0,1,0,0,1
314226855,0,1,0,0,1
314233869,0,1,0,0,1
314353093,0,1,0,0,1
314372414,0,1,0,0,1
314377342,0,1,0,0,1
314419039,0,1,0,0,1
314577095,0,1,0,0,1
314613185,0,1,0,0,1
313542727,0,1,0,0,1
313529206,0,0,0,1,1
313454492,0,1,0,0,1
312703042,0,1,0,0,1
312127217,0,1,0,0,1
312139533,0,1,0,0,1
312153262,0,1,0,0,1
312169249,0,0,1,0,1
312203213,1,0,0,0,1
312284005,0,1,0,0,1
312344844,0,1,0,0,1
312417934,0,1,0,0,1
312567099,0,1,0,0,1
312691936,0,1,0,0,1
312704201,0,1,0,0,1
313406010,0,1,0,0,1
312778341,1,0,0,0,1
312884433,0,1,0,0,1
312968278,0,1,0,0,1
313127588,0,1,0,0,1
313148987,0,1,0,0,1
313270318,0,1,0,0,1
313303962,0,1,0,0,1
313320099,0,1,0,0,1
313330311,0,1,0,0,1
313400540,0,1,0,0,1
319208793,0,1,0,0,1
319406270,0,1,0,0,1
309453661,0,1,0,0,1
325573139,0,0,0,1,1
325629260,0,1,0,0,1
325685723,0,1,0,0,1
325697107,0,1,0,0,1
325740738,0,1,0,0,1
325832451,0,1,0,0,1
325847220,0,1,0,0,1
325924495,1,0,0,0,1
325968579,0,1,0,0,1
326167025,1,0,0,0,1
326173104,0,1,0,0,1
326222913,0,1,0,0,1
326272095,1,0,0,0,1
326293910,0,1,0,0,1
326335937,0,0,0,1,1
326401697,0,1,0,0,1
326448466,1,0,0,0,1
326474804,0,1,0,0,1
326476529,0,1,0,0,1
326540264,0,1,0,0,1
326738807,0,1,0,0,1
326754583,0,0,1,0,1
326797258,0,1,0,0,1
326864625,0,1,0,0,1
325620670,0,1,0,0,1
325548856,1,0,0,0,1
319423927,0,1,0,0,1
325510247,0,1,0,0,1
324120875,0,1,0,0,1
324224762,0,1,0,0,1
324238777,1,0,0,0,1
324248244,0,1,0,0,1
324291067,0,1,0,0,1
324301810,0,1,0,0,1
324333183,0,1,0,0,1
324526133,0,1,0,0,1
324690605,0,1,0,0,1
324724181,0,1,0,0,1
324781804,1,0,0,0,1
324810785,0,1,0,0,1
324937840,0,1,0,0,1
324944176,0,0,1,0,1
324952277,0,0,0,1,1
324985263,0,1,0,0,1
324985853,0,0,0,1,1
325024711,0,1,0,0,1
325122747,0,1,0,0,1
325307884,0,1,0,0,1
325403700,0,1,0,0,1
325407966,1,0,0,0,1
325426526,0,1,0,0,1
326957691,0,1,0,0,1
326987405,0,1,0,0,1
327016851,1,0,0,0,1
327139161,0,1,0,0,1
328426716,0,1,0,0,1
328446694,0,1,0,0,1
328457935,0,1,0,0,1
328478587,0,1,0,0,1
328484250,0,1,0,0,1
328545947,0,1,0,0,1
328550081,0,1,0,0,1
328560154,0,1,0,0,1
328579670,0,1,0,0,1
328741299,1,0,0,0,1
328816203,0,1,0,0,1
328857610,0,1,0,0,1
328880973,0,1,0,0,1
329014366,0,1,0,0,1
329033788,0,1,0,0,1
329071797,0,1,0,0,1
329094668,0,1,0,0,1
329109886,0,1,0,0,1
329169856,0,1,0,0,1
329174801,0,1,0,0,1
329216331,1,0,0,0,1
329308017,0,1,0,0,1
329355272,0,1,0,0,1
328386200,0,1,0,0,1
328218074,0,1,0,0,1
328215193,1,0,0,0,1
327640544,0,1,0,0,1
327246006,0,1,0,0,1
327254750,0,1,0,0,1
327331956,0,1,0,0,1
327381081,1,0,0,0,1
327426702,0,1,0,0,1
327430636,0,1,0,0,1
327486372,0,1,0,0,1
327529196,0,1,0,0,1
327531955,0,1,0,0,1
327548327,1,0,0,0,1
327656744,0,1,0,0,1
328174018,0,1,0,0,1
327680146,0,1,0,0,1
327814903,0,1,0,0,1
327817778,0,1,0,0,1
327826790,1,0,0,0,1
327866332,0,1,0,0,1
327868314,0,1,0,0,1
327939218,1,0,0,0,1
327951172,0,1,0,0,1
328043116,0,1,0,0,1
328153354,0,1,0,0,1
324117895,1,0,0,0,1
324034425,0,1,0,0,1
323978097,0,1,0,0,1
321437631,1,0,0,0,1
320431432,0,1,0,0,1
320591823,0,1,0,0,1
320628919,0,1,0,0,1
320644130,0,1,0,0,1
320683998,0,1,0,0,1
320703700,0,1,0,0,1
320722426,0,1,0,0,1
320745306,0,1,0,0,1
320790659,0,1,0,0,1
320836035,1,0,0,0,1
320913980,0,1,0,0,1
320919057,0,1,0,0,1
320987975,0,0,1,0,1
321047579,0,1,0,0,1
321212887,0,1,0,0,1
321245574,0,0,1,0,1
321250500,0,1,0,0,1
321274253,0,1,0,0,1
321325674,0,1,0,0,1
321390135,0,1,0,0,1
321395012,0,1,0,0,1
321397123,0,1,0,0,1
321417100,0,1,0,0,1
320417800,1,0,0,0,1
320361997,1,0,0,0,1
320232753,0,1,0,0,1
319762205,0,1,0,0,1
319533093,0,1,0,0,1
319542833,0,0,0,1,1
319593131,0,1,0,0,1
319595840,0,1,0,0,1
319610824,0,1,0,0,1
319627253,1,0,0,0,1
319682354,0,0,0,1,1
319722132,0,1,0,0,1
319723404,0,1,0,0,1
319738458,1,0,0,0,1
319765121,0,1,0,0,1
320204400,1,0,0,0,1
319842419,0,1,0,0,1
319917291,0,1,0,0,1
319962842,0,1,0,0,1
320036317,0,1,0,0,1
320046562,0,1,0,0,1
320090500,0,1,0,0,1
320131750,0,1,0,0,1
320163868,0,1,0,0,1
320192129,0,1,0,0,1
320202799,0,1,0,0,1
321418693,0,1,0,0,1
321498943,0,1,0,0,1
323952207,0,1,0,0,1
321513119,0,1,0,0,1
322876963,1,0,0,0,1
322881021,0,1,0,0,1
322981677,0,1,0,0,1
323098772,0,1,0,0,1
323165684,0,1,0,0,1
323197452,0,1,0,0,1
323227501,1,0,0,0,1
323242859,1,0,0,0,1
323242931,1,0,0,0,1
323363947,1,0,0,0,1
323382281,0,1,0,0,1
323390803,0,1,0,0,1
323410157,0,1,0,0,1
323473548,0,1,0,0,1
323543635,0,1,0,0,1
323643609,0,1,0,0,1
323712217,1,0,0,0,1
323748335,0,1,0,0,1
323781974,0,1,0,0,1
323859058,0,1,0,0,1
323871261,0,0,0,1,1
323871737,1,0,0,0,1
323908596,0,1,0,0,1
322827431,0,1,0,0,1
322728085,0,1,0,0,1
322700536,0,1,0,0,1
321953678,0,1,0,0,1
321536145,0,1,0,0,1
321536443,0,1,0,0,1
321543114,0,1,0,0,1
321577276,0,1,0,0,1
321630247,0,1,0,0,1
321766895,0,0,1,0,1
321797924,0,1,0,0,1
321863431,0,1,0,0,1
321915687,0,1,0,0,1
321945798,0,1,0,0,1
322147980,0,0,0,1,1
322677919,0,1,0,0,1
322168182,0,1,0,0,1
322186032,0,1,0,0,1
322286840,0,1,0,0,1
322304650,0,1,0,0,1
322459327,0,1,0,0,1
322487326,0,0,1,0,1
322512693,0,1,0,0,1
322527094,0,1,0,0,1
322575167,0,1,0,0,1
322615183,0,1,0,0,1
309512660,0,1,0,0,1
309331314,0,1,0,0,1
291592243,0,1,0,0,1
296723219,0,1,0,0,1
296813646,0,1,0,0,1
296874310,0,1,0,0,1
296896512,0,1,0,0,1
296902747,0,1,0,0,1
296964568,0,1,0,0,1
297049585,0,1,0,0,1
297078426,0,1,0,0,1
297086099,0,1,0,0,1
297091089,0,0,0,1,1
297096908,0,1,0,0,1
297209406,0,1,0,0,1
297392032,0,1,0,0,1
297396881,0,1,0,0,1
297413120,0,1,0,0,1
297498464,0,1,0,0,1
297502309,0,1,0,0,1
297510111,0,1,0,0,1
297570602,0,1,0,0,1
297727107,0,0,0,1,1
297880212,1,0,0,0,1
297887055,0,1,0,0,1
297934305,0,1,0,0,1
297958367,0,1,0,0,1
296740406,1,0,0,0,1
296698378,0,1,0,0,1
300548556,0,1,0,0,1
296598612,0,1,0,0,1
295841056,0,1,0,0,1
295842824,0,0,0,1,1
295849676,0,1,0,0,1
295900028,0,0,1,0,1
295930831,0,1,0,0,1
295941102,0,1,0,0,1
295953728,1,0,0,0,1
295966275,0,1,0,0,1
295970796,0,1,0,0,1
296049430,0,1,0,0,1
296078446,0,1,0,0,1
296133247,1,0,0,0,1
296181083,0,1,0,0,1
296192815,1,0,0,0,1
296251084,0,1,0,0,1
296308749,0,1,0,0,1
296313093,0,1,0,0,1
296368293,0,1,0,0,1
296373059,0,1,0,0,1
296418534,0,1,0,0,1
296452855,0,1,0,0,1
296454569,0,1,0,0,1
296505048,0,1,0,0,1
297969029,0,1,0,0,1
298079290,0,1,0,0,1
298104039,0,1,0,0,1
298145793,1,0,0,0,1
299153534,0,1,0,0,1
299297268,0,1,0,0,1
299312724,1,0,0,0,1
299578786,0,1,0,0,1
299599858,0,1,0,0,1
299612236,1,0,0,0,1
299616490,0,1,0,0,1
299680020,0,1,0,0,1
299685030,1,0,0,0,1
299725586,0,1,0,0,1
299795793,0,1,0,0,1
299912439,0,1,0,0,1
299963205,0,1,0,0,1
300069227,0,1,0,0,1
300203395,0,1,0,0,1
300226082,0,1,0,0,1
300238603,0,0,1,0,1
300250110,0,1,0,0,1
300319795,0,1,0,0,1
300425208,0,1,0,0,1
300451989,0,1,0,0,1
300488885,0,1,0,0,1
300491778,0,1,0,0,1
299128095,0,1,0,0,1
299120395,0,1,0,0,1
299061083,1,0,0,0,1
298641701,0,1,0,0,1
298156689,0,1,0,0,1
298170176,0,1,0,0,1
298336600,0,1,0,0,1
298340871,0,1,0,0,1
298386881,0,1,0,0,1
298399843,0,1,0,0,1
298404222,0,1,0,0,1
298548558,1,0,0,0,1
298571054,0,1,0,0,1
298612330,0,1,0,0,1
298647383,0,1,0,0,1
299048866,0,1,0,0,1
298653549,0,1,0,0,1
298686584,0,1,0,0,1
298712624,0,1,0,0,1
298741679,0,1,0,0,1
298748052,0,1,0,0,1
298771953,0,1,0,0,1
298808025,0,1,0,0,1
298914498,0,1,0,0,1
298921070,0,1,0,0,1
299010237,0,1,0,0,1
295834660,1,0,0,0,1
295827800,0,1,0,0,1
295823861,0,1,0,0,1
293358646,0,1,0,0,1
292540069,0,1,0,0,1
292580168,0,1,0,0,1
292592672,1,0,0,0,1
292618412,0,1,0,0,1
292719867,0,1,0,0,1
292797578,0,1,0,0,1
292814457,0,1,0,0,1
292840680,0,1,0,0,1
292864097,0,1,0,0,1
292885857,0,1,0,0,1
292909439,1,0,0,0,1
292909619,0,1,0,0,1
292932766,0,1,0,0,1
292949028,0,0,0,1,1
292984367,1,0,0,0,1
292998648,0,1,0,0,1
293049019,0,1,0,0,1
293052284,0,1,0,0,1
293108180,0,1,0,0,1
293115781,0,1,0,0,1
293205561,0,1,0,0,1
293315470,0,1,0,0,1
293347415,0,1,0,0,1
292505173,0,1,0,0,1
292439491,0,1,0,0,1
292430259,0,1,0,0,1
292217468,0,1,0,0,1
291607726,0,1,0,0,1
291620371,0,1,0,0,1
291771744,0,1,0,0,1
291859054,0,1,0,0,1
291862778,0,1,0,0,1
291925746,0,1,0,0,1
292132524,0,1,0,0,1
292146543,0,1,0,0,1
292162635,0,1,0,0,1
292184713,0,1,0,0,1
292248070,0,1,0,0,1
292426244,0,1,0,0,1
292276905,0,1,0,0,1
292282013,0,1,0,0,1
292301131,0,1,0,0,1
292345292,0,1,0,0,1
292353242,1,0,0,0,1
292383545,0,1,0,0,1
292388359,0,1,0,0,1
292405617,0,1,0,0,1
292409464,0,1,0,0,1
292420286,0,1,0,0,1
293349702,0,1,0,0,1
293385224,0,1,0,0,1
295797876,0,1,0,0,1
293405233,1,0,0,0,1
294863898,0,1,0,0,1
295028029,0,1,0,0,1
295094935,0,0,1,0,1
295095558,0,1,0,0,1
295120211,1,0,0,0,1
295211634,0,1,0,0,1
295237724,0,1,0,0,1
295339332,0,1,0,0,1
295375128,1,0,0,0,1
295452028,0,1,0,0,1
295526046,0,1,0,0,1
295543843,0,1,0,0,1
295549939,0,1,0,0,1
295553697,0,1,0,0,1
295588393,0,1,0,0,1
295606387,0,0,0,1,1
295648326,0,1,0,0,1
295652657,0,1,0,0,1
295675462,0,1,0,0,1
295692276,0,1,0,0,1
295698191,0,1,0,0,1
295717444,1,0,0,0,1
295745642,0,1,0,0,1
294817568,0,1,0,0,1
294493453,0,1,0,0,1
294488035,0,1,0,0,1
294040723,0,1,0,0,1
293516773,1,0,0,0,1
293539332,0,1,0,0,1
293757452,0,1,0,0,1
293850009,0,1,0,0,1
293944193,0,1,0,0,1
293953028,0,1,0,0,1
293953862,0,0,0,1,1
294013572,0,1,0,0,1
294019552,0,1,0,0,1
294027987,0,1,0,0,1
294049177,0,1,0,0,1
294386643,0,1,0,0,1
294071908,0,1,0,0,1
294218448,0,1,0,0,1
294249881,0,1,0,0,1
294282996,0,1,0,0,1
294305749,0,1,0,0,1
294311530,0,1,0,0,1
294336559,0,1,0,0,1
294340420,0,0,0,1,1
294371930,0,1,0,0,1
294374742,0,1,0,0,1
300543331,0,1,0,0,1
300564408,0,1,0,0,1
309295250,0,0,1,0,1
305741660,0,1,0,0,1
305832906,0,1,0,0,1
305877937,0,1,0,0,1
305977039,1,0,0,0,1
306032639,0,1,0,0,1
306053050,0,0,1,0,1
306054703,0,1,0,0,1
306068267,0,1,0,0,1
306159147,0,1,0,0,1
306166986,1,0,0,0,1
306192072,0,1,0,0,1
306320570,0,1,0,0,1
306337543,0,1,0,0,1
306342216,0,1,0,0,1
306368093,0,1,0,0,1
306483344,0,1,0,0,1
306538527,1,0,0,0,1
306611154,0,1,0,0,1
306649020,0,1,0,0,1
306655573,0,1,0,0,1
306658040,0,1,0,0,1
306658635,0,1,0,0,1
306702707,1,0,0,0,1
306716760,1,0,0,0,1
305825799,0,1,0,0,1
305688995,0,1,0,0,1
300585194,0,1,0,0,1
305499708,0,1,0,0,1
304511554,1,0,0,0,1
304575140,0,1,0,0,1
304591682,0,1,0,0,1
304627083,0,1,0,0,1
304686602,0,1,0,0,1
304771434,0,1,0,0,1
304836065,0,1,0,0,1
304869230,0,1,0,0,1
304949145,0,1,0,0,1
304963993,0,1,0,0,1
304996542,0,1,0,0,1
305075408,0,1,0,0,1
305085771,0,1,0,0,1
305196478,0,1,0,0,1
305221233,0,1,0,0,1
305226086,0,1,0,0,1
305245773,0,1,0,0,1
305264846,0,1,0,0,1
305322704,0,0,0,1,1
305358883,1,0,0,0,1
305429918,0,1,0,0,1
305433376,0,1,0,0,1
305488094,0,1,0,0,1
306849308,0,1,0,0,1
306883215,0,1,0,0,1
306918650,0,1,0,0,1
306919109,0,1,0,0,1
308400731,0,1,0,0,1
308416614,0,1,0,0,1
308421917,0,1,0,0,1
308469082,0,1,0,0,1
308511346,0,1,0,0,1
308522652,0,1,0,0,1
308532265,0,1,0,0,1
308550900,0,1,0,0,1
308560113,0,1,0,0,1
308600093,1,0,0,0,1
308724388,0,1,0,0,1
308759465,0,1,0,0,1
308835155,0,1,0,0,1
308887354,0,1,0,0,1
308911696,0,1,0,0,1
308938568,0,1,0,0,1
308942657,0,1,0,0,1
308957169,0,1,0,0,1
308963405,0,1,0,0,1
309071876,0,1,0,0,1
309092640,0,1,0,0,1
309127675,0,1,0,0,1
309275623,1,0,0,0,1
308379717,0,1,0,0,1
308366176,0,1,0,0,1
308347926,0,1,0,0,1
307850851,1,0,0,0,1
306962650,0,1,0,0,1
306997414,0,1,0,0,1
307097375,0,1,0,0,1
307162507,1,0,0,0,1
307229492,0,1,0,0,1
307407974,1,0,0,0,1
307527416,0,1,0,0,1
307572535,0,1,0,0,1
307628491,0,1,0,0,1
307744696,0,1,0,0,1
307905252,0,1,0,0,1
308344290,0,1,0,0,1
307914769,0,1,0,0,1
307986439,0,1,0,0,1
307994732,1,0,0,0,1
308035533,0,1,0,0,1
308044803,0,1,0,0,1
308077503,0,1,0,0,1
308116511,0,1,0,0,1
308170159,0,1,0,0,1
308271303,0,1,0,0,1
308327989,0,1,0,0,1
304503454,0,0,0,1,1
304480873,0,0,0,1,1
304479085,0,1,0,0,1
302628183,0,1,0,0,1
301791990,0,1,0,0,1
301825388,0,1,0,0,1
301910915,0,1,0,0,1
301951931,0,1,0,0,1
301958727,0,1,0,0,1
301959117,0,1,0,0,1
301981923,0,1,0,0,1
301982495,0,1,0,0,1
301998852,0,1,0,0,1
302022703,0,1,0,0,1
302112178,0,0,1,0,1
302188552,0,1,0,0,1
302196003,1,0,0,0,1
302303102,0,1,0,0,1
302369611,0,1,0,0,1
302430950,0,0,0,1,1
302489616,0,1,0,0,1
302497032,0,1,0,0,1
302550283,0,1,0,0,1
302555944,0,1,0,0,1
302566766,0,1,0,0,1
302578162,0,1,0,0,1
302616303,0,1,0,0,1
301748488,0,1,0,0,1
301717777,0,1,0,0,1
301692094,0,1,0,0,1
301335270,0,1,0,0,1
300627553,0,1,0,0,1
300676549,0,1,0,0,1
300881491,0,1,0,0,1
301001004,0,1,0,0,1
301004648,0,1,0,0,1
301071896,0,1,0,0,1
301086126,0,1,0,0,1
301249440,0,1,0,0,1
301257023,0,1,0,0,1
301312937,0,1,0,0,1
301400162,0,1,0,0,1
301668130,0,1,0,0,1
301444625,0,1,0,0,1
301461154,0,1,0,0,1
301499613,0,0,1,0,1
301547306,1,0,0,0,1
301570955,0,1,0,0,1
301584357,0,1,0,0,1
301610351,0,1,0,0,1
301613764,0,1,0,0,1
301622567,0,1,0,0,1
301664105,0,1,0,0,1
302623023,0,1,0,0,1
302647817,0,1,0,0,1
304444441,0,1,0,0,1
302702693,1,0,0,0,1
303324434,0,1,0,0,1
303339570,0,1,0,0,1
303345617,0,1,0,0,1
303368340,1,0,0,0,1
303421399,0,1,0,0,1
303463034,0,1,0,0,1
303517434,0,1,0,0,1
303623821,0,1,0,0,1
303748185,1,0,0,0,1
303848945,1,0,0,0,1
303912017,0,1,0,0,1
303982660,0,1,0,0,1
303986285,0,1,0,0,1
304105935,0,1,0,0,1
304199038,0,0,0,1,1
304211480,0,1,0,0,1
304211641,1,0,0,0,1
304250269,1,0,0,0,1
304259002,1,0,0,0,1
304261353,0,1,0,0,1
304275799,0,1,0,0,1
304406546,0,1,0,0,1
304413542,0,1,0,0,1
303317291,0,1,0,0,1
303316592,1,0,0,0,1
303301226,0,1,0,0,1
302967451,0,1,0,0,1
302704001,0,1,0,0,1
302710397,0,1,0,0,1
302712875,0,0,1,0,1
302766743,0,1,0,0,1
302775028,0,0,0,1,1
302783968,0,1,0,0,1
302829550,0,1,0,0,1
302830835,0,1,0,0,1
302851147,0,1,0,0,1
302910835,0,1,0,0,1
303042985,0,1,0,0,1
303245205,0,1,0,0,1
303062981,0,1,0,0,1
303089854,0,1,0,0,1
303096233,0,1,0,0,1
303109288,0,1,0,0,1
303130542,0,1,0,0,1
303143875,0,1,0,0,1
303148472,0,1,0,0,1
303173034,0,1,0,0,1
303200296,0,0,0,1,1
303219287,0,1,0,0,1
255667282,0,1,0,0,1
255637301,0,1,0,0,1
329487356,0,1,0,0,1
211181742,0,1,0,0,1
211189418,0,0,0,1,1
211225673,0,1,0,0,1
211272531,1,0,0,0,1
211337962,0,1,0,0,1
211376028,0,1,0,0,1
211452255,0,1,0,0,1
211455516,0,1,0,0,1
211458328,0,1,0,0,1
211476981,0,0,1,0,1
211477490,0,1,0,0,1
211501411,0,1,0,0,1
211507619,0,1,0,0,1
211561223,0,1,0,0,1
211606849,0,1,0,0,1
211705405,0,1,0,0,1
211735568,0,1,0,0,1
211861968,0,1,0,0,1
211867366,1,0,0,0,1
211886987,0,1,0,0,1
211929122,0,1,0,0,1
211940361,0,1,0,0,1
212100144,1,0,0,0,1
212106616,0,1,0,0,1
211185134,0,1,0,0,1
211161075,0,1,0,0,1
210008009,0,1,0,0,1
211119735,1,0,0,0,1
210037921,0,1,0,0,1
210048653,0,1,0,0,1
210051575,0,1,0,0,1
210118514,0,1,0,0,1
210184740,0,1,0,0,1
210218880,1,0,0,0,1
210248591,0,1,0,0,1
210432270,0,1,0,0,1
210600859,0,1,0,0,1
210625385,0,1,0,0,1
210678127,1,0,0,0,1
210688911,0,1,0,0,1
210751927,0,1,0,0,1
210778634,0,1,0,0,1
210794285,0,1,0,0,1
210846490,0,1,0,0,1
210875107,1,0,0,0,1
210926594,0,1,0,0,1
210927110,0,1,0,0,1
210950522,0,1,0,0,1
210957759,0,1,0,0,1
210965252,0,1,0,0,1
211055800,1,0,0,0,1
212167038,1,0,0,0,1
212184371,0,1,0,0,1
212217529,0,1,0,0,1
212240467,0,1,0,0,1
213071058,0,1,0,0,1
213086097,0,1,0,0,1
213104561,0,1,0,0,1
213174018,0,1,0,0,1
213227965,0,1,0,0,1
213245607,0,1,0,0,1
213269584,0,1,0,0,1
213269946,0,1,0,0,1
213277106,0,1,0,0,1
213288471,0,1,0,0,1
213318347,0,1,0,0,1
213435663,1,0,0,0,1
213524554,0,1,0,0,1
213538128,0,1,0,0,1
213553986,0,1,0,0,1
213558833,0,1,0,0,1
213662791,0,1,0,0,1
213701553,0,1,0,0,1
213731998,0,1,0,0,1
213785823,0,1,0,0,1
213805541,1,0,0,0,1
213853954,0,1,0,0,1
213878611,0,1,0,0,1
213063233,0,1,0,0,1
213054481,0,1,0,0,1
213030725,0,1,0,0,1
212601963,0,1,0,0,1
212322403,0,0,0,1,1
212350777,0,1,0,0,1
212351588,0,1,0,0,1
212371794,1,0,0,0,1
212381427,0,1,0,0,1
212404225,0,1,0,0,1
212430265,1,0,0,0,1
212508102,0,1,0,0,1
212510667,1,0,0,0,1
212539313,0,1,0,0,1
212624999,0,1,0,0,1
213022384,0,1,0,0,1
212649148,0,1,0,0,1
212653629,1,0,0,0,1
212663167,0,1,0,0,1
212699602,1,0,0,0,1
212810052,0,1,0,0,1
212821939,0,1,0,0,1
212838268,0,1,0,0,1
212838560,0,1,0,0,1
212852324,1,0,0,0,1
212962955,0,1,0,0,1
210022268,0,1,0,0,1
209997156,0,1,0,0,1
255600766,0,1,0,0,1
205287945,0,1,0,0,1
205305379,0,1,0,0,1
205472863,0,1,0,0,1
205654408,0,1,0,0,1
205668508,0,1,0,0,1
205700679,0,1,0,0,1
205706223,0,1,0,0,1
205767452,0,1,0,0,1
205832214,0,1,0,0,1
206096674,0,1,0,0,1
206220082,0,1,0,0,1
206226749,0,1,0,0,1
206310957,0,1,0,0,1
206312017,1,0,0,0,1
206387004,0,1,0,0,1
206469934,0,1,0,0,1
206533380,0,1,0,0,1
206621610,1,0,0,0,1
206655406,0,1,0,0,1
206687146,1,0,0,0,1
206756207,0,1,0,0,1
206788356,0,1,0,0,1
206795644,0,1,0,0,1
206819945,1,0,0,0,1
205305249,0,1,0,0,1
205235353,1,0,0,0,1
209961564,0,1,0,0,1
205122319,0,1,0,0,1
203898200,0,1,0,0,1
203975963,0,1,0,0,1
203994630,0,1,0,0,1
204099797,0,1,0,0,1
204166346,0,1,0,0,1
204286798,0,0,0,1,1
204288840,0,1,0,0,1
204353568,0,1,0,0,1
204488460,0,1,0,0,1
204512308,0,1,0,0,1
204550585,0,1,0,0,1
204559990,1,0,0,0,1
204577757,0,1,0,0,1
204688679,0,1,0,0,1
204729727,1,0,0,0,1
204731069,0,1,0,0,1
204731505,0,1,0,0,1
204819136,0,1,0,0,1
204864531,1,0,0,0,1
204883718,0,1,0,0,1
204916652,0,1,0,0,1
204956711,0,0,1,0,1
204969153,0,1,0,0,1
206824189,0,1,0,0,1
206906996,0,1,0,0,1
206952204,0,1,0,0,1
206990228,0,1,0,0,1
207846524,1,0,0,0,1
208381921,0,1,0,0,1
208411562,0,1,0,0,1
208436602,0,1,0,0,1
208553719,0,1,0,0,1
208598255,0,1,0,0,1
208627952,1,0,0,0,1
208708658,0,1,0,0,1
208889357,0,1,0,0,1
209038563,0,1,0,0,1
209053347,1,0,0,0,1
209074028,0,1,0,0,1
209075089,0,1,0,0,1
209142223,0,1,0,0,1
209261985,0,1,0,0,1
209327080,0,1,0,0,1
209424996,0,1,0,0,1
209530992,0,1,0,0,1
209559437,1,0,0,0,1
209616741,0,1,0,0,1
209618253,0,1,0,0,1
209652875,0,1,0,0,1
209682872,0,1,0,0,1
207740763,0,0,0,1,1
207682271,0,1,0,0,1
207584849,0,1,0,0,1
207136500,0,1,0,0,1
206992479,0,1,0,0,1
207002198,0,1,0,0,1
207025699,0,1,0,0,1
207045192,0,1,0,0,1
207046137,0,1,0,0,1
207072832,0,1,0,0,1
207093756,0,1,0,0,1
207095249,0,1,0,0,1
207103497,0,1,0,0,1
207120519,0,1,0,0,1
207183519,0,1,0,0,1
207560965,0,1,0,0,1
207190699,0,1,0,0,1
207219452,0,1,0,0,1
207229366,0,1,0,0,1
207291498,0,1,0,0,1
207309035,0,1,0,0,1
207401072,0,1,0,0,1
207459428,0,1,0,0,1
207480208,0,1,0,0,1
207536053,1,0,0,0,1
207541030,0,0,0,1,1
213977493,0,1,0,0,1
214090646,0,1,0,0,1
214171423,0,1,0,0,1
220044877,0,1,0,0,1
220110398,1,0,0,0,1
220124701,0,0,0,1,1
220207782,0,1,0,0,1
220276970,0,1,0,0,1
220330515,1,0,0,0,1
220335734,1,0,0,0,1
220455236,0,1,0,0,1
220489253,0,1,0,0,1
220527745,0,1,0,0,1
220621743,0,1,0,0,1
220627281,0,1,0,0,1
220633938,0,1,0,0,1
220681450,0,1,0,0,1
220714570,0,1,0,0,1
220740541,0,1,0,0,1
220758514,1,0,0,0,1
220866923,1,0,0,0,1
220882464,1,0,0,0,1
220882562,0,1,0,0,1
220921857,0,1,0,0,1
220937147,1,0,0,0,1
220955431,1,0,0,0,1
220996082,0,1,0,0,1
220068234,0,1,0,0,1
220043584,0,1,0,0,1
214200844,1,0,0,0,1
219996077,0,1,0,0,1
218974301,0,1,0,0,1
219028502,0,1,0,0,1
219107333,0,1,0,0,1
219207012,0,0,1,0,1
219207035,1,0,0,0,1
219218493,0,1,0,0,1
219280432,0,0,1,0,1
219289786,0,1,0,0,1
219340340,0,1,0,0,1
219373012,1,0,0,0,1
219419370,0,1,0,0,1
219458319,0,1,0,0,1
219488915,0,1,0,0,1
219506418,0,1,0,0,1
219520718,0,1,0,0,1
219569233,0,1,0,0,1
219579364,0,1,0,0,1
219750467,0,1,0,0,1
219797789,0,1,0,0,1
219879996,1,0,0,0,1
219894392,1,0,0,0,1
219955152,0,1,0,0,1
219995427,1,0,0,0,1
220998632,0,1,0,0,1
221007698,0,1,0,0,1
221008937,0,1,0,0,1
221022215,0,1,0,0,1
222160662,0,1,0,0,1
222166736,0,1,0,0,1
222176911,0,1,0,0,1
222189493,0,1,0,0,1
222253154,0,1,0,0,1
222307873,1,0,0,0,1
222340739,0,1,0,0,1
222371467,0,1,0,0,1
222375100,0,1,0,0,1
222413233,0,1,0,0,1
222537873,0,1,0,0,1
222540486,0,1,0,0,1
222603056,0,1,0,0,1
222604603,0,0,0,1,1
222605974,0,1,0,0,1
222676826,0,1,0,0,1
222680595,0,1,0,0,1
222694058,1,0,0,0,1
222723961,0,1,0,0,1
222775300,0,1,0,0,1
222788703,0,1,0,0,1
222835184,0,1,0,0,1
222882837,0,1,0,0,1
222104372,1,0,0,0,1
222073655,0,1,0,0,1
222051500,1,0,0,0,1
221535008,0,1,0,0,1
221039905,0,1,0,0,1
221073887,0,1,0,0,1
221108215,0,1,0,0,1
221245643,0,1,0,0,1
221298715,0,1,0,0,1
221329495,1,0,0,0,1
221352282,0,1,0,0,1
221376648,0,1,0,0,1
221441872,0,1,0,0,1
221480500,0,1,0,0,1
221623049,0,1,0,0,1
222026108,0,1,0,0,1
221671056,1,0,0,0,1
221699666,0,1,0,0,1
221726652,0,1,0,0,1
221743779,0,1,0,0,1
221832244,0,1,0,0,1
221899415,0,0,0,1,1
221936102,0,1,0,0,1
221968104,1,0,0,0,1
221982301,0,0,0,1,1
222023877,1,0,0,0,1
218961432,0,1,0,0,1
218882283,0,1,0,0,1
218787326,0,1,0,0,1
216421320,0,1,0,0,1
215223186,0,1,0,0,1
215294124,0,1,0,0,1
215371662,0,1,0,0,1
215397149,1,0,0,0,1
215409699,0,1,0,0,1
215461965,0,1,0,0,1
215581082,0,1,0,0,1
215618525,0,1,0,0,1
215637492,0,1,0,0,1
215658201,1,0,0,0,1
215708812,0,1,0,0,1
215720948,0,1,0,0,1
215787875,0,1,0,0,1
215886213,0,1,0,0,1
215888193,1,0,0,0,1
215908542,0,1,0,0,1
216036408,0,1,0,0,1
216042363,0,1,0,0,1
216063111,0,1,0,0,1
216288776,0,1,0,0,1
216308857,0,1,0,0,1
216329795,0,1,0,0,1
216336340,0,1,0,0,1
215191961,0,1,0,0,1
215191695,0,1,0,0,1
215190213,0,1,0,0,1
214570826,0,1,0,0,1
214213512,0,1,0,0,1
214306064,0,0,0,1,1
214324033,0,1,0,0,1
214352450,0,1,0,0,1
214360716,0,1,0,0,1
214376875,0,1,0,0,1
214382478,0,1,0,0,1
214392317,0,1,0,0,1
214423533,0,1,0,0,1
214494307,0,1,0,0,1
214613127,0,1,0,0,1
215183117,0,1,0,0,1
214632712,0,1,0,0,1
214738548,0,1,0,0,1
214796336,0,1,0,0,1
214919746,1,0,0,0,1
215007525,0,1,0,0,1
215010257,0,1,0,0,1
215061540,0,1,0,0,1
215067473,1,0,0,0,1
215142665,1,0,0,0,1
215182627,0,1,0,0,1
216349737,0,1,0,0,1
216460093,0,1,0,0,1
218637182,0,1,0,0,1
216460521,0,1,0,0,1
217489193,0,1,0,0,1
217495676,1,0,0,0,1
217517332,0,1,0,0,1
217637159,1,0,0,0,1
217701498,0,1,0,0,1
217763636,1,0,0,0,1
217771456,1,0,0,0,1
217812083,0,1,0,0,1
217855448,0,1,0,0,1
218045639,0,1,0,0,1
218073062,0,1,0,0,1
218083443,0,0,0,1,1
218161379,0,1,0,0,1
218196340,0,1,0,0,1
218235003,0,1,0,0,1
218247339,0,0,1,0,1
218349794,0,0,0,1,1
218362119,1,0,0,0,1
218428162,1,0,0,0,1
218455348,0,0,1,0,1
218509148,0,0,1,0,1
218584807,1,0,0,0,1
218617565,0,1,0,0,1
217427541,0,1,0,0,1
217339056,0,1,0,0,1
217286126,0,1,0,0,1
216920296,0,1,0,0,1
216480747,0,1,0,0,1
216516650,0,1,0,0,1
216616028,0,1,0,0,1
216644825,0,1,0,0,1
216717589,0,1,0,0,1
216731064,0,1,0,0,1
216786228,0,1,0,0,1
216809777,0,1,0,0,1
216854182,0,1,0,0,1
216859461,0,1,0,0,1
216941569,0,1,0,0,1
217264453,0,1,0,0,1
216956207,0,1,0,0,1
217005168,0,1,0,0,1
217015808,0,1,0,0,1
217058655,0,1,0,0,1
217092251,0,1,0,0,1
217104703,0,1,0,0,1
217105865,1,0,0,0,1
217126537,0,1,0,0,1
217190844,1,0,0,0,1
217214991,0,0,1,0,1
203879660,0,1,0,0,1
203821012,0,1,0,0,1
203818459,0,0,0,1,1
191073269,0,1,0,0,1
191187618,0,0,0,1,1
191190179,0,1,0,0,1
191315904,0,1,0,0,1
191342246,0,1,0,0,1
191350659,0,1,0,0,1
191357181,0,1,0,0,1
191357577,1,0,0,0,1
191376204,0,1,0,0,1
191379105,0,1,0,0,1
191385806,0,1,0,0,1
191397458,1,0,0,0,1
191493885,1,0,0,0,1
191542583,0,1,0,0,1
191559976,1,0,0,0,1
191567744,0,1,0,0,1
191625450,0,1,0,0,1
191630558,0,1,0,0,1
191778438,0,1,0,0,1
191817855,0,1,0,0,1
191829986,0,1,0,0,1
191938697,0,1,0,0,1
191951092,0,1,0,0,1
191967950,0,1,0,0,1
191165781,0,1,0,0,1
191042160,0,1,0,0,1
194475272,0,1,0,0,1
190988803,0,1,0,0,1
190004665,0,1,0,0,1
190011442,0,0,0,1,1
190086283,0,1,0,0,1
190104429,0,0,1,0,1
190107173,0,1,0,0,1
190154112,0,1,0,0,1
190164884,0,1,0,0,1
190166666,1,0,0,0,1
190207075,0,1,0,0,1
190353278,0,1,0,0,1
190488932,0,1,0,0,1
190494265,0,1,0,0,1
190495280,0,1,0,0,1
190587629,0,1,0,0,1
190598437,0,1,0,0,1
190608784,0,1,0,0,1
190637206,0,1,0,0,1
190738628,0,1,0,0,1
190740340,0,1,0,0,1
190793437,0,1,0,0,1
190955517,1,0,0,0,1
190961108,0,1,0,0,1
190963231,1,0,0,0,1
191971679,0,1,0,0,1
191972989,0,1,0,0,1
192069750,0,1,0,0,1
192071770,0,1,0,0,1
192801292,0,1,0,0,1
192835638,1,0,0,0,1
192914890,1,0,0,0,1
192917745,0,0,0,1,1
192957695,0,1,0,0,1
192980686,0,1,0,0,1
193214955,0,1,0,0,1
193215014,0,1,0,0,1
193357228,0,1,0,0,1
193368732,1,0,0,0,1
193553087,0,1,0,0,1
193620348,0,1,0,0,1
193627325,0,1,0,0,1
193638966,0,1,0,0,1
193713519,0,1,0,0,1
193859777,0,1,0,0,1
193870239,0,1,0,0,1
193896600,1,0,0,0,1
194039530,1,0,0,0,1
194042460,0,1,0,0,1
194076604,0,0,1,0,1
194112333,0,1,0,0,1
194149195,0,1,0,0,1
192744941,0,1,0,0,1
192675874,0,1,0,0,1
192585938,1,0,0,0,1
192258482,0,1,0,0,1
192113665,0,1,0,0,1
192118878,0,1,0,0,1
192129678,0,0,1,0,1
192170642,0,1,0,0,1
192180214,0,1,0,0,1
192213821,0,1,0,0,1
192222562,0,0,0,1,1
192222631,0,1,0,0,1
192223390,0,1,0,0,1
192256415,0,1,0,0,1
192259436,0,1,0,0,1
192585617,0,1,0,0,1
192283428,0,1,0,0,1
192298906,0,1,0,0,1
192310334,1,0,0,0,1
192344443,0,1,0,0,1
192351844,0,1,0,0,1
192471104,0,1,0,0,1
192474819,0,1,0,0,1
192519485,0,1,0,0,1
192536636,0,1,0,0,1
192575711,1,0,0,0,1
189970304,0,1,0,0,1
189958319,0,1,0,0,1
189926657,0,1,0,0,1
187254532,0,1,0,0,1
186120260,0,1,0,0,1
186126114,0,1,0,0,1
186221116,0,1,0,0,1
186307153,0,1,0,0,1
186370188,0,1,0,0,1
186407598,0,1,0,0,1
186419376,0,1,0,0,1
186481570,0,0,0,1,1
186507837,0,0,0,1,1
186533350,0,1,0,0,1
186598595,0,1,0,0,1
186620258,0,0,0,1,1
186682774,0,1,0,0,1
186717312,1,0,0,0,1
186797437,0,1,0,0,1
186827382,0,1,0,0,1
186836153,0,1,0,0,1
186859826,0,1,0,0,1
187012783,0,1,0,0,1
187074523,0,1,0,0,1
187089691,1,0,0,0,1
187179252,0,1,0,0,1
187191112,1,0,0,0,1
186102904,0,0,0,1,1
186049639,0,1,0,0,1
186045896,0,1,0,0,1
185713046,0,1,0,0,1
185367751,0,1,0,0,1
185375928,0,1,0,0,1
185381434,0,1,0,0,1
185408611,0,1,0,0,1
185422468,0,1,0,0,1
185438358,0,1,0,0,1
185564922,0,1,0,0,1
185606428,0,1,0,0,1
185691333,1,0,0,0,1
185694060,0,1,0,0,1
185716891,0,1,0,0,1
186011752,0,1,0,0,1
185778994,0,1,0,0,1
185798143,0,1,0,0,1
185803630,1,0,0,0,1
185812400,0,1,0,0,1
185814562,0,1,0,0,1
185946756,0,1,0,0,1
185946970,0,1,0,0,1
185953291,0,1,0,0,1
185962289,0,1,0,0,1
185976971,1,0,0,0,1
187235540,0,1,0,0,1
187313697,1,0,0,0,1
189918381,0,1,0,0,1
187466448,1,0,0,0,1
189054237,0,1,0,0,1
189077470,0,1,0,0,1
189084857,0,1,0,0,1
189131399,1,0,0,0,1
189134652,0,1,0,0,1
189147824,0,1,0,0,1
189162559,0,1,0,0,1
189213455,0,1,0,0,1
189311321,0,1,0,0,1
189371975,0,0,1,0,1
189396207,0,1,0,0,1
189410830,0,1,0,0,1
189446632,0,1,0,0,1
189503029,0,1,0,0,1
189514982,0,1,0,0,1
189552141,0,1,0,0,1
189556814,0,1,0,0,1
189565494,0,1,0,0,1
189657767,0,1,0,0,1
189661256,0,1,0,0,1
189825485,0,1,0,0,1
189847322,0,1,0,0,1
189873145,1,0,0,0,1
189007123,0,1,0,0,1
188903918,0,1,0,0,1
188858897,0,1,0,0,1
188109859,1,0,0,0,1
187466854,0,0,0,1,1
187553686,0,1,0,0,1
187692034,0,1,0,0,1
187820984,0,1,0,0,1
187853716,0,1,0,0,1
187869592,0,1,0,0,1
187912062,0,1,0,0,1
187950583,1,0,0,0,1
188050354,0,1,0,0,1
188064013,0,1,0,0,1
188129785,0,1,0,0,1
188831350,0,1,0,0,1
188254011,1,0,0,0,1
188315749,0,1,0,0,1
188330776,0,1,0,0,1
188351332,0,1,0,0,1
188367508,1,0,0,0,1
188562170,0,0,0,1,1
188648148,0,1,0,0,1
188675431,0,1,0,0,1
188711072,0,1,0,0,1
188788642,1,0,0,0,1
194350898,0,1,0,0,1
194496946,0,1,0,0,1
203579596,0,1,0,0,1
199598718,1,0,0,0,1
199660597,0,1,0,0,1
199698282,0,1,0,0,1
199714321,0,1,0,0,1
199746108,0,1,0,0,1
199808054,0,1,0,0,1
199810766,0,1,0,0,1
199810894,0,1,0,0,1
199859048,0,1,0,0,1
199978171,0,1,0,0,1
200034990,0,1,0,0,1
200099196,0,1,0,0,1
200176122,0,1,0,0,1
200191771,0,1,0,0,1
200192383,0,1,0,0,1
200196958,0,0,0,1,1
200469276,0,1,0,0,1
200507259,0,1,0,0,1
200509968,0,1,0,0,1
200625375,0,1,0,0,1
200634158,0,1,0,0,1
200680317,0,1,0,0,1
200730883,0,1,0,0,1
200775234,0,1,0,0,1
199620260,0,1,0,0,1
199442654,0,1,0,0,1
194523469,0,1,0,0,1
199424993,0,1,0,0,1
198805054,0,1,0,0,1
198810007,0,1,0,0,1
198848442,1,0,0,0,1
198856737,1,0,0,0,1
198943581,0,1,0,0,1
198997144,0,1,0,0,1
199025028,0,1,0,0,1
199134769,0,0,0,1,1
199145948,0,1,0,0,1
199188777,0,1,0,0,1
199194769,0,1,0,0,1
199195386,1,0,0,0,1
199203907,0,1,0,0,1
199219333,0,1,0,0,1
199247282,0,1,0,0,1
199251327,0,1,0,0,1
199263799,0,1,0,0,1
199269417,0,1,0,0,1
199314665,0,1,0,0,1
199353514,0,0,1,0,1
199354835,1,0,0,0,1
199366878,1,0,0,0,1
199415800,0,1,0,0,1
200784793,1,0,0,0,1
200788460,0,1,0,0,1
200808934,1,0,0,0,1
200900587,0,1,0,0,1
202567456,1,0,0,0,1
202626110,0,1,0,0,1
202638492,1,0,0,0,1
202680303,0,1,0,0,1
202785116,0,1,0,0,1
202817780,0,1,0,0,1
202822143,0,1,0,0,1
202842537,0,1,0,0,1
202963011,0,1,0,0,1
202969324,0,1,0,0,1
203009913,0,1,0,0,1
203011278,0,1,0,0,1
203102745,0,1,0,0,1
203110085,1,0,0,0,1
203117688,0,1,0,0,1
203155125,0,1,0,0,1
203169050,0,1,0,0,1
203335034,0,1,0,0,1
203385378,0,1,0,0,1
203423649,0,1,0,0,1
203455299,0,1,0,0,1
203480003,0,0,1,0,1
203510016,0,1,0,0,1
202343221,0,1,0,0,1
202314377,0,1,0,0,1
202285711,0,1,0,0,1
201554956,0,1,0,0,1
200959522,0,1,0,0,1
200961223,0,1,0,0,1
200989497,1,0,0,0,1
201069808,0,1,0,0,1
201105629,0,1,0,0,1
201133818,0,1,0,0,1
201159531,1,0,0,0,1
201188015,0,1,0,0,1
201199106,0,1,0,0,1
201446193,0,1,0,0,1
201696719,0,1,0,0,1
202180085,0,1,0,0,1
201727015,0,1,0,0,1
201733981,0,1,0,0,1
201747901,0,1,0,0,1
201799868,0,1,0,0,1
201820171,0,0,0,1,1
201923814,0,1,0,0,1
202115945,0,1,0,0,1
202121595,0,1,0,0,1
202161994,0,1,0,0,1
202177088,1,0,0,0,1
198801986,0,0,1,0,1
198800335,0,1,0,0,1
198792190,0,1,0,0,1
196570905,0,1,0,0,1
195666631,0,1,0,0,1
195674746,0,1,0,0,1
195683005,0,1,0,0,1
195714277,0,1,0,0,1
195734357,0,0,0,1,1
195750645,0,1,0,0,1
195779203,0,1,0,0,1
195788364,0,1,0,0,1
195846630,0,1,0,0,1
195861580,0,1,0,0,1
196051132,0,0,1,0,1
196058138,0,1,0,0,1
196100436,0,0,1,0,1
196203495,0,1,0,0,1
196207784,0,1,0,0,1
196224825,0,1,0,0,1
196302166,1,0,0,0,1
196409089,0,1,0,0,1
196415460,1,0,0,0,1
196495159,0,1,0,0,1
196504255,1,0,0,0,1
196528450,0,1,0,0,1
196537225,0,1,0,0,1
195654470,0,1,0,0,1
195644093,0,1,0,0,1
195580320,0,0,0,1,1
195006267,0,1,0,0,1
194553080,0,1,0,0,1
194571033,0,1,0,0,1
194608722,0,1,0,0,1
194620829,0,1,0,0,1
194624228,0,1,0,0,1
194698679,0,1,0,0,1
194768688,0,1,0,0,1
194790721,0,1,0,0,1
194958639,0,1,0,0,1
194984878,0,1,0,0,1
195030518,0,1,0,0,1
195565103,1,0,0,0,1
195038283,0,1,0,0,1
195067564,0,1,0,0,1
195097728,0,1,0,0,1
195103876,1,0,0,0,1
195238833,0,1,0,0,1
195270926,0,1,0,0,1
195300906,0,1,0,0,1
195317324,0,1,0,0,1
195359440,1,0,0,0,1
195390886,0,1,0,0,1
196550782,0,1,0,0,1
196578278,0,0,1,0,1
198716147,1,0,0,0,1
196607761,0,1,0,0,1
197902300,0,1,0,0,1
197916091,0,1,0,0,1
197978384,0,1,0,0,1
198030618,0,0,1,0,1
198047152,0,1,0,0,1
198068751,0,1,0,0,1
198090276,1,0,0,0,1
198093342,0,0,0,1,1
198097178,0,1,0,0,1
198099605,0,1,0,0,1
198104833,1,0,0,0,1
198132647,0,1,0,0,1
198262027,1,0,0,0,1
198276791,0,1,0,0,1
198285759,1,0,0,0,1
198393228,0,1,0,0,1
198400743,0,1,0,0,1
198401233,0,1,0,0,1
198415338,0,1,0,0,1
198569377,0,1,0,0,1
198582347,1,0,0,0,1
198597265,0,1,0,0,1
198669754,1,0,0,0,1
197893257,0,1,0,0,1
197869912,0,1,0,0,1
197843269,1,0,0,0,1
197357769,0,1,0,0,1
196628845,0,1,0,0,1
196696415,0,1,0,0,1
196720187,0,1,0,0,1
196732875,0,1,0,0,1
196733354,0,1,0,0,1
196917501,0,1,0,0,1
196992797,0,1,0,0,1
197107274,0,1,0,0,1
197258140,0,1,0,0,1
197345060,1,0,0,0,1
197390531,0,1,0,0,1
197833852,0,1,0,0,1
197422350,1,0,0,0,1
197441908,0,1,0,0,1
197469147,0,1,0,0,1
197475664,0,1,0,0,1
197587476,0,1,0,0,1
197728294,1,0,0,0,1
197760943,0,1,0,0,1
197804854,1,0,0,0,1
197814846,0,1,0,0,1
197832037,0,1,0,0,1
222920712,0,1,0,0,1
222930358,0,1,0,0,1
223021742,0,1,0,0,1
244957467,0,1,0,0,1
245004800,0,1,0,0,1
245010639,0,1,0,0,1
245048447,0,1,0,0,1
245069398,0,1,0,0,1
245085352,0,1,0,0,1
245122586,0,0,0,1,1
245254367,0,1,0,0,1
245276692,0,1,0,0,1
245360721,0,1,0,0,1
245378372,0,1,0,0,1
245407297,0,1,0,0,1
245450751,0,1,0,0,1
245459003,0,1,0,0,1
245490015,0,1,0,0,1
245532806,0,1,0,0,1
245675509,0,1,0,0,1
245724895,0,1,0,0,1
245738784,0,1,0,0,1
245747607,0,1,0,0,1
245767118,0,0,1,0,1
245803202,0,1,0,0,1
245836073,0,1,0,0,1
245864349,0,1,0,0,1
244967913,0,1,0,0,1
244889235,0,1,0,0,1
247556472,0,1,0,0,1
244836521,0,1,0,0,1
244136890,0,1,0,0,1
244157943,0,1,0,0,1
244176414,0,1,0,0,1
244183128,0,1,0,0,1
244189062,1,0,0,0,1
244273031,0,1,0,0,1
244273193,0,1,0,0,1
244296714,0,1,0,0,1
244359913,0,1,0,0,1
244408581,0,1,0,0,1
244429930,1,0,0,0,1
244453748,1,0,0,0,1
244454212,0,0,0,1,1
244494079,1,0,0,0,1
244496221,0,1,0,0,1
244529024,0,1,0,0,1
244537640,0,1,0,0,1
244558446,0,1,0,0,1
244594817,0,0,0,1,1
244644289,0,1,0,0,1
244653172,0,1,0,0,1
244726100,0,1,0,0,1
244783697,0,1,0,0,1
245880979,0,1,0,0,1
245894762,0,1,0,0,1
245923730,0,1,0,0,1
245940902,1,0,0,0,1
246830406,0,0,1,0,1
246940612,0,1,0,0,1
246945124,0,0,1,0,1
246990216,0,1,0,0,1
246992639,1,0,0,0,1
247027685,0,1,0,0,1
247119389,0,1,0,0,1
247171731,1,0,0,0,1
247194243,0,1,0,0,1
247213400,0,1,0,0,1
247237695,0,1,0,0,1
247240196,0,1,0,0,1
247276966,0,1,0,0,1
247309534,0,1,0,0,1
247312318,0,1,0,0,1
247332602,1,0,0,0,1
247340778,1,0,0,0,1
247375401,0,1,0,0,1
247385048,0,1,0,0,1
247389407,0,1,0,0,1
247404591,0,0,0,1,1
247439166,0,0,0,1,1
247513026,0,1,0,0,1
246814458,0,1,0,0,1
246814445,0,1,0,0,1
246784076,0,1,0,0,1
246282377,0,1,0,0,1
246005942,0,1,0,0,1
246020109,0,1,0,0,1
246079980,0,1,0,0,1
246119438,0,1,0,0,1
246138943,1,0,0,0,1
246186885,0,1,0,0,1
246196701,0,1,0,0,1
246203185,0,1,0,0,1
246211281,1,0,0,0,1
246242340,0,1,0,0,1
246316774,0,1,0,0,1
246780894,0,1,0,0,1
246325107,0,1,0,0,1
246335868,0,1,0,0,1
246384637,0,1,0,0,1
246430845,1,0,0,0,1
246478203,0,1,0,0,1
246560258,1,0,0,0,1
246611213,0,1,0,0,1
246661970,0,0,0,1,1
246725760,0,1,0,0,1
246769710,1,0,0,0,1
244113825,0,1,0,0,1
244086748,0,1,0,0,1
244049123,0,1,0,0,1
242467994,0,1,0,0,1
241742240,0,1,0,0,1
241775669,1,0,0,0,1
241788879,0,1,0,0,1
241819761,0,1,0,0,1
241875855,0,1,0,0,1
241880164,0,1,0,0,1
242011045,0,1,0,0,1
242025526,1,0,0,0,1
242036132,0,1,0,0,1
242036734,1,0,0,0,1
242181861,1,0,0,0,1
242224213,0,1,0,0,1
242246625,0,1,0,0,1
242250017,0,1,0,0,1
242250403,0,1,0,0,1
242278751,1,0,0,0,1
242299055,0,1,0,0,1
242303146,0,1,0,0,1
242303401,0,1,0,0,1
242319692,0,1,0,0,1
242323327,0,1,0,0,1
242353005,0,1,0,0,1
242375644,0,1,0,0,1
241704297,0,1,0,0,1
241672033,0,1,0,0,1
241643059,0,1,0,0,1
241128119,0,1,0,0,1
240846263,0,1,0,0,1
240871564,1,0,0,0,1
240913423,0,1,0,0,1
240945470,0,1,0,0,1
240971437,0,1,0,0,1
241025643,1,0,0,0,1
241074480,1,0,0,0,1
241084765,0,1,0,0,1
241104901,0,0,1,0,1
241106682,0,1,0,0,1
241167763,0,1,0,0,1
241620237,0,0,0,1,1
241214515,1,0,0,0,1
241310768,0,1,0,0,1
241321065,0,1,0,0,1
241396449,0,1,0,0,1
241413057,0,1,0,0,1
241437424,0,1,0,0,1
241477571,0,1,0,0,1
241483380,1,0,0,0,1
241504297,0,1,0,0,1
241530460,0,1,0,0,1
242418143,0,1,0,0,1
242505443,0,1,0,0,1
244039307,1,0,0,0,1
242579943,0,1,0,0,1
243297600,0,1,0,0,1
243297765,0,1,0,0,1
243307443,0,1,0,0,1
243341626,0,1,0,0,1
243369173,0,1,0,0,1
243400742,0,1,0,0,1
243471104,0,1,0,0,1
243480532,0,1,0,0,1
243516741,0,1,0,0,1
243521369,0,1,0,0,1
243544098,0,0,1,0,1
243555211,0,1,0,0,1
243577256,0,1,0,0,1
243582289,0,1,0,0,1
243624898,1,0,0,0,1
243673973,0,1,0,0,1
243675005,0,1,0,0,1
243698208,0,1,0,0,1
243703572,0,1,0,0,1
243777147,0,1,0,0,1
243834329,0,1,0,0,1
244020184,0,1,0,0,1
244023019,0,1,0,0,1
243279065,0,1,0,0,1
243255136,0,1,0,0,1
243251955,0,1,0,0,1
242866878,0,1,0,0,1
242626741,0,1,0,0,1
242651047,0,1,0,0,1
242652753,1,0,0,0,1
242676720,0,1,0,0,1
242779496,0,1,0,0,1
242780839,0,1,0,0,1
242794171,0,1,0,0,1
242808620,0,1,0,0,1
242835468,0,0,0,1,1
242849343,0,1,0,0,1
242873945,0,1,0,0,1
243144870,0,1,0,0,1
242894449,1,0,0,0,1
242922585,0,1,0,0,1
242960325,0,1,0,0,1
242975562,0,1,0,0,1
242980681,0,0,1,0,1
243061060,0,1,0,0,1
243075788,0,1,0,0,1
243089308,0,1,0,0,1
243104330,0,0,0,1,1
243127614,0,1,0,0,1
247555885,0,1,0,0,1
247602934,1,0,0,0,1
240747220,0,1,0,0,1
252491155,0,0,0,1,1
252599035,0,0,0,1,1
252643527,1,0,0,0,1
252653204,1,0,0,0,1
252698718,0,1,0,0,1
252701495,0,1,0,0,1
252878410,0,1,0,0,1
252909381,0,1,0,0,1
253037542,0,1,0,0,1
253043533,0,1,0,0,1
253077441,0,1,0,0,1
253084336,0,1,0,0,1
253089388,0,1,0,0,1
253205654,0,1,0,0,1
253237104,0,1,0,0,1
253244310,0,1,0,0,1
253251292,1,0,0,0,1
253269042,0,1,0,0,1
253327861,0,1,0,0,1
253336075,0,1,0,0,1
253340379,0,1,0,0,1
253373358,0,1,0,0,1
253416807,0,1,0,0,1
253475157,0,1,0,0,1
252517276,0,1,0,0,1
252473067,0,1,0,0,1
247663594,0,1,0,0,1
252452082,0,1,0,0,1
251590600,0,1,0,0,1
251640726,0,1,0,0,1
251709902,0,1,0,0,1
251753170,0,1,0,0,1
251770196,0,1,0,0,1
251796760,0,1,0,0,1
251815211,0,1,0,0,1
251815423,0,1,0,0,1
251836094,0,1,0,0,1
251872642,0,1,0,0,1
251881984,0,1,0,0,1
252123543,0,1,0,0,1
252128691,0,1,0,0,1
252170335,0,1,0,0,1
252179600,0,1,0,0,1
252219047,0,1,0,0,1
252231858,0,1,0,0,1
252239826,0,1,0,0,1
252268185,1,0,0,0,1
252338597,0,1,0,0,1
252390511,0,1,0,0,1
252392863,0,1,0,0,1
252435648,0,1,0,0,1
253479867,0,1,0,0,1
253519942,0,1,0,0,1
253536859,0,1,0,0,1
253591639,0,1,0,0,1
254546733,0,1,0,0,1
254556576,0,0,0,1,1
254605066,0,1,0,0,1
254751143,0,1,0,0,1
254765039,0,1,0,0,1
254781024,0,1,0,0,1
254784507,0,1,0,0,1
254790314,0,1,0,0,1
254898581,0,1,0,0,1
254914248,0,1,0,0,1
255007996,1,0,0,0,1
255163607,0,1,0,0,1
255164244,0,1,0,0,1
255171623,0,1,0,0,1
255304936,0,1,0,0,1
255325409,1,0,0,0,1
255334723,1,0,0,0,1
255434395,0,1,0,0,1
255496963,0,1,0,0,1
255502794,0,1,0,0,1
255587866,0,1,0,0,1
255593399,0,1,0,0,1
255596856,0,1,0,0,1
254546084,0,1,0,0,1
254537544,0,1,0,0,1
254504216,0,1,0,0,1
253883935,0,1,0,0,1
253597186,0,1,0,0,1
253620879,0,1,0,0,1
253647516,0,1,0,0,1
253676941,1,0,0,0,1
253709812,0,1,0,0,1
253711889,0,1,0,0,1
253802092,0,1,0,0,1
253805143,0,0,0,1,1
253827378,0,1,0,0,1
253879047,1,0,0,0,1
253896216,0,1,0,0,1
254502590,0,1,0,0,1
253909593,1,0,0,0,1
254148469,1,0,0,0,1
254216024,0,1,0,0,1
254233759,0,1,0,0,1
254363033,0,1,0,0,1
254379091,0,1,0,0,1
254413090,1,0,0,0,1
254415126,0,1,0,0,1
254440239,1,0,0,0,1
254446862,0,1,0,0,1
251561309,1,0,0,0,1
251438342,0,1,0,0,1
251426418,1,0,0,0,1
249562162,0,1,0,0,1
248675299,1,0,0,0,1
248695257,0,1,0,0,1
248805361,0,1,0,0,1
248834443,0,1,0,0,1
248858483,0,1,0,0,1
248876751,0,1,0,0,1
248879227,1,0,0,0,1
248922503,0,1,0,0,1
248950943,0,1,0,0,1
248956988,0,1,0,0,1
248960577,0,1,0,0,1
249015092,0,1,0,0,1
249142604,0,1,0,0,1
249151103,0,1,0,0,1
249151942,1,0,0,0,1
249185887,1,0,0,0,1
249218075,0,1,0,0,1
249298125,1,0,0,0,1
249307891,1,0,0,0,1
249365510,0,1,0,0,1
249411691,0,0,1,0,1
249429282,0,1,0,0,1
249526833,0,1,0,0,1
248659986,0,1,0,0,1
248612964,0,1,0,0,1
248584838,0,1,0,0,1
248074799,0,1,0,0,1
247667083,0,1,0,0,1
247685917,0,1,0,0,1
247742109,0,1,0,0,1
247777571,0,1,0,0,1
247868001,0,1,0,0,1
247955085,0,1,0,0,1
247975848,0,1,0,0,1
247977217,0,1,0,0,1
248059520,0,1,0,0,1
248061975,0,1,0,0,1
248106837,0,1,0,0,1
248521822,0,1,0,0,1
248189583,0,1,0,0,1
248206864,0,1,0,0,1
248257505,0,1,0,0,1
248262925,0,1,0,0,1
248270337,0,1,0,0,1
248337750,0,1,0,0,1
248367226,0,1,0,0,1
248379407,0,1,0,0,1
248412992,0,0,0,1,1
248439389,0,1,0,0,1
249558763,0,1,0,0,1
249573877,0,1,0,0,1
251389897,1,0,0,0,1
249593744,0,1,0,0,1
250584517,0,1,0,0,1
250608016,0,1,0,0,1
250623982,0,1,0,0,1
250707511,0,1,0,0,1
250708096,0,0,0,1,1
250726072,0,1,0,0,1
250784913,1,0,0,0,1
250791674,0,1,0,0,1
250830420,0,1,0,0,1
250970402,0,1,0,0,1
250973503,0,0,1,0,1
251011046,0,1,0,0,1
251014676,0,1,0,0,1
251028006,0,1,0,0,1
251084543,0,1,0,0,1
251237764,0,1,0,0,1
251238941,0,1,0,0,1
251239715,0,0,0,1,1
251303183,0,1,0,0,1
251330989,0,1,0,0,1
251343716,1,0,0,0,1
251351890,0,1,0,0,1
251386781,0,0,1,0,1
250545303,0,1,0,0,1
250540553,0,1,0,0,1
250513566,0,1,0,0,1
250032967,0,1,0,0,1
249604668,0,1,0,0,1
249628000,0,1,0,0,1
249653927,0,1,0,0,1
249734576,1,0,0,0,1
249895896,0,1,0,0,1
249928730,0,1,0,0,1
249959357,0,1,0,0,1
249971275,0,1,0,0,1
250020815,1,0,0,0,1
250031654,0,1,0,0,1
250033206,1,0,0,0,1
250480066,0,1,0,0,1
250037950,0,1,0,0,1
250070824,0,1,0,0,1
250160659,0,1,0,0,1
250164922,0,1,0,0,1
250169101,0,1,0,0,1
250181858,0,1,0,0,1
250189048,0,1,0,0,1
250197912,0,1,0,0,1
250302496,0,1,0,0,1
250372639,0,1,0,0,1
240789602,0,1,0,0,1
240746873,0,1,0,0,1
223066873,0,1,0,0,1
228302215,0,1,0,0,1
228411890,0,1,0,0,1
228423623,0,1,0,0,1
228484958,0,1,0,0,1
228509447,0,1,0,0,1
228536201,0,1,0,0,1
228574021,0,1,0,0,1
228581274,0,1,0,0,1
228595456,0,1,0,0,1
228621222,1,0,0,0,1
228631574,0,0,0,1,1
228640054,0,1,0,0,1
228656199,0,0,1,0,1
228696160,0,1,0,0,1
228707116,0,1,0,0,1
228708568,0,1,0,0,1
228721142,0,1,0,0,1
228728179,0,1,0,0,1
228737569,0,1,0,0,1
228755759,0,1,0,0,1
228772636,1,0,0,0,1
228775579,1,0,0,0,1
228790362,0,1,0,0,1
228796310,0,1,0,0,1
228306027,0,1,0,0,1
228291496,1,0,0,0,1
231353266,0,1,0,0,1
228136821,0,1,0,0,1
227273104,0,1,0,0,1
227276039,0,1,0,0,1
227306673,0,1,0,0,1
227314105,0,1,0,0,1
227316248,0,1,0,0,1
227359335,0,1,0,0,1
227362258,1,0,0,0,1
227409456,0,1,0,0,1
227521854,0,1,0,0,1
227593488,0,1,0,0,1
227604336,0,1,0,0,1
227617274,1,0,0,0,1
227642843,0,1,0,0,1
227663609,0,1,0,0,1
227674136,1,0,0,0,1
227763857,0,1,0,0,1
227843713,0,1,0,0,1
227893232,1,0,0,0,1
227937365,0,1,0,0,1
227975037,1,0,0,0,1
228099346,0,1,0,0,1
228123300,0,1,0,0,1
228127439,0,1,0,0,1
228921949,0,1,0,0,1
228922366,0,1,0,0,1
229074581,0,1,0,0,1
229147009,0,1,0,0,1
230444527,0,1,0,0,1
230478804,0,1,0,0,1
230483620,0,1,0,0,1
230484923,0,1,0,0,1
230501517,0,1,0,0,1
230537665,0,1,0,0,1
230585691,0,1,0,0,1
230657844,0,1,0,0,1
230668242,0,1,0,0,1
230687961,0,1,0,0,1
230752619,0,1,0,0,1
230772726,0,1,0,0,1
230800309,1,0,0,0,1
230964751,0,1,0,0,1
231004952,1,0,0,0,1
231022191,0,1,0,0,1
231043934,0,1,0,0,1
231073683,0,1,0,0,1
231094493,0,1,0,0,1
231121082,0,1,0,0,1
231170452,0,1,0,0,1
231181731,0,1,0,0,1
231192166,0,1,0,0,1
230369434,0,1,0,0,1
230342529,0,1,0,0,1
230286876,1,0,0,0,1
229749799,0,1,0,0,1
229171994,0,1,0,0,1
229202948,0,1,0,0,1
229410118,1,0,0,0,1
229429891,0,1,0,0,1
229458346,0,1,0,0,1
229522188,0,1,0,0,1
229594193,0,1,0,0,1
229594864,1,0,0,0,1
229639905,0,1,0,0,1
229648167,1,0,0,0,1
229760874,0,1,0,0,1
230274374,0,1,0,0,1
229858310,0,1,0,0,1
229903332,0,0,0,1,1
229906987,0,1,0,0,1
229924974,1,0,0,0,1
229940799,0,1,0,0,1
230048523,0,1,0,0,1
230139881,1,0,0,0,1
230150760,0,1,0,0,1
230154679,0,1,0,0,1
230243584,0,1,0,0,1
227272224,0,1,0,0,1
227103643,0,1,0,0,1
227092531,0,1,0,0,1
224813019,0,1,0,0,1
223921907,1,0,0,0,1
223937823,0,1,0,0,1
224032111,0,1,0,0,1
224042254,0,1,0,0,1
224044607,0,1,0,0,1
224111514,0,1,0,0,1
224143544,1,0,0,0,1
224187714,0,1,0,0,1
224233859,0,1,0,0,1
224273373,0,1,0,0,1
224276433,0,1,0,0,1
224289419,0,1,0,0,1
224302407,0,1,0,0,1
224333383,1,0,0,0,1
224364796,0,1,0,0,1
224491664,1,0,0,0,1
224525953,0,1,0,0,1
224575797,0,1,0,0,1
224577823,1,0,0,0,1
224674842,0,1,0,0,1
224675143,0,1,0,0,1
224729213,0,1,0,0,1
224742129,0,1,0,0,1
223912549,0,1,0,0,1
223869876,1,0,0,0,1
223868628,0,1,0,0,1
223460324,0,1,0,0,1
223076254,0,1,0,0,1
223134922,0,1,0,0,1
223155597,0,0,0,1,1
223180961,0,1,0,0,1
223218222,1,0,0,0,1
223224100,1,0,0,0,1
223275442,0,1,0,0,1
223284868,0,1,0,0,1
223339123,0,1,0,0,1
223410833,1,0,0,0,1
223517786,0,1,0,0,1
223861251,0,1,0,0,1
223527058,0,1,0,0,1
223601173,0,1,0,0,1
223705296,0,1,0,0,1
223713712,0,1,0,0,1
223767851,0,1,0,0,1
223776871,0,1,0,0,1
223785004,0,1,0,0,1
223820538,0,1,0,0,1
223827204,0,0,0,1,1
223839779,0,1,0,0,1
224789933,0,0,0,1,1
225020456,0,1,0,0,1
227049746,0,1,0,0,1
225040924,0,1,0,0,1
226237122,0,1,0,0,1
226297235,0,1,0,0,1
226298251,0,1,0,0,1
226356384,0,1,0,0,1
226389761,0,1,0,0,1
226440350,0,1,0,0,1
226486072,0,1,0,0,1
226520567,0,1,0,0,1
226525239,0,1,0,0,1
226547248,0,1,0,0,1
226562077,0,1,0,0,1
226618594,0,1,0,0,1
226633507,0,1,0,0,1
226636510,0,1,0,0,1
226822956,0,1,0,0,1
226827262,0,1,0,0,1
226857308,0,1,0,0,1
226875823,0,1,0,0,1
226891503,0,1,0,0,1
226892086,0,1,0,0,1
226917572,0,1,0,0,1
226925733,0,1,0,0,1
226926769,0,1,0,0,1
226234783,0,0,1,0,1
226192151,0,1,0,0,1
226171410,0,1,0,0,1
225579888,0,1,0,0,1
225119521,0,0,1,0,1
225259558,1,0,0,0,1
225265935,0,1,0,0,1
225279772,1,0,0,0,1
225303440,0,1,0,0,1
225346750,0,1,0,0,1
225450171,0,1,0,0,1
225504938,0,1,0,0,1
225553221,0,1,0,0,1
225565918,0,1,0,0,1
225583894,0,1,0,0,1
226124772,0,1,0,0,1
225589857,0,1,0,0,1
225734314,0,1,0,0,1
225744357,0,1,0,0,1
225753240,0,1,0,0,1
225866451,0,1,0,0,1
225896556,0,1,0,0,1
225904062,0,1,0,0,1
225930210,0,1,0,0,1
225966517,0,1,0,0,1
226121288,0,1,0,0,1
231346514,1,0,0,0,1
231391123,0,1,0,0,1
240698532,0,1,0,0,1
236741333,0,1,0,0,1
236820871,0,1,0,0,1
236834281,0,1,0,0,1
236944054,0,1,0,0,1
236967417,1,0,0,0,1
236972703,0,1,0,0,1
237050530,0,1,0,0,1
237147566,0,1,0,0,1
237150632,0,1,0,0,1
237186921,0,1,0,0,1
237265149,0,1,0,0,1
237394833,0,0,0,1,1
237437870,0,1,0,0,1
237509454,1,0,0,0,1
237601373,0,1,0,0,1
237610850,0,1,0,0,1
237684796,0,1,0,0,1
237754882,1,0,0,0,1
237762121,1,0,0,0,1
237765622,0,1,0,0,1
237779517,0,1,0,0,1
237785048,0,1,0,0,1
238038616,0,1,0,0,1
238065390,0,1,0,0,1
236780451,0,1,0,0,1
236741021,0,1,0,0,1
231690452,0,1,0,0,1
236738223,0,1,0,0,1
235548881,0,1,0,0,1
235560780,1,0,0,0,1
235601080,0,1,0,0,1
235639114,0,1,0,0,1
235661334,0,1,0,0,1
235782385,0,1,0,0,1
235795724,0,1,0,0,1
236058357,0,1,0,0,1
236108180,0,1,0,0,1
236157840,0,1,0,0,1
236359651,0,1,0,0,1
236460191,0,1,0,0,1
236460499,0,1,0,0,1
236461270,0,1,0,0,1
236493520,0,1,0,0,1
236510272,0,0,0,1,1
236529581,0,1,0,0,1
236529593,0,1,0,0,1
236541225,0,1,0,0,1
236542356,0,1,0,0,1
236627421,0,1,0,0,1
236667756,0,1,0,0,1
236732454,0,1,0,0,1
238079614,0,1,0,0,1
238162577,0,1,0,0,1
238175261,0,1,0,0,1
238215318,0,1,0,0,1
239496376,1,0,0,0,1
239496452,0,1,0,0,1
239533317,0,1,0,0,1
239536724,1,0,0,0,1
239727946,0,1,0,0,1
239748895,0,1,0,0,1
239818478,1,0,0,0,1
239892125,0,1,0,0,1
239892638,0,1,0,0,1
240173702,1,0,0,0,1
240225464,0,0,1,0,1
240301428,0,1,0,0,1
240349022,0,1,0,0,1
240377348,0,0,1,0,1
240388342,0,1,0,0,1
240428168,0,1,0,0,1
240436141,0,1,0,0,1
240452129,1,0,0,0,1
240516893,0,1,0,0,1
240629940,1,0,0,0,1
240652943,1,0,0,0,1
240657930,0,1,0,0,1
240666878,0,1,0,0,1
239388228,0,1,0,0,1
239378263,0,1,0,0,1
239375683,0,1,0,0,1
238767678,0,1,0,0,1
238216459,0,1,0,0,1
238331676,0,1,0,0,1
238384649,0,1,0,0,1
238403523,0,1,0,0,1
238476601,0,1,0,0,1
238572910,0,1,0,0,1
238579597,0,1,0,0,1
238669468,0,0,0,1,1
238733817,0,1,0,0,1
238741064,0,1,0,0,1
238825774,0,0,0,1,1
239366580,0,1,0,0,1
238836902,0,1,0,0,1
238902486,0,1,0,0,1
238911416,0,1,0,0,1
238925160,1,0,0,0,1
238927035,0,1,0,0,1
238994967,0,0,0,1,1
239101030,0,1,0,0,1
239195121,0,1,0,0,1
239262112,0,1,0,0,1
239297077,0,1,0,0,1
235530537,0,1,0,0,1
235521257,0,1,0,0,1
235506399,0,1,0,0,1
233640948,0,1,0,0,1
232727821,0,1,0,0,1
232779736,0,1,0,0,1
232801589,0,1,0,0,1
232899468,0,1,0,0,1
232914454,0,1,0,0,1
232976160,1,0,0,0,1
232976490,0,1,0,0,1
233033482,0,1,0,0,1
233062378,0,1,0,0,1
233087076,0,1,0,0,1
233107271,0,1,0,0,1
233239695,0,1,0,0,1
233273367,0,1,0,0,1
233335579,1,0,0,0,1
233336757,0,0,0,1,1
233375858,0,1,0,0,1
233446012,0,1,0,0,1
233450023,1,0,0,0,1
233500155,1,0,0,0,1
233510227,0,1,0,0,1
233528126,0,1,0,0,1
233531122,0,1,0,0,1
233534532,0,1,0,0,1
232676660,1,0,0,0,1
232635905,0,1,0,0,1
232634964,0,1,0,0,1
232164564,0,1,0,0,1
231715198,0,1,0,0,1
231755035,0,1,0,0,1
231757984,0,1,0,0,1
231832669,0,1,0,0,1
231856986,0,1,0,0,1
231916335,0,1,0,0,1
231974568,0,1,0,0,1
232026065,0,1,0,0,1
232028497,0,1,0,0,1
232103335,1,0,0,0,1
232187050,0,1,0,0,1
232624159,0,1,0,0,1
232188075,0,1,0,0,1
232221202,0,0,1,0,1
232265793,1,0,0,0,1
232302260,0,1,0,0,1
232410283,0,1,0,0,1
232469746,0,1,0,0,1
232580582,0,1,0,0,1
232614269,0,1,0,0,1
232619868,0,0,0,1,1
232620598,0,1,0,0,1
233609124,0,1,0,0,1
233643664,0,1,0,0,1
235439129,0,1,0,0,1
233680187,0,0,1,0,1
234438489,0,1,0,0,1
234469834,0,1,0,0,1
234491154,1,0,0,0,1
234551562,0,0,1,0,1
234614818,0,1,0,0,1
234704780,1,0,0,0,1
234717567,0,1,0,0,1
234736409,0,1,0,0,1
234772684,0,1,0,0,1
234783467,0,1,0,0,1
234890783,0,1,0,0,1
234919886,0,1,0,0,1
235027138,0,1,0,0,1
235071524,1,0,0,0,1
235079248,0,1,0,0,1
235114663,0,1,0,0,1
235123248,0,1,0,0,1
235152973,0,0,0,1,1
235166272,0,1,0,0,1
235278361,0,1,0,0,1
235307873,0,1,0,0,1
235309313,0,1,0,0,1
235374881,0,1,0,0,1
234388311,0,1,0,0,1
234376478,0,1,0,0,1
234337794,0,1,0,0,1
233977269,0,0,0,1,1
233736071,0,0,0,1,1
233767912,0,1,0,0,1
233885363,0,1,0,0,1
233891028,1,0,0,0,1
233900048,1,0,0,0,1
233906102,0,1,0,0,1
233918905,1,0,0,0,1
233932416,0,1,0,0,1
233954710,0,1,0,0,1
233955546,0,1,0,0,1
233980699,1,0,0,0,1
234326644,0,1,0,0,1
234007013,1,0,0,0,1
234038448,0,1,0,0,1
234085681,0,1,0,0,1
234212651,0,1,0,0,1
234275459,1,0,0,0,1
234276192,0,1,0,0,1
234279640,0,1,0,0,1
234281725,1,0,0,0,1
234312002,0,1,0,0,1
234326513,0,1,0,0,1
329375050,0,1,0,0,1
329509901,0,1,0,0,1
532535566,0,1,0,0,1
447944976,0,1,0,0,1
448292351,0,1,0,0,1
448415833,0,1,0,0,1
448672912,0,1,0,0,1
448746170,1,0,0,0,1
448750282,0,1,0,0,1
448765251,0,1,0,0,1
448777523,0,1,0,0,1
448899315,0,1,0,0,1
448961537,0,1,0,0,1
448981774,0,1,0,0,1
449258315,0,1,0,0,1
449381632,0,1,0,0,1
449415912,0,1,0,0,1
449436006,0,1,0,0,1
449556346,0,1,0,0,1
449712712,0,1,0,0,1
449822664,0,1,0,0,1
449830950,0,1,0,0,1
449853361,0,1,0,0,1
449874161,0,1,0,0,1
449971279,0,1,0,0,1
450034985,0,1,0,0,1
450088105,1,0,0,0,1
448017725,1,0,0,0,1
447942685,0,1,0,0,1
446075432,0,1,0,0,1
447911116,0,1,0,0,1
446156541,0,1,0,0,1
446208727,0,1,0,0,1
446284821,0,1,0,0,1
446464589,0,1,0,0,1
446501867,0,1,0,0,1
446653138,0,1,0,0,1
446768028,0,1,0,0,1
446793917,0,1,0,0,1
446821797,0,1,0,0,1
446940728,1,0,0,0,1
446988129,0,1,0,0,1
447035467,1,0,0,0,1
447054242,1,0,0,0,1
447096356,0,1,0,0,1
447109758,0,1,0,0,1
447125783,0,1,0,0,1
447153062,0,1,0,0,1
447277538,0,1,0,0,1
447316649,0,1,0,0,1
447392743,0,1,0,0,1
447450826,0,1,0,0,1
447452303,0,1,0,0,1
447457752,0,1,0,0,1
450188467,0,1,0,0,1
450302721,1,0,0,0,1
450383984,0,1,0,0,1
450386128,0,1,0,0,1
451557153,0,1,0,0,1
451596236,0,1,0,0,1
451633616,0,1,0,0,1
451665942,0,1,0,0,1
451678262,0,1,0,0,1
451685402,0,1,0,0,1
451728478,0,1,0,0,1
451744143,0,1,0,0,1
451775329,0,1,0,0,1
451924878,0,1,0,0,1
451933346,0,1,0,0,1
452013510,0,1,0,0,1
452062842,0,1,0,0,1
452085014,0,1,0,0,1
452176075,0,1,0,0,1
452432954,0,1,0,0,1
452448422,1,0,0,0,1
452777469,0,1,0,0,1
452849355,0,1,0,0,1
452921304,1,0,0,0,1
453032954,0,1,0,0,1
453038995,0,1,0,0,1
453208593,0,1,0,0,1
451509331,0,1,0,0,1
451464450,0,1,0,0,1
451404412,0,1,0,0,1
450815432,0,1,0,0,1
450429910,1,0,0,0,1
450461563,0,1,0,0,1
450508780,0,1,0,0,1
450532439,0,1,0,0,1
450560281,1,0,0,0,1
450569411,0,1,0,0,1
450633441,1,0,0,0,1
450661816,0,0,0,1,1
450751790,0,1,0,0,1
450796297,0,1,0,0,1
450834073,1,0,0,0,1
451303409,0,1,0,0,1
450862121,0,1,0,0,1
450919310,0,1,0,0,1
450964054,0,1,0,0,1
451013291,0,1,0,0,1
451144600,0,1,0,0,1
451175996,0,1,0,0,1
451202627,0,1,0,0,1
451223553,0,1,0,0,1
451252480,0,1,0,0,1
451285417,0,1,0,0,1
446112869,0,1,0,0,1
446055745,0,1,0,0,1
412685519,0,1,0,0,1
440091092,0,1,0,0,1
440247035,0,1,0,0,1
440254900,0,1,0,0,1
440261346,0,1,0,0,1
440323226,1,0,0,0,1
440372706,0,1,0,0,1
440399076,0,1,0,0,1
440437942,0,1,0,0,1
440547091,0,1,0,0,1
440565038,0,1,0,0,1
440568982,0,1,0,0,1
440621720,0,1,0,0,1
440631114,0,0,1,0,1
440691898,0,1,0,0,1
441050172,0,1,0,0,1
441119761,0,1,0,0,1
441289118,0,1,0,0,1
441356094,0,1,0,0,1
441404743,0,1,0,0,1
441562571,0,1,0,0,1
441606951,0,1,0,0,1
441734938,0,1,0,0,1
441759155,1,0,0,0,1
441831978,0,1,0,0,1
440236693,0,1,0,0,1
439905616,0,1,0,0,1
445935084,1,0,0,0,1
439868228,0,1,0,0,1
438330831,0,1,0,0,1
438372638,0,1,0,0,1
438380267,0,1,0,0,1
438642921,0,1,0,0,1
438899680,0,1,0,0,1
439131272,0,1,0,0,1
439199052,0,1,0,0,1
439219541,0,1,0,0,1
439234061,0,0,0,1,1
439243186,0,1,0,0,1
439245535,0,1,0,0,1
439307787,0,1,0,0,1
439339490,0,1,0,0,1
439352689,0,1,0,0,1
439415011,0,1,0,0,1
439421679,0,1,0,0,1
439439615,0,1,0,0,1
439530703,0,1,0,0,1
439555636,0,1,0,0,1
439560153,0,1,0,0,1
439764486,0,1,0,0,1
439826271,0,1,0,0,1
439849777,1,0,0,0,1
441919444,0,1,0,0,1
441973258,0,1,0,0,1
441984846,0,1,0,0,1
442044830,0,1,0,0,1
443958424,0,1,0,0,1
444103690,0,0,0,1,1
444115526,0,1,0,0,1
444146917,0,1,0,0,1
444547682,0,1,0,0,1
444616224,1,0,0,0,1
444696667,0,1,0,0,1
444820775,0,1,0,0,1
444833144,1,0,0,0,1
444905912,0,1,0,0,1
444998380,0,1,0,0,1
445047537,0,1,0,0,1
445110987,0,1,0,0,1
445212477,1,0,0,0,1
445221091,1,0,0,0,1
445260439,0,1,0,0,1
445284372,0,1,0,0,1
445322035,0,1,0,0,1
445329294,0,1,0,0,1
445416954,0,1,0,0,1
445508629,0,0,0,1,1
445523703,0,1,0,0,1
445608258,1,0,0,0,1
443940972,0,1,0,0,1
443904414,0,1,0,0,1
443824463,0,1,0,0,1
443088751,0,1,0,0,1
442134771,0,1,0,0,1
442187604,0,1,0,0,1
442412219,1,0,0,0,1
442467456,1,0,0,0,1
442632367,0,1,0,0,1
442744097,0,1,0,0,1
442818416,1,0,0,0,1
442842277,1,0,0,0,1
442905879,1,0,0,0,1
443042544,0,1,0,0,1
443091355,0,1,0,0,1
443810561,0,0,0,1,1
443109089,0,1,0,0,1
443109769,0,1,0,0,1
443274446,0,1,0,0,1
443337302,0,1,0,0,1
443458928,0,1,0,0,1
443567574,1,0,0,0,1
443696054,0,1,0,0,1
443709394,0,1,0,0,1
443749635,0,1,0,0,1
443790662,0,1,0,0,1
453496502,1,0,0,0,1
453543306,0,0,0,1,1
453677181,0,1,0,0,1
462118455,0,1,0,0,1
462336215,1,0,0,0,1
462432221,0,1,0,0,1
462465455,0,1,0,0,1
462502231,0,1,0,0,1
462607736,0,1,0,0,1
462667147,0,1,0,0,1
462690627,0,1,0,0,1
462709992,0,1,0,0,1
462720956,0,1,0,0,1
462765777,0,1,0,0,1
462775380,0,1,0,0,1
462787809,0,1,0,0,1
462808763,0,1,0,0,1
462809523,0,1,0,0,1
462810976,0,0,0,1,1
463117420,0,1,0,0,1
463175133,1,0,0,0,1
463294188,0,1,0,0,1
463307531,0,1,0,0,1
463574989,1,0,0,0,1
463698033,0,1,0,0,1
463763571,0,1,0,0,1
463841277,0,1,0,0,1
462235312,0,1,0,0,1
461981933,1,0,0,0,1
453787424,0,1,0,0,1
461957833,1,0,0,0,1
460574885,0,1,0,0,1
460614495,0,1,0,0,1
460692104,0,1,0,0,1
460723865,0,1,0,0,1
460784263,0,1,0,0,1
460988448,0,1,0,0,1
461005632,1,0,0,0,1
461053094,0,1,0,0,1
461068929,0,0,0,1,1
461075641,0,1,0,0,1
461080921,0,0,1,0,1
461179083,1,0,0,0,1
461203520,0,1,0,0,1
461278075,0,1,0,0,1
461318356,1,0,0,0,1
461408514,0,1,0,0,1
461428783,0,1,0,0,1
461449783,0,0,0,1,1
461473763,0,1,0,0,1
461687694,0,1,0,0,1
461871523,1,0,0,0,1
461935486,0,0,0,1,1
461937617,0,1,0,0,1
463899683,0,1,0,0,1
463933467,0,1,0,0,1
463984804,0,1,0,0,1
464028973,0,1,0,0,1
466036850,0,1,0,0,1
466461678,0,1,0,0,1
466561553,0,1,0,0,1
466723854,0,1,0,0,1
466781524,0,1,0,0,1
466935812,0,1,0,0,1
467101994,0,1,0,0,1
467102968,0,1,0,0,1
467122361,0,1,0,0,1
467164764,0,1,0,0,1
467209089,0,1,0,0,1
467214771,0,1,0,0,1
467274004,0,1,0,0,1
467313569,0,1,0,0,1
467326092,0,1,0,0,1
467366824,0,1,0,0,1
467465009,0,1,0,0,1
467607259,0,1,0,0,1
467634495,1,0,0,0,1
467733717,0,1,0,0,1
467825137,0,1,0,0,1
467865199,0,1,0,0,1
467873270,0,1,0,0,1
465882073,0,1,0,0,1
465878604,0,1,0,0,1
465864119,0,1,0,0,1
464871353,0,1,0,0,1
464031432,0,1,0,0,1
464036709,0,1,0,0,1
464289318,0,1,0,0,1
464301848,0,1,0,0,1
464399558,0,1,0,0,1
464402918,0,1,0,0,1
464501286,0,1,0,0,1
464745853,0,1,0,0,1
464778570,1,0,0,0,1
464792683,0,1,0,0,1
465099475,0,0,0,1,1
465860666,0,1,0,0,1
465158443,0,1,0,0,1
465270113,0,0,1,0,1
465386228,0,1,0,0,1
465446166,1,0,0,0,1
465471132,0,1,0,0,1
465536566,1,0,0,0,1
465711806,0,0,1,0,1
465734474,0,1,0,0,1
465795673,0,1,0,0,1
465829056,0,1,0,0,1
460362573,0,1,0,0,1
460342206,1,0,0,0,1
460258735,0,1,0,0,1
456770511,1,0,0,0,1
455654034,0,1,0,0,1
455696613,0,1,0,0,1
455721904,0,1,0,0,1
455772044,1,0,0,0,1
455824961,0,1,0,0,1
455833886,0,1,0,0,1
455888650,0,1,0,0,1
455936584,0,1,0,0,1
455961231,0,1,0,0,1
455996435,0,1,0,0,1
456029673,1,0,0,0,1
456107908,0,1,0,0,1
456271926,0,1,0,0,1
456375369,0,1,0,0,1
456407853,0,1,0,0,1
456413636,0,1,0,0,1
456478702,0,1,0,0,1
456528850,0,1,0,0,1
456582393,0,1,0,0,1
456653345,0,1,0,0,1
456679532,0,1,0,0,1
456731480,0,1,0,0,1
456735060,0,1,0,0,1
455613408,1,0,0,0,1
455568795,1,0,0,0,1
455497862,0,1,0,0,1
454345851,0,1,0,0,1
453798839,0,1,0,0,1
453807566,1,0,0,0,1
453842594,0,1,0,0,1
453853604,0,1,0,0,1
453867250,0,1,0,0,1
453878302,1,0,0,0,1
454080663,1,0,0,0,1
454118191,0,1,0,0,1
454185687,1,0,0,0,1
454273241,0,0,0,1,1
454546161,0,1,0,0,1
455471703,0,1,0,0,1
454635491,0,1,0,0,1
454766187,0,1,0,0,1
454814892,1,0,0,0,1
454994048,0,1,0,0,1
455042589,0,1,0,0,1
455209331,0,1,0,0,1
455261114,1,0,0,0,1
455294758,0,1,0,0,1
455373102,0,1,0,0,1
455392322,0,1,0,0,1
456748705,1,0,0,0,1
456856127,0,1,0,0,1
460147045,0,1,0,0,1
456860303,0,1,0,0,1
458441010,0,1,0,0,1
458537243,0,1,0,0,1
458548628,0,1,0,0,1
458593264,1,0,0,0,1
458654579,0,0,0,1,1
458683703,1,0,0,0,1
458685667,0,1,0,0,1
458703713,0,1,0,0,1
459054966,0,1,0,0,1
459080799,0,1,0,0,1
459109716,1,0,0,0,1
459204873,0,1,0,0,1
459276126,0,1,0,0,1
459350744,0,1,0,0,1
459356720,0,1,0,0,1
459366859,0,1,0,0,1
459400904,0,1,0,0,1
459568647,0,1,0,0,1
459643341,1,0,0,0,1
459675095,0,1,0,0,1
459832614,1,0,0,0,1
460096803,0,1,0,0,1
460135851,0,1,0,0,1
458378581,0,1,0,0,1
458363627,0,1,0,0,1
458325775,0,1,0,0,1
457548552,0,1,0,0,1
456918001,0,1,0,0,1
456961408,0,1,0,0,1
457047163,0,1,0,0,1
457102095,1,0,0,0,1
457204629,0,1,0,0,1
457210054,0,1,0,0,1
457321815,0,0,0,1,1
457327882,0,1,0,0,1
457384105,0,1,0,0,1
457496793,0,1,0,0,1
457717637,0,1,0,0,1
458291126,1,0,0,0,1
457720623,0,1,0,0,1
457757472,0,1,0,0,1
457760760,0,1,0,0,1
457905447,0,1,0,0,1
457915516,1,0,0,0,1
457953402,0,1,0,0,1
458068039,0,1,0,0,1
458131793,0,0,0,1,1
458149964,0,1,0,0,1
458236148,0,1,0,0,1
438326515,0,1,0,0,1
438286900,0,1,0,0,1
438237954,0,1,0,0,1
420273295,0,1,0,0,1
420356213,0,1,0,0,1
420419717,0,1,0,0,1
420480583,0,1,0,0,1
420484631,0,1,0,0,1
420503636,0,1,0,0,1
420630663,1,0,0,0,1
420649847,0,1,0,0,1
420815437,0,1,0,0,1
420842279,0,1,0,0,1
420921183,0,1,0,0,1
420981951,0,1,0,0,1
421062936,0,1,0,0,1
421065094,0,1,0,0,1
421083907,0,1,0,0,1
421129954,0,1,0,0,1
421146184,1,0,0,0,1
421217742,0,0,0,1,1
421293303,0,1,0,0,1
421349674,0,1,0,0,1
421467941,0,1,0,0,1
421533059,0,1,0,0,1
421545282,0,1,0,0,1
421570234,0,1,0,0,1
420293485,0,1,0,0,1
420188169,0,1,0,0,1
424407259,1,0,0,0,1
420093550,0,1,0,0,1
419256305,0,1,0,0,1
419272687,1,0,0,0,1
419327066,0,1,0,0,1
419331252,0,1,0,0,1
419351719,0,1,0,0,1
419359220,1,0,0,0,1
419395504,0,0,1,0,1
419446494,0,1,0,0,1
419511175,0,1,0,0,1
419582062,1,0,0,0,1
419604273,1,0,0,0,1
419663674,0,1,0,0,1
419663993,1,0,0,0,1
419726199,0,1,0,0,1
419730339,0,1,0,0,1
419733123,0,1,0,0,1
419769045,1,0,0,0,1
419789472,0,1,0,0,1
419806659,0,1,0,0,1
419858349,0,1,0,0,1
419899527,0,1,0,0,1
419902032,0,1,0,0,1
419968309,0,1,0,0,1
421627337,0,1,0,0,1
421659360,0,1,0,0,1
421752205,0,1,0,0,1
421787801,0,1,0,0,1
423336567,1,0,0,0,1
423346058,0,1,0,0,1
423379053,0,1,0,0,1
423392263,0,1,0,0,1
423425316,1,0,0,0,1
423580459,0,1,0,0,1
423621158,0,1,0,0,1
423625076,0,1,0,0,1
423685220,0,1,0,0,1
423692319,0,0,1,0,1
423735185,0,1,0,0,1
423763425,0,1,0,0,1
423869313,0,1,0,0,1
423903701,0,1,0,0,1
423915085,0,1,0,0,1
423930505,0,1,0,0,1
423991294,1,0,0,0,1
424091722,1,0,0,0,1
424138448,0,0,0,1,1
424165695,0,1,0,0,1
424179380,0,1,0,0,1
424204001,0,1,0,0,1
424256116,0,1,0,0,1
423327746,0,1,0,0,1
423286659,0,1,0,0,1
423221734,0,1,0,0,1
422493641,0,1,0,0,1
421867271,0,1,0,0,1
421925058,0,1,0,0,1
421936063,0,1,0,0,1
422014485,1,0,0,0,1
422016761,0,1,0,0,1
422038092,0,1,0,0,1
422089017,0,1,0,0,1
422143318,0,1,0,0,1
422263039,0,1,0,0,1
422293539,0,1,0,0,1
422574971,0,0,0,1,1
423191478,0,1,0,0,1
422589468,0,1,0,0,1
422651057,0,1,0,0,1
422658933,0,1,0,0,1
422668299,0,1,0,0,1
422738750,0,1,0,0,1
422804369,0,1,0,0,1
422833457,0,1,0,0,1
422929442,0,1,0,0,1
423066945,0,1,0,0,1
423128676,0,1,0,0,1
419168562,0,1,0,0,1
419101460,0,1,0,0,1
419080443,0,1,0,0,1
415624143,0,1,0,0,1
414383579,0,0,0,1,1
414412006,0,1,0,0,1
414466287,1,0,0,0,1
414645692,0,1,0,0,1
414648706,0,1,0,0,1
414652389,1,0,0,0,1
414655671,0,1,0,0,1
414661336,0,1,0,0,1
414670746,0,1,0,0,1
414712355,0,1,0,0,1
414827758,0,1,0,0,1
414848647,1,0,0,0,1
414865666,1,0,0,0,1
414887518,0,1,0,0,1
414908573,0,1,0,0,1
414999435,0,1,0,0,1
415308885,0,1,0,0,1
415313686,0,1,0,0,1
415405619,1,0,0,0,1
415457723,0,1,0,0,1
415462393,1,0,0,0,1
415484779,1,0,0,0,1
415553048,1,0,0,0,1
414370883,0,1,0,0,1
414355917,0,1,0,0,1
414208540,0,1,0,0,1
413603025,0,0,1,0,1
412840822,1,0,0,0,1
412924538,0,1,0,0,1
412981390,0,1,0,0,1
413041933,0,1,0,0,1
413065609,0,1,0,0,1
413070977,0,1,0,0,1
413170499,1,0,0,0,1
413211326,0,1,0,0,1
413264482,0,1,0,0,1
413419402,0,1,0,0,1
413645675,0,1,0,0,1
414152168,1,0,0,0,1
413711770,1,0,0,0,1
413716264,0,1,0,0,1
413747510,0,1,0,0,1
413826911,0,1,0,0,1
413900517,0,1,0,0,1
413938490,0,1,0,0,1
413995584,0,1,0,0,1
414018561,0,1,0,0,1
414124177,0,0,0,1,1
414125995,0,1,0,0,1
415569234,0,1,0,0,1
415646262,0,1,0,0,1
419006379,0,1,0,0,1
415687097,0,1,0,0,1
417465631,0,1,0,0,1
417502088,0,1,0,0,1
417571583,0,1,0,0,1
417583714,1,0,0,0,1
417663840,0,1,0,0,1
417697063,0,1,0,0,1
417709051,0,1,0,0,1
417763872,0,1,0,0,1
417977550,0,1,0,0,1
418038830,0,0,1,0,1
418056796,0,1,0,0,1
418101625,0,1,0,0,1
418104533,1,0,0,0,1
418140369,0,1,0,0,1
418244058,0,1,0,0,1
418296385,1,0,0,0,1
418356602,0,1,0,0,1
418361745,0,1,0,0,1
418384965,1,0,0,0,1
418627715,0,1,0,0,1
418661895,0,1,0,0,1
418884764,0,1,0,0,1
418918858,0,1,0,0,1
417429312,0,1,0,0,1
417319852,0,1,0,0,1
417225531,0,1,0,0,1
416515609,0,1,0,0,1
415860885,1,0,0,0,1
415913788,0,1,0,0,1
416004797,0,1,0,0,1
416027105,0,1,0,0,1
416084480,0,1,0,0,1
416220421,0,0,1,0,1
416269825,0,1,0,0,1
416379925,0,1,0,0,1
416434193,0,1,0,0,1
416487523,1,0,0,0,1
416599289,0,0,0,1,1
417214214,0,1,0,0,1
416614443,0,1,0,0,1
416774736,0,1,0,0,1
416811720,0,1,0,0,1
416910173,1,0,0,0,1
416912120,0,1,0,0,1
416918004,0,1,0,0,1
416939272,0,1,0,0,1
416971586,1,0,0,0,1
417172724,0,1,0,0,1
417185273,0,1,0,0,1
424261708,0,1,0,0,1
424556647,0,1,0,0,1
438215087,0,1,0,0,1
433377525,0,1,0,0,1
433432078,0,1,0,0,1
433447648,1,0,0,0,1
433457937,0,1,0,0,1
433471148,0,1,0,0,1
433493272,0,1,0,0,1
433495947,0,1,0,0,1
433539457,0,1,0,0,1
433556267,0,1,0,0,1
433660166,0,1,0,0,1
433674730,0,1,0,0,1
433736413,0,1,0,0,1
434203999,0,1,0,0,1
434213280,1,0,0,0,1
434604931,0,1,0,0,1
434641623,0,1,0,0,1
434729141,0,1,0,0,1
434773561,0,1,0,0,1
434779495,0,1,0,0,1
434791119,0,1,0,0,1
434817214,0,1,0,0,1
434824740,0,1,0,0,1
434910008,0,1,0,0,1
434931722,0,1,0,0,1
433409175,0,1,0,0,1
433377362,1,0,0,0,1
424657317,0,1,0,0,1
433356230,0,1,0,0,1
431431117,0,1,0,0,1
431466538,0,1,0,0,1
431615807,0,1,0,0,1
431686805,0,1,0,0,1
431749380,0,0,0,1,1
431759018,1,0,0,0,1
431793661,0,1,0,0,1
431969214,1,0,0,0,1
432330263,0,1,0,0,1
432380412,0,1,0,0,1
432380591,0,1,0,0,1
432448911,0,1,0,0,1
432546055,0,1,0,0,1
432573289,1,0,0,0,1
432592457,0,1,0,0,1
432684206,0,1,0,0,1
432703148,0,1,0,0,1
432848262,0,0,0,1,1
432878395,0,1,0,0,1
433131811,0,1,0,0,1
433190074,0,1,0,0,1
433241219,0,1,0,0,1
433352590,0,1,0,0,1
435089831,1,0,0,0,1
435112501,0,1,0,0,1
435130827,0,1,0,0,1
435207355,0,1,0,0,1
436829419,0,1,0,0,1
436858640,0,1,0,0,1
436862326,0,1,0,0,1
436874402,0,1,0,0,1
436891265,0,1,0,0,1
436924436,0,1,0,0,1
436939379,0,1,0,0,1
436985162,1,0,0,0,1
437032890,0,1,0,0,1
437083725,0,1,0,0,1
437191496,0,1,0,0,1
437195135,0,1,0,0,1
437485245,0,1,0,0,1
437504610,0,1,0,0,1
437563229,0,1,0,0,1
437564443,0,1,0,0,1
437603451,0,1,0,0,1
437647708,0,1,0,0,1
437781069,0,1,0,0,1
437891775,0,1,0,0,1
437916374,0,1,0,0,1
438054177,0,1,0,0,1
438164060,0,0,1,0,1
436799323,1,0,0,0,1
436701062,0,1,0,0,1
436673245,0,1,0,0,1
435842357,1,0,0,0,1
435233200,0,1,0,0,1
435236613,0,1,0,0,1
435407146,0,1,0,0,1
435467040,0,1,0,0,1
435561604,1,0,0,0,1
435616866,0,1,0,0,1
435670174,0,1,0,0,1
435751230,0,1,0,0,1
435766045,0,1,0,0,1
435808807,0,1,0,0,1
435892600,0,0,0,1,1
436619050,0,1,0,0,1
435922349,0,1,0,0,1
435939985,0,1,0,0,1
436011631,0,1,0,0,1
436026170,0,1,0,0,1
436093845,0,1,0,0,1
436209751,0,1,0,0,1
436300431,0,1,0,0,1
436322352,0,1,0,0,1
436407640,0,1,0,0,1
436534480,0,1,0,0,1
431389628,0,1,0,0,1
431304706,0,1,0,0,1
431288284,0,1,0,0,1
427471845,0,1,0,0,1
426246902,0,1,0,0,1
426290260,0,1,0,0,1
426308644,0,1,0,0,1
426375783,0,1,0,0,1
426377150,0,1,0,0,1
426413511,0,1,0,0,1
426447435,0,1,0,0,1
426495027,0,1,0,0,1
426633779,0,1,0,0,1
426713721,1,0,0,0,1
426780903,1,0,0,0,1
426935164,0,1,0,0,1
426998091,0,0,0,1,1
427242236,0,1,0,0,1
427247226,0,1,0,0,1
427249367,0,1,0,0,1
427251281,0,1,0,0,1
427278283,0,1,0,0,1
427291991,0,1,0,0,1
427311656,0,1,0,0,1
427339099,0,1,0,0,1
427366060,0,1,0,0,1
427417129,0,1,0,0,1
426115227,0,1,0,0,1
425912197,0,0,0,1,1
425848274,0,1,0,0,1
425348525,0,1,0,0,1
424720966,0,1,0,0,1
424859337,0,1,0,0,1
424948487,0,1,0,0,1
425010303,0,1,0,0,1
425028244,0,1,0,0,1
425069433,0,1,0,0,1
425113189,0,1,0,0,1
425238755,0,0,1,0,1
425244898,0,1,0,0,1
425311644,0,1,0,0,1
425356460,0,1,0,0,1
425845141,1,0,0,0,1
425406241,0,0,1,0,1
425425214,0,1,0,0,1
425463944,0,0,1,0,1
425468976,0,1,0,0,1
425684171,0,1,0,0,1
425693887,0,1,0,0,1
425705835,0,1,0,0,1
425743772,0,1,0,0,1
425768657,0,1,0,0,1
425844344,0,1,0,0,1
427447264,0,1,0,0,1
427501425,0,1,0,0,1
431149686,0,1,0,0,1
427766509,0,1,0,0,1
429875115,0,1,0,0,1
429885479,0,1,0,0,1
429962565,1,0,0,0,1
429995580,0,1,0,0,1
429997468,0,1,0,0,1
430023261,0,1,0,0,1
430057402,0,1,0,0,1
430156439,0,1,0,0,1
430293513,1,0,0,0,1
430362343,0,1,0,0,1
430398028,0,1,0,0,1
430548150,0,0,1,0,1
430572544,1,0,0,0,1
430632055,0,1,0,0,1
430717826,0,1,0,0,1
430723686,0,0,0,1,1
430731900,0,1,0,0,1
430813892,0,1,0,0,1
430894650,0,1,0,0,1
430934917,0,1,0,0,1
431020598,0,1,0,0,1
431126992,0,1,0,0,1
431132315,1,0,0,0,1
429873593,0,1,0,0,1
429826791,0,1,0,0,1
429788453,0,1,0,0,1
428569223,0,1,0,0,1
427865420,0,1,0,0,1
428020174,0,1,0,0,1
428060531,0,1,0,0,1
428203413,0,1,0,0,1
428419969,0,1,0,0,1
428442795,0,1,0,0,1
428454304,1,0,0,0,1
428468373,1,0,0,0,1
428501412,0,1,0,0,1
428514593,0,1,0,0,1
428585142,0,1,0,0,1
429438013,0,1,0,0,1
428589857,0,1,0,0,1
428661528,0,1,0,0,1
428686654,0,1,0,0,1
428719236,0,0,1,0,1
428854615,0,1,0,0,1
428873873,0,1,0,0,1
428892421,0,1,0,0,1
429031916,0,1,0,0,1
429197833,0,1,0,0,1
429281317,0,1,0,0,1
467913601,0,1,0,0,1
467935976,0,1,0,0,1
467972595,1,0,0,0,1
506998664,0,1,0,0,1
507239123,0,1,0,0,1
507289722,0,1,0,0,1
507331423,0,1,0,0,1
507704256,0,1,0,0,1
507752986,0,1,0,0,1
507885347,0,1,0,0,1
507924981,0,1,0,0,1
507966663,0,1,0,0,1
507968625,0,1,0,0,1
508129744,0,1,0,0,1
508312215,0,1,0,0,1
508438870,0,1,0,0,1
508495090,0,1,0,0,1
508643721,0,1,0,0,1
508705991,0,1,0,0,1
508771442,0,1,0,0,1
508798903,0,1,0,0,1
508809046,0,1,0,0,1
508824080,0,1,0,0,1
508980968,0,1,0,0,1
509099261,0,1,0,0,1
509115995,0,1,0,0,1
509176871,0,1,0,0,1
507234561,0,1,0,0,1
506953967,0,1,0,0,1
514315049,0,1,0,0,1
506940140,0,1,0,0,1
504858245,0,1,0,0,1
504863550,1,0,0,0,1
504871346,0,1,0,0,1
504899997,0,1,0,0,1
504942109,0,1,0,0,1
505058687,0,1,0,0,1
505100766,0,1,0,0,1
505454042,0,1,0,0,1
505541093,1,0,0,0,1
505592204,0,1,0,0,1
505927486,0,0,0,1,1
505935328,1,0,0,0,1
505999054,0,1,0,0,1
506046622,0,1,0,0,1
506060402,0,1,0,0,1
506068757,0,1,0,0,1
506077786,0,1,0,0,1
506147444,0,1,0,0,1
506311967,0,1,0,0,1
506664216,0,1,0,0,1
506876785,1,0,0,0,1
506905283,0,1,0,0,1
506912325,0,1,0,0,1
509184015,0,1,0,0,1
509694304,1,0,0,0,1
509842302,0,0,0,1,1
509968598,1,0,0,0,1
512087048,0,1,0,0,1
512097725,0,1,0,0,1
512168730,0,1,0,0,1
512276892,0,1,0,0,1
512436792,0,1,0,0,1
512503783,0,1,0,0,1
512654831,0,1,0,0,1
512814104,0,1,0,0,1
513015527,0,1,0,0,1
513103210,0,1,0,0,1
513163020,0,1,0,0,1
513166596,0,1,0,0,1
513190560,0,1,0,0,1
513346945,0,1,0,0,1
513381875,0,1,0,0,1
513433128,1,0,0,0,1
513469246,0,1,0,0,1
513495431,0,1,0,0,1
513504061,0,1,0,0,1
513643431,0,1,0,0,1
513790402,0,1,0,0,1
513949316,1,0,0,0,1
513971044,0,1,0,0,1
512000166,0,1,0,0,1
511879217,0,1,0,0,1
511665574,0,1,0,0,1
510731492,0,1,0,0,1
510022193,0,1,0,0,1
510031701,1,0,0,0,1
510050546,0,1,0,0,1
510077136,0,1,0,0,1
510117907,1,0,0,0,1
510141015,0,1,0,0,1
510171749,0,1,0,0,1
510183629,0,1,0,0,1
510230108,0,1,0,0,1
510720904,0,1,0,0,1
510741584,1,0,0,0,1
511629865,0,1,0,0,1
510742852,0,1,0,0,1
510850832,0,1,0,0,1
510866744,0,1,0,0,1
510969101,0,1,0,0,1
511043957,0,1,0,0,1
511106349,0,1,0,0,1
511190951,0,1,0,0,1
511423244,1,0,0,0,1
511563655,1,0,0,0,1
511575643,0,1,0,0,1
504797112,0,1,0,0,1
504697745,0,1,0,0,1
504648110,0,1,0,0,1
499808528,1,0,0,0,1
498090548,0,0,0,1,1
498212924,0,1,0,0,1
498251000,0,1,0,0,1
498538543,0,0,0,1,1
498579743,0,1,0,0,1
498591548,1,0,0,0,1
498625930,0,1,0,0,1
498653035,0,1,0,0,1
498736706,0,1,0,0,1
498960903,0,1,0,0,1
499057556,0,1,0,0,1
499069555,0,1,0,0,1
499168047,0,1,0,0,1
499172705,0,1,0,0,1
499230615,1,0,0,0,1
499375917,0,1,0,0,1
499424488,0,1,0,0,1
499432080,0,1,0,0,1
499545288,1,0,0,0,1
499584928,0,1,0,0,1
499699049,0,1,0,0,1
499733920,0,1,0,0,1
499772334,0,1,0,0,1
498022597,0,1,0,0,1
497885623,0,1,0,0,1
497638085,0,1,0,0,1
496807475,1,0,0,0,1
496364896,0,1,0,0,1
496422855,0,1,0,0,1
496424948,0,0,0,1,1
496480280,0,1,0,0,1
496608775,0,1,0,0,1
496610078,0,1,0,0,1
496664271,0,1,0,0,1
496742197,0,1,0,0,1
496792957,0,1,0,0,1
496796386,0,1,0,0,1
496862827,0,1,0,0,1
497628392,0,1,0,0,1
496876659,0,1,0,0,1
496891589,0,1,0,0,1
496918445,0,1,0,0,1
497122842,0,0,0,1,1
497131165,0,1,0,0,1
497188910,0,1,0,0,1
497199969,0,1,0,0,1
497366191,0,1,0,0,1
497420267,0,0,0,1,1
497555163,0,1,0,0,1
499799194,0,1,0,0,1
499890190,0,1,0,0,1
504527537,0,1,0,0,1
499935652,0,1,0,0,1
501662779,0,1,0,0,1
501751183,0,1,0,0,1
501858641,1,0,0,0,1
501882242,0,1,0,0,1
501921135,0,1,0,0,1
501947316,0,1,0,0,1
502073538,0,1,0,0,1
502073989,0,1,0,0,1
502094950,0,0,0,1,1
502189283,0,1,0,0,1
502302081,0,1,0,0,1
502685088,0,1,0,0,1
502787533,0,1,0,0,1
503638959,0,1,0,0,1
503705034,0,1,0,0,1
503737758,0,1,0,0,1
503848967,0,1,0,0,1
503994978,1,0,0,0,1
504294364,0,0,0,1,1
504331765,0,1,0,0,1
504342871,0,1,0,0,1
504405980,0,1,0,0,1
504517098,0,1,0,0,1
501610114,0,1,0,0,1
501609487,0,1,0,0,1
501562244,0,1,0,0,1
500708031,0,1,0,0,1
499953115,0,1,0,0,1
499975060,0,1,0,0,1
500073147,0,1,0,0,1
500093799,1,0,0,0,1
500211206,0,1,0,0,1
500447566,0,1,0,0,1
500513648,0,1,0,0,1
500547079,0,1,0,0,1
500598871,1,0,0,0,1
500683078,0,1,0,0,1
500712765,0,1,0,0,1
501509552,0,1,0,0,1
500823358,0,1,0,0,1
500857824,1,0,0,0,1
500955480,0,1,0,0,1
501003556,0,1,0,0,1
501008222,1,0,0,0,1
501029212,0,1,0,0,1
501060027,0,1,0,0,1
501079770,1,0,0,0,1
501306931,0,1,0,0,1
501312403,0,1,0,0,1
514154654,0,1,0,0,1
514368519,0,0,0,1,1
496295925,1,0,0,0,1
525409148,1,0,0,0,1
525621864,0,1,0,0,1
525738889,0,1,0,0,1
525833619,0,0,1,0,1
525842020,0,1,0,0,1
525857359,0,1,0,0,1
525880789,0,1,0,0,1
525898810,0,1,0,0,1
525924257,1,0,0,0,1
526085650,1,0,0,0,1
526156926,0,1,0,0,1
526223260,0,1,0,0,1
526281006,1,0,0,0,1
526305308,0,1,0,0,1
526460852,0,1,0,0,1
526502537,0,1,0,0,1
526718703,0,1,0,0,1
526903082,1,0,0,0,1
527160533,0,0,1,0,1
527252975,0,1,0,0,1
527266172,1,0,0,0,1
527316190,0,1,0,0,1
527319018,1,0,0,0,1
527362471,1,0,0,0,1
525516032,0,1,0,0,1
525408254,0,1,0,0,1
514404035,0,0,1,0,1
525253446,1,0,0,0,1
523284912,0,1,0,0,1
523357370,0,1,0,0,1
523396692,0,1,0,0,1
523466669,0,1,0,0,1
523482085,0,1,0,0,1
523624779,0,1,0,0,1
523629163,0,1,0,0,1
523882142,0,1,0,0,1
523936966,0,1,0,0,1
524120693,0,1,0,0,1
524252997,0,1,0,0,1
524259418,0,1,0,0,1
524302504,0,1,0,0,1
524382507,1,0,0,0,1
524498090,0,1,0,0,1
524625923,0,1,0,0,1
524627622,0,1,0,0,1
524690050,0,1,0,0,1
524758567,0,1,0,0,1
524842381,0,1,0,0,1
525064188,0,1,0,0,1
525157716,0,1,0,0,1
525236633,0,1,0,0,1
527401765,0,1,0,0,1
527440925,0,1,0,0,1
527509375,0,1,0,0,1
527659354,0,1,0,0,1
529792243,0,1,0,0,1
530984611,0,1,0,0,1
531047374,0,1,0,0,1
531050581,0,1,0,0,1
531050902,0,1,0,0,1
531263092,0,1,0,0,1
531338835,0,1,0,0,1
531371855,1,0,0,0,1
531422272,0,1,0,0,1
531554308,0,1,0,0,1
531565454,0,1,0,0,1
531639044,0,1,0,0,1
531640269,0,1,0,0,1
531760752,0,1,0,0,1
531868342,0,1,0,0,1
531927060,0,1,0,0,1
531977555,0,1,0,0,1
531984958,0,1,0,0,1
532108983,0,1,0,0,1
532141869,0,0,0,1,1
532194219,0,1,0,0,1
532306493,0,0,0,1,1
532366451,0,1,0,0,1
529677565,0,1,0,0,1
529609509,0,1,0,0,1
529531769,0,1,0,0,1
528823413,0,1,0,0,1
527735884,1,0,0,0,1
527908019,0,1,0,0,1
528075827,0,1,0,0,1
528183960,1,0,0,0,1
528413279,1,0,0,0,1
528605027,0,1,0,0,1
528637786,0,1,0,0,1
528641391,0,1,0,0,1
528701409,0,1,0,0,1
528716487,0,1,0,0,1
528829560,0,1,0,0,1
529527945,0,1,0,0,1
528840864,0,1,0,0,1
528904498,0,1,0,0,1
529126263,0,1,0,0,1
529182875,1,0,0,0,1
529199128,0,1,0,0,1
529228746,0,1,0,0,1
529232944,0,1,0,0,1
529443595,0,1,0,0,1
529450922,0,1,0,0,1
529484921,0,1,0,0,1
523236312,0,1,0,0,1
523217335,0,1,0,0,1
523118072,1,0,0,0,1
518932112,0,1,0,0,1
516717817,0,1,0,0,1
516727238,0,1,0,0,1
516818222,0,1,0,0,1
517070647,0,0,1,0,1
517160402,0,1,0,0,1
517242318,0,1,0,0,1
517331956,0,1,0,0,1
517537854,0,1,0,0,1
517585820,0,1,0,0,1
517821929,1,0,0,0,1
517930094,0,1,0,0,1
517932775,0,1,0,0,1
517941228,0,1,0,0,1
517986257,0,1,0,0,1
518061540,0,1,0,0,1
518145061,0,1,0,0,1
518228105,0,1,0,0,1
518355857,1,0,0,0,1
518362848,0,1,0,0,1
518443766,0,1,0,0,1
518486571,0,1,0,0,1
518498057,0,1,0,0,1
518714873,0,1,0,0,1
516538805,0,1,0,0,1
516414599,0,1,0,0,1
516204948,0,1,0,0,1
515136191,0,1,0,0,1
514423609,1,0,0,0,1
514465124,0,1,0,0,1
514465622,0,1,0,0,1
514569677,0,1,0,0,1
514592252,1,0,0,0,1
514634764,0,1,0,0,1
514692252,0,1,0,0,1
514723837,0,1,0,0,1
514870087,0,1,0,0,1
515124045,0,1,0,0,1
515136907,0,0,0,1,1
516168981,0,1,0,0,1
515146052,0,1,0,0,1
515205767,0,1,0,0,1
515237691,0,1,0,0,1
515281374,0,1,0,0,1
515435503,0,1,0,0,1
515513607,0,1,0,0,1
515660957,1,0,0,0,1
515842757,0,1,0,0,1
516018132,0,1,0,0,1
516110379,0,1,0,0,1
518873513,0,1,0,0,1
519250786,0,0,0,1,1
523065651,0,1,0,0,1
519356612,0,1,0,0,1
521258507,0,1,0,0,1
521339689,1,0,0,0,1
521405528,0,1,0,0,1
521413706,0,1,0,0,1
521721024,0,1,0,0,1
522033696,0,1,0,0,1
522154371,0,1,0,0,1
522321484,0,1,0,0,1
522327283,0,1,0,0,1
522369787,0,1,0,0,1
522370853,0,1,0,0,1
522404815,0,0,0,1,1
522500092,0,1,0,0,1
522667905,0,1,0,0,1
522677707,0,1,0,0,1
522681410,1,0,0,0,1
522707824,0,1,0,0,1
522711064,0,1,0,0,1
522755063,0,1,0,0,1
522808717,0,1,0,0,1
523013977,0,0,0,1,1
523026360,0,1,0,0,1
523034211,0,1,0,0,1
521235158,0,1,0,0,1
521228711,0,1,0,0,1
521201614,0,1,0,0,1
520275168,0,1,0,0,1
519379680,0,1,0,0,1
519421332,0,1,0,0,1
519439649,1,0,0,0,1
519641816,0,1,0,0,1
519790653,0,1,0,0,1
519885353,0,1,0,0,1
519895572,0,1,0,0,1
520104453,0,1,0,0,1
520249371,0,1,0,0,1
520250054,0,1,0,0,1
520353589,0,1,0,0,1
520981064,0,0,0,1,1
520360464,0,1,0,0,1
520402932,0,1,0,0,1
520407281,0,1,0,0,1
520556336,0,1,0,0,1
520570656,0,1,0,0,1
520582881,0,1,0,0,1
520593936,0,1,0,0,1
520649038,0,1,0,0,1
520665427,0,1,0,0,1
520977832,0,1,0,0,1
496322174,0,1,0,0,1
496282216,0,1,0,0,1
468070140,1,0,0,0,1
476078452,0,1,0,0,1
476094022,0,0,0,1,1
476182304,0,1,0,0,1
476195136,1,0,0,0,1
476229740,0,0,0,1,1
476247750,0,1,0,0,1
476270727,0,1,0,0,1
476317744,0,0,0,1,1
476414170,0,1,0,0,1
476565462,0,0,1,0,1
476642021,0,1,0,0,1
476650928,1,0,0,0,1
476676615,0,1,0,0,1
476755212,0,1,0,0,1
476774544,1,0,0,0,1
476789609,0,1,0,0,1
476790604,1,0,0,0,1
476939024,1,0,0,0,1
477352273,0,1,0,0,1
477384338,0,1,0,0,1
477415155,0,1,0,0,1
477604630,0,1,0,0,1
477620439,0,1,0,0,1
477637985,0,1,0,0,1
476083308,0,1,0,0,1
476027048,1,0,0,0,1
480494661,0,1,0,0,1
475917285,0,1,0,0,1
474311467,0,1,0,0,1
474319849,0,1,0,0,1
474502739,0,1,0,0,1
474621255,0,1,0,0,1
474622526,0,1,0,0,1
474677046,1,0,0,0,1
474746833,0,1,0,0,1
474749215,0,1,0,0,1
474867919,0,1,0,0,1
475030642,0,1,0,0,1
475032387,0,1,0,0,1
475054834,0,1,0,0,1
475091570,0,0,0,1,1
475169512,0,1,0,0,1
475398127,0,0,0,1,1
475475037,0,1,0,0,1
475504683,0,1,0,0,1
475514954,1,0,0,0,1
475580468,1,0,0,0,1
475643477,0,1,0,0,1
475658722,0,1,0,0,1
475722293,0,1,0,0,1
475738842,0,1,0,0,1
477743748,0,1,0,0,1
477854454,0,1,0,0,1
477855073,0,1,0,0,1
477877454,0,0,0,1,1
479026758,0,1,0,0,1
479051963,1,0,0,0,1
479279524,0,1,0,0,1
479285770,0,1,0,0,1
479294155,0,1,0,0,1
479339270,0,1,0,0,1
479577109,0,1,0,0,1
479578603,0,1,0,0,1
479657595,0,1,0,0,1
479728363,0,1,0,0,1
479770366,0,0,1,0,1
479795304,0,1,0,0,1
479836029,0,1,0,0,1
479848295,0,1,0,0,1
479953703,0,1,0,0,1
479982919,0,1,0,0,1
480022827,0,1,0,0,1
480099767,0,1,0,0,1
480101427,1,0,0,0,1
480150055,0,1,0,0,1
480301510,0,1,0,0,1
480374163,0,1,0,0,1
480378712,0,1,0,0,1
478944135,0,1,0,0,1
478901760,0,1,0,0,1
478889514,0,1,0,0,1
478420873,0,1,0,0,1
477917179,0,1,0,0,1
477924340,0,1,0,0,1
477936973,0,1,0,0,1
477996405,0,1,0,0,1
478078007,0,1,0,0,1
478133069,0,1,0,0,1
478227188,0,1,0,0,1
478264573,1,0,0,0,1
478344501,1,0,0,0,1
478416659,0,1,0,0,1
478472877,0,1,0,0,1
478876940,0,1,0,0,1
478526678,0,1,0,0,1
478626986,1,0,0,0,1
478635954,0,1,0,0,1
478669715,0,1,0,0,1
478718465,1,0,0,0,1
478724883,0,0,0,1,1
478772734,1,0,0,0,1
478797059,1,0,0,0,1
478831011,0,1,0,0,1
478831382,0,1,0,0,1
474264914,0,1,0,0,1
474220147,1,0,0,0,1
474088652,0,1,0,0,1
470930849,0,1,0,0,1
469459062,0,1,0,0,1
469587560,0,1,0,0,1
469655298,0,1,0,0,1
469756901,0,1,0,0,1
469774014,1,0,0,0,1
469829320,0,1,0,0,1
469845989,0,0,1,0,1
470006436,0,1,0,0,1
470016964,0,1,0,0,1
470161189,0,1,0,0,1
470183956,1,0,0,0,1
470349216,0,1,0,0,1
470460290,0,1,0,0,1
470531804,0,1,0,0,1
470535095,0,0,1,0,1
470560939,0,1,0,0,1
470633689,0,1,0,0,1
470665668,0,1,0,0,1
470693721,0,1,0,0,1
470725259,0,1,0,0,1
470772685,0,1,0,0,1
470799329,0,0,1,0,1
470895803,0,1,0,0,1
469457715,0,1,0,0,1
469414709,0,1,0,0,1
469377269,0,1,0,0,1
468577441,0,1,0,0,1
468076068,0,1,0,0,1
468119636,0,1,0,0,1
468176639,0,1,0,0,1
468278116,0,1,0,0,1
468281101,0,1,0,0,1
468380508,1,0,0,0,1
468432336,0,1,0,0,1
468449184,0,1,0,0,1
468456597,0,1,0,0,1
468572332,0,1,0,0,1
468758318,0,1,0,0,1
469292971,0,1,0,0,1
468865540,0,1,0,0,1
468907538,1,0,0,0,1
468944058,0,1,0,0,1
468949054,0,1,0,0,1
468958185,0,1,0,0,1
469045639,0,1,0,0,1
469195142,0,1,0,0,1
469212437,0,1,0,0,1
469214464,0,1,0,0,1
469273693,0,1,0,0,1
470897781,1,0,0,0,1
470931504,0,1,0,0,1
474080676,1,0,0,0,1
471026154,1,0,0,0,1
472446035,0,1,0,0,1
472447110,0,1,0,0,1
472484794,0,1,0,0,1
472720903,0,1,0,0,1
472777638,0,1,0,0,1
472817547,0,1,0,0,1
472971051,0,1,0,0,1
473120491,0,0,0,1,1
473156607,0,1,0,0,1
473175042,0,1,0,0,1
473292711,0,1,0,0,1
473323380,0,1,0,0,1
473409469,0,1,0,0,1
473522094,0,0,0,1,1
473525247,0,1,0,0,1
473588982,1,0,0,0,1
473630435,0,1,0,0,1
473737560,0,1,0,0,1
473763855,1,0,0,0,1
473844739,0,1,0,0,1
473858152,0,1,0,0,1
473948808,0,1,0,0,1
473994537,0,1,0,0,1
472418074,0,1,0,0,1
472305190,0,1,0,0,1
472276631,0,1,0,0,1
471713042,1,0,0,0,1
471033343,0,1,0,0,1
471103824,0,1,0,0,1
471113155,0,1,0,0,1
471231310,0,1,0,0,1
471301995,0,0,0,1,1
471302073,0,1,0,0,1
471455635,0,1,0,0,1
471455771,0,1,0,0,1
471580986,0,1,0,0,1
471699166,0,0,0,1,1
471831519,1,0,0,0,1
472238511,0,1,0,0,1
471855585,0,1,0,0,1
471888003,0,1,0,0,1
471988465,0,0,1,0,1
472056036,0,1,0,0,1
472111638,0,0,0,1,1
472150657,0,0,1,0,1
472165119,0,1,0,0,1
472171125,0,0,0,1,1
472175348,0,1,0,0,1
472218306,0,1,0,0,1
480464637,0,1,0,0,1
480506465,0,1,0,0,1
496080451,0,1,0,0,1
490338884,1,0,0,0,1
490519987,0,1,0,0,1
490537663,0,1,0,0,1
490642460,0,1,0,0,1
490653273,0,1,0,0,1
490675750,0,1,0,0,1
490712545,0,1,0,0,1
490790871,0,1,0,0,1
490859491,0,1,0,0,1
490987788,0,1,0,0,1
491013828,0,1,0,0,1
491103397,0,1,0,0,1
491166163,0,1,0,0,1
491175113,0,1,0,0,1
491210709,0,1,0,0,1
491472275,0,1,0,0,1
491665621,0,1,0,0,1
491697192,0,1,0,0,1
491737821,0,1,0,0,1
491871850,0,1,0,0,1
491891261,0,1,0,0,1
491930602,0,1,0,0,1
492007823,0,1,0,0,1
492029908,0,1,0,0,1
490371208,0,1,0,0,1
490332740,0,1,0,0,1
480579345,0,1,0,0,1
490247081,0,1,0,0,1
488404549,0,1,0,0,1
488436919,1,0,0,0,1
488477233,0,1,0,0,1
488574758,0,1,0,0,1
488609194,0,1,0,0,1
488632791,0,1,0,0,1
488682072,0,1,0,0,1
488798264,0,1,0,0,1
488927836,0,1,0,0,1
488950725,0,1,0,0,1
489082559,0,1,0,0,1
489150794,1,0,0,0,1
489207134,0,1,0,0,1
489222890,1,0,0,0,1
489344931,0,1,0,0,1
489482046,0,1,0,0,1
489803562,0,1,0,0,1
489809829,1,0,0,0,1
489822418,0,1,0,0,1
489965993,0,1,0,0,1
490133708,0,1,0,0,1
490143025,0,1,0,0,1
490160100,0,1,0,0,1
492071385,0,1,0,0,1
492143029,0,1,0,0,1
492483276,0,1,0,0,1
492486247,0,1,0,0,1
494187772,1,0,0,0,1
494215682,0,1,0,0,1
494259870,0,1,0,0,1
494268468,0,1,0,0,1
494305193,0,1,0,0,1
494377020,0,1,0,0,1
494485358,1,0,0,0,1
494575343,1,0,0,0,1
494802041,0,1,0,0,1
494827892,1,0,0,0,1
494885255,0,0,0,1,1
494886730,0,0,0,1,1
494947710,0,1,0,0,1
495164125,0,1,0,0,1
495266174,1,0,0,0,1
495283588,0,1,0,0,1
495403782,0,1,0,0,1
495438817,0,1,0,0,1
495622522,0,1,0,0,1
495667839,0,1,0,0,1
495676860,0,1,0,0,1
495778339,0,1,0,0,1
495786711,0,1,0,0,1
493919436,0,1,0,0,1
493833883,0,1,0,0,1
493703928,0,1,0,0,1
493286975,0,1,0,0,1
492707727,0,1,0,0,1
492777912,0,1,0,0,1
492793762,0,1,0,0,1
492922183,0,1,0,0,1
492951121,0,0,0,1,1
493013848,0,1,0,0,1
493020277,0,1,0,0,1
493092651,0,1,0,0,1
493164975,0,1,0,0,1
493247573,0,1,0,0,1
493289635,0,1,0,0,1
493688569,0,1,0,0,1
493304866,0,1,0,0,1
493312934,0,1,0,0,1
493339540,0,1,0,0,1
493415784,0,1,0,0,1
493432239,0,1,0,0,1
493441261,1,0,0,0,1
493487198,0,1,0,0,1
493533141,0,1,0,0,1
493539628,0,1,0,0,1
493616609,0,0,0,1,1
488400468,0,1,0,0,1
488352716,0,1,0,0,1
488237950,0,1,0,0,1
483942639,0,1,0,0,1
482361323,1,0,0,0,1
482390855,0,1,0,0,1
482483205,0,1,0,0,1
482585998,0,1,0,0,1
482685647,0,1,0,0,1
482728086,0,1,0,0,1
482774450,0,1,0,0,1
482853833,0,1,0,0,1
482908068,0,1,0,0,1
482923008,0,1,0,0,1
482943433,0,1,0,0,1
482959721,0,1,0,0,1
483027845,0,1,0,0,1
483043695,0,1,0,0,1
483147803,0,1,0,0,1
483250340,0,1,0,0,1
483286598,0,1,0,0,1
483318195,0,0,0,1,1
483359372,0,0,0,1,1
483380231,1,0,0,0,1
483650569,0,1,0,0,1
483696565,0,1,0,0,1
483780096,0,1,0,0,1
482311689,0,1,0,0,1
482295901,0,1,0,0,1
482277319,0,1,0,0,1
481287765,0,1,0,0,1
480682459,0,1,0,0,1
480690232,1,0,0,0,1
480690988,0,1,0,0,1
480694607,0,1,0,0,1
480850621,0,1,0,0,1
480928357,1,0,0,0,1
480947703,0,1,0,0,1
481014616,0,1,0,0,1
481039712,0,1,0,0,1
481202139,0,1,0,0,1
481360062,0,1,0,0,1
482264746,0,1,0,0,1
481384938,0,1,0,0,1
481417731,0,1,0,0,1
481431790,0,1,0,0,1
481485765,1,0,0,0,1
481545935,1,0,0,0,1
481604459,0,1,0,0,1
481632001,0,1,0,0,1
481754849,0,1,0,0,1
482051329,0,1,0,0,1
482137069,0,1,0,0,1
483876175,0,1,0,0,1
483996128,0,0,0,1,1
488143436,1,0,0,0,1
484080959,0,1,0,0,1
486517391,0,1,0,0,1
486609523,0,1,0,0,1
486647556,0,1,0,0,1
486665154,0,1,0,0,1
486742344,0,1,0,0,1
486842944,0,1,0,0,1
486886542,0,1,0,0,1
486912719,0,1,0,0,1
486920729,0,1,0,0,1
486951801,1,0,0,0,1
487049312,0,1,0,0,1
487292934,0,1,0,0,1
487425519,0,1,0,0,1
487438079,0,1,0,0,1
487442676,1,0,0,0,1
487613619,0,1,0,0,1
487723661,0,1,0,0,1
487822650,0,1,0,0,1
487880032,0,1,0,0,1
487883211,0,1,0,0,1
488029621,0,1,0,0,1
488037006,0,1,0,0,1
488056864,0,1,0,0,1
486500293,0,1,0,0,1
486458170,0,1,0,0,1
486085945,0,1,0,0,1
485343364,0,1,0,0,1
484144863,0,1,0,0,1
484253581,0,1,0,0,1
484270721,0,1,0,0,1
484284695,1,0,0,0,1
484475017,0,1,0,0,1
484519212,0,1,0,0,1
484592863,0,1,0,0,1
484623102,0,1,0,0,1
485068800,1,0,0,0,1
485137891,0,1,0,0,1
485361391,0,1,0,0,1
486084827,0,1,0,0,1
485408864,0,1,0,0,1
485552971,1,0,0,0,1
485560033,0,1,0,0,1
485584363,0,1,0,0,1
485694144,0,1,0,0,1
485711961,0,1,0,0,1
485779668,0,1,0,0,1
485822495,0,1,0,0,1
485976898,1,0,0,0,1
486027045,0,1,0,0,1
412773158,0,1,0,0,1
412670404,0,1,0,0,1
329523464,0,1,0,0,1
357576888,0,1,0,0,1
357596297,1,0,0,0,1
357610525,1,0,0,0,1
357678149,0,1,0,0,1
357705530,0,1,0,0,1
357804230,0,1,0,0,1
357847488,0,1,0,0,1
358004798,0,1,0,0,1
358083914,0,1,0,0,1
358092964,0,1,0,0,1
358115187,0,1,0,0,1
358151362,0,1,0,0,1
358212381,0,1,0,0,1
358223899,1,0,0,0,1
358313850,0,1,0,0,1
358387003,0,1,0,0,1
358419587,0,1,0,0,1
358448762,0,0,1,0,1
358605125,1,0,0,0,1
358626243,0,1,0,0,1
358656472,1,0,0,0,1
358759926,0,1,0,0,1
358851998,0,1,0,0,1
358861285,0,1,0,0,1
357581779,0,1,0,0,1
357556151,0,1,0,0,1
356443795,0,1,0,0,1
357521082,1,0,0,0,1
356687113,1,0,0,0,1
356694687,0,1,0,0,1
356791670,0,1,0,0,1
356814013,0,1,0,0,1
356816693,0,1,0,0,1
356846594,1,0,0,0,1
356860334,0,1,0,0,1
356892056,0,1,0,0,1
357011414,0,1,0,0,1
357142859,0,1,0,0,1
357159127,0,1,0,0,1
357179778,0,1,0,0,1
357187990,0,1,0,0,1
357201415,0,1,0,0,1
357205429,1,0,0,0,1
357267251,0,1,0,0,1
357270972,0,1,0,0,1
357292693,0,1,0,0,1
357318590,0,1,0,0,1
357334673,0,1,0,0,1
357346033,0,1,0,0,1
357444397,1,0,0,0,1
357471645,0,1,0,0,1
358929663,0,1,0,0,1
358940512,0,1,0,0,1
359001985,0,1,0,0,1
359074585,0,1,0,0,1
360240317,0,1,0,0,1
360282314,0,1,0,0,1
360376849,0,1,0,0,1
360389895,0,1,0,0,1
360397664,0,1,0,0,1
360472623,0,1,0,0,1
360503485,0,1,0,0,1
360511368,0,1,0,0,1
360592342,0,1,0,0,1
360606782,0,1,0,0,1
360608397,0,1,0,0,1
360613373,0,1,0,0,1
360623902,0,1,0,0,1
360757907,0,1,0,0,1
360793382,0,1,0,0,1
360871703,0,1,0,0,1
361020838,0,1,0,0,1
361145082,0,1,0,0,1
361204748,0,1,0,0,1
361249380,0,1,0,0,1
361258767,0,1,0,0,1
361293956,0,1,0,0,1
361299900,0,1,0,0,1
360085447,0,1,0,0,1
360080130,1,0,0,0,1
360012277,0,1,0,0,1
359512020,0,1,0,0,1
359110369,0,1,0,0,1
359159028,0,1,0,0,1
359197035,0,1,0,0,1
359234552,0,1,0,0,1
359333693,0,1,0,0,1
359337121,0,1,0,0,1
359339161,0,1,0,0,1
359399726,0,1,0,0,1
359442638,0,1,0,0,1
359469792,0,1,0,0,1
359516858,1,0,0,0,1
359997432,0,1,0,0,1
359542560,0,1,0,0,1
359677666,0,1,0,0,1
359741191,1,0,0,0,1
359762848,0,1,0,0,1
359789361,0,1,0,0,1
359793610,0,1,0,0,1
359912237,0,1,0,0,1
359914203,0,1,0,0,1
359942344,0,1,0,0,1
359980714,0,1,0,0,1
356601847,0,1,0,0,1
356424314,0,1,0,0,1
412648054,0,1,0,0,1
352264642,0,1,0,0,1
352355263,0,1,0,0,1
352490344,0,1,0,0,1
352500218,0,1,0,0,1
352546819,0,1,0,0,1
352827855,0,1,0,0,1
352940283,0,1,0,0,1
352967390,1,0,0,0,1
352984223,0,1,0,0,1
353216074,0,1,0,0,1
353356800,0,1,0,0,1
353386239,0,1,0,0,1
353424575,0,1,0,0,1
353461338,0,1,0,0,1
353461486,0,1,0,0,1
353616520,0,1,0,0,1
353653242,0,1,0,0,1
353656520,0,1,0,0,1
353688943,0,1,0,0,1
353768465,0,1,0,0,1
353809860,1,0,0,0,1
353955685,0,1,0,0,1
354087372,0,1,0,0,1
354128108,0,1,0,0,1
352346436,0,1,0,0,1
352260367,0,1,0,0,1
356424160,0,1,0,0,1
352201870,0,1,0,0,1
351080422,0,1,0,0,1
351117961,1,0,0,0,1
351148151,0,1,0,0,1
351204158,0,1,0,0,1
351204415,0,1,0,0,1
351335886,0,0,0,1,1
351408605,0,1,0,0,1
351408989,0,1,0,0,1
351441166,1,0,0,0,1
351446360,1,0,0,0,1
351600648,0,1,0,0,1
351603174,1,0,0,0,1
351633855,0,1,0,0,1
351652758,0,1,0,0,1
351717829,1,0,0,0,1
351877616,0,1,0,0,1
351948893,0,1,0,0,1
351952422,0,1,0,0,1
352087687,0,1,0,0,1
352097954,0,1,0,0,1
352110421,0,1,0,0,1
352182919,0,1,0,0,1
352194765,1,0,0,0,1
354180347,0,1,0,0,1
354186526,0,1,0,0,1
354243484,1,0,0,0,1
354297631,0,1,0,0,1
355505439,0,0,0,1,1
355512194,0,1,0,0,1
355545085,0,1,0,0,1
355578787,0,1,0,0,1
355643838,1,0,0,0,1
355671241,0,1,0,0,1
355697479,0,1,0,0,1
355773858,1,0,0,0,1
355952700,0,1,0,0,1
355957367,0,1,0,0,1
356028639,0,1,0,0,1
356038837,0,1,0,0,1
356063820,0,1,0,0,1
356076328,0,1,0,0,1
356082163,1,0,0,0,1
356161297,0,1,0,0,1
356206496,0,1,0,0,1
356239153,1,0,0,0,1
356284160,0,1,0,0,1
356284842,0,1,0,0,1
356363791,0,1,0,0,1
356416072,0,1,0,0,1
356423346,0,1,0,0,1
355480150,0,1,0,0,1
355478973,0,1,0,0,1
355458124,0,1,0,0,1
354839014,0,1,0,0,1
354302769,1,0,0,0,1
354351323,1,0,0,0,1
354372161,0,1,0,0,1
354387726,0,1,0,0,1
354391685,1,0,0,0,1
354510656,1,0,0,0,1
354566007,0,1,0,0,1
354593580,0,1,0,0,1
354819500,0,0,1,0,1
354838061,1,0,0,0,1
354842257,0,1,0,0,1
355457370,0,1,0,0,1
354909257,0,0,0,1,1
355019370,0,1,0,0,1
355050743,0,1,0,0,1
355057966,0,1,0,0,1
355068517,0,1,0,0,1
355157657,0,1,0,0,1
355339020,0,1,0,0,1
355365078,0,1,0,0,1
355431354,0,1,0,0,1
355439319,0,1,0,0,1
361389412,0,1,0,0,1
361423247,0,1,0,0,1
361512244,1,0,0,0,1
367487545,0,1,0,0,1
367609291,0,1,0,0,1
367645959,0,1,0,0,1
367650099,0,1,0,0,1
367681208,0,1,0,0,1
367734326,0,1,0,0,1
367783193,0,1,0,0,1
367806111,1,0,0,0,1
367831759,1,0,0,0,1
367832396,0,1,0,0,1
367917292,0,1,0,0,1
368001720,0,1,0,0,1
368012099,0,1,0,0,1
368167323,0,1,0,0,1
368280148,0,1,0,0,1
368287239,0,1,0,0,1
368287768,0,1,0,0,1
368375389,0,1,0,0,1
368448719,0,1,0,0,1
368525958,1,0,0,0,1
368543088,0,1,0,0,1
368561925,0,1,0,0,1
368583699,0,1,0,0,1
368677986,0,1,0,0,1
367593473,0,1,0,0,1
367436614,0,1,0,0,1
361550269,0,1,0,0,1
367386653,0,1,0,0,1
366605070,0,1,0,0,1
366632841,0,1,0,0,1
366673685,1,0,0,0,1
366703741,0,1,0,0,1
366710055,0,1,0,0,1
366800490,0,1,0,0,1
366832028,1,0,0,0,1
366981413,0,0,0,1,1
366997928,0,1,0,0,1
367050560,0,1,0,0,1
367050948,0,1,0,0,1
367086880,0,1,0,0,1
367133545,0,0,0,1,1
367162824,0,1,0,0,1
367171310,0,1,0,0,1
367171920,0,1,0,0,1
367193495,0,1,0,0,1
367202105,0,1,0,0,1
367269406,0,1,0,0,1
367296011,0,1,0,0,1
367345880,1,0,0,0,1
367359964,0,0,0,1,1
367361041,0,1,0,0,1
368684694,0,1,0,0,1
368740659,0,1,0,0,1
368887368,0,1,0,0,1
368968268,0,1,0,0,1
370219961,0,1,0,0,1
370302388,0,1,0,0,1
370394682,0,1,0,0,1
370401571,1,0,0,0,1
370406417,0,1,0,0,1
370439540,0,1,0,0,1
370495058,0,0,0,1,1
370511184,0,1,0,0,1
370517348,0,1,0,0,1
370577778,0,1,0,0,1
370597744,1,0,0,0,1
370604952,0,1,0,0,1
370721448,0,1,0,0,1
370827171,0,1,0,0,1
370892849,0,1,0,0,1
370979803,0,1,0,0,1
371051661,0,1,0,0,1
371063126,0,1,0,0,1
371163789,0,1,0,0,1
371201267,0,1,0,0,1
371204957,0,1,0,0,1
371233889,1,0,0,0,1
371295497,0,1,0,0,1
370190368,0,1,0,0,1
370166151,0,1,0,0,1
370151394,1,0,0,0,1
369572760,1,0,0,0,1
369065546,0,1,0,0,1
369094361,0,1,0,0,1
369137471,0,1,0,0,1
369147622,0,1,0,0,1
369314308,0,1,0,0,1
369344849,0,1,0,0,1
369388136,0,1,0,0,1
369549107,0,1,0,0,1
369553873,1,0,0,0,1
369571717,0,0,0,1,1
369575774,0,1,0,0,1
370098599,0,1,0,0,1
369800798,0,1,0,0,1
369838944,0,1,0,0,1
369851211,0,1,0,0,1
369870041,0,1,0,0,1
369871846,0,1,0,0,1
369953177,0,1,0,0,1
369972706,0,1,0,0,1
370010919,0,1,0,0,1
370058624,0,1,0,0,1
370069388,0,1,0,0,1
366592102,0,1,0,0,1
366547253,0,1,0,0,1
366500115,0,0,1,0,1
363804048,0,1,0,0,1
362819338,0,1,0,0,1
362911382,0,1,0,0,1
362950022,0,1,0,0,1
363015783,0,0,0,1,1
363072417,0,1,0,0,1
363075764,0,1,0,0,1
363088688,0,1,0,0,1
363090666,1,0,0,0,1
363148297,0,1,0,0,1
363178016,0,1,0,0,1
363394823,0,1,0,0,1
363435373,0,1,0,0,1
363446199,0,1,0,0,1
363475590,0,1,0,0,1
363529634,0,1,0,0,1
363585950,0,1,0,0,1
363597002,0,1,0,0,1
363612076,0,1,0,0,1
363643553,0,1,0,0,1
363698586,0,1,0,0,1
363703949,0,1,0,0,1
363740929,0,1,0,0,1
363786481,0,1,0,0,1
362691040,0,1,0,0,1
362679016,0,1,0,0,1
362558311,1,0,0,0,1
361925170,1,0,0,0,1
361557763,0,1,0,0,1
361622642,0,1,0,0,1
361658748,0,1,0,0,1
361687724,0,0,1,0,1
361708795,0,1,0,0,1
361743964,0,1,0,0,1
361787988,0,1,0,0,1
361808089,0,1,0,0,1
361858892,0,1,0,0,1
361910415,0,1,0,0,1
361964886,0,1,0,0,1
362524755,0,1,0,0,1
361989467,0,1,0,0,1
361991290,1,0,0,0,1
362091773,0,1,0,0,1
362209266,0,1,0,0,1
362285642,0,1,0,0,1
362304985,0,1,0,0,1
362339339,0,1,0,0,1
362353559,0,1,0,0,1
362355010,0,1,0,0,1
362444624,0,1,0,0,1
363799915,0,1,0,0,1
363841744,0,1,0,0,1
366441092,0,1,0,0,1
363854281,0,1,0,0,1
365373027,0,1,0,0,1
365398076,0,1,0,0,1
365456880,0,1,0,0,1
365474877,0,1,0,0,1
365523475,0,0,0,1,1
365526469,0,1,0,0,1
365569658,0,1,0,0,1
365590161,0,1,0,0,1
365597144,0,1,0,0,1
365614431,0,1,0,0,1
365615666,0,1,0,0,1
365692420,0,1,0,0,1
365722232,0,0,1,0,1
365730597,0,1,0,0,1
365817337,0,1,0,0,1
365891102,0,1,0,0,1
365914760,0,1,0,0,1
365916153,0,1,0,0,1
365952863,0,1,0,0,1
365963023,0,1,0,0,1
366000862,0,1,0,0,1
366005886,0,1,0,0,1
366065091,0,1,0,0,1
365343798,0,1,0,0,1
365311639,1,0,0,0,1
365247162,0,1,0,0,1
364348216,0,1,0,0,1
363873746,0,1,0,0,1
363972192,0,1,0,0,1
364081865,0,1,0,0,1
364180533,0,1,0,0,1
364243923,0,1,0,0,1
364251874,1,0,0,0,1
364257939,1,0,0,0,1
364278023,0,1,0,0,1
364284740,0,1,0,0,1
364343069,0,1,0,0,1
364411661,0,1,0,0,1
365050493,0,1,0,0,1
364432818,0,1,0,0,1
364494647,0,1,0,0,1
364505968,1,0,0,0,1
364613955,0,1,0,0,1
364656599,0,1,0,0,1
364706524,0,1,0,0,1
364787015,0,1,0,0,1
364916154,1,0,0,0,1
364979670,0,1,0,0,1
364998401,0,1,0,0,1
351066202,1,0,0,0,1
351059116,0,1,0,0,1
351047389,0,1,0,0,1
336544114,1,0,0,0,1
336682786,0,1,0,0,1
336725907,0,1,0,0,1
336735979,0,1,0,0,1
336861271,0,1,0,0,1
336958876,0,1,0,0,1
336972624,0,1,0,0,1
336988074,0,1,0,0,1
337007377,0,1,0,0,1
337060311,0,1,0,0,1
337136343,0,1,0,0,1
337152978,0,1,0,0,1
337154255,0,1,0,0,1
337169637,0,1,0,0,1
337182709,1,0,0,0,1
337183037,0,1,0,0,1
337224887,0,1,0,0,1
337302240,0,1,0,0,1
337476573,1,0,0,0,1
337512647,0,1,0,0,1
337602051,0,0,0,1,1
337603927,1,0,0,0,1
337622080,1,0,0,0,1
337643348,0,1,0,0,1
336593494,0,1,0,0,1
336534357,0,1,0,0,1
340232061,0,1,0,0,1
336508904,1,0,0,0,1
335365982,0,0,0,1,1
335489271,0,1,0,0,1
335548675,0,1,0,0,1
335556970,0,1,0,0,1
335578227,0,1,0,0,1
335580846,0,1,0,0,1
335612675,0,1,0,0,1
335851836,0,0,0,1,1
335911706,1,0,0,0,1
335919040,0,0,1,0,1
335984875,0,1,0,0,1
336013267,0,1,0,0,1
336054068,0,1,0,0,1
336058636,0,0,0,1,1
336065898,0,1,0,0,1
336142195,0,0,1,0,1
336155770,0,1,0,0,1
336168071,0,1,0,0,1
336346706,1,0,0,0,1
336360317,1,0,0,0,1
336468623,0,1,0,0,1
336482814,0,1,0,0,1
336496723,0,1,0,0,1
337645220,0,1,0,0,1
337692592,0,1,0,0,1
337701221,0,1,0,0,1
337711985,0,1,0,0,1
339015401,1,0,0,0,1
339064285,0,1,0,0,1
339072752,0,1,0,0,1
339078998,1,0,0,0,1
339117967,0,1,0,0,1
339129605,1,0,0,0,1
339191709,0,0,1,0,1
339208512,0,1,0,0,1
339210906,1,0,0,0,1
339246916,0,1,0,0,1
339315273,0,1,0,0,1
339382173,0,1,0,0,1
339504588,0,1,0,0,1
339659551,0,1,0,0,1
339679398,0,1,0,0,1
339747044,0,1,0,0,1
339848545,0,1,0,0,1
339859907,0,1,0,0,1
339871843,0,1,0,0,1
339898986,0,1,0,0,1
339997557,0,1,0,0,1
340124851,1,0,0,0,1
340182968,0,1,0,0,1
339015025,0,1,0,0,1
338923559,0,1,0,0,1
338921630,0,1,0,0,1
338241427,0,1,0,0,1
337722304,0,1,0,0,1
337741058,0,1,0,0,1
337750557,0,1,0,0,1
337807611,0,1,0,0,1
337858621,0,1,0,0,1
337880290,0,1,0,0,1
337907534,0,1,0,0,1
337930556,0,1,0,0,1
337938586,0,1,0,0,1
337955755,0,1,0,0,1
338279088,0,1,0,0,1
338891402,0,1,0,0,1
338364302,0,1,0,0,1
338379036,0,1,0,0,1
338413075,0,1,0,0,1
338473859,1,0,0,0,1
338597951,0,1,0,0,1
338611621,0,0,1,0,1
338654684,0,1,0,0,1
338661490,0,1,0,0,1
338840973,0,1,0,0,1
338873328,1,0,0,0,1
335362330,1,0,0,0,1
335307774,1,0,0,0,1
335272408,1,0,0,0,1
332678297,0,1,0,0,1
330832378,0,1,0,0,1
330833510,0,1,0,0,1
330851227,0,1,0,0,1
330901885,0,1,0,0,1
331049795,0,1,0,0,1
331087025,1,0,0,0,1
331099557,0,1,0,0,1
331100346,0,1,0,0,1
331104316,0,1,0,0,1
331109610,1,0,0,0,1
331119235,0,1,0,0,1
331121605,0,1,0,0,1
331282549,0,1,0,0,1
331444184,0,1,0,0,1
331463208,0,1,0,0,1
331479899,0,1,0,0,1
331678205,0,1,0,0,1
331730251,1,0,0,0,1
331752382,0,1,0,0,1
332088889,0,1,0,0,1
332207323,0,1,0,0,1
332209438,0,1,0,0,1
332324998,0,1,0,0,1
330810885,0,1,0,0,1
330723278,0,1,0,0,1
330638523,0,1,0,0,1
330033770,0,1,0,0,1
329586005,0,1,0,0,1
329594987,0,1,0,0,1
329623128,0,1,0,0,1
329659117,1,0,0,0,1
329660012,0,1,0,0,1
329711808,0,1,0,0,1
329850788,0,1,0,0,1
329931732,0,1,0,0,1
330016679,1,0,0,0,1
330017179,0,1,0,0,1
330046741,0,1,0,0,1
330625542,0,1,0,0,1
330192485,1,0,0,0,1
330196261,0,1,0,0,1
330236412,0,1,0,0,1
330250342,0,1,0,0,1
330258090,0,1,0,0,1
330340815,0,1,0,0,1
330406517,0,1,0,0,1
330476024,0,1,0,0,1
330477519,0,1,0,0,1
330537540,0,1,0,0,1
332347276,0,1,0,0,1
332681326,0,1,0,0,1
335269726,0,1,0,0,1
332701724,0,0,1,0,1
334264212,0,1,0,0,1
334278958,1,0,0,0,1
334348807,0,1,0,0,1
334382829,0,1,0,0,1
334512087,0,1,0,0,1
334680099,0,1,0,0,1
334692444,0,1,0,0,1
334709637,0,1,0,0,1
334720088,0,1,0,0,1
334739572,0,1,0,0,1
334765767,0,1,0,0,1
334865797,0,1,0,0,1
334888674,0,1,0,0,1
335037195,0,1,0,0,1
335096977,0,1,0,0,1
335099350,0,1,0,0,1
335104496,0,1,0,0,1
335143057,0,1,0,0,1
335160014,1,0,0,0,1
335176123,0,1,0,0,1
335201607,1,0,0,0,1
335216503,0,1,0,0,1
335223327,0,1,0,0,1
334112049,0,1,0,0,1
333960283,0,1,0,0,1
333950094,1,0,0,0,1
333287693,1,0,0,0,1
332720133,0,1,0,0,1
332812637,1,0,0,0,1
332868472,0,1,0,0,1
332911609,0,1,0,0,1
332931290,0,1,0,0,1
333014276,1,0,0,0,1
333229786,0,1,0,0,1
333230959,0,1,0,0,1
333255260,0,1,0,0,1
333265493,0,1,0,0,1
333385379,0,1,0,0,1
333924306,0,1,0,0,1
333403672,0,1,0,0,1
333413279,1,0,0,0,1
333456075,0,1,0,0,1
333487360,0,1,0,0,1
333499094,0,1,0,0,1
333590879,0,1,0,0,1
333623951,0,1,0,0,1
333789625,0,1,0,0,1
333823078,1,0,0,0,1
333872870,0,1,0,0,1
340219263,0,1,0,0,1
340258039,0,1,0,0,1
351044840,0,0,0,1,1
347089630,1,0,0,0,1
347148411,0,1,0,0,1
347151595,0,1,0,0,1
347179381,0,1,0,0,1
347189066,0,1,0,0,1
347307446,0,1,0,0,1
347324021,0,1,0,0,1
347601960,0,1,0,0,1
347799272,0,1,0,0,1
347814706,0,1,0,0,1
347818487,0,1,0,0,1
347874947,0,1,0,0,1
347964545,0,1,0,0,1
347965549,0,1,0,0,1
347998078,1,0,0,0,1
347999395,0,1,0,0,1
348087292,0,0,1,0,1
348231773,0,1,0,0,1
348307249,0,1,0,0,1
348381205,1,0,0,0,1
348386637,0,1,0,0,1
348387400,0,1,0,0,1
348393398,0,0,0,1,1
348555383,0,1,0,0,1
347106946,0,1,0,0,1
347022801,0,1,0,0,1
340301117,0,1,0,0,1
346696542,0,1,0,0,1
345828427,0,1,0,0,1
345923382,0,1,0,0,1
345946553,0,1,0,0,1
345956586,0,1,0,0,1
346012104,0,1,0,0,1
346020368,0,1,0,0,1
346037045,1,0,0,0,1
346055006,0,1,0,0,1
346067781,0,0,0,1,1
346132951,0,1,0,0,1
346172523,0,1,0,0,1
346178292,0,0,0,1,1
346236073,0,1,0,0,1
346236401,0,1,0,0,1
346304936,0,1,0,0,1
346344101,0,1,0,0,1
346415196,0,0,0,1,1
346498015,1,0,0,0,1
346532435,0,1,0,0,1
346544773,0,0,0,1,1
346653053,0,1,0,0,1
346660225,0,1,0,0,1
346692486,0,1,0,0,1
348615325,0,1,0,0,1
348620772,0,1,0,0,1
348721240,0,1,0,0,1
348765334,0,1,0,0,1
349756757,0,1,0,0,1
349763772,0,0,0,1,1
349773296,0,1,0,0,1
349791544,0,1,0,0,1
349853881,0,1,0,0,1
349960565,0,1,0,0,1
349993979,0,1,0,0,1
350095519,0,1,0,0,1
350133779,0,1,0,0,1
350149869,0,0,1,0,1
350187041,0,1,0,0,1
350189997,0,1,0,0,1
350252762,0,1,0,0,1
350274771,0,1,0,0,1
350364148,0,1,0,0,1
350388833,0,1,0,0,1
350510856,0,1,0,0,1
350540691,0,1,0,0,1
350733604,0,1,0,0,1
350738487,0,1,0,0,1
350783170,0,1,0,0,1
350809495,0,1,0,0,1
350932128,0,1,0,0,1
349743072,1,0,0,0,1
349713713,0,1,0,0,1
349695893,1,0,0,0,1
349141533,0,1,0,0,1
348788073,0,1,0,0,1
348799574,1,0,0,0,1
348853525,0,1,0,0,1
349009864,0,1,0,0,1
349028884,0,1,0,0,1
349057777,0,1,0,0,1
349084008,0,1,0,0,1
349108203,0,1,0,0,1
349117930,0,1,0,0,1
349126118,0,1,0,0,1
349171859,0,1,0,0,1
349668812,0,1,0,0,1
349228252,0,1,0,0,1
349237559,0,1,0,0,1
349247383,1,0,0,0,1
349264051,0,1,0,0,1
349276378,0,1,0,0,1
349293516,0,1,0,0,1
349419581,1,0,0,0,1
349513637,0,1,0,0,1
349546917,0,1,0,0,1
349660725,0,1,0,0,1
345770198,1,0,0,0,1
345750854,0,1,0,0,1
345679452,0,1,0,0,1
343323067,0,1,0,0,1
341862151,0,1,0,0,1
341951790,1,0,0,0,1
342004053,0,1,0,0,1
342016328,0,1,0,0,1
342028286,0,1,0,0,1
342098955,1,0,0,0,1
342322913,1,0,0,0,1
342446216,0,1,0,0,1
342477601,0,1,0,0,1
342576702,1,0,0,0,1
342586771,0,1,0,0,1
342709703,1,0,0,0,1
342747169,1,0,0,0,1
342749902,0,1,0,0,1
342799198,0,1,0,0,1
342828432,0,1,0,0,1
342937266,1,0,0,0,1
343023366,0,1,0,0,1
343031023,0,1,0,0,1
343112578,0,1,0,0,1
343150559,0,1,0,0,1
343264621,0,1,0,0,1
343293083,0,1,0,0,1
341850630,0,1,0,0,1
341804937,0,1,0,0,1
341641537,0,1,0,0,1
340826075,0,1,0,0,1
340343822,0,1,0,0,1
340481991,0,1,0,0,1
340491847,1,0,0,0,1
340498991,0,1,0,0,1
340509680,0,1,0,0,1
340541153,0,1,0,0,1
340545072,0,1,0,0,1
340582241,0,1,0,0,1
340782741,1,0,0,0,1
340785923,0,1,0,0,1
340834430,0,1,0,0,1
341536581,0,1,0,0,1
340931837,0,1,0,0,1
340963050,0,1,0,0,1
340977799,0,1,0,0,1
341000262,0,1,0,0,1
341108276,0,1,0,0,1
341227618,0,1,0,0,1
341237631,0,1,0,0,1
341327946,1,0,0,0,1
341421244,0,1,0,0,1
341517670,1,0,0,0,1
343308709,0,1,0,0,1
343325252,0,1,0,0,1
345642698,0,0,1,0,1
343343854,1,0,0,0,1
344626195,0,1,0,0,1
344636455,0,1,0,0,1
344636669,1,0,0,0,1
344659169,0,1,0,0,1
344669752,0,1,0,0,1
344703440,1,0,0,0,1
344781251,0,1,0,0,1
344784485,0,1,0,0,1
344802378,0,1,0,0,1
344817403,0,1,0,0,1
344855437,0,1,0,0,1
344887200,1,0,0,0,1
344922440,0,1,0,0,1
344932812,0,1,0,0,1
344933571,0,1,0,0,1
344952003,0,1,0,0,1
345148698,1,0,0,0,1
345226853,0,1,0,0,1
345327883,0,1,0,0,1
345328584,0,0,1,0,1
345387656,0,1,0,0,1
345560200,0,1,0,0,1
345566319,0,1,0,0,1
344617882,0,1,0,0,1
344520954,0,1,0,0,1
344464059,0,1,0,0,1
343858083,0,1,0,0,1
343440159,0,1,0,0,1
343457966,0,1,0,0,1
343464189,0,1,0,0,1
343493914,0,1,0,0,1
343495009,0,0,1,0,1
343505217,0,1,0,0,1
343531448,0,1,0,0,1
343539072,0,1,0,0,1
343576941,1,0,0,0,1
343803971,0,1,0,0,1
343933160,1,0,0,0,1
344425320,0,0,0,1,1
343960114,0,1,0,0,1
343980966,0,1,0,0,1
344012247,0,1,0,0,1
344029393,1,0,0,0,1
344040482,1,0,0,0,1
344058812,0,1,0,0,1
344083874,0,1,0,0,1
344231736,1,0,0,0,1
344292553,1,0,0,0,1
344373492,0,1,0,0,1
371336490,0,0,0,1,1
371365012,0,1,0,0,1
371404049,0,1,0,0,1
397198325,0,1,0,0,1
397271343,0,1,0,0,1
397289221,0,1,0,0,1
397365910,0,1,0,0,1
397387641,1,0,0,0,1
397408669,0,1,0,0,1
397579406,0,1,0,0,1
397594864,1,0,0,0,1
397674471,0,1,0,0,1
397685878,0,1,0,0,1
397746524,0,0,1,0,1
397978784,0,1,0,0,1
398022325,0,1,0,0,1
398025599,0,1,0,0,1
398123463,0,1,0,0,1
398201625,0,1,0,0,1
398222025,1,0,0,0,1
398258324,0,1,0,0,1
398406689,0,1,0,0,1
398526958,0,1,0,0,1
398550231,0,1,0,0,1
398590510,0,1,0,0,1
398605877,0,1,0,0,1
398887740,0,1,0,0,1
397221247,0,0,0,1,1
397115621,0,1,0,0,1
401467874,0,1,0,0,1
397080021,0,1,0,0,1
395428269,0,1,0,0,1
395455596,0,1,0,0,1
395477031,0,1,0,0,1
395489552,0,1,0,0,1
395531330,0,1,0,0,1
395533815,0,1,0,0,1
395540676,0,1,0,0,1
395617181,0,1,0,0,1
395736312,0,1,0,0,1
395848699,0,1,0,0,1
395911211,1,0,0,0,1
395993515,0,1,0,0,1
396023528,0,0,0,1,1
396100187,1,0,0,0,1
396317005,0,1,0,0,1
396321638,0,0,0,1,1
396342515,0,1,0,0,1
396389456,1,0,0,0,1
396412992,0,1,0,0,1
396452362,0,0,0,1,1
396480121,0,1,0,0,1
396842342,0,1,0,0,1
396969576,0,1,0,0,1
398934233,0,1,0,0,1
399044866,0,1,0,0,1
399259538,0,1,0,0,1
399286137,0,1,0,0,1
400403301,0,1,0,0,1
400504464,0,1,0,0,1
400521810,0,1,0,0,1
400553222,0,1,0,0,1
400585013,0,1,0,0,1
400678013,0,1,0,0,1
400741945,0,1,0,0,1
400766834,0,1,0,0,1
400860401,0,1,0,0,1
400906497,1,0,0,0,1
400998108,0,1,0,0,1
401011452,0,0,0,1,1
401047108,0,1,0,0,1
401048929,0,1,0,0,1
401058539,0,1,0,0,1
401204224,0,1,0,0,1
401269169,1,0,0,0,1
401353323,0,1,0,0,1
401365391,1,0,0,0,1
401378378,0,1,0,0,1
401425695,0,1,0,0,1
401429820,0,1,0,0,1
401432921,0,1,0,0,1
400362418,0,1,0,0,1
400320616,0,1,0,0,1
400306739,0,0,0,1,1
399846306,0,1,0,0,1
399286609,1,0,0,0,1
399338469,0,0,1,0,1
399362336,0,0,0,1,1
399488284,0,1,0,0,1
399492959,1,0,0,0,1
399518288,0,1,0,0,1
399595766,0,1,0,0,1
399598946,0,1,0,0,1
399686917,0,0,1,0,1
399773395,1,0,0,0,1
399995430,0,1,0,0,1
400285962,0,0,0,1,1
400072597,0,1,0,0,1
400078019,0,1,0,0,1
400080298,0,1,0,0,1
400094929,0,1,0,0,1
400109951,0,1,0,0,1
400127172,0,1,0,0,1
400127599,0,0,0,1,1
400237258,1,0,0,0,1
400241751,1,0,0,0,1
400269550,0,1,0,0,1
395408390,0,1,0,0,1
395392537,0,1,0,0,1
395377704,0,1,0,0,1
392790310,1,0,0,0,1
391894707,0,1,0,0,1
391993920,0,1,0,0,1
392086950,0,1,0,0,1
392132054,0,1,0,0,1
392137069,0,1,0,0,1
392163668,0,1,0,0,1
392183840,1,0,0,0,1
392197028,0,1,0,0,1
392203667,0,1,0,0,1
392221059,0,1,0,0,1
392272932,0,1,0,0,1
392281165,0,1,0,0,1
392284514,0,1,0,0,1
392383733,0,1,0,0,1
392497998,0,1,0,0,1
392521217,1,0,0,0,1
392552289,0,1,0,0,1
392567874,0,1,0,0,1
392611108,0,1,0,0,1
392635317,0,1,0,0,1
392673861,0,0,0,1,1
392743715,0,1,0,0,1
392768458,1,0,0,0,1
391801431,0,1,0,0,1
391706953,0,0,1,0,1
391681473,0,1,0,0,1
390840867,0,1,0,0,1
390366820,1,0,0,0,1
390392773,0,1,0,0,1
390414956,0,1,0,0,1
390603815,0,1,0,0,1
390641663,0,1,0,0,1
390677950,0,1,0,0,1
390694804,0,1,0,0,1
390723707,0,1,0,0,1
390799655,0,1,0,0,1
390827927,0,1,0,0,1
390865418,0,1,0,0,1
391635096,1,0,0,0,1
390870661,1,0,0,0,1
390934000,0,1,0,0,1
390944247,0,1,0,0,1
391051589,0,1,0,0,1
391076016,0,1,0,0,1
391251696,0,1,0,0,1
391256401,0,1,0,0,1
391321335,0,1,0,0,1
391491343,0,1,0,0,1
391591757,0,1,0,0,1
392786665,0,1,0,0,1
392828902,0,1,0,0,1
395374425,0,1,0,0,1
392886568,0,1,0,0,1
394401824,0,1,0,0,1
394448803,0,1,0,0,1
394617771,1,0,0,0,1
394623581,0,1,0,0,1
394637051,0,1,0,0,1
394639684,0,1,0,0,1
394642452,0,0,0,1,1
394648663,0,1,0,0,1
394709939,0,1,0,0,1
394736945,0,1,0,0,1
394753670,0,1,0,0,1
394830481,0,1,0,0,1
394860882,0,1,0,0,1
395007368,0,1,0,0,1
395011753,0,1,0,0,1
395057541,1,0,0,0,1
395127878,0,1,0,0,1
395222372,1,0,0,0,1
395236173,0,1,0,0,1
395298845,0,1,0,0,1
395309103,0,1,0,0,1
395322189,1,0,0,0,1
395349300,0,1,0,0,1
394115760,0,0,1,0,1
394079908,0,1,0,0,1
394039436,0,1,0,0,1
393291761,0,0,1,0,1
392911893,0,1,0,0,1
392926655,0,1,0,0,1
392940388,0,1,0,0,1
392944808,0,1,0,0,1
392981152,0,1,0,0,1
393030888,0,1,0,0,1
393097276,0,0,1,0,1
393146444,0,1,0,0,1
393213744,0,1,0,0,1
393267512,1,0,0,0,1
393389277,1,0,0,0,1
393995020,0,1,0,0,1
393475768,0,1,0,0,1
393554507,1,0,0,0,1
393639724,0,1,0,0,1
393672895,0,1,0,0,1
393682518,0,1,0,0,1
393725810,0,1,0,0,1
393867458,0,1,0,0,1
393929765,0,1,0,0,1
393967766,0,1,0,0,1
393971044,0,1,0,0,1
401455670,1,0,0,0,1
401472426,0,1,0,0,1
390125444,0,1,0,0,1
408314303,0,1,0,0,1
408360989,0,1,0,0,1
408375326,0,1,0,0,1
408426285,0,1,0,0,1
408502556,0,0,0,1,1
408529483,0,1,0,0,1
408584251,0,1,0,0,1
408635743,0,1,0,0,1
408710622,0,1,0,0,1
408774049,0,1,0,0,1
408906521,0,1,0,0,1
409060503,0,1,0,0,1
409241653,0,1,0,0,1
409245395,0,1,0,0,1
409294537,0,1,0,0,1
409304901,0,1,0,0,1
409318570,0,1,0,0,1
409349498,0,1,0,0,1
409354211,0,1,0,0,1
409437103,0,0,0,1,1
409559527,0,0,1,0,1
409568934,0,1,0,0,1
409576700,0,1,0,0,1
409645883,1,0,0,0,1
408335391,0,1,0,0,1
408237224,0,1,0,0,1
401478688,0,1,0,0,1
408219505,0,1,0,0,1
406825354,1,0,0,0,1
406856188,0,1,0,0,1
406927244,0,1,0,0,1
407020992,0,0,0,1,1
407044860,0,1,0,0,1
407048454,0,1,0,0,1
407082824,0,1,0,0,1
407087929,0,1,0,0,1
407103061,1,0,0,0,1
407275329,0,1,0,0,1
407301525,0,1,0,0,1
407478353,0,1,0,0,1
407492240,0,1,0,0,1
407582399,0,1,0,0,1
407592265,0,1,0,0,1
407614732,0,1,0,0,1
407635906,0,1,0,0,1
407810320,0,1,0,0,1
407820108,0,1,0,0,1
407831463,0,1,0,0,1
407910480,0,1,0,0,1
407934784,0,1,0,0,1
408092457,0,1,0,0,1
409719727,0,1,0,0,1
409727654,0,1,0,0,1
409739279,0,1,0,0,1
409752100,0,1,0,0,1
411176136,0,0,1,0,1
411181595,1,0,0,0,1
411217829,0,1,0,0,1
411377266,1,0,0,0,1
411440484,0,1,0,0,1
411477040,0,0,1,0,1
411481047,0,1,0,0,1
411582718,0,1,0,0,1
411614752,0,1,0,0,1
411672072,0,1,0,0,1
411686207,0,1,0,0,1
411719688,0,1,0,0,1
411777000,1,0,0,0,1
411821389,0,1,0,0,1
411970725,0,1,0,0,1
412039427,0,1,0,0,1
412063079,0,0,0,1,1
412287766,0,1,0,0,1
412391257,0,1,0,0,1
412438115,0,1,0,0,1
412474587,0,1,0,0,1
412498401,0,1,0,0,1
412563067,0,1,0,0,1
411040104,0,1,0,0,1
410998141,0,1,0,0,1
410921782,0,1,0,0,1
410190982,0,1,0,0,1
409815285,0,0,1,0,1
409824643,1,0,0,0,1
409892410,0,0,1,0,1
409919218,0,1,0,0,1
410041882,0,1,0,0,1
410065500,0,1,0,0,1
410103064,0,1,0,0,1
410151580,0,1,0,0,1
410161956,0,1,0,0,1
410178708,1,0,0,0,1
410204774,0,1,0,0,1
410872109,0,1,0,0,1
410208174,0,1,0,0,1
410248429,0,1,0,0,1
410321995,0,1,0,0,1
410381776,1,0,0,0,1
410388446,0,1,0,0,1
410487627,0,1,0,0,1
410549221,1,0,0,0,1
410650472,0,1,0,0,1
410761937,1,0,0,0,1
410776504,0,1,0,0,1
406805714,1,0,0,0,1
406722559,0,1,0,0,1
406658977,0,1,0,0,1
404556571,0,1,0,0,1
403153382,0,0,0,1,1
403219220,0,1,0,0,1
403253716,0,1,0,0,1
403366663,0,1,0,0,1
403484458,0,1,0,0,1
403538003,0,1,0,0,1
403548479,0,1,0,0,1
403607264,0,1,0,0,1
403711976,1,0,0,0,1
403927216,0,1,0,0,1
403940698,1,0,0,0,1
404011855,0,1,0,0,1
404049851,0,1,0,0,1
404163542,0,1,0,0,1
404285623,0,1,0,0,1
404324765,0,1,0,0,1
404327813,0,1,0,0,1
404376189,0,0,0,1,1
404390873,0,1,0,0,1
404394744,0,1,0,0,1
404423877,0,1,0,0,1
404456594,1,0,0,0,1
404512786,1,0,0,0,1
403145971,0,1,0,0,1
403086277,0,1,0,0,1
402967303,1,0,0,0,1
402259004,0,1,0,0,1
401508933,0,1,0,0,1
401530881,0,1,0,0,1
401588012,0,1,0,0,1
401718858,0,1,0,0,1
401823454,0,1,0,0,1
401886645,0,1,0,0,1
402090679,0,1,0,0,1
402121427,0,1,0,0,1
402142134,0,1,0,0,1
402250454,0,1,0,0,1
402412639,0,1,0,0,1
402964868,0,1,0,0,1
402422196,0,1,0,0,1
402434458,0,1,0,0,1
402499127,0,1,0,0,1
402576698,0,1,0,0,1
402654578,0,1,0,0,1
402703787,0,1,0,0,1
402770408,0,1,0,0,1
402889276,1,0,0,0,1
402911593,0,1,0,0,1
402922953,0,1,0,0,1
404540693,0,1,0,0,1
404714325,1,0,0,0,1
406648848,0,1,0,0,1
404767782,0,0,1,0,1
405590291,0,1,0,0,1
405590920,0,1,0,0,1
405591776,0,0,1,0,1
405604486,0,1,0,0,1
405633156,0,1,0,0,1
405704972,0,1,0,0,1
405705114,1,0,0,0,1
405773717,0,1,0,0,1
405845606,0,1,0,0,1
405855989,0,1,0,0,1
405857174,0,1,0,0,1
406046421,0,1,0,0,1
406059868,0,1,0,0,1
406086629,0,1,0,0,1
406140942,0,1,0,0,1
406185588,0,1,0,0,1
406361456,1,0,0,0,1
406380205,0,1,0,0,1
406450179,0,1,0,0,1
406461068,0,0,0,1,1
406526651,1,0,0,0,1
406532488,0,1,0,0,1
406599623,0,1,0,0,1
405573665,0,1,0,0,1
405522290,0,1,0,0,1
405433179,0,1,0,0,1
405061028,0,1,0,0,1
404785976,0,1,0,0,1
404793437,0,1,0,0,1
404795263,0,1,0,0,1
404855367,0,1,0,0,1
404899748,0,1,0,0,1
404908079,0,1,0,0,1
404930384,0,1,0,0,1
404976196,0,0,0,1,1
404983276,0,1,0,0,1
404997778,0,1,0,0,1
405069733,0,1,0,0,1
405362068,0,1,0,0,1
405069864,0,1,0,0,1
405100387,0,1,0,0,1
405123364,0,1,0,0,1
405157472,0,1,0,0,1
405188454,0,1,0,0,1
405194953,1,0,0,0,1
405250597,0,1,0,0,1
405256550,0,1,0,0,1
405263712,0,1,0,0,1
405359378,0,1,0,0,1
390251141,0,1,0,0,1
390083616,0,1,0,0,1
371485193,0,1,0,0,1
376239141,0,1,0,0,1
376248457,1,0,0,0,1
376294975,0,1,0,0,1
376517179,0,1,0,0,1
376556775,0,1,0,0,1
376603608,0,1,0,0,1
376656562,0,1,0,0,1
376724192,0,1,0,0,1
376748053,1,0,0,0,1
376776457,1,0,0,0,1
376785583,1,0,0,0,1
376786932,0,1,0,0,1
376920189,0,1,0,0,1
376925090,0,1,0,0,1
376937152,0,1,0,0,1
376953700,0,1,0,0,1
377013645,0,1,0,0,1
377052124,0,0,1,0,1
377053743,0,1,0,0,1
377203914,0,1,0,0,1
377257875,1,0,0,0,1
377268030,0,1,0,0,1
377287476,0,1,0,0,1
377309879,0,1,0,0,1
376244636,1,0,0,0,1
376231360,0,0,1,0,1
380053650,0,1,0,0,1
376216976,0,1,0,0,1
375488294,0,1,0,0,1
375511974,0,1,0,0,1
375535893,0,1,0,0,1
375579405,0,0,0,1,1
375708690,0,1,0,0,1
375761094,0,1,0,0,1
375782967,0,1,0,0,1
375789929,0,1,0,0,1
375886827,0,1,0,0,1
375888337,0,1,0,0,1
375996958,0,1,0,0,1
376050435,0,1,0,0,1
376053386,0,1,0,0,1
376058537,0,1,0,0,1
376099694,0,1,0,0,1
376111826,0,1,0,0,1
376128047,0,1,0,0,1
376147051,0,1,0,0,1
376152238,0,0,0,1,1
376177017,0,1,0,0,1
376188474,0,1,0,0,1
376190658,0,1,0,0,1
376216550,1,0,0,0,1
377343794,0,0,1,0,1
377345183,0,1,0,0,1
377380234,1,0,0,0,1
377562168,0,1,0,0,1
378764416,0,1,0,0,1
378839317,1,0,0,0,1
378845818,0,1,0,0,1
378850325,0,1,0,0,1
379000170,0,1,0,0,1
379069646,0,1,0,0,1
379072520,1,0,0,0,1
379107027,0,1,0,0,1
379110780,0,1,0,0,1
379152405,0,1,0,0,1
379158331,0,1,0,0,1
379232394,0,1,0,0,1
379305040,0,1,0,0,1
379412408,0,1,0,0,1
379643030,1,0,0,0,1
379656034,0,1,0,0,1
379678423,0,1,0,0,1
379681856,1,0,0,0,1
379701597,0,1,0,0,1
379768010,0,1,0,0,1
379810943,0,1,0,0,1
379909757,0,1,0,0,1
379935880,0,1,0,0,1
378707722,0,1,0,0,1
378686448,1,0,0,0,1
378678427,0,1,0,0,1
378031649,0,1,0,0,1
377611244,0,1,0,0,1
377700407,1,0,0,0,1
377803879,0,1,0,0,1
377854299,0,1,0,0,1
377878096,0,1,0,0,1
377938100,0,1,0,0,1
377952177,0,1,0,0,1
377972974,0,0,1,0,1
377989788,0,1,0,0,1
378016563,0,1,0,0,1
378092499,0,0,1,0,1
378655253,0,1,0,0,1
378131689,0,0,0,1,1
378183319,0,1,0,0,1
378217242,1,0,0,0,1
378391767,0,1,0,0,1
378440117,1,0,0,0,1
378473739,0,1,0,0,1
378524353,1,0,0,0,1
378547589,0,1,0,0,1
378564590,0,1,0,0,1
378566172,0,1,0,0,1
375476529,0,1,0,0,1
375456899,0,1,0,0,1
375382436,0,1,0,0,1
373180587,0,1,0,0,1
372363635,0,1,0,0,1
372432937,0,1,0,0,1
372447514,1,0,0,0,1
372464674,0,1,0,0,1
372507537,0,1,0,0,1
372512689,0,1,0,0,1
372518188,0,1,0,0,1
372651680,0,1,0,0,1
372700580,1,0,0,0,1
372710008,0,0,0,1,1
372754277,0,0,0,1,1
372756531,0,1,0,0,1
372769294,0,1,0,0,1
372785588,0,1,0,0,1
372809955,0,1,0,0,1
372834661,0,1,0,0,1
372866049,0,1,0,0,1
372872248,1,0,0,0,1
372878182,0,1,0,0,1
372881332,0,1,0,0,1
372891453,1,0,0,0,1
372932621,1,0,0,0,1
372982226,0,1,0,0,1
372356951,1,0,0,0,1
372315596,0,1,0,0,1
372315441,0,1,0,0,1
371820361,0,1,0,0,1
371485624,0,1,0,0,1
371552020,0,1,0,0,1
371562139,0,1,0,0,1
371596093,0,1,0,0,1
371635156,0,1,0,0,1
371660253,0,1,0,0,1
371674812,0,1,0,0,1
371701707,0,1,0,0,1
371727835,0,1,0,0,1
371764603,0,1,0,0,1
371821612,0,0,0,1,1
372282714,0,1,0,0,1
371861797,1,0,0,0,1
371901242,1,0,0,0,1
371902299,0,1,0,0,1
372003137,0,1,0,0,1
372070121,0,1,0,0,1
372128010,0,1,0,0,1
372141892,0,1,0,0,1
372176534,0,1,0,0,1
372190344,0,1,0,0,1
372254588,1,0,0,0,1
373049625,0,1,0,0,1
373198868,0,1,0,0,1
375316672,0,1,0,0,1
373277850,0,0,1,0,1
374491649,1,0,0,0,1
374499913,0,1,0,0,1
374510529,1,0,0,0,1
374522219,0,1,0,0,1
374678289,0,1,0,0,1
374713015,0,1,0,0,1
374732488,0,1,0,0,1
374732550,0,1,0,0,1
374746312,0,1,0,0,1
374769903,0,1,0,0,1
374913712,0,1,0,0,1
374950071,0,1,0,0,1
374951750,1,0,0,0,1
374983303,1,0,0,0,1
375014689,0,1,0,0,1
375148478,0,1,0,0,1
375163617,0,0,1,0,1
375176828,0,1,0,0,1
375184860,0,1,0,0,1
375287337,0,1,0,0,1
375289965,1,0,0,0,1
375294224,0,1,0,0,1
375303982,0,1,0,0,1
374443662,0,1,0,0,1
374434484,0,1,0,0,1
374369959,1,0,0,0,1
373710978,0,1,0,0,1
373318440,0,1,0,0,1
373341220,0,1,0,0,1
373342928,0,1,0,0,1
373397183,0,1,0,0,1
373407139,0,1,0,0,1
373407169,0,1,0,0,1
373452887,0,1,0,0,1
373478996,0,1,0,0,1
373496626,0,1,0,0,1
373535926,0,1,0,0,1
373749997,1,0,0,0,1
374236992,0,1,0,0,1
373814378,1,0,0,0,1
373836462,0,1,0,0,1
373861527,0,1,0,0,1
373863186,1,0,0,0,1
373881160,0,1,0,0,1
373984826,0,1,0,0,1
373988464,0,1,0,0,1
374021234,0,0,0,1,1
374096811,1,0,0,0,1
374167375,0,1,0,0,1
379956066,0,1,0,0,1
380127168,0,0,1,0,1
389996536,0,1,0,0,1
386352384,0,1,0,0,1
386452694,1,0,0,0,1
386470548,0,1,0,0,1
386519400,0,0,1,0,1
386527612,0,1,0,0,1
386543171,0,1,0,0,1
386560001,1,0,0,0,1
386631157,0,1,0,0,1
386688181,0,1,0,0,1
386747876,0,1,0,0,1
386776603,0,1,0,0,1
386782225,0,1,0,0,1
386808882,0,1,0,0,1
386854695,1,0,0,0,1
386940581,0,0,1,0,1
386942137,0,0,1,0,1
386942464,0,1,0,0,1
386968679,0,1,0,0,1
386968897,0,1,0,0,1
387023419,0,1,0,0,1
387048339,1,0,0,0,1
387066864,0,1,0,0,1
387135187,0,1,0,0,1
387154336,1,0,0,0,1
386439533,0,1,0,0,1
386173189,0,1,0,0,1
380189237,0,1,0,0,1
386172445,0,1,0,0,1
385020965,1,0,0,0,1
385065819,0,1,0,0,1
385069691,0,1,0,0,1
385173212,0,1,0,0,1
385287400,0,1,0,0,1
385325759,0,1,0,0,1
385363152,0,1,0,0,1
385419669,0,1,0,0,1
385427193,0,1,0,0,1
385438560,0,1,0,0,1
385514702,0,0,0,1,1
385620802,0,1,0,0,1
385698853,0,1,0,0,1
385841249,0,1,0,0,1
385857629,0,1,0,0,1
385869391,0,1,0,0,1
385916145,0,0,1,0,1
385921555,0,1,0,0,1
385926593,1,0,0,0,1
385993829,0,1,0,0,1
386030380,0,1,0,0,1
386067954,0,1,0,0,1
386110413,1,0,0,0,1
387208952,0,1,0,0,1
387242305,0,1,0,0,1
387279588,0,1,0,0,1
387405939,0,1,0,0,1
388854171,0,1,0,0,1
388895694,0,1,0,0,1
388947237,0,0,0,1,1
388969895,0,1,0,0,1
389031957,0,1,0,0,1
389039338,0,1,0,0,1
389076011,0,1,0,0,1
389347993,0,1,0,0,1
389353166,0,1,0,0,1
389419847,0,1,0,0,1
389444689,0,1,0,0,1
389467428,0,0,1,0,1
389521252,0,1,0,0,1
389522959,1,0,0,0,1
389523597,0,1,0,0,1
389528617,0,1,0,0,1
389581525,0,1,0,0,1
389627969,0,1,0,0,1
389673791,0,1,0,0,1
389767637,0,1,0,0,1
389796063,1,0,0,0,1
389810936,0,1,0,0,1
389965881,0,1,0,0,1
388787688,0,1,0,0,1
388774547,0,1,0,0,1
388766693,0,1,0,0,1
388091265,0,1,0,0,1
387570338,0,1,0,0,1
387589265,0,1,0,0,1
387589566,0,1,0,0,1
387621592,0,0,0,1,1
387648622,1,0,0,0,1
387726029,0,1,0,0,1
387736563,0,1,0,0,1
387786066,0,1,0,0,1
387882328,0,1,0,0,1
387920769,0,1,0,0,1
388206950,0,0,1,0,1
388733470,0,1,0,0,1
388217478,0,1,0,0,1
388241280,0,1,0,0,1
388355994,0,1,0,0,1
388389211,0,1,0,0,1
388407238,0,1,0,0,1
388445896,0,1,0,0,1
388473330,0,1,0,0,1
388561943,0,1,0,0,1
388646207,0,1,0,0,1
388663219,0,1,0,0,1
385017562,0,1,0,0,1
384976743,0,1,0,0,1
384946427,0,1,0,0,1
382637973,0,1,0,0,1
381636982,0,1,0,0,1
381710179,1,0,0,0,1
381724310,1,0,0,0,1
381736495,0,1,0,0,1
381739935,0,1,0,0,1
381811353,0,1,0,0,1
381910183,0,1,0,0,1
381914360,0,1,0,0,1
382018744,0,1,0,0,1
382020533,0,1,0,0,1
382096906,0,1,0,0,1
382205637,0,1,0,0,1
382220893,0,0,0,1,1
382246098,0,1,0,0,1
382254185,1,0,0,0,1
382256152,1,0,0,0,1
382282549,0,1,0,0,1
382303383,0,1,0,0,1
382306274,0,1,0,0,1
382492986,0,1,0,0,1
382512063,0,1,0,0,1
382522817,0,1,0,0,1
382524524,0,1,0,0,1
381542237,0,1,0,0,1
381522477,0,1,0,0,1
381511178,1,0,0,0,1
380555502,0,1,0,0,1
380216408,0,1,0,0,1
380231626,0,1,0,0,1
380284227,0,1,0,0,1
380288305,0,1,0,0,1
380306569,0,1,0,0,1
380394797,0,1,0,0,1
380488215,0,1,0,0,1
380508221,0,1,0,0,1
380519113,0,1,0,0,1
380528895,0,1,0,0,1
380555738,0,1,0,0,1
381394625,0,1,0,0,1
380804498,0,0,1,0,1
380845859,0,1,0,0,1
380988541,0,1,0,0,1
381028359,1,0,0,0,1
381045256,0,1,0,0,1
381128775,0,1,0,0,1
381293930,0,1,0,0,1
381338347,0,1,0,0,1
381382478,0,1,0,0,1
381383063,0,1,0,0,1
382591847,0,0,1,0,1
382710321,0,1,0,0,1
384932265,0,1,0,0,1
382767159,1,0,0,0,1
384148207,0,1,0,0,1
384162248,1,0,0,0,1
384176072,0,1,0,0,1
384195951,1,0,0,0,1
384244151,0,1,0,0,1
384277563,0,1,0,0,1
384297997,0,1,0,0,1
384317366,0,1,0,0,1
384402376,0,1,0,0,1
384429591,1,0,0,0,1
384452664,0,1,0,0,1
384463823,0,1,0,0,1
384564146,0,1,0,0,1
384617870,1,0,0,0,1
384630356,0,1,0,0,1
384717973,1,0,0,0,1
384729895,0,1,0,0,1
384780859,1,0,0,0,1
384808475,0,1,0,0,1
384815029,0,1,0,0,1
384884459,0,1,0,0,1
384910835,1,0,0,0,1
384923143,0,1,0,0,1
384017928,0,1,0,0,1
383956784,0,1,0,0,1
383949832,0,1,0,0,1
383313895,0,1,0,0,1
382836952,0,1,0,0,1
382897181,0,1,0,0,1
382977686,0,1,0,0,1
383029340,0,1,0,0,1
383150503,0,0,1,0,1
383152196,0,1,0,0,1
383236624,0,1,0,0,1
383251211,0,0,0,1,1
383269969,0,1,0,0,1
383279184,0,1,0,0,1
383350707,0,1,0,0,1
383880426,0,1,0,0,1
383398023,0,1,0,0,1
383401242,0,1,0,0,1
383438066,0,1,0,0,1
383453541,0,1,0,0,1
383688667,1,0,0,0,1
383696816,0,1,0,0,1
383747998,0,1,0,0,1
383801430,0,1,0,0,1
383803931,0,1,0,0,1
383845090,0,1,0,0,1
185346286,0,1,0,0,1
185286744,0,1,0,0,1
185195661,0,1,0,0,1
41317044,0,1,0,0,1
41362122,0,1,0,0,1
41379168,0,1,0,0,1
41398492,0,1,0,0,1
41399671,1,0,0,0,1
41401222,0,1,0,0,1
41402001,0,1,0,0,1
41442780,0,0,1,0,1
41482391,0,0,1,0,1
41515782,0,1,0,0,1
41522958,0,1,0,0,1
41551956,0,1,0,0,1
41579175,0,1,0,0,1
41641653,0,1,0,0,1
41646909,0,1,0,0,1
41655670,0,1,0,0,1
41664005,0,1,0,0,1
41669038,0,0,1,0,1
41690206,0,1,0,0,1
41757811,0,1,0,0,1
41764820,0,1,0,0,1
41795475,0,1,0,0,1
41847759,1,0,0,0,1
41850850,0,1,0,0,1
41327217,0,1,0,0,1
41278885,1,0,0,0,1
40696740,0,0,1,0,1
41249676,1,0,0,0,1
40758096,0,1,0,0,1
40777277,1,0,0,0,1
40818775,0,1,0,0,1
40841619,0,0,0,1,1
40863085,0,1,0,0,1
40871064,1,0,0,0,1
40891997,1,0,0,0,1
40929609,0,1,0,0,1
41004749,0,1,0,0,1
41009668,0,1,0,0,1
41014243,0,1,0,0,1
41060663,0,1,0,0,1
41067310,0,1,0,0,1
41069942,0,1,0,0,1
41090618,1,0,0,0,1
41119352,0,1,0,0,1
41125020,0,1,0,0,1
41138418,0,1,0,0,1
41176756,0,1,0,0,1
41182043,0,1,0,0,1
41187466,0,1,0,0,1
41219241,0,1,0,0,1
41222601,0,1,0,0,1
41870240,0,1,0,0,1
41874315,1,0,0,0,1
41924532,0,1,0,0,1
41939206,0,1,0,0,1
42332041,1,0,0,0,1
42337579,0,1,0,0,1
42342155,0,1,0,0,1
42378816,0,1,0,0,1
42382246,0,1,0,0,1
42389356,0,1,0,0,1
42398119,0,1,0,0,1
42399734,0,1,0,0,1
42471578,0,1,0,0,1
42482807,0,1,0,0,1
42491302,1,0,0,0,1
42497679,1,0,0,0,1
42507907,0,0,0,1,1
42547269,1,0,0,0,1
42589075,1,0,0,0,1
42606089,0,1,0,0,1
42628487,0,1,0,0,1
42661081,0,1,0,0,1
42664107,0,1,0,0,1
42666097,1,0,0,0,1
42708491,0,1,0,0,1
42746613,0,1,0,0,1
42752468,1,0,0,0,1
42323762,0,1,0,0,1
42303304,0,1,0,0,1
42295538,0,1,0,0,1
42025317,0,1,0,0,1
41947891,0,1,0,0,1
41955395,0,1,0,0,1
41959872,0,1,0,0,1
41984609,0,1,0,0,1
41984860,0,1,0,0,1
41993349,0,1,0,0,1
41993743,0,0,1,0,1
41994019,0,1,0,0,1
42004833,0,1,0,0,1
42014740,1,0,0,0,1
42072169,0,1,0,0,1
42294231,0,1,0,0,1
42073326,0,1,0,0,1
42090296,0,0,0,1,1
42095705,0,1,0,0,1
42210924,1,0,0,0,1
42254798,0,1,0,0,1
42257450,0,1,0,0,1
42264350,0,1,0,0,1
42264700,0,1,0,0,1
42265682,0,1,0,0,1
42291443,0,1,0,0,1
40722792,0,1,0,0,1
40659315,0,0,1,0,1
29863499,0,1,0,0,1
39123309,0,1,0,0,1
39195553,1,0,0,0,1
39209722,0,0,0,1,1
39213003,0,1,0,0,1
39215111,0,1,0,0,1
39220638,0,1,0,0,1
39304486,0,1,0,0,1
39311062,0,1,0,0,1
39333820,1,0,0,0,1
39340515,0,1,0,0,1
39350419,1,0,0,0,1
39356894,0,1,0,0,1
39384113,0,1,0,0,1
39406173,0,1,0,0,1
39423454,0,1,0,0,1
39457387,0,1,0,0,1
39473298,0,1,0,0,1
39480304,0,1,0,0,1
39485300,0,1,0,0,1
39494194,0,1,0,0,1
39498718,1,0,0,0,1
39511351,0,1,0,0,1
39527407,0,1,0,0,1
39558266,0,0,1,0,1
39130254,1,0,0,0,1
39112791,1,0,0,0,1
40646502,0,1,0,0,1
39111037,0,1,0,0,1
38566568,1,0,0,0,1
38576120,0,1,0,0,1
38629796,0,1,0,0,1
38650674,0,1,0,0,1
38657987,0,1,0,0,1
38684797,0,1,0,0,1
38693128,0,1,0,0,1
38726071,0,1,0,0,1
38735209,1,0,0,0,1
38793549,0,1,0,0,1
38828190,0,1,0,0,1
38898670,0,1,0,0,1
38909611,0,1,0,0,1
38936601,0,1,0,0,1
38944298,0,1,0,0,1
38947627,0,1,0,0,1
38955690,0,1,0,0,1
38976168,0,1,0,0,1
38987478,0,1,0,0,1
39026347,1,0,0,0,1
39039790,0,1,0,0,1
39041254,0,1,0,0,1
39110550,0,1,0,0,1
39578455,0,1,0,0,1
39603710,1,0,0,0,1
39628819,0,1,0,0,1
39635236,1,0,0,0,1
40279802,0,1,0,0,1
40298275,0,1,0,0,1
40309296,0,1,0,0,1
40373695,0,1,0,0,1
40390502,0,1,0,0,1
40397897,1,0,0,0,1
40415307,1,0,0,0,1
40429103,0,1,0,0,1
40444599,0,1,0,0,1
40476553,1,0,0,0,1
40477520,0,1,0,0,1
40493570,0,0,0,1,1
40509141,0,1,0,0,1
40518523,0,1,0,0,1
40545418,0,1,0,0,1
40547279,0,1,0,0,1
40558517,0,1,0,0,1
40567671,0,1,0,0,1
40571460,0,1,0,0,1
40606680,0,1,0,0,1
40635708,0,1,0,0,1
40643815,0,1,0,0,1
40645197,1,0,0,0,1
40250211,1,0,0,0,1
40243413,0,1,0,0,1
40228642,0,1,0,0,1
39930521,0,1,0,0,1
39676932,0,1,0,0,1
39689218,0,0,1,0,1
39710163,0,1,0,0,1
39713792,0,1,0,0,1
39781534,0,1,0,0,1
39790195,0,1,0,0,1
39791366,0,1,0,0,1
39866766,0,1,0,0,1
39889387,0,1,0,0,1
39915136,0,1,0,0,1
39959464,0,1,0,0,1
40222041,0,1,0,0,1
39960774,0,1,0,0,1
39968716,0,1,0,0,1
39974194,0,0,1,0,1
40005554,0,1,0,0,1
40047099,0,1,0,0,1
40060847,0,0,0,1,1
40089260,0,1,0,0,1
40109301,0,1,0,0,1
40203820,0,1,0,0,1
40216315,0,1,0,0,1
42792991,0,1,0,0,1
42836207,0,1,0,0,1
42842577,0,1,0,0,1
46070524,0,1,0,0,1
46101318,0,1,0,0,1
46112508,0,1,0,0,1
46114432,0,1,0,0,1
46123068,0,1,0,0,1
46130658,0,1,0,0,1
46195746,0,1,0,0,1
46219443,0,1,0,0,1
46229720,1,0,0,0,1
46249287,0,1,0,0,1
46300758,0,1,0,0,1
46302073,0,1,0,0,1
46303085,1,0,0,0,1
46303108,0,1,0,0,1
46317111,0,1,0,0,1
46345881,0,1,0,0,1
46436284,0,1,0,0,1
46464547,0,1,0,0,1
46474052,0,1,0,0,1
46483561,0,1,0,0,1
46485354,0,1,0,0,1
46502602,1,0,0,0,1
46518323,1,0,0,0,1
46550609,0,0,1,0,1
46079926,0,1,0,0,1
46068759,0,1,0,0,1
42881787,0,1,0,0,1
46064268,0,1,0,0,1
45473645,0,1,0,0,1
45495217,0,1,0,0,1
45526829,0,1,0,0,1
45554011,0,1,0,0,1
45583209,0,1,0,0,1
45583938,0,1,0,0,1
45609488,0,1,0,0,1
45612027,0,1,0,0,1
45612707,0,1,0,0,1
45622352,0,1,0,0,1
45684134,0,1,0,0,1
45705667,0,1,0,0,1
45722862,0,1,0,0,1
45756906,0,1,0,0,1
45765176,0,1,0,0,1
45781867,0,1,0,0,1
45808654,0,1,0,0,1
45813858,0,1,0,0,1
45819774,1,0,0,0,1
45825438,0,1,0,0,1
45829804,0,1,0,0,1
45849090,0,1,0,0,1
45890260,0,1,0,0,1
46620902,0,0,0,1,1
46630135,0,1,0,0,1
46630207,0,1,0,0,1
46631906,1,0,0,0,1
47151483,0,1,0,0,1
47205924,0,0,1,0,1
47210097,0,1,0,0,1
47213788,0,1,0,0,1
47215171,0,1,0,0,1
47215749,0,1,0,0,1
47225053,0,1,0,0,1
47252480,0,1,0,0,1
47306692,0,1,0,0,1
47346306,0,1,0,0,1
47351145,0,1,0,0,1
47370892,0,1,0,0,1
47401433,0,1,0,0,1
47408653,0,1,0,0,1
47430210,0,1,0,0,1
47499174,0,1,0,0,1
47502871,0,1,0,0,1
47518682,0,1,0,0,1
47525752,0,1,0,0,1
47556579,0,1,0,0,1
47582608,0,1,0,0,1
47585550,0,1,0,0,1
47587089,0,1,0,0,1
47124322,0,1,0,0,1
47122567,0,1,0,0,1
47117453,0,1,0,0,1
46838713,0,1,0,0,1
46637257,0,1,0,0,1
46637282,0,1,0,0,1
46667249,0,1,0,0,1
46679546,0,1,0,0,1
46702199,0,1,0,0,1
46739024,0,0,1,0,1
46759733,0,1,0,0,1
46763116,0,0,0,1,1
46821743,0,1,0,0,1
46833486,0,1,0,0,1
46863368,0,1,0,0,1
47109990,0,1,0,0,1
46875495,0,1,0,0,1
46879823,1,0,0,0,1
46904795,0,1,0,0,1
46910503,0,1,0,0,1
46943255,1,0,0,0,1
46971601,0,1,0,0,1
47028136,1,0,0,0,1
47052792,0,1,0,0,1
47074030,0,1,0,0,1
47093727,0,1,0,0,1
45437307,0,1,0,0,1
45387127,1,0,0,0,1
45378718,1,0,0,0,1
43929227,1,0,0,0,1
43505700,0,1,0,0,1
43513753,0,1,0,0,1
43541194,0,1,0,0,1
43591993,0,1,0,0,1
43633246,1,0,0,0,1
43661074,0,1,0,0,1
43681065,0,1,0,0,1
43721839,0,1,0,0,1
43730156,1,0,0,0,1
43730789,0,1,0,0,1
43740548,1,0,0,0,1
43753390,0,1,0,0,1
43777057,0,1,0,0,1
43790604,0,1,0,0,1
43824916,1,0,0,0,1
43830834,0,1,0,0,1
43837643,0,1,0,0,1
43844251,1,0,0,0,1
43850334,0,1,0,0,1
43867888,0,1,0,0,1
43872404,1,0,0,0,1
43875856,0,1,0,0,1
43927924,1,0,0,0,1
43497072,0,1,0,0,1
43461540,1,0,0,0,1
43427495,0,1,0,0,1
43096708,0,1,0,0,1
42884061,0,1,0,0,1
42889567,0,1,0,0,1
42891817,0,1,0,0,1
42898872,0,1,0,0,1
42948541,0,1,0,0,1
42951954,0,1,0,0,1
42983151,0,1,0,0,1
43039904,0,1,0,0,1
43070814,0,1,0,0,1
43090484,0,1,0,0,1
43124113,0,1,0,0,1
43412258,0,1,0,0,1
43128129,0,1,0,0,1
43141140,0,1,0,0,1
43203834,0,1,0,0,1
43242558,0,0,1,0,1
43286748,0,1,0,0,1
43303692,0,1,0,0,1
43312680,0,1,0,0,1
43326045,0,1,0,0,1
43364743,0,0,0,1,1
43385878,0,1,0,0,1
43928052,1,0,0,0,1
44033119,0,1,0,0,1
45373653,0,1,0,0,1
44105012,0,1,0,0,1
44634001,1,0,0,0,1
44669147,0,1,0,0,1
44669736,0,1,0,0,1
44716793,0,1,0,0,1
44748432,0,1,0,0,1
44816736,0,0,0,1,1
44852097,0,1,0,0,1
44893738,0,1,0,0,1
44962648,0,1,0,0,1
45018937,0,1,0,0,1
45083212,0,1,0,0,1
45105127,0,1,0,0,1
45131936,0,1,0,0,1
45189631,0,1,0,0,1
45199646,0,1,0,0,1
45208293,0,1,0,0,1
45212295,0,1,0,0,1
45233567,0,1,0,0,1
45294943,1,0,0,0,1
45297720,0,1,0,0,1
45311390,0,1,0,0,1
45315898,0,1,0,0,1
45324568,0,1,0,0,1
44627674,0,0,0,1,1
44598916,0,1,0,0,1
44594070,0,1,0,0,1
44353174,0,1,0,0,1
44124183,0,1,0,0,1
44133216,0,1,0,0,1
44135422,0,1,0,0,1
44173516,1,0,0,0,1
44183502,0,1,0,0,1
44265306,0,1,0,0,1
44294968,0,1,0,0,1
44298383,0,1,0,0,1
44337500,0,1,0,0,1
44340654,0,1,0,0,1
44440275,1,0,0,0,1
44586580,0,1,0,0,1
44466079,0,1,0,0,1
44475402,1,0,0,0,1
44513904,1,0,0,0,1
44517586,0,1,0,0,1
44530669,0,1,0,0,1
44547646,0,1,0,0,1
44553707,1,0,0,0,1
44557821,0,1,0,0,1
44572817,0,1,0,0,1
44583763,0,1,0,0,1
38548306,0,1,0,0,1
38536844,1,0,0,0,1
38513684,0,1,0,0,1
32884172,1,0,0,0,1
32913295,0,1,0,0,1
32929848,0,1,0,0,1
32933673,0,1,0,0,1
32972354,1,0,0,0,1
33050693,1,0,0,0,1
33055805,0,1,0,0,1
33071431,0,1,0,0,1
33075601,0,1,0,0,1
33079525,0,1,0,0,1
33079873,0,1,0,0,1
33081838,0,1,0,0,1
33096909,0,0,0,1,1
33125011,0,1,0,0,1
33128740,0,1,0,0,1
33130755,0,1,0,0,1
33155050,0,1,0,0,1
33156049,0,1,0,0,1
33178791,1,0,0,0,1
33180715,1,0,0,0,1
33183258,0,1,0,0,1
33192889,0,1,0,0,1
33215709,0,1,0,0,1
33237036,0,1,0,0,1
32891878,0,1,0,0,1
32883015,0,1,0,0,1
34343286,0,1,0,0,1
32868326,0,1,0,0,1
32479747,0,1,0,0,1
32487224,0,0,1,0,1
32491824,0,1,0,0,1
32512592,0,1,0,0,1
32514900,1,0,0,0,1
32538228,0,1,0,0,1
32552208,0,1,0,0,1
32586709,0,1,0,0,1
32604546,0,1,0,0,1
32639859,0,1,0,0,1
32643163,0,1,0,0,1
32651107,0,1,0,0,1
32660842,0,1,0,0,1
32697935,0,1,0,0,1
32703561,1,0,0,0,1
32709197,0,1,0,0,1
32751236,0,1,0,0,1
32786184,0,1,0,0,1
32810312,0,1,0,0,1
32835530,0,1,0,0,1
32841180,0,1,0,0,1
32846083,0,1,0,0,1
32859733,0,1,0,0,1
33240502,1,0,0,0,1
33288569,0,1,0,0,1
33303813,0,1,0,0,1
33315943,0,1,0,0,1
34024789,0,1,0,0,1
34056559,0,1,0,0,1
34125487,0,1,0,0,1
34135329,0,1,0,0,1
34169805,0,1,0,0,1
34188414,0,1,0,0,1
34188909,0,1,0,0,1
34206249,0,1,0,0,1
34207102,0,1,0,0,1
34210153,1,0,0,0,1
34212981,0,1,0,0,1
34227918,0,1,0,0,1
34240278,0,1,0,0,1
34240486,0,1,0,0,1
34241381,0,1,0,0,1
34250919,0,1,0,0,1
34261810,0,1,0,0,1
34262879,0,1,0,0,1
34267967,1,0,0,0,1
34272780,0,1,0,0,1
34279982,0,0,1,0,1
34286732,0,1,0,0,1
34292829,0,1,0,0,1
34012557,1,0,0,0,1
33938653,0,1,0,0,1
33930875,0,1,0,0,1
33696525,0,1,0,0,1
33335093,0,1,0,0,1
33389538,0,1,0,0,1
33395455,0,1,0,0,1
33402673,0,1,0,0,1
33473174,0,0,1,0,1
33496276,0,1,0,0,1
33554171,0,1,0,0,1
33555985,0,1,0,0,1
33583334,0,1,0,0,1
33605995,1,0,0,0,1
33712487,0,1,0,0,1
33927704,0,1,0,0,1
33746442,0,1,0,0,1
33767565,0,1,0,0,1
33790345,0,1,0,0,1
33820318,0,1,0,0,1
33868508,0,1,0,0,1
33884871,0,1,0,0,1
33896147,0,1,0,0,1
33907874,0,1,0,0,1
33926620,0,1,0,0,1
33927113,1,0,0,0,1
32478208,0,1,0,0,1
32469084,0,1,0,0,1
32446433,0,1,0,0,1
30917123,1,0,0,0,1
30426639,0,1,0,0,1
30434028,0,1,0,0,1
30438828,0,1,0,0,1
30443775,0,1,0,0,1
30476749,0,1,0,0,1
30515014,0,1,0,0,1
30523252,0,1,0,0,1
30532394,0,1,0,0,1
30582947,0,1,0,0,1
30615713,1,0,0,0,1
30616451,0,1,0,0,1
30625659,0,1,0,0,1
30640220,0,1,0,0,1
30665800,1,0,0,0,1
30713421,0,1,0,0,1
30714144,0,1,0,0,1
30779468,0,1,0,0,1
30793359,0,1,0,0,1
30815105,0,1,0,0,1
30827472,0,1,0,0,1
30827541,0,1,0,0,1
30842039,0,1,0,0,1
30867398,0,1,0,0,1
30391708,0,1,0,0,1
30388678,0,1,0,0,1
30377040,0,1,0,0,1
30230986,0,1,0,0,1
29964118,0,1,0,0,1
29986235,0,1,0,0,1
30030744,0,1,0,0,1
30043230,0,1,0,0,1
30059366,0,1,0,0,1
30114376,0,0,0,1,1
30122900,0,1,0,0,1
30168505,0,1,0,0,1
30212310,0,1,0,0,1
30227867,0,0,0,1,1
30236338,0,1,0,0,1
30366113,1,0,0,0,1
30240712,0,1,0,0,1
30248430,0,1,0,0,1
30265738,0,1,0,0,1
30274860,0,1,0,0,1
30279188,0,1,0,0,1
30294619,0,1,0,0,1
30342449,1,0,0,0,1
30350791,1,0,0,0,1
30353172,0,1,0,0,1
30361980,0,1,0,0,1
30873999,0,1,0,0,1
30960972,0,1,0,0,1
32438705,0,1,0,0,1
30984837,0,1,0,0,1
31661626,1,0,0,0,1
31680451,0,1,0,0,1
31712631,0,1,0,0,1
31725206,0,1,0,0,1
31755984,0,1,0,0,1
31761211,0,1,0,0,1
31811435,0,1,0,0,1
32070099,0,1,0,0,1
32169306,0,1,0,0,1
32169517,0,1,0,0,1
32222268,0,1,0,0,1
32249695,0,1,0,0,1
32252458,0,1,0,0,1
32281428,0,1,0,0,1
32281804,0,1,0,0,1
32286972,0,1,0,0,1
32308064,0,1,0,0,1
32317152,0,1,0,0,1
32325806,0,1,0,0,1
32328953,0,1,0,0,1
32337662,0,1,0,0,1
32368497,0,1,0,0,1
32433859,0,1,0,0,1
31632468,1,0,0,0,1
31488410,1,0,0,0,1
31483197,0,1,0,0,1
31110228,0,1,0,0,1
30988558,0,1,0,0,1
31006088,0,1,0,0,1
31034185,0,1,0,0,1
31049591,0,1,0,0,1
31052410,0,0,1,0,1
31070308,0,1,0,0,1
31073214,0,1,0,0,1
31087278,0,1,0,0,1
31088892,0,1,0,0,1
31100180,0,1,0,0,1
31135621,0,1,0,0,1
31416560,0,1,0,0,1
31154314,0,0,1,0,1
31167749,1,0,0,0,1
31191835,1,0,0,0,1
31215405,1,0,0,0,1
31233576,0,1,0,0,1
31240927,0,1,0,0,1
31247121,0,1,0,0,1
31318482,0,1,0,0,1
31360609,0,1,0,0,1
31381824,0,1,0,0,1
34296155,0,1,0,0,1
34345303,0,1,0,0,1
38495037,0,1,0,0,1
36853559,0,1,0,0,1
36918945,0,1,0,0,1
36935028,0,1,0,0,1
36960651,1,0,0,0,1
36966953,0,1,0,0,1
37004236,0,1,0,0,1
37007352,0,1,0,0,1
37026575,0,1,0,0,1
37096895,0,1,0,0,1
37103904,0,1,0,0,1
37141099,0,1,0,0,1
37149619,0,1,0,0,1
37179759,0,1,0,0,1
37214630,0,0,1,0,1
37233755,0,1,0,0,1
37235759,0,1,0,0,1
37239705,0,1,0,0,1
37252109,1,0,0,0,1
37256782,0,1,0,0,1
37294200,1,0,0,0,1
37311880,1,0,0,0,1
37407255,0,1,0,0,1
37432471,0,1,0,0,1
37443108,0,1,0,0,1
36886093,0,0,1,0,1
36848351,0,1,0,0,1
34346537,0,1,0,0,1
36778738,0,1,0,0,1
36324058,1,0,0,0,1
36326004,1,0,0,0,1
36355593,1,0,0,0,1
36355642,0,1,0,0,1
36366865,0,1,0,0,1
36374946,0,1,0,0,1
36398308,0,1,0,0,1
36411279,0,1,0,0,1
36429006,0,1,0,0,1
36447097,0,1,0,0,1
36471621,0,1,0,0,1
36488827,0,1,0,0,1
36513112,0,1,0,0,1
36540620,0,1,0,0,1
36575218,0,1,0,0,1
36580423,0,0,1,0,1
36594312,0,0,1,0,1
36628902,0,1,0,0,1
36638004,0,1,0,0,1
36639869,0,1,0,0,1
36661419,0,1,0,0,1
36719476,0,1,0,0,1
36749711,0,1,0,0,1
37452269,1,0,0,0,1
37474000,0,1,0,0,1
37498833,0,1,0,0,1
37552089,0,1,0,0,1
38090791,0,1,0,0,1
38101699,1,0,0,0,1
38124709,0,1,0,0,1
38128220,0,1,0,0,1
38135668,0,1,0,0,1
38141146,1,0,0,0,1
38146588,1,0,0,0,1
38155307,0,1,0,0,1
38166320,0,1,0,0,1
38181645,1,0,0,0,1
38191713,0,1,0,0,1
38194177,0,0,0,1,1
38208002,0,1,0,0,1
38225209,0,1,0,0,1
38268238,0,1,0,0,1
38280840,0,1,0,0,1
38296173,0,1,0,0,1
38369187,1,0,0,0,1
38385683,0,1,0,0,1
38391847,0,1,0,0,1
38395976,0,0,1,0,1
38402800,0,0,0,1,1
38422776,0,1,0,0,1
38050781,0,1,0,0,1
38002194,0,1,0,0,1
37948589,0,1,0,0,1
37716856,0,1,0,0,1
37579871,1,0,0,0,1
37580120,0,1,0,0,1
37586034,0,1,0,0,1
37604152,1,0,0,0,1
37615918,0,1,0,0,1
37641316,1,0,0,0,1
37652013,0,1,0,0,1
37657882,0,1,0,0,1
37671963,0,1,0,0,1
37692349,0,1,0,0,1
37792216,0,1,0,0,1
37934608,0,1,0,0,1
37793700,0,1,0,0,1
37793884,0,1,0,0,1
37794665,0,1,0,0,1
37811942,0,1,0,0,1
37835750,0,1,0,0,1
37863826,1,0,0,0,1
37878044,0,1,0,0,1
37878090,0,1,0,0,1
37890030,0,1,0,0,1
37895395,1,0,0,0,1
36309919,1,0,0,0,1
36291458,0,1,0,0,1
36285562,0,1,0,0,1
35445501,1,0,0,0,1
34877486,0,1,0,0,1
34891167,0,1,0,0,1
34898921,0,1,0,0,1
34903105,0,1,0,0,1
34903770,0,1,0,0,1
34921389,0,1,0,0,1
34968496,0,1,0,0,1
34977510,0,1,0,0,1
35007791,0,1,0,0,1
35011793,0,1,0,0,1
35022755,0,1,0,0,1
35045311,0,1,0,0,1
35066685,0,1,0,0,1
35084541,0,1,0,0,1
35110833,0,1,0,0,1
35116992,0,1,0,0,1
35167247,0,1,0,0,1
35180413,0,1,0,0,1
35202735,0,1,0,0,1
35230486,0,1,0,0,1
35236918,0,1,0,0,1
35307919,0,1,0,0,1
35344094,0,1,0,0,1
34853709,0,1,0,0,1
34850314,0,1,0,0,1
34847201,0,1,0,0,1
34569770,0,1,0,0,1
34386745,0,1,0,0,1
34389093,0,1,0,0,1
34394441,0,1,0,0,1
34411113,0,1,0,0,1
34435025,0,1,0,0,1
34442432,0,1,0,0,1
34524072,0,1,0,0,1
34525936,1,0,0,0,1
34538937,0,1,0,0,1
34556388,0,1,0,0,1
34583684,0,1,0,0,1
34838144,0,1,0,0,1
34591699,0,1,0,0,1
34613418,0,1,0,0,1
34640292,1,0,0,0,1
34659328,0,1,0,0,1
34662952,0,1,0,0,1
34667024,0,1,0,0,1
34693205,1,0,0,0,1
34749773,0,1,0,0,1
34831910,0,1,0,0,1
34834560,0,1,0,0,1
35430890,0,0,0,1,1
35471497,0,1,0,0,1
36253693,1,0,0,0,1
35490826,0,1,0,0,1
35870629,0,1,0,0,1
35911381,0,1,0,0,1
35924311,1,0,0,0,1
35930213,0,1,0,0,1
35930386,0,1,0,0,1
35943651,0,1,0,0,1
35964024,0,1,0,0,1
36004319,0,1,0,0,1
36022485,0,1,0,0,1
36025123,0,1,0,0,1
36030707,1,0,0,0,1
36037128,0,1,0,0,1
36041800,0,1,0,0,1
36041826,0,1,0,0,1
36050897,0,0,0,1,1
36087311,0,1,0,0,1
36088853,0,1,0,0,1
36099960,0,1,0,0,1
36101196,0,1,0,0,1
36113691,0,1,0,0,1
36125631,0,1,0,0,1
36171173,0,1,0,0,1
36217649,0,1,0,0,1
35864680,0,1,0,0,1
35827783,0,1,0,0,1
35813556,0,1,0,0,1
35670796,0,1,0,0,1
35496303,0,1,0,0,1
35524592,0,1,0,0,1
35528283,0,1,0,0,1
35533777,0,1,0,0,1
35552126,0,1,0,0,1
35555237,0,1,0,0,1
35563039,1,0,0,0,1
35589791,0,1,0,0,1
35601758,0,0,0,1,1
35646964,1,0,0,0,1
35672684,0,1,0,0,1
35789761,0,1,0,0,1
35674233,0,1,0,0,1
35677344,0,1,0,0,1
35723296,1,0,0,0,1
35729263,0,1,0,0,1
35737433,0,1,0,0,1
35745208,0,1,0,0,1
35746861,0,1,0,0,1
35765069,0,1,0,0,1
35765292,0,1,0,0,1
35766485,0,1,0,0,1
47589132,0,1,0,0,1
47601897,1,0,0,0,1
47614862,0,0,0,1,1
60167372,0,1,0,0,1
60175285,0,1,0,0,1
60204733,0,1,0,0,1
60242749,0,1,0,0,1
60247913,0,1,0,0,1
60250991,0,1,0,0,1
60278785,0,1,0,0,1
60300499,0,1,0,0,1
60425879,0,1,0,0,1
60443738,1,0,0,0,1
60461183,0,1,0,0,1
60474495,1,0,0,0,1
60498366,0,1,0,0,1
60534157,0,1,0,0,1
60571006,0,1,0,0,1
60589530,0,1,0,0,1
60604840,0,1,0,0,1
60610994,0,1,0,0,1
60669335,0,1,0,0,1
60685889,0,1,0,0,1
60827844,0,1,0,0,1
60854598,0,1,0,0,1
60862254,0,1,0,0,1
60871046,1,0,0,0,1
60170391,0,1,0,0,1
60153218,0,1,0,0,1
62226838,0,1,0,0,1
60093009,0,1,0,0,1
59380332,0,1,0,0,1
59412412,0,1,0,0,1
59429203,0,1,0,0,1
59491603,0,1,0,0,1
59621062,0,0,1,0,1
59632123,0,1,0,0,1
59659082,0,1,0,0,1
59703913,0,1,0,0,1
59736477,0,1,0,0,1
59776866,0,1,0,0,1
59793989,0,1,0,0,1
59807709,1,0,0,0,1
59834748,0,1,0,0,1
59857414,0,1,0,0,1
59865692,0,1,0,0,1
59880716,0,1,0,0,1
59887348,0,1,0,0,1
59939312,0,1,0,0,1
60004795,0,1,0,0,1
60006673,0,0,0,1,1
60034614,0,1,0,0,1
60057696,0,1,0,0,1
60087239,0,0,1,0,1
60875243,0,1,0,0,1
60898382,0,1,0,0,1
60925228,0,1,0,0,1
60931914,1,0,0,0,1
61646375,0,1,0,0,1
61647981,0,1,0,0,1
61662979,0,1,0,0,1
61663531,0,1,0,0,1
61696939,0,1,0,0,1
61697429,0,0,0,1,1
61704955,0,1,0,0,1
61756904,0,1,0,0,1
61762488,0,1,0,0,1
61769187,0,1,0,0,1
61774083,0,1,0,0,1
61784270,0,1,0,0,1
61800213,0,1,0,0,1
61867089,0,1,0,0,1
61894626,0,1,0,0,1
61926206,0,1,0,0,1
61992699,0,1,0,0,1
62070198,0,0,1,0,1
62091497,0,1,0,0,1
62096167,0,1,0,0,1
62110241,0,1,0,0,1
62166943,0,1,0,0,1
62178607,0,1,0,0,1
61611674,1,0,0,0,1
61601959,0,1,0,0,1
61582186,0,1,0,0,1
61168823,0,1,0,0,1
60937280,0,1,0,0,1
60946400,0,1,0,0,1
60973889,0,1,0,0,1
60988157,0,1,0,0,1
60989165,1,0,0,0,1
61001300,0,1,0,0,1
61029033,0,1,0,0,1
61081491,0,1,0,0,1
61114276,0,1,0,0,1
61115414,0,1,0,0,1
61198294,1,0,0,0,1
61580915,0,1,0,0,1
61333525,0,1,0,0,1
61367661,0,1,0,0,1
61373765,0,1,0,0,1
61401463,0,1,0,0,1
61441696,0,1,0,0,1
61454979,0,1,0,0,1
61491876,1,0,0,0,1
61496992,0,1,0,0,1
61501365,0,1,0,0,1
61536065,1,0,0,0,1
59353071,0,1,0,0,1
59337851,0,1,0,0,1
59336781,1,0,0,0,1
57981320,0,1,0,0,1
57308020,0,1,0,0,1
57314631,0,1,0,0,1
57506236,0,1,0,0,1
57556781,0,1,0,0,1
57600909,0,1,0,0,1
57601773,0,1,0,0,1
57621965,0,1,0,0,1
57622123,0,1,0,0,1
57623308,0,1,0,0,1
57628963,1,0,0,0,1
57631109,0,0,1,0,1
57669427,0,1,0,0,1
57673609,0,1,0,0,1
57696236,0,1,0,0,1
57798837,1,0,0,0,1
57826413,0,1,0,0,1
57829629,0,1,0,0,1
57856566,0,1,0,0,1
57904062,1,0,0,0,1
57905073,0,1,0,0,1
57913034,0,0,1,0,1
57965194,0,1,0,0,1
57971872,0,1,0,0,1
57272228,0,1,0,0,1
57246656,0,1,0,0,1
57238415,0,1,0,0,1
56974526,0,1,0,0,1
56657557,0,1,0,0,1
56679894,1,0,0,0,1
56687763,0,1,0,0,1
56708578,0,1,0,0,1
56751272,0,1,0,0,1
56775248,0,1,0,0,1
56798488,0,1,0,0,1
56940093,0,1,0,0,1
56962815,0,1,0,0,1
56966615,0,1,0,0,1
56997561,0,1,0,0,1
57229555,0,1,0,0,1
57011172,0,1,0,0,1
57018887,0,0,0,1,1
57038623,0,1,0,0,1
57072321,0,1,0,0,1
57076911,0,1,0,0,1
57087181,0,1,0,0,1
57104194,1,0,0,0,1
57136655,0,1,0,0,1
57144171,0,1,0,0,1
57144463,0,1,0,0,1
57974615,0,1,0,0,1
58016502,0,1,0,0,1
59257613,0,1,0,0,1
58057209,0,1,0,0,1
58753254,0,1,0,0,1
58768691,0,1,0,0,1
58773410,1,0,0,0,1
58794586,0,1,0,0,1
58800229,0,1,0,0,1
58810469,0,1,0,0,1
58818835,0,1,0,0,1
58819553,0,1,0,0,1
58822578,0,1,0,0,1
58862439,0,1,0,0,1
58879089,0,1,0,0,1
58902971,0,1,0,0,1
58955608,0,1,0,0,1
58970424,1,0,0,0,1
59038851,1,0,0,0,1
59087719,0,1,0,0,1
59088962,0,1,0,0,1
59091465,1,0,0,0,1
59097969,1,0,0,0,1
59130965,0,1,0,0,1
59210477,0,1,0,0,1
59214156,0,1,0,0,1
59242601,0,1,0,0,1
58741325,0,0,0,1,1
58738350,0,1,0,0,1
58688095,0,1,0,0,1
58295328,0,1,0,0,1
58087238,0,1,0,0,1
58122413,0,1,0,0,1
58136867,0,1,0,0,1
58162833,0,1,0,0,1
58163265,0,1,0,0,1
58168140,0,1,0,0,1
58184608,0,1,0,0,1
58225873,0,1,0,0,1
58235803,0,1,0,0,1
58243311,0,1,0,0,1
58296880,0,1,0,0,1
58649685,0,0,0,1,1
58300415,0,1,0,0,1
58314688,0,1,0,0,1
58347404,0,1,0,0,1
58357333,0,1,0,0,1
58422071,0,1,0,0,1
58422606,0,1,0,0,1
58443247,0,1,0,0,1
58547905,1,0,0,0,1
58611031,1,0,0,0,1
58614620,0,1,0,0,1
62217416,0,0,1,0,1
62229685,0,1,0,0,1
56600653,0,1,0,0,1
65958434,0,1,0,0,1
66016167,0,1,0,0,1
66017030,0,1,0,0,1
66053598,0,0,0,1,1
66094771,0,1,0,0,1
66114413,0,1,0,0,1
66126175,0,1,0,0,1
66132864,0,1,0,0,1
66144291,0,1,0,0,1
66218063,0,1,0,0,1
66281405,0,1,0,0,1
66349441,0,1,0,0,1
66393352,0,1,0,0,1
66486371,1,0,0,0,1
66613076,0,1,0,0,1
66615353,0,1,0,0,1
66617140,0,1,0,0,1
66625688,0,1,0,0,1
66644549,0,1,0,0,1
66647781,0,1,0,0,1
66657714,0,1,0,0,1
66661584,0,1,0,0,1
66668320,0,1,0,0,1
66671894,0,1,0,0,1
66013819,0,1,0,0,1
65919981,0,1,0,0,1
62234130,0,1,0,0,1
65853428,0,1,0,0,1
65392919,0,1,0,0,1
65448783,0,1,0,0,1
65449299,0,1,0,0,1
65472627,0,1,0,0,1
65474845,0,1,0,0,1
65476562,0,1,0,0,1
65479744,0,1,0,0,1
65535004,0,1,0,0,1
65535162,0,1,0,0,1
65563600,0,1,0,0,1
65577553,1,0,0,0,1
65586798,0,1,0,0,1
65614134,0,1,0,0,1
65617648,0,1,0,0,1
65629574,0,1,0,0,1
65646472,0,1,0,0,1
65689718,0,1,0,0,1
65691157,0,1,0,0,1
65700868,0,1,0,0,1
65720419,0,1,0,0,1
65742865,0,1,0,0,1
65789937,0,1,0,0,1
65801482,0,1,0,0,1
66680890,0,1,0,0,1
66695211,0,1,0,0,1
66702360,0,1,0,0,1
66729519,0,1,0,0,1
67623571,0,1,0,0,1
67630197,1,0,0,0,1
67657246,1,0,0,0,1
67696231,0,1,0,0,1
67720874,0,1,0,0,1
67751753,0,1,0,0,1
67849904,0,1,0,0,1
67901733,0,1,0,0,1
67909618,0,1,0,0,1
67936898,1,0,0,0,1
67988709,0,1,0,0,1
68018631,0,1,0,0,1
68089788,0,1,0,0,1
68090681,1,0,0,0,1
68094979,0,0,0,1,1
68111348,0,1,0,0,1
68130327,0,1,0,0,1
68138422,0,0,1,0,1
68175525,0,1,0,0,1
68183662,0,1,0,0,1
68189396,0,1,0,0,1
68283636,0,1,0,0,1
68292358,0,1,0,0,1
67592935,0,1,0,0,1
67584573,0,1,0,0,1
67548459,0,1,0,0,1
67022869,0,1,0,0,1
66760614,1,0,0,0,1
66764471,0,1,0,0,1
66780893,1,0,0,0,1
66868775,0,1,0,0,1
66882012,0,1,0,0,1
66897685,0,1,0,0,1
66906399,0,1,0,0,1
66949010,0,1,0,0,1
66953003,0,1,0,0,1
67000735,0,1,0,0,1
67100032,0,1,0,0,1
67541349,1,0,0,0,1
67229818,0,1,0,0,1
67254817,0,0,0,1,1
67286842,1,0,0,0,1
67298755,0,0,0,1,1
67387345,0,1,0,0,1
67390166,0,1,0,0,1
67410632,0,1,0,0,1
67424138,0,0,1,0,1
67428426,1,0,0,0,1
67529578,0,1,0,0,1
65371062,0,1,0,0,1
65343903,0,1,0,0,1
65338875,0,1,0,0,1
63731853,0,1,0,0,1
63154839,0,1,0,0,1
63194491,1,0,0,0,1
63210367,0,1,0,0,1
63252297,0,1,0,0,1
63258521,1,0,0,0,1
63280478,0,1,0,0,1
63322233,0,1,0,0,1
63326746,0,1,0,0,1
63353920,0,1,0,0,1
63354194,0,0,1,0,1
63437909,1,0,0,0,1
63443303,1,0,0,0,1
63448298,0,1,0,0,1
63451911,0,1,0,0,1
63481130,0,1,0,0,1
63482723,0,1,0,0,1
63559159,0,1,0,0,1
63562180,0,1,0,0,1
63655381,0,1,0,0,1
63669405,0,1,0,0,1
63677075,1,0,0,0,1
63679742,0,1,0,0,1
63702129,0,0,0,1,1
63119285,1,0,0,0,1
63115240,1,0,0,0,1
63097802,0,1,0,0,1
62531469,1,0,0,0,1
62236500,0,1,0,0,1
62246236,0,0,0,1,1
62256263,0,1,0,0,1
62326091,0,1,0,0,1
62386454,0,1,0,0,1
62388920,0,1,0,0,1
62414527,0,1,0,0,1
62419527,0,1,0,0,1
62427302,0,1,0,0,1
62475956,0,1,0,0,1
62601577,0,1,0,0,1
63065364,0,1,0,0,1
62617728,0,1,0,0,1
62635517,0,1,0,0,1
62644743,0,1,0,0,1
62646287,0,1,0,0,1
62732401,0,1,0,0,1
62738466,0,1,0,0,1
62839999,0,1,0,0,1
62855729,0,1,0,0,1
62937479,0,1,0,0,1
62999961,0,1,0,0,1
63709319,0,1,0,0,1
63740851,0,1,0,0,1
65338310,0,1,0,0,1
63789872,0,1,0,0,1
64540769,1,0,0,0,1
64569520,1,0,0,0,1
64596270,0,1,0,0,1
64614904,0,1,0,0,1
64616990,0,1,0,0,1
64662043,0,0,0,1,1
64667722,1,0,0,0,1
64677170,0,1,0,0,1
64677718,1,0,0,0,1
64740421,0,1,0,0,1
64760588,0,1,0,0,1
64764809,0,1,0,0,1
64831212,0,1,0,0,1
64853417,0,1,0,0,1
64927350,0,1,0,0,1
65009032,0,1,0,0,1
65019709,0,1,0,0,1
65037784,0,1,0,0,1
65066267,0,1,0,0,1
65066504,1,0,0,0,1
65116850,0,1,0,0,1
65121664,0,1,0,0,1
65336581,0,1,0,0,1
64525792,0,1,0,0,1
64477204,0,0,0,1,1
64452420,0,1,0,0,1
64053322,0,1,0,0,1
63850122,0,1,0,0,1
63881090,1,0,0,0,1
63905174,0,1,0,0,1
63923318,0,1,0,0,1
63923404,0,1,0,0,1
63933133,0,1,0,0,1
63945802,0,1,0,0,1
63975859,1,0,0,0,1
63997977,0,1,0,0,1
63999872,1,0,0,0,1
64072941,0,1,0,0,1
64409444,0,1,0,0,1
64088100,1,0,0,0,1
64096873,1,0,0,0,1
64166556,0,1,0,0,1
64229884,0,1,0,0,1
64287341,0,1,0,0,1
64298453,0,1,0,0,1
64306588,0,1,0,0,1
64348530,0,1,0,0,1
64380228,0,1,0,0,1
64384897,0,1,0,0,1
56630476,1,0,0,0,1
56593900,0,1,0,0,1
47691584,0,1,0,0,1
49609777,0,1,0,0,1
49654359,1,0,0,0,1
49663205,0,1,0,0,1
49668631,0,1,0,0,1
49670213,0,1,0,0,1
49687930,1,0,0,0,1
49702710,0,1,0,0,1
49756977,0,1,0,0,1
49759002,0,1,0,0,1
49761968,0,1,0,0,1
49767130,0,1,0,0,1
49778011,0,1,0,0,1
49795012,1,0,0,0,1
49799000,0,1,0,0,1
49899004,0,1,0,0,1
49907145,0,1,0,0,1
49924427,0,1,0,0,1
49926399,0,1,0,0,1
49941230,0,0,1,0,1
49950877,0,1,0,0,1
49951120,0,1,0,0,1
49959070,1,0,0,0,1
49976762,0,1,0,0,1
49987303,1,0,0,0,1
49639799,1,0,0,0,1
49599231,0,1,0,0,1
51099749,0,1,0,0,1
49588625,0,1,0,0,1
49219932,0,1,0,0,1
49226404,0,1,0,0,1
49227390,1,0,0,0,1
49249409,0,1,0,0,1
49258147,0,1,0,0,1
49280147,0,1,0,0,1
49285589,0,0,1,0,1
49303023,0,1,0,0,1
49305937,0,1,0,0,1
49342976,0,1,0,0,1
49365255,0,1,0,0,1
49375557,0,1,0,0,1
49411926,0,1,0,0,1
49448002,0,1,0,0,1
49448459,0,1,0,0,1
49469566,0,1,0,0,1
49471321,0,1,0,0,1
49479598,0,1,0,0,1
49500330,0,1,0,0,1
49503100,0,1,0,0,1
49535362,0,1,0,0,1
49539318,0,1,0,0,1
49584881,0,1,0,0,1
49988320,0,1,0,0,1
50006249,0,1,0,0,1
50036601,0,1,0,0,1
50046950,0,1,0,0,1
50681151,1,0,0,0,1
50696252,0,0,1,0,1
50706362,0,1,0,0,1
50714031,0,1,0,0,1
50731557,0,1,0,0,1
50788540,0,1,0,0,1
50801833,0,1,0,0,1
50895454,0,1,0,0,1
50925842,0,1,0,0,1
50945880,0,1,0,0,1
50957189,0,1,0,0,1
50966091,0,1,0,0,1
50977327,0,1,0,0,1
50983657,0,1,0,0,1
50985511,0,1,0,0,1
50991083,0,1,0,0,1
51002037,0,1,0,0,1
51021358,0,1,0,0,1
51046847,0,1,0,0,1
51054366,1,0,0,0,1
51063139,0,1,0,0,1
51073089,0,1,0,0,1
51086933,0,1,0,0,1
50648364,0,1,0,0,1
50631407,0,1,0,0,1
50624137,0,1,0,0,1
50373350,0,1,0,0,1
50178717,0,1,0,0,1
50207960,0,1,0,0,1
50250028,0,1,0,0,1
50253004,0,1,0,0,1
50259831,0,1,0,0,1
50259839,0,1,0,0,1
50286556,0,1,0,0,1
50314738,0,1,0,0,1
50335401,0,0,1,0,1
50363366,0,1,0,0,1
50377701,0,1,0,0,1
50620384,0,1,0,0,1
50395444,0,1,0,0,1
50435253,0,1,0,0,1
50482132,0,1,0,0,1
50490041,0,1,0,0,1
50508029,0,1,0,0,1
50512313,1,0,0,0,1
50536618,0,1,0,0,1
50555140,0,1,0,0,1
50597546,0,1,0,0,1
50604652,1,0,0,0,1
49208827,0,1,0,0,1
49187956,0,1,0,0,1
49186567,0,1,0,0,1
48358237,0,1,0,0,1
48058862,0,1,0,0,1
48085071,0,1,0,0,1
48095434,0,1,0,0,1
48098429,0,1,0,0,1
48099795,0,1,0,0,1
48111989,1,0,0,0,1
48113280,0,1,0,0,1
48128750,0,1,0,0,1
48141540,1,0,0,0,1
48144137,0,1,0,0,1
48249790,0,1,0,0,1
48256070,1,0,0,0,1
48274563,0,1,0,0,1
48291403,0,1,0,0,1
48297506,0,1,0,0,1
48299474,0,1,0,0,1
48309186,1,0,0,0,1
48316928,0,1,0,0,1
48324005,0,1,0,0,1
48324028,0,1,0,0,1
48324158,0,1,0,0,1
48332910,0,1,0,0,1
48334852,0,1,0,0,1
48043844,0,1,0,0,1
48027265,0,1,0,0,1
48025359,0,1,0,0,1
47816109,0,1,0,0,1
47703004,0,1,0,0,1
47706946,0,1,0,0,1
47711779,0,1,0,0,1
47713094,0,1,0,0,1
47753333,0,1,0,0,1
47762624,0,0,1,0,1
47770947,0,0,1,0,1
47773238,0,1,0,0,1
47773601,0,1,0,0,1
47814072,0,1,0,0,1
47821189,0,1,0,0,1
48020443,0,1,0,0,1
47832561,0,1,0,0,1
47836216,1,0,0,0,1
47861184,0,1,0,0,1
47892029,0,1,0,0,1
47896021,0,1,0,0,1
47919577,0,1,0,0,1
47957420,0,1,0,0,1
47966023,1,0,0,0,1
47968641,0,1,0,0,1
48005170,0,1,0,0,1
48354184,0,1,0,0,1
48378236,0,1,0,0,1
49159218,0,1,0,0,1
48389713,1,0,0,0,1
48854629,1,0,0,0,1
48877205,0,1,0,0,1
48889742,0,1,0,0,1
48955613,0,1,0,0,1
48965695,0,1,0,0,1
48967730,0,1,0,0,1
48975408,0,0,0,1,1
48999352,0,1,0,0,1
49002560,0,1,0,0,1
49011176,0,1,0,0,1
49013960,0,1,0,0,1
49024825,1,0,0,0,1
49024896,0,1,0,0,1
49047093,0,1,0,0,1
49070244,1,0,0,0,1
49120625,0,1,0,0,1
49122850,1,0,0,0,1
49130658,0,1,0,0,1
49133656,0,1,0,0,1
49139258,0,1,0,0,1
49139523,0,0,1,0,1
49143982,0,1,0,0,1
49151318,0,1,0,0,1
48832137,1,0,0,0,1
48831824,0,1,0,0,1
48823888,0,1,0,0,1
48633239,0,1,0,0,1
48440084,0,1,0,0,1
48450935,0,1,0,0,1
48494546,0,1,0,0,1
48519302,0,1,0,0,1
48520441,0,1,0,0,1
48541806,0,1,0,0,1
48543575,1,0,0,0,1
48545740,0,1,0,0,1
48568857,0,1,0,0,1
48612422,0,1,0,0,1
48642476,1,0,0,0,1
48778852,0,1,0,0,1
48647290,0,1,0,0,1
48666485,0,1,0,0,1
48671575,0,1,0,0,1
48677821,0,1,0,0,1
48697101,0,1,0,0,1
48700214,0,1,0,0,1
48707075,0,1,0,0,1
48718512,0,1,0,0,1
48746421,0,1,0,0,1
48765902,0,1,0,0,1
51089155,0,1,0,0,1
51118975,0,1,0,0,1
56529853,1,0,0,0,1
54550408,0,1,0,0,1
54604382,0,1,0,0,1
54664294,0,1,0,0,1
54673723,1,0,0,0,1
54690971,0,1,0,0,1
54720203,0,1,0,0,1
54744051,0,1,0,0,1
54760625,0,1,0,0,1
54801818,0,1,0,0,1
54810639,1,0,0,0,1
54830315,0,1,0,0,1
54844729,0,1,0,0,1
54844843,0,1,0,0,1
54888889,0,1,0,0,1
54921551,1,0,0,0,1
54950449,0,1,0,0,1
54986954,0,1,0,0,1
55128346,0,1,0,0,1
55171851,1,0,0,0,1
55177871,0,1,0,0,1
55189047,0,1,0,0,1
55197338,0,1,0,0,1
55243008,0,1,0,0,1
55259018,0,1,0,0,1
54556056,0,1,0,0,1
54517682,0,1,0,0,1
51147107,1,0,0,0,1
54507001,0,1,0,0,1
53836242,0,1,0,0,1
53870125,1,0,0,0,1
53896774,0,1,0,0,1
53957396,0,1,0,0,1
53963427,0,1,0,0,1
53975301,0,0,1,0,1
54000045,0,1,0,0,1
54007755,1,0,0,0,1
54011034,0,1,0,0,1
54033848,1,0,0,0,1
54034509,0,1,0,0,1
54077380,1,0,0,0,1
54167689,0,1,0,0,1
54169685,0,1,0,0,1
54182891,0,1,0,0,1
54188562,0,1,0,0,1
54222078,0,1,0,0,1
54229080,0,1,0,0,1
54307022,0,1,0,0,1
54315061,0,1,0,0,1
54436737,0,1,0,0,1
54476164,0,1,0,0,1
54483692,0,1,0,0,1
55260457,0,1,0,0,1
55264503,0,1,0,0,1
55266658,0,1,0,0,1
55295586,0,1,0,0,1
55886888,0,1,0,0,1
55894661,0,1,0,0,1
55932965,1,0,0,0,1
55941415,0,1,0,0,1
55944538,0,1,0,0,1
56027046,0,1,0,0,1
56027709,0,1,0,0,1
56066371,0,1,0,0,1
56085142,0,1,0,0,1
56087540,0,1,0,0,1
56130367,0,1,0,0,1
56147198,0,1,0,0,1
56163351,0,1,0,0,1
56175246,0,0,1,0,1
56296108,0,1,0,0,1
56355904,0,1,0,0,1
56362885,1,0,0,0,1
56366142,0,1,0,0,1
56381682,0,1,0,0,1
56456404,0,1,0,0,1
56466023,1,0,0,0,1
56490715,0,1,0,0,1
56526877,0,1,0,0,1
55868044,0,1,0,0,1
55820608,0,1,0,0,1
55814899,0,1,0,0,1
55556542,0,1,0,0,1
55306273,0,1,0,0,1
55312574,0,1,0,0,1
55313301,1,0,0,0,1
55341514,0,1,0,0,1
55344593,0,1,0,0,1
55349847,0,1,0,0,1
55392380,0,1,0,0,1
55393222,0,1,0,0,1
55471819,0,1,0,0,1
55489327,0,1,0,0,1
55564763,0,1,0,0,1
55813832,0,1,0,0,1
55619520,0,1,0,0,1
55642438,0,1,0,0,1
55651793,0,1,0,0,1
55655161,1,0,0,0,1
55769687,0,1,0,0,1
55770981,0,1,0,0,1
55788787,0,1,0,0,1
55807549,0,1,0,0,1
55807588,0,1,0,0,1
55810658,0,1,0,0,1
53790272,0,1,0,0,1
53782873,1,0,0,0,1
53770710,0,1,0,0,1
52345827,0,1,0,0,1
51701758,0,1,0,0,1
51713825,1,0,0,0,1
51776733,0,1,0,0,1
51786212,0,1,0,0,1
51790959,0,1,0,0,1
51792960,0,1,0,0,1
51805233,1,0,0,0,1
51806533,0,1,0,0,1
51841191,0,1,0,0,1
51844407,0,1,0,0,1
51846511,0,1,0,0,1
51857986,0,1,0,0,1
51866048,1,0,0,0,1
51891829,0,1,0,0,1
52025358,0,1,0,0,1
52072055,1,0,0,0,1
52094431,0,1,0,0,1
52159501,0,1,0,0,1
52182369,0,1,0,0,1
52188128,0,1,0,0,1
52208319,1,0,0,0,1
52258067,0,1,0,0,1
52339742,0,0,0,1,1
51693407,0,0,1,0,1
51690052,1,0,0,0,1
51687348,1,0,0,0,1
51354595,0,1,0,0,1
51156879,0,1,0,0,1
51162046,0,1,0,0,1
51179277,1,0,0,0,1
51205861,0,1,0,0,1
51218414,0,1,0,0,1
51219024,0,1,0,0,1
51226231,1,0,0,0,1
51250859,0,1,0,0,1
51251415,0,1,0,0,1
51322815,0,1,0,0,1
51378611,0,1,0,0,1
51650539,0,1,0,0,1
51388545,0,1,0,0,1
51419303,0,0,1,0,1
51487693,0,1,0,0,1
51491541,0,1,0,0,1
51500251,0,1,0,0,1
51515753,0,1,0,0,1
51529979,0,1,0,0,1
51570590,0,1,0,0,1
51602000,0,1,0,0,1
51617725,0,1,0,0,1
52343149,0,0,0,1,1
52354508,0,1,0,0,1
53764527,0,1,0,0,1
52387489,0,1,0,0,1
53104807,0,1,0,0,1
53152737,0,1,0,0,1
53157739,0,1,0,0,1
53206928,0,1,0,0,1
53231217,0,1,0,0,1
53274451,0,1,0,0,1
53324396,0,1,0,0,1
53380939,0,1,0,0,1
53423371,0,1,0,0,1
53423743,0,1,0,0,1
53425098,0,1,0,0,1
53501313,0,1,0,0,1
53510003,0,1,0,0,1
53521718,0,0,0,1,1
53527882,0,1,0,0,1
53547446,0,1,0,0,1
53548638,0,1,0,0,1
53649705,1,0,0,0,1
53662441,0,1,0,0,1
53694335,0,1,0,0,1
53734369,0,1,0,0,1
53757387,0,1,0,0,1
53762228,0,1,0,0,1
53104607,0,1,0,0,1
53102055,1,0,0,0,1
53034192,0,1,0,0,1
52626159,1,0,0,0,1
52423655,0,0,0,1,1
52428210,0,1,0,0,1
52435480,0,1,0,0,1
52469256,0,1,0,0,1
52477296,0,1,0,0,1
52540378,0,1,0,0,1
52594178,0,1,0,0,1
52595803,0,1,0,0,1
52604103,0,1,0,0,1
52606553,0,1,0,0,1
52683525,0,0,1,0,1
53013955,0,1,0,0,1
52703893,0,1,0,0,1
52724731,1,0,0,0,1
52740233,0,1,0,0,1
52762991,0,1,0,0,1
52763608,0,1,0,0,1
52766429,0,1,0,0,1
52806537,0,1,0,0,1
52911757,0,1,0,0,1
53005510,0,1,0,0,1
53009491,1,0,0,0,1
29892286,0,1,0,0,1
29825679,0,1,0,0,1
185113657,0,1,0,0,1
17209805,0,1,0,0,1
17217970,0,1,0,0,1
17218623,0,1,0,0,1
17233717,1,0,0,0,1
17238026,0,1,0,0,1
17240710,0,1,0,0,1
17243392,1,0,0,0,1
17244412,0,1,0,0,1
17271202,0,1,0,0,1
17275329,0,1,0,0,1
17283700,0,1,0,0,1
17296820,0,1,0,0,1
17325586,0,1,0,0,1
17326664,0,1,0,0,1
17344504,0,1,0,0,1
17360803,0,1,0,0,1
17378870,0,1,0,0,1
17387589,0,1,0,0,1
17390242,0,1,0,0,1
17396157,0,1,0,0,1
17400044,0,1,0,0,1
17415497,0,1,0,0,1
17419745,0,1,0,0,1
17434625,0,1,0,0,1
17212132,0,1,0,0,1
17197622,0,1,0,0,1
17012102,0,1,0,0,1
17195540,0,1,0,0,1
17012707,0,1,0,0,1
17013058,0,1,0,0,1
17017636,0,1,0,0,1
17026674,0,1,0,0,1
17037608,0,1,0,0,1
17038049,0,1,0,0,1
17051520,0,1,0,0,1
17067726,0,1,0,0,1
17074431,0,1,0,0,1
17079759,0,1,0,0,1
17083191,0,1,0,0,1
17104559,0,1,0,0,1
17105128,0,1,0,0,1
17106037,0,1,0,0,1
17129384,1,0,0,0,1
17129511,0,1,0,0,1
17130989,0,1,0,0,1
17132332,0,1,0,0,1
17147215,0,1,0,0,1
17147717,0,1,0,0,1
17160553,0,1,0,0,1
17164741,0,1,0,0,1
17178516,0,1,0,0,1
17449331,0,1,0,0,1
17468249,0,1,0,0,1
17469576,0,1,0,0,1
17494516,0,1,0,0,1
17677498,0,1,0,0,1
17682741,0,1,0,0,1
17684894,0,1,0,0,1
17701238,0,1,0,0,1
17705724,0,1,0,0,1
17706784,0,0,0,1,1
17709531,0,1,0,0,1
17709932,1,0,0,0,1
17710657,0,1,0,0,1
17710680,0,1,0,0,1
17713659,0,1,0,0,1
17715698,0,0,0,1,1
17722065,1,0,0,0,1
17728677,0,1,0,0,1
17741576,0,1,0,0,1
17748173,0,1,0,0,1
17749763,0,0,0,1,1
17752794,0,1,0,0,1
17759748,0,1,0,0,1
17759943,1,0,0,0,1
17773367,1,0,0,0,1
17781928,1,0,0,0,1
17787069,0,1,0,0,1
17670195,0,1,0,0,1
17667773,1,0,0,0,1
17661470,0,1,0,0,1
17569440,0,0,1,0,1
17495574,0,1,0,0,1
17495690,0,0,1,0,1
17499139,0,1,0,0,1
17516015,0,1,0,0,1
17518892,1,0,0,0,1
17531673,0,1,0,0,1
17532492,0,1,0,0,1
17538828,0,1,0,0,1
17549359,0,1,0,0,1
17563848,0,0,1,0,1
17570091,0,0,0,1,1
17658103,0,1,0,0,1
17581004,1,0,0,0,1
17586716,1,0,0,0,1
17587353,0,1,0,0,1
17589625,1,0,0,0,1
17593157,0,1,0,0,1
17604980,1,0,0,0,1
17605364,1,0,0,0,1
17630233,0,1,0,0,1
17644917,1,0,0,0,1
17652526,0,1,0,0,1
17012164,0,1,0,0,1
17006237,0,1,0,0,1
29777055,0,1,0,0,1
16374995,0,1,0,0,1
16392613,0,1,0,0,1
16422138,0,1,0,0,1
16426293,0,1,0,0,1
16439259,0,1,0,0,1
16440044,0,0,1,0,1
16441917,0,1,0,0,1
16465702,0,1,0,0,1
16469487,0,0,0,1,1
16471280,0,1,0,0,1
16475267,0,1,0,0,1
16479822,0,1,0,0,1
16481893,0,1,0,0,1
16485030,0,1,0,0,1
16492636,0,1,0,0,1
16509864,0,1,0,0,1
16513305,0,1,0,0,1
16521268,0,1,0,0,1
16525488,0,1,0,0,1
16529049,1,0,0,0,1
16533385,0,1,0,0,1
16534382,0,1,0,0,1
16538546,0,1,0,0,1
16550025,1,0,0,0,1
16391618,1,0,0,0,1
16371064,0,1,0,0,1
17003812,0,1,0,0,1
16364416,0,1,0,0,1
16161488,0,1,0,0,1
16172587,1,0,0,0,1
16189710,0,1,0,0,1
16193898,0,1,0,0,1
16205278,0,1,0,0,1
16217685,1,0,0,0,1
16220573,1,0,0,0,1
16224428,0,1,0,0,1
16233647,0,1,0,0,1
16238605,0,1,0,0,1
16245462,0,1,0,0,1
16257582,0,1,0,0,1
16271356,0,0,1,0,1
16282605,0,1,0,0,1
16297840,0,1,0,0,1
16309539,0,1,0,0,1
16310474,0,1,0,0,1
16315875,1,0,0,0,1
16337690,0,1,0,0,1
16338090,1,0,0,0,1
16343441,1,0,0,0,1
16347635,0,1,0,0,1
16362151,0,1,0,0,1
16564639,1,0,0,0,1
16565901,0,1,0,0,1
16574359,0,1,0,0,1
16574773,1,0,0,0,1
16789467,1,0,0,0,1
16824982,0,1,0,0,1
16843920,0,1,0,0,1
16858208,0,1,0,0,1
16859771,0,1,0,0,1
16861429,0,1,0,0,1
16890181,1,0,0,0,1
16905638,0,1,0,0,1
16910068,0,1,0,0,1
16916445,0,1,0,0,1
16917593,0,1,0,0,1
16923481,0,1,0,0,1
16925407,0,1,0,0,1
16925598,1,0,0,0,1
16933019,0,0,0,1,1
16938726,0,1,0,0,1
16960647,0,1,0,0,1
16964847,0,0,0,1,1
16967836,0,0,0,1,1
16977860,0,1,0,0,1
16983746,0,1,0,0,1
16988701,0,1,0,0,1
17001490,0,1,0,0,1
16783988,0,1,0,0,1
16753692,0,1,0,0,1
16751724,0,1,0,0,1
16642283,0,1,0,0,1
16587154,0,1,0,0,1
16592577,0,1,0,0,1
16594527,0,1,0,0,1
16604074,0,1,0,0,1
16608127,0,1,0,0,1
16616321,0,1,0,0,1
16621072,0,0,0,1,1
16629569,0,0,0,1,1
16634486,0,1,0,0,1
16642033,0,1,0,0,1
16653733,0,1,0,0,1
16745492,1,0,0,0,1
16656505,1,0,0,0,1
16672644,0,1,0,0,1
16678332,0,1,0,0,1
16678742,0,0,1,0,1
16681966,0,1,0,0,1
16688081,0,1,0,0,1
16716142,0,1,0,0,1
16719058,0,1,0,0,1
16726866,0,1,0,0,1
16730803,0,1,0,0,1
17788120,0,1,0,0,1
17813614,0,1,0,0,1
17822396,0,1,0,0,1
18928660,0,1,0,0,1
18957058,0,1,0,0,1
18959713,0,1,0,0,1
18962412,0,1,0,0,1
18967454,0,1,0,0,1
18982396,0,1,0,0,1
18985754,0,1,0,0,1
19005310,0,1,0,0,1
19007525,0,1,0,0,1
19008210,0,1,0,0,1
19012787,0,1,0,0,1
19019641,0,1,0,0,1
19039864,0,1,0,0,1
19041787,1,0,0,0,1
19044158,0,1,0,0,1
19053559,1,0,0,0,1
19065355,0,1,0,0,1
19071298,1,0,0,0,1
19077784,0,1,0,0,1
19083538,0,1,0,0,1
19103447,0,1,0,0,1
19142008,0,1,0,0,1
19150368,0,1,0,0,1
19170641,0,1,0,0,1
18950829,0,1,0,0,1
18924321,0,1,0,0,1
17829889,0,1,0,0,1
18903054,0,1,0,0,1
18718676,0,1,0,0,1
18718727,0,0,0,1,1
18728580,0,1,0,0,1
18733040,0,1,0,0,1
18736833,0,1,0,0,1
18739200,0,0,0,1,1
18759715,0,1,0,0,1
18760393,0,1,0,0,1
18779290,1,0,0,0,1
18782794,0,1,0,0,1
18785429,1,0,0,0,1
18786430,0,1,0,0,1
18788795,0,1,0,0,1
18807050,0,1,0,0,1
18810275,0,1,0,0,1
18821540,0,0,0,1,1
18832004,0,1,0,0,1
18838712,0,1,0,0,1
18839446,0,1,0,0,1
18842793,0,0,1,0,1
18846619,0,1,0,0,1
18868110,1,0,0,0,1
18899992,0,1,0,0,1
19171014,0,1,0,0,1
19181026,0,1,0,0,1
19188132,0,1,0,0,1
19191029,0,1,0,0,1
19388898,0,1,0,0,1
19405276,0,1,0,0,1
19415488,1,0,0,0,1
19434018,0,1,0,0,1
19435213,0,1,0,0,1
19444217,0,1,0,0,1
19453480,0,1,0,0,1
19497358,0,1,0,0,1
19509858,0,1,0,0,1
19515997,0,1,0,0,1
19519125,1,0,0,0,1
19521944,0,1,0,0,1
19527839,0,1,0,0,1
19532949,0,1,0,0,1
19535737,0,1,0,0,1
19538431,0,1,0,0,1
19540368,0,1,0,0,1
19550301,0,1,0,0,1
19569136,1,0,0,0,1
19572157,0,1,0,0,1
19574541,0,1,0,0,1
19575489,0,1,0,0,1
19578198,0,1,0,0,1
19387953,0,1,0,0,1
19380089,1,0,0,0,1
19379508,0,1,0,0,1
19255799,1,0,0,0,1
19192361,0,1,0,0,1
19200480,0,1,0,0,1
19203412,1,0,0,0,1
19230408,0,1,0,0,1
19235226,0,1,0,0,1
19237001,0,1,0,0,1
19240291,0,1,0,0,1
19242543,0,1,0,0,1
19247800,0,1,0,0,1
19253182,0,0,0,1,1
19271309,1,0,0,0,1
19375423,0,0,0,1,1
19273571,0,1,0,0,1
19282941,0,1,0,0,1
19288987,0,1,0,0,1
19290070,0,1,0,0,1
19314414,0,0,0,1,1
19330585,0,1,0,0,1
19337916,0,1,0,0,1
19346838,0,1,0,0,1
19355850,0,1,0,0,1
19367740,0,1,0,0,1
18712684,1,0,0,0,1
18702318,1,0,0,0,1
18701314,0,1,0,0,1
18283159,0,0,1,0,1
18087434,0,1,0,0,1
18097912,1,0,0,0,1
18100555,0,1,0,0,1
18118720,0,1,0,0,1
18132967,0,1,0,0,1
18134596,0,1,0,0,1
18143364,1,0,0,0,1
18145319,0,1,0,0,1
18152020,0,1,0,0,1
18154692,0,1,0,0,1
18162662,0,1,0,0,1
18163138,0,1,0,0,1
18175161,0,1,0,0,1
18190361,1,0,0,0,1
18215203,0,1,0,0,1
18218420,1,0,0,0,1
18220745,0,0,1,0,1
18224811,0,1,0,0,1
18226028,0,1,0,0,1
18236215,0,1,0,0,1
18248383,0,1,0,0,1
18265291,0,1,0,0,1
18270291,1,0,0,0,1
18072452,0,1,0,0,1
18072110,0,1,0,0,1
18030259,0,1,0,0,1
17909774,0,1,0,0,1
17843247,1,0,0,0,1
17862067,0,1,0,0,1
17863822,0,1,0,0,1
17871912,0,1,0,0,1
17872024,0,1,0,0,1
17887132,0,1,0,0,1
17894272,1,0,0,0,1
17894706,0,1,0,0,1
17901742,1,0,0,0,1
17903756,0,1,0,0,1
17921988,0,1,0,0,1
18011233,1,0,0,0,1
17923419,0,1,0,0,1
17954385,0,1,0,0,1
17956413,0,1,0,0,1
17979245,0,1,0,0,1
17996380,0,1,0,0,1
17997231,0,1,0,0,1
17999649,1,0,0,0,1
18000564,1,0,0,0,1
18000747,0,1,0,0,1
18002106,0,1,0,0,1
18272853,0,1,0,0,1
18290737,0,0,0,1,1
18690830,0,1,0,0,1
18300385,0,1,0,0,1
18567715,0,1,0,0,1
18577800,0,1,0,0,1
18579067,0,1,0,0,1
18585654,1,0,0,0,1
18587835,0,1,0,0,1
18592212,1,0,0,0,1
18593435,0,1,0,0,1
18597129,0,1,0,0,1
18601783,0,1,0,0,1
18606105,0,1,0,0,1
18611609,0,1,0,0,1
18613893,0,1,0,0,1
18622364,0,1,0,0,1
18628515,0,1,0,0,1
18630659,0,1,0,0,1
18630915,0,1,0,0,1
18633331,0,1,0,0,1
18633349,0,1,0,0,1
18644245,1,0,0,0,1
18644650,0,1,0,0,1
18665514,0,1,0,0,1
18668110,1,0,0,0,1
18682051,0,1,0,0,1
18559837,0,1,0,0,1
18548778,0,1,0,0,1
18541780,0,1,0,0,1
18416134,1,0,0,0,1
18304860,0,1,0,0,1
18337400,0,1,0,0,1
18337912,0,0,1,0,1
18341645,0,0,1,0,1
18346688,0,1,0,0,1
18347809,0,1,0,0,1
18354776,0,1,0,0,1
18363962,0,0,1,0,1
18381121,0,1,0,0,1
18407931,0,1,0,0,1
18425091,1,0,0,0,1
18536656,0,1,0,0,1
18465507,0,1,0,0,1
18472086,0,1,0,0,1
18479889,0,1,0,0,1
18485036,0,1,0,0,1
18489117,0,1,0,0,1
18492286,0,1,0,0,1
18511142,1,0,0,0,1
18514539,0,0,0,1,1
18525497,0,1,0,0,1
18533166,1,0,0,0,1
16141166,1,0,0,0,1
16132396,0,1,0,0,1
16132241,0,1,0,0,1
11971712,0,1,0,0,1
12166972,0,1,0,0,1
12244762,0,1,0,0,1
12256592,0,1,0,0,1
12301832,0,1,0,0,1
12377472,0,1,0,0,1
12391462,0,0,0,1,1
12493262,0,1,0,0,1
12693042,0,0,1,0,1
12758072,1,0,0,0,1
12778952,0,1,0,0,1
12858752,0,1,0,0,1
12933332,0,1,0,0,1
12945002,1,0,0,0,1
12945962,0,1,0,0,1
12964542,0,1,0,0,1
13036352,0,1,0,0,1
13129962,1,0,0,0,1
13137392,0,1,0,0,1
13165482,0,1,0,0,1
13220942,0,1,0,0,1
13232322,0,1,0,0,1
13286282,0,1,0,0,1
13344492,0,1,0,0,1
12025372,0,1,0,0,1
11930162,0,1,0,0,1
14461111,0,1,0,0,1
11888932,0,1,0,0,1
10454222,0,1,0,0,1
10465542,1,0,0,0,1
10477952,0,1,0,0,1
10482452,0,1,0,0,1
10818272,0,1,0,0,1
10979872,1,0,0,0,1
11063312,0,1,0,0,1
11067082,0,1,0,0,1
11155062,0,1,0,0,1
11190672,0,1,0,0,1
11225192,0,1,0,0,1
11260212,1,0,0,0,1
11309852,0,1,0,0,1
11456782,0,1,0,0,1
11557372,1,0,0,0,1
11570672,0,1,0,0,1
11586452,0,1,0,0,1
11610112,0,1,0,0,1
11633812,1,0,0,0,1
11654552,0,1,0,0,1
11770332,0,0,1,0,1
11773172,0,1,0,0,1
11874272,1,0,0,0,1
13393182,0,1,0,0,1
13535082,0,1,0,0,1
13541712,1,0,0,0,1
13598452,0,1,0,0,1
14262216,1,0,0,0,1
14282848,0,0,1,0,1
14288066,0,1,0,0,1
14291993,0,1,0,0,1
14298360,1,0,0,0,1
14301229,0,1,0,0,1
14310238,0,1,0,0,1
14322276,0,1,0,0,1
14324681,0,1,0,0,1
14335399,1,0,0,0,1
14337704,0,1,0,0,1
14340043,0,1,0,0,1
14343429,0,1,0,0,1
14367849,1,0,0,0,1
14369561,0,1,0,0,1
14373248,1,0,0,0,1
14376280,0,1,0,0,1
14397158,0,1,0,0,1
14424413,0,1,0,0,1
14427575,0,1,0,0,1
14428768,0,1,0,0,1
14452322,0,1,0,0,1
14452955,0,1,0,0,1
14259868,0,1,0,0,1
14253657,0,1,0,0,1
14250415,0,1,0,0,1
14180489,0,1,0,0,1
13910842,1,0,0,0,1
14051384,0,1,0,0,1
14066797,0,1,0,0,1
14076636,0,1,0,0,1
14107564,0,1,0,0,1
14116686,0,1,0,0,1
14127183,0,1,0,0,1
14131599,0,1,0,0,1
14138359,0,1,0,0,1
14160558,0,1,0,0,1
14180671,0,1,0,0,1
14242706,0,1,0,0,1
14183051,0,1,0,0,1
14196181,0,1,0,0,1
14203426,0,1,0,0,1
14212114,1,0,0,0,1
14213981,0,1,0,0,1
14214945,0,1,0,0,1
14217419,1,0,0,0,1
14218303,0,1,0,0,1
14228300,0,1,0,0,1
14235177,1,0,0,0,1
10453122,0,1,0,0,1
10377332,0,1,0,0,1
10342142,1,0,0,0,1
6073052,0,1,0,0,1
1630511,0,1,0,0,1
1792551,0,1,0,0,1
2000531,0,1,0,0,1
2066991,0,1,0,0,1
2199541,0,1,0,0,1
2487131,1,0,0,0,1
2918111,0,1,0,0,1
3462421,0,1,0,0,1
3545551,1,0,0,0,1
3688111,0,1,0,0,1
3883561,0,1,0,0,1
4147471,0,1,0,0,1
5379272,1,0,0,0,1
5388812,1,0,0,0,1
5417862,0,1,0,0,1
5474522,0,1,0,0,1
5483462,0,1,0,0,1
5508872,0,1,0,0,1
5539902,0,1,0,0,1
5582122,0,1,0,0,1
5779732,1,0,0,0,1
5907282,0,1,0,0,1
5944152,0,1,0,0,1
1612011,0,1,0,0,1
1602331,0,1,0,0,1
1586871,0,1,0,0,1
782529,0,1,0,0,1
65803,0,1,0,0,1
82433,1,0,0,0,1
431033,0,1,0,0,1
607093,0,1,0,0,1
611073,0,1,0,0,1
686483,0,1,0,0,1
696163,0,1,0,0,1
704543,0,1,0,0,1
766150,0,1,0,0,1
767858,0,0,1,0,1
803179,0,1,0,0,1
1557761,0,1,0,0,1
807824,0,0,1,0,1
812337,0,1,0,0,1
851681,0,1,0,0,1
904361,0,1,0,0,1
983501,0,1,0,0,1
989261,1,0,0,0,1
1015991,0,1,0,0,1
1140451,1,0,0,0,1
1276821,1,0,0,0,1
1443131,0,1,0,0,1
5952402,0,1,0,0,1
6087482,1,0,0,0,1
10218892,1,0,0,0,1
6103812,1,0,0,0,1
8039552,0,1,0,0,1
8053772,0,1,0,0,1
8079392,0,0,1,0,1
8242062,1,0,0,0,1
8252022,0,1,0,0,1
8308222,0,1,0,0,1
8367012,0,1,0,0,1
8395672,0,1,0,0,1
8399282,0,1,0,0,1
8408262,0,1,0,0,1
8919672,0,0,1,0,1
8949152,0,1,0,0,1
9179432,0,1,0,0,1
9378802,0,1,0,0,1
9386072,0,1,0,0,1
9404182,0,1,0,0,1
9709412,0,1,0,0,1
9717222,0,1,0,0,1
9935212,0,0,1,0,1
10001562,0,1,0,0,1
10006962,0,1,0,0,1
10138662,0,1,0,0,1
10172452,0,1,0,0,1
7980242,0,0,0,1,1
7962452,0,1,0,0,1
7911642,0,1,0,0,1
6979102,1,0,0,0,1
6117132,0,1,0,0,1
6256362,1,0,0,0,1
6270182,1,0,0,0,1
6426402,0,1,0,0,1
6450622,0,0,1,0,1
6567072,1,0,0,0,1
6572452,0,1,0,0,1
6575962,0,1,0,0,1
6775962,0,1,0,0,1
6828422,0,1,0,0,1
7106612,1,0,0,0,1
7778772,1,0,0,0,1
7116432,0,1,0,0,1
7121042,0,1,0,0,1
7310842,0,1,0,0,1
7350052,0,1,0,0,1
7385152,0,1,0,0,1
7438552,0,1,0,0,1
7496742,0,1,0,0,1
7594302,1,0,0,0,1
7609862,0,1,0,0,1
7667902,0,1,0,0,1
14456191,0,1,0,0,1
14467487,0,1,0,0,1
16122366,0,0,1,0,1
15526867,0,1,0,0,1
15543748,0,1,0,0,1
15557891,0,1,0,0,1
15563223,0,1,0,0,1
15572262,0,1,0,0,1
15592258,0,1,0,0,1
15593694,0,1,0,0,1
15594247,0,0,0,1,1
15595632,0,1,0,0,1
15609951,0,1,0,0,1
15612227,0,1,0,0,1
15617781,0,1,0,0,1
15625727,0,1,0,0,1
15641725,0,1,0,0,1
15660370,0,1,0,0,1
15663254,0,1,0,0,1
15663428,0,1,0,0,1
15667626,1,0,0,0,1
15679962,0,1,0,0,1
15681914,0,1,0,0,1
15683338,0,1,0,0,1
15692386,0,1,0,0,1
15694866,0,1,0,0,1
15699837,1,0,0,0,1
15536095,0,1,0,0,1
15505922,0,1,0,0,1
14480819,0,1,0,0,1
15504811,0,1,0,0,1
15319834,1,0,0,0,1
15329753,1,0,0,0,1
15350414,0,1,0,0,1
15355274,0,1,0,0,1
15364344,0,1,0,0,1
15367365,0,1,0,0,1
15368940,0,1,0,0,1
15376344,1,0,0,0,1
15387635,0,1,0,0,1
15395753,0,1,0,0,1
15399790,0,1,0,0,1
15406736,0,1,0,0,1
15409080,0,1,0,0,1
15423701,0,1,0,0,1
15440802,0,1,0,0,1
15460376,0,1,0,0,1
15474813,0,1,0,0,1
15475819,0,1,0,0,1
15482458,0,1,0,0,1
15483126,0,1,0,0,1
15487145,0,1,0,0,1
15492916,0,1,0,0,1
15501887,0,1,0,0,1
15715020,1,0,0,0,1
15730225,0,1,0,0,1
15737533,1,0,0,0,1
15741049,0,1,0,0,1
15925503,0,1,0,0,1
15938984,0,1,0,0,1
15963802,0,1,0,0,1
15967000,0,0,1,0,1
15969095,1,0,0,0,1
15978244,1,0,0,0,1
15988555,0,1,0,0,1
15993582,0,1,0,0,1
16002166,0,1,0,0,1
16021340,0,1,0,0,1
16023946,0,1,0,0,1
16027848,0,1,0,0,1
16049108,0,1,0,0,1
16059750,0,0,0,1,1
16065352,0,1,0,0,1
16070303,1,0,0,0,1
16092114,1,0,0,0,1
16094355,1,0,0,0,1
16094409,0,1,0,0,1
16102171,0,1,0,0,1
16106166,0,1,0,0,1
16117966,0,1,0,0,1
16121574,1,0,0,0,1
15924303,0,1,0,0,1
15913801,0,0,1,0,1
15910431,0,1,0,0,1
15806521,0,1,0,0,1
15741261,0,0,0,1,1
15750903,1,0,0,0,1
15768499,1,0,0,0,1
15777890,0,1,0,0,1
15778419,0,1,0,0,1
15781594,0,1,0,0,1
15794515,0,0,0,1,1
15795513,0,1,0,0,1
15796073,0,1,0,0,1
15801945,0,1,0,0,1
15824522,1,0,0,0,1
15907956,0,1,0,0,1
15826965,0,0,0,1,1
15837079,0,1,0,0,1
15847875,0,1,0,0,1
15860422,0,1,0,0,1
15865399,0,1,0,0,1
15867014,0,1,0,0,1
15870659,1,0,0,0,1
15876825,0,1,0,0,1
15901081,0,1,0,0,1
15906435,0,1,0,0,1
15309048,0,1,0,0,1
15282545,0,1,0,0,1
15282338,0,1,0,0,1
14849855,0,1,0,0,1
14696890,0,1,0,0,1
14708309,0,1,0,0,1
14719443,0,1,0,0,1
14729154,0,1,0,0,1
14731096,0,1,0,0,1
14731343,1,0,0,0,1
14733819,0,1,0,0,1
14739737,0,1,0,0,1
14750664,0,1,0,0,1
14764149,0,1,0,0,1
14764995,1,0,0,0,1
14772503,1,0,0,0,1
14786139,0,1,0,0,1
14788128,1,0,0,0,1
14791290,0,1,0,0,1
14793505,1,0,0,0,1
14801881,0,1,0,0,1
14811702,0,1,0,0,1
14819311,1,0,0,0,1
14823153,0,1,0,0,1
14825686,0,1,0,0,1
14830382,0,1,0,0,1
14831419,0,1,0,0,1
14685081,1,0,0,0,1
14683174,0,1,0,0,1
14651508,1,0,0,0,1
14551262,1,0,0,0,1
14482396,0,1,0,0,1
14508342,0,1,0,0,1
14509962,0,1,0,0,1
14525652,0,1,0,0,1
14525929,1,0,0,0,1
14528342,1,0,0,0,1
14535500,0,1,0,0,1
14545609,0,1,0,0,1
14547199,0,1,0,0,1
14547978,0,1,0,0,1
14558002,0,1,0,0,1
14640823,0,1,0,0,1
14573964,0,1,0,0,1
14578759,1,0,0,0,1
14581732,1,0,0,0,1
14587099,1,0,0,0,1
14589287,0,1,0,0,1
14621344,0,1,0,0,1
14623866,0,1,0,0,1
14635730,0,1,0,0,1
14638232,1,0,0,0,1
14639551,0,1,0,0,1
14833980,1,0,0,0,1
14868798,0,1,0,0,1
15275034,1,0,0,0,1
14869296,0,1,0,0,1
15086970,0,1,0,0,1
15090241,0,1,0,0,1
15111424,1,0,0,0,1
15111649,0,1,0,0,1
15144247,0,1,0,0,1
15148531,0,1,0,0,1
15156509,0,0,0,1,1
15161318,0,1,0,0,1
15163016,0,1,0,0,1
15166288,1,0,0,0,1
15181002,0,1,0,0,1
15191681,0,1,0,0,1
15192770,0,1,0,0,1
15197773,0,1,0,0,1
15215455,0,1,0,0,1
15229972,0,1,0,0,1
15250927,0,1,0,0,1
15253100,0,1,0,0,1
15255259,0,1,0,0,1
15262299,0,1,0,0,1
15272182,0,1,0,0,1
15273531,0,1,0,0,1
15274921,0,1,0,0,1
15075835,0,1,0,0,1
15071017,0,1,0,0,1
15059710,0,0,1,0,1
14925655,1,0,0,0,1
14871593,0,1,0,0,1
14884472,1,0,0,0,1
14889994,0,1,0,0,1
14892228,1,0,0,0,1
14895637,0,1,0,0,1
14896409,0,1,0,0,1
14907957,0,1,0,0,1
14913540,0,1,0,0,1
14914045,0,1,0,0,1
14921494,0,1,0,0,1
14939200,0,1,0,0,1
15033622,1,0,0,0,1
14941817,1,0,0,0,1
14943172,0,1,0,0,1
14966163,0,1,0,0,1
14991184,0,1,0,0,1
14997156,0,1,0,0,1
15002893,0,1,0,0,1
15006602,0,1,0,0,1
15007770,1,0,0,0,1
15024307,0,1,0,0,1
15028456,0,1,0,0,1
19583135,0,1,0,0,1
19590631,0,1,0,0,1
19596624,0,1,0,0,1
25337577,0,1,0,0,1
25347009,0,1,0,0,1
25393894,0,1,0,0,1
25416468,0,1,0,0,1
25444888,0,1,0,0,1
25465356,0,1,0,0,1
25469559,0,1,0,0,1
25480807,1,0,0,0,1
25487241,0,1,0,0,1
25525558,0,1,0,0,1
25541173,1,0,0,0,1
25552265,0,1,0,0,1
25552531,0,1,0,0,1
25554116,1,0,0,0,1
25560470,0,1,0,0,1
25562054,0,1,0,0,1
25570168,1,0,0,0,1
25587929,0,1,0,0,1
25590852,0,1,0,0,1
25594381,0,1,0,0,1
25605896,0,1,0,0,1
25611965,0,1,0,0,1
25620512,0,1,0,0,1
25645618,0,1,0,0,1
25344584,0,1,0,0,1
25327727,1,0,0,0,1
26602331,0,1,0,0,1
25317086,0,1,0,0,1
25040776,0,1,0,0,1
25057613,0,1,0,0,1
25073223,0,1,0,0,1
25080971,0,1,0,0,1
25092342,0,1,0,0,1
25093867,0,1,0,0,1
25096804,0,1,0,0,1
25146597,0,1,0,0,1
25153237,0,1,0,0,1
25189016,0,1,0,0,1
25213031,0,1,0,0,1
25226906,0,1,0,0,1
25230076,0,1,0,0,1
25233855,0,1,0,0,1
25250672,0,1,0,0,1
25257824,0,1,0,0,1
25260372,0,1,0,0,1
25264619,0,1,0,0,1
25271227,0,1,0,0,1
25275979,0,1,0,0,1
25290180,1,0,0,0,1
25292895,0,1,0,0,1
25299827,0,1,0,0,1
25645943,0,1,0,0,1
25652837,1,0,0,0,1
25657290,0,1,0,0,1
25679089,0,1,0,0,1
26181418,0,1,0,0,1
26188976,0,1,0,0,1
26209214,0,1,0,0,1
26244115,1,0,0,0,1
26285885,0,1,0,0,1
26289792,0,1,0,0,1
26290452,1,0,0,0,1
26290797,0,1,0,0,1
26312383,0,1,0,0,1
26332904,1,0,0,0,1
26359772,1,0,0,0,1
26369335,0,1,0,0,1
26410835,0,1,0,0,1
26415785,1,0,0,0,1
26456559,0,1,0,0,1
26467668,0,1,0,0,1
26480238,1,0,0,0,1
26480938,0,1,0,0,1
26497618,0,1,0,0,1
26497879,0,1,0,0,1
26509044,1,0,0,0,1
26541444,0,1,0,0,1
26554804,0,1,0,0,1
26147909,0,1,0,0,1
26087263,0,1,0,0,1
26007542,0,1,0,0,1
25843776,0,1,0,0,1
25680726,0,1,0,0,1
25681418,0,1,0,0,1
25687831,0,0,1,0,1
25745701,0,1,0,0,1
25751247,0,1,0,0,1
25773779,0,1,0,0,1
25795749,0,1,0,0,1
25804835,0,0,1,0,1
25806448,0,1,0,0,1
25808449,0,1,0,0,1
25857363,0,1,0,0,1
26000803,0,1,0,0,1
25890902,0,1,0,0,1
25918021,1,0,0,0,1
25920345,1,0,0,0,1
25928099,0,1,0,0,1
25930940,0,1,0,0,1
25952321,0,1,0,0,1
25952898,0,1,0,0,1
25980535,0,1,0,0,1
25992637,0,1,0,0,1
25994748,0,0,1,0,1
25033062,0,1,0,0,1
25033013,0,1,0,0,1
25023065,0,0,0,1,1
24278396,0,1,0,0,1
23929169,0,1,0,0,1
23938818,0,1,0,0,1
23950193,1,0,0,0,1
23953095,0,1,0,0,1
23979185,0,1,0,0,1
23983559,0,1,0,0,1
23993399,0,1,0,0,1
24012354,0,1,0,0,1
24026224,0,1,0,0,1
24033426,0,1,0,0,1
24037316,0,1,0,0,1
24069499,0,1,0,0,1
24128368,0,1,0,0,1
24141214,0,1,0,0,1
24175262,1,0,0,0,1
24203403,0,1,0,0,1
24214080,0,1,0,0,1
24214759,0,0,0,1,1
24215769,0,1,0,0,1
24220348,0,1,0,0,1
24226200,0,1,0,0,1
24226774,0,1,0,0,1
24236454,0,1,0,0,1
23921425,0,1,0,0,1
23905500,0,1,0,0,1
23901372,0,1,0,0,1
23717017,0,1,0,0,1
23553150,0,1,0,0,1
23559255,0,1,0,0,1
23579460,0,1,0,0,1
23580134,0,1,0,0,1
23583958,0,1,0,0,1
23586111,0,1,0,0,1
23586155,0,1,0,0,1
23606264,0,0,0,1,1
23613579,0,0,1,0,1
23702273,0,1,0,0,1
23735750,1,0,0,0,1
23890856,0,1,0,0,1
23748340,0,1,0,0,1
23773085,0,1,0,0,1
23788085,0,1,0,0,1
23795090,0,1,0,0,1
23822971,0,1,0,0,1
23841235,0,1,0,0,1
23865584,0,1,0,0,1
23870386,0,1,0,0,1
23873458,1,0,0,0,1
23885166,0,1,0,0,1
24267328,0,1,0,0,1
24284507,1,0,0,0,1
25017516,0,1,0,0,1
24296541,0,1,0,0,1
24637382,0,1,0,0,1
24639503,0,1,0,0,1
24655482,0,1,0,0,1
24663904,0,1,0,0,1
24675979,0,1,0,0,1
24711820,0,1,0,0,1
24732131,1,0,0,0,1
24745185,0,1,0,0,1
24752464,1,0,0,0,1
24760871,0,1,0,0,1
24772696,0,1,0,0,1
24777521,0,1,0,0,1
24799533,0,1,0,0,1
24824489,0,1,0,0,1
24857905,1,0,0,0,1
24887235,0,1,0,0,1
24903113,0,1,0,0,1
24922975,0,1,0,0,1
24924077,0,1,0,0,1
24927392,0,1,0,0,1
24928793,0,0,1,0,1
24938740,0,1,0,0,1
24998463,0,1,0,0,1
24631288,0,1,0,0,1
24624967,0,1,0,0,1
24615026,0,1,0,0,1
24469269,0,1,0,0,1
24299842,0,1,0,0,1
24367622,0,1,0,0,1
24403686,1,0,0,0,1
24408575,0,1,0,0,1
24428058,0,1,0,0,1
24431892,0,1,0,0,1
24439468,0,1,0,0,1
24442476,1,0,0,0,1
24463829,0,1,0,0,1
24469034,0,1,0,0,1
24470290,0,1,0,0,1
24606358,0,1,0,0,1
24504349,0,1,0,0,1
24516595,0,1,0,0,1
24519105,0,1,0,0,1
24525372,0,1,0,0,1
24544532,0,1,0,0,1
24547879,0,0,0,1,1
24557679,0,1,0,0,1
24588953,0,1,0,0,1
24596213,0,1,0,0,1
24606148,0,1,0,0,1
26576084,0,1,0,0,1
26617160,0,1,0,0,1
23520927,1,0,0,0,1
28529204,0,1,0,0,1
28532074,1,0,0,0,1
28536013,0,1,0,0,1
28542103,0,0,1,0,1
28580582,0,1,0,0,1
28585697,0,1,0,0,1
28597897,0,1,0,0,1
28600527,0,1,0,0,1
28605143,0,1,0,0,1
28608767,0,1,0,0,1
28629858,0,1,0,0,1
28638806,0,1,0,0,1
28661855,0,1,0,0,1
28680627,0,1,0,0,1
28700169,0,1,0,0,1
28704797,0,1,0,0,1
28709919,0,1,0,0,1
28741614,0,1,0,0,1
28773428,0,1,0,0,1
28793850,1,0,0,0,1
28803148,0,1,0,0,1
28810305,0,1,0,0,1
28831245,0,1,0,0,1
28832775,0,1,0,0,1
28531862,0,1,0,0,1
28521658,0,1,0,0,1
26617743,0,1,0,0,1
28519505,1,0,0,0,1
28093810,0,1,0,0,1
28121742,0,1,0,0,1
28143554,0,1,0,0,1
28144127,0,1,0,0,1
28158578,0,1,0,0,1
28170270,0,1,0,0,1
28195191,1,0,0,0,1
28206940,1,0,0,0,1
28212033,0,1,0,0,1
28225243,0,1,0,0,1
28263208,0,1,0,0,1
28302031,0,1,0,0,1
28330487,0,1,0,0,1
28339561,0,1,0,0,1
28375976,0,1,0,0,1
28388286,1,0,0,0,1
28414727,0,1,0,0,1
28416230,0,1,0,0,1
28466277,1,0,0,0,1
28479208,0,1,0,0,1
28493080,0,1,0,0,1
28506718,0,1,0,0,1
28514818,0,1,0,0,1
28835359,0,1,0,0,1
28853211,0,1,0,0,1
28860543,1,0,0,0,1
28862739,0,1,0,0,1
29286586,0,1,0,0,1
29303470,0,1,0,0,1
29346937,0,1,0,0,1
29354615,0,1,0,0,1
29398170,0,1,0,0,1
29433171,1,0,0,0,1
29440928,0,1,0,0,1
29455283,0,1,0,0,1
29459243,0,1,0,0,1
29461258,1,0,0,0,1
29467737,0,1,0,0,1
29477209,0,1,0,0,1
29497044,0,1,0,0,1
29515141,0,1,0,0,1
29541514,0,1,0,0,1
29556575,1,0,0,0,1
29591370,0,1,0,0,1
29622908,0,0,1,0,1
29662823,0,1,0,0,1
29681791,0,0,0,1,1
29713734,1,0,0,0,1
29752376,0,1,0,0,1
29772220,0,1,0,0,1
29286367,0,1,0,0,1
29283817,1,0,0,0,1
29275869,0,1,0,0,1
29080062,0,1,0,0,1
28898803,0,1,0,0,1
28922417,0,1,0,0,1
28939533,0,1,0,0,1
28970475,0,1,0,0,1
29019934,0,1,0,0,1
29024261,0,1,0,0,1
29031355,0,1,0,0,1
29059784,0,1,0,0,1
29061374,0,1,0,0,1
29063143,0,1,0,0,1
29082276,1,0,0,0,1
29268852,0,1,0,0,1
29092124,0,1,0,0,1
29092540,0,1,0,0,1
29121035,0,1,0,0,1
29144234,0,1,0,0,1
29181742,0,1,0,0,1
29187817,0,1,0,0,1
29199860,0,1,0,0,1
29213957,0,1,0,0,1
29220863,0,1,0,0,1
29234408,0,1,0,0,1
28086422,0,1,0,0,1
28076474,1,0,0,0,1
28067838,0,1,0,0,1
27419523,0,1,0,0,1
27025861,0,1,0,0,1
27028193,0,1,0,0,1
27030929,0,1,0,0,1
27038427,0,1,0,0,1
27048263,1,0,0,0,1
27080710,1,0,0,0,1
27113758,0,1,0,0,1
27138454,0,1,0,0,1
27138464,0,1,0,0,1
27166333,0,1,0,0,1
27198233,0,1,0,0,1
27202261,1,0,0,0,1
27202349,0,1,0,0,1
27225614,1,0,0,0,1
27294051,0,1,0,0,1
27303015,0,1,0,0,1
27312014,1,0,0,0,1
27314590,0,1,0,0,1
27329169,0,1,0,0,1
27346025,1,0,0,0,1
27364068,0,1,0,0,1
27401902,0,1,0,0,1
27407304,0,1,0,0,1
26984289,0,1,0,0,1
26955039,0,1,0,0,1
26932923,0,1,0,0,1
26788424,0,1,0,0,1
26649527,1,0,0,0,1
26650301,0,1,0,0,1
26683532,0,1,0,0,1
26689131,0,1,0,0,1
26702637,0,1,0,0,1
26706544,0,0,1,0,1
26717723,0,1,0,0,1
26735650,0,1,0,0,1
26736689,0,1,0,0,1
26747121,0,1,0,0,1
26792380,0,1,0,0,1
26931273,0,0,1,0,1
26821199,0,1,0,0,1
26822864,0,1,0,0,1
26832194,0,1,0,0,1
26839139,0,1,0,0,1
26842131,1,0,0,0,1
26847630,0,1,0,0,1
26850404,0,1,0,0,1
26896936,1,0,0,0,1
26907250,0,1,0,0,1
26915673,0,1,0,0,1
27416961,0,1,0,0,1
27424841,0,1,0,0,1
28058342,0,1,0,0,1
27431788,0,1,0,0,1
27729676,0,1,0,0,1
27732558,0,1,0,0,1
27734716,0,1,0,0,1
27742067,0,1,0,0,1
27746796,0,1,0,0,1
27791722,0,1,0,0,1
27820534,0,1,0,0,1
27832504,0,1,0,0,1
27839763,0,0,0,1,1
27845587,0,1,0,0,1
27877430,0,1,0,0,1
27893665,0,1,0,0,1
27906308,1,0,0,0,1
27908774,0,1,0,0,1
27915442,1,0,0,0,1
27927281,1,0,0,0,1
27933636,0,1,0,0,1
27940020,1,0,0,0,1
27945849,0,1,0,0,1
27972480,0,1,0,0,1
28026156,0,1,0,0,1
28044313,1,0,0,0,1
28056341,0,1,0,0,1
27726572,0,1,0,0,1
27724507,0,1,0,0,1
27701734,0,1,0,0,1
27536867,0,1,0,0,1
27438852,1,0,0,0,1
27458501,1,0,0,0,1
27459374,0,1,0,0,1
27462816,0,1,0,0,1
27464235,0,1,0,0,1
27482330,0,1,0,0,1
27493438,1,0,0,0,1
27493883,0,1,0,0,1
27505469,0,1,0,0,1
27517902,0,1,0,0,1
27539658,0,0,0,1,1
27696743,0,1,0,0,1
27591699,1,0,0,0,1
27597133,1,0,0,0,1
27612150,0,1,0,0,1
27619684,0,1,0,0,1
27620446,1,0,0,0,1
27626443,0,1,0,0,1
27629878,1,0,0,0,1
27638261,0,0,0,1,1
27639330,0,1,0,0,1
27639485,0,1,0,0,1
23530838,0,1,0,0,1
23480800,0,1,0,0,1
19598085,1,0,0,0,1
20659250,0,1,0,0,1
20672299,1,0,0,0,1
20685724,1,0,0,0,1
20700194,0,1,0,0,1
20700764,1,0,0,0,1
20702508,1,0,0,0,1
20716870,0,1,0,0,1
20749600,1,0,0,0,1
20750639,1,0,0,0,1
20751592,0,1,0,0,1
20752767,0,1,0,0,1
20760700,0,1,0,0,1
20775183,1,0,0,0,1
20778980,1,0,0,0,1
20790431,0,1,0,0,1
20807560,0,1,0,0,1
20808631,0,1,0,0,1
20828548,0,1,0,0,1
20843262,0,1,0,0,1
20852736,1,0,0,0,1
20855572,0,1,0,0,1
20859634,1,0,0,0,1
20868505,0,1,0,0,1
20904401,0,1,0,0,1
20669664,0,1,0,0,1
20651704,0,1,0,0,1
21362251,0,1,0,0,1
20635049,0,1,0,0,1
20439310,1,0,0,0,1
20473390,0,0,0,1,1
20476235,0,1,0,0,1
20481001,0,1,0,0,1
20482310,1,0,0,0,1
20502620,0,1,0,0,1
20516387,0,1,0,0,1
20526482,0,1,0,0,1
20532640,0,1,0,0,1
20535018,0,1,0,0,1
20541961,0,0,0,1,1
20542576,0,1,0,0,1
20544529,0,1,0,0,1
20554879,0,1,0,0,1
20570735,0,1,0,0,1
20573098,0,1,0,0,1
20595483,0,1,0,0,1
20600195,1,0,0,0,1
20600204,0,0,0,1,1
20611084,1,0,0,0,1
20613745,0,1,0,0,1
20623266,1,0,0,0,1
20623531,0,1,0,0,1
20907874,0,0,1,0,1
20927672,0,1,0,0,1
20936768,0,1,0,0,1
20938068,0,1,0,0,1
21182172,0,1,0,0,1
21182486,0,1,0,0,1
21189232,0,1,0,0,1
21190886,0,1,0,0,1
21200393,0,1,0,0,1
21208454,0,0,1,0,1
21208769,0,1,0,0,1
21209606,0,1,0,0,1
21211346,0,1,0,0,1
21218331,0,1,0,0,1
21222563,0,1,0,0,1
21222599,0,1,0,0,1
21230062,0,1,0,0,1
21231726,0,1,0,0,1
21231908,0,1,0,0,1
21240584,0,1,0,0,1
21251537,1,0,0,0,1
21299959,0,1,0,0,1
21313701,0,1,0,0,1
21334834,0,1,0,0,1
21335778,0,1,0,0,1
21345453,0,1,0,0,1
21346094,0,1,0,0,1
21181715,0,1,0,0,1
21163093,0,1,0,0,1
21162756,0,1,0,0,1
21069703,0,1,0,0,1
20939307,0,1,0,0,1
20944649,0,0,1,0,1
20961162,1,0,0,0,1
20989465,0,1,0,0,1
20991076,1,0,0,0,1
21014338,0,1,0,0,1
21038168,0,1,0,0,1
21040954,0,1,0,0,1
21041005,0,1,0,0,1
21041242,1,0,0,0,1
21081521,0,1,0,0,1
21158797,0,1,0,0,1
21084137,0,1,0,0,1
21094085,0,1,0,0,1
21096414,1,0,0,0,1
21113258,0,1,0,0,1
21122377,0,1,0,0,1
21127705,0,1,0,0,1
21141449,0,1,0,0,1
21141933,1,0,0,0,1
21147553,0,1,0,0,1
21151367,0,1,0,0,1
20437512,0,1,0,0,1
20404217,0,0,1,0,1
20382035,0,1,0,0,1
20020954,0,1,0,0,1
19824636,0,1,0,0,1
19838781,0,0,0,1,1
19854181,0,1,0,0,1
19860071,0,1,0,0,1
19860864,0,1,0,0,1
19875177,0,1,0,0,1
19885037,0,1,0,0,1
19898535,1,0,0,0,1
19898593,0,1,0,0,1
19915082,0,1,0,0,1
19922357,0,1,0,0,1
19924308,0,1,0,0,1
19927461,0,1,0,0,1
19937980,0,1,0,0,1
19943469,0,1,0,0,1
19972264,0,1,0,0,1
19976598,0,1,0,0,1
19979925,0,1,0,0,1
19997877,0,1,0,0,1
19998892,0,1,0,0,1
20015219,0,1,0,0,1
20015978,0,0,0,1,1
20016123,1,0,0,0,1
19819733,0,1,0,0,1
19808401,0,1,0,0,1
19806605,0,1,0,0,1
19703746,0,1,0,0,1
19615328,0,0,1,0,1
19617187,0,1,0,0,1
19618543,0,1,0,0,1
19622182,0,1,0,0,1
19641119,0,1,0,0,1
19654909,0,1,0,0,1
19672853,0,1,0,0,1
19699804,0,1,0,0,1
19702547,0,1,0,0,1
19703507,0,1,0,0,1
19711390,0,1,0,0,1
19791754,0,1,0,0,1
19722723,0,1,0,0,1
19724044,0,1,0,0,1
19737294,0,1,0,0,1
19755486,0,0,0,1,1
19766628,0,1,0,0,1
19770738,0,1,0,0,1
19772291,0,1,0,0,1
19774813,0,1,0,0,1
19781924,0,1,0,0,1
19791374,0,1,0,0,1
20018144,0,1,0,0,1
20031049,0,1,0,0,1
20378103,0,1,0,0,1
20032935,0,1,0,0,1
20227419,0,1,0,0,1
20230439,0,1,0,0,1
20241436,0,1,0,0,1
20243153,0,1,0,0,1
20247091,0,1,0,0,1
20267174,0,1,0,0,1
20268575,0,1,0,0,1
20269352,0,1,0,0,1
20271044,0,1,0,0,1
20288594,0,1,0,0,1
20293363,0,1,0,0,1
20297741,1,0,0,0,1
20301335,1,0,0,0,1
20304018,0,0,0,1,1
20315146,0,1,0,0,1
20327958,0,1,0,0,1
20338028,0,1,0,0,1
20338658,0,0,0,1,1
20341934,0,1,0,0,1
20353477,0,1,0,0,1
20358191,1,0,0,0,1
20358917,0,1,0,0,1
20364039,0,1,0,0,1
20224588,1,0,0,0,1
20222310,0,1,0,0,1
20222205,1,0,0,0,1
20141240,0,1,0,0,1
20038291,0,1,0,0,1
20047375,0,1,0,0,1
20051069,1,0,0,0,1
20052236,0,1,0,0,1
20054216,0,0,1,0,1
20056900,0,1,0,0,1
20071095,0,1,0,0,1
20111713,0,1,0,0,1
20132485,0,1,0,0,1
20132696,1,0,0,0,1
20143135,0,1,0,0,1
20211761,0,1,0,0,1
20144948,0,1,0,0,1
20145436,1,0,0,0,1
20163447,0,0,0,1,1
20165785,0,0,1,0,1
20167024,0,1,0,0,1
20191866,0,1,0,0,1
20194311,0,1,0,0,1
20194543,0,1,0,0,1
20198797,0,1,0,0,1
20204757,1,0,0,0,1
21356985,1,0,0,0,1
21363584,0,1,0,0,1
23462014,0,1,0,0,1
22632809,0,1,0,0,1
22658678,0,1,0,0,1
22682422,0,1,0,0,1
22699104,0,1,0,0,1
22702661,0,1,0,0,1
22703339,1,0,0,0,1
22725962,1,0,0,0,1
22729305,0,1,0,0,1
22732005,0,1,0,0,1
22733746,1,0,0,0,1
22736375,1,0,0,0,1
22760468,0,0,1,0,1
22799705,0,1,0,0,1
22804255,0,1,0,0,1
22815719,0,1,0,0,1
22818179,1,0,0,0,1
22824575,0,0,1,0,1
22833326,0,1,0,0,1
22834939,0,1,0,0,1
22855109,0,1,0,0,1
22865905,0,1,0,0,1
22872291,0,1,0,0,1
22880489,0,1,0,0,1
22908803,1,0,0,0,1
22641534,0,1,0,0,1
22622212,0,1,0,0,1
21366392,0,1,0,0,1
22617135,0,1,0,0,1
22372121,0,1,0,0,1
22383760,0,1,0,0,1
22388211,0,1,0,0,1
22410025,0,1,0,0,1
22421947,0,1,0,0,1
22427758,0,1,0,0,1
22465218,0,1,0,0,1
22472593,1,0,0,0,1
22494529,0,1,0,0,1
22495673,0,0,1,0,1
22496046,0,0,1,0,1
22501856,0,1,0,0,1
22524976,0,1,0,0,1
22525933,0,1,0,0,1
22534042,0,1,0,0,1
22546722,0,1,0,0,1
22559434,0,1,0,0,1
22583403,0,1,0,0,1
22588010,0,1,0,0,1
22594706,0,0,1,0,1
22596904,0,1,0,0,1
22601309,0,1,0,0,1
22603518,0,1,0,0,1
22951215,1,0,0,0,1
22952167,0,0,1,0,1
22956115,0,1,0,0,1
22959607,0,1,0,0,1
23156922,0,1,0,0,1
23172583,0,1,0,0,1
23189765,0,1,0,0,1
23193321,0,1,0,0,1
23224148,0,0,0,1,1
23229696,0,1,0,0,1
23240462,0,1,0,0,1
23244260,0,1,0,0,1
23264490,0,1,0,0,1
23276931,0,1,0,0,1
23290442,0,1,0,0,1
23307557,0,1,0,0,1
23311310,0,1,0,0,1
23316581,0,1,0,0,1
23332316,0,1,0,0,1
23334023,0,1,0,0,1
23335676,0,1,0,0,1
23351984,0,1,0,0,1
23357547,0,1,0,0,1
23360723,0,1,0,0,1
23426046,0,1,0,0,1
23432914,0,1,0,0,1
23438818,0,1,0,0,1
23152507,0,1,0,0,1
23145640,0,1,0,0,1
23142757,0,1,0,0,1
23024891,0,1,0,0,1
22960651,0,1,0,0,1
22970729,0,1,0,0,1
22971744,0,1,0,0,1
22975508,0,1,0,0,1
22975938,0,1,0,0,1
22977459,0,1,0,0,1
23000620,0,1,0,0,1
23006156,0,1,0,0,1
23006267,0,1,0,0,1
23008390,0,1,0,0,1
23042738,0,1,0,0,1
23134931,0,1,0,0,1
23043102,0,1,0,0,1
23045130,0,1,0,0,1
23046968,0,1,0,0,1
23053598,0,1,0,0,1
23055907,0,1,0,0,1
23059887,0,1,0,0,1
23081797,0,1,0,0,1
23088556,0,1,0,0,1
23092438,1,0,0,0,1
23093438,0,1,0,0,1
22371560,0,1,0,0,1
22360322,0,1,0,0,1
22349112,0,1,0,0,1
21837883,0,1,0,0,1
21607697,0,1,0,0,1
21612042,0,1,0,0,1
21624310,0,1,0,0,1
21631194,0,1,0,0,1
21632185,1,0,0,0,1
21645908,1,0,0,0,1
21649184,0,1,0,0,1
21677937,0,1,0,0,1
21678512,0,1,0,0,1
21683863,0,1,0,0,1
21720540,1,0,0,0,1
21724107,1,0,0,0,1
21735814,1,0,0,0,1
21742949,0,1,0,0,1
21748150,1,0,0,0,1
21754565,0,1,0,0,1
21763352,0,1,0,0,1
21794235,1,0,0,0,1
21794437,0,1,0,0,1
21799020,0,0,1,0,1
21804436,1,0,0,0,1
21805913,0,1,0,0,1
21808491,1,0,0,0,1
21603901,0,0,0,1,1
21602214,0,1,0,0,1
21567660,0,0,1,0,1
21447395,1,0,0,0,1
21375676,1,0,0,0,1
21377845,0,1,0,0,1
21384709,0,1,0,0,1
21393709,0,1,0,0,1
21404592,0,1,0,0,1
21421032,0,1,0,0,1
21423190,1,0,0,0,1
21424813,1,0,0,0,1
21430872,0,1,0,0,1
21438143,1,0,0,0,1
21449630,1,0,0,0,1
21551984,1,0,0,0,1
21449974,1,0,0,0,1
21462165,0,1,0,0,1
21467864,1,0,0,0,1
21469975,0,1,0,0,1
21484872,0,0,1,0,1
21530080,0,1,0,0,1
21544108,1,0,0,0,1
21545292,0,1,0,0,1
21547158,0,1,0,0,1
21550236,1,0,0,0,1
21810493,1,0,0,0,1
21839925,0,1,0,0,1
22339420,0,1,0,0,1
21847864,0,1,0,0,1
22146210,0,1,0,0,1
22154136,1,0,0,0,1
22154474,0,1,0,0,1
22157576,0,0,0,1,1
22178050,0,1,0,0,1
22202911,0,1,0,0,1
22208776,0,1,0,0,1
22217541,0,0,1,0,1
22227189,0,1,0,0,1
22231957,0,1,0,0,1
22235632,0,1,0,0,1
22241715,0,1,0,0,1
22258796,1,0,0,0,1
22258918,1,0,0,0,1
22265531,0,1,0,0,1
22273640,0,1,0,0,1
22274126,0,1,0,0,1
22288031,0,1,0,0,1
22295173,0,1,0,0,1
22298548,0,1,0,0,1
22305794,0,1,0,0,1
22309315,0,1,0,0,1
22312462,0,1,0,0,1
22136311,0,1,0,0,1
22118256,1,0,0,0,1
22114999,0,0,0,1,1
21992115,0,1,0,0,1
21853422,0,1,0,0,1
21858674,0,1,0,0,1
21876225,1,0,0,0,1
21889071,0,1,0,0,1
21912277,0,1,0,0,1
21944842,0,1,0,0,1
21959370,0,1,0,0,1
21966249,0,1,0,0,1
21971966,0,1,0,0,1
21992108,0,1,0,0,1
21995733,0,1,0,0,1
22113948,1,0,0,0,1
22026736,0,1,0,0,1
22033762,1,0,0,0,1
22038308,0,1,0,0,1
22052038,1,0,0,0,1
22063600,0,1,0,0,1
22080432,0,1,0,0,1
22083799,0,1,0,0,1
22099171,0,1,0,0,1
22106094,0,1,0,0,1
22109426,0,1,0,0,1
68298194,0,1,0,0,1
68326561,0,1,0,0,1
68359183,1,0,0,0,1
140489249,0,1,0,0,1
140517418,0,1,0,0,1
140526643,0,1,0,0,1
140535691,1,0,0,0,1
140553478,1,0,0,0,1
140606748,0,1,0,0,1
140677135,1,0,0,0,1
140680853,1,0,0,0,1
140704213,0,1,0,0,1
140726759,1,0,0,0,1
140752137,0,1,0,0,1
140758097,0,1,0,0,1
140774744,1,0,0,0,1
140775986,1,0,0,0,1
140793396,0,0,0,1,1
140794047,0,1,0,0,1
140800285,0,1,0,0,1
140801131,0,1,0,0,1
140812175,0,1,0,0,1
140819917,0,1,0,0,1
140874664,0,1,0,0,1
140883428,0,1,0,0,1
140922503,0,0,1,0,1
140935303,1,0,0,0,1
140495172,0,1,0,0,1
140479861,0,1,0,0,1
139576419,0,1,0,0,1
140461804,0,1,0,0,1
139604369,0,1,0,0,1
139664221,0,1,0,0,1
139668920,0,1,0,0,1
139717925,0,1,0,0,1
139737133,0,1,0,0,1
139743158,0,0,1,0,1
139746501,0,1,0,0,1
139846808,0,1,0,0,1
139860697,1,0,0,0,1
139933380,0,1,0,0,1
139999815,0,1,0,0,1
140016916,0,1,0,0,1
140076712,0,1,0,0,1
140245071,0,1,0,0,1
140281533,0,1,0,0,1
140319868,0,1,0,0,1
140322530,0,1,0,0,1
140330898,0,1,0,0,1
140360666,0,1,0,0,1
140372759,0,1,0,0,1
140382927,0,1,0,0,1
140394191,1,0,0,0,1
140426118,1,0,0,0,1
140944142,0,1,0,0,1
140993164,1,0,0,0,1
141033886,0,1,0,0,1
141065580,0,1,0,0,1
141593833,0,1,0,0,1
141613621,0,1,0,0,1
141654491,0,1,0,0,1
141677649,0,1,0,0,1
141711314,0,1,0,0,1
141791229,0,1,0,0,1
141794136,0,1,0,0,1
141856887,1,0,0,0,1
141857375,0,1,0,0,1
141859336,1,0,0,0,1
141865323,0,1,0,0,1
141879763,0,1,0,0,1
141887287,0,1,0,0,1
141901567,0,1,0,0,1
141906122,0,1,0,0,1
141923435,0,0,1,0,1
141942607,0,1,0,0,1
141957390,1,0,0,0,1
141983071,0,1,0,0,1
141990482,0,1,0,0,1
142006553,0,1,0,0,1
142027691,0,1,0,0,1
142141583,0,1,0,0,1
141547198,0,1,0,0,1
141488000,0,1,0,0,1
141470361,0,0,1,0,1
141169076,0,0,1,0,1
141076254,1,0,0,0,1
141078990,0,0,0,1,1
141094050,0,1,0,0,1
141107293,1,0,0,0,1
141116653,0,1,0,0,1
141118624,0,1,0,0,1
141122863,1,0,0,0,1
141137812,0,0,1,0,1
141150560,0,1,0,0,1
141152537,0,0,1,0,1
141175605,0,1,0,0,1
141466282,1,0,0,0,1
141192391,1,0,0,0,1
141198270,0,1,0,0,1
141208568,0,1,0,0,1
141219365,0,1,0,0,1
141244176,0,1,0,0,1
141298522,0,1,0,0,1
141338392,1,0,0,0,1
141372616,0,1,0,0,1
141415588,0,1,0,0,1
141418153,0,1,0,0,1
139592478,1,0,0,0,1
139491947,1,0,0,0,1
68372117,0,1,0,0,1
137233553,0,1,0,0,1
137241739,0,1,0,0,1
137290405,0,1,0,0,1
137294390,0,1,0,0,1
137301665,0,1,0,0,1
137308805,0,1,0,0,1
137373121,0,1,0,0,1
137395404,0,1,0,0,1
137396048,0,1,0,0,1
137431124,0,1,0,0,1
137471240,0,1,0,0,1
137503421,0,1,0,0,1
137509957,0,1,0,0,1
137557229,0,1,0,0,1
137565963,0,1,0,0,1
137634129,1,0,0,0,1
137643354,0,1,0,0,1
137655302,0,0,1,0,1
137657661,0,1,0,0,1
137725828,0,1,0,0,1
137766084,0,1,0,0,1
137772009,0,1,0,0,1
137819975,1,0,0,0,1
137839601,0,1,0,0,1
137234687,0,0,0,1,1
137219144,0,1,0,0,1
139465965,0,1,0,0,1
137214895,0,1,0,0,1
136254368,0,1,0,0,1
136292599,1,0,0,0,1
136337198,0,1,0,0,1
136391517,1,0,0,0,1
136545821,1,0,0,0,1
136569966,1,0,0,0,1
136602448,0,1,0,0,1
136634865,0,1,0,0,1
136657061,0,1,0,0,1
136674406,0,1,0,0,1
136767270,0,1,0,0,1
136884541,0,1,0,0,1
136916951,1,0,0,0,1
136922655,0,1,0,0,1
136926315,0,1,0,0,1
136938208,1,0,0,0,1
136957175,0,0,1,0,1
136966980,0,1,0,0,1
136984600,0,1,0,0,1
137018349,1,0,0,0,1
137113449,0,1,0,0,1
137177171,0,1,0,0,1
137196923,0,1,0,0,1
137842958,0,1,0,0,1
137877290,0,1,0,0,1
137892844,0,1,0,0,1
137898088,0,1,0,0,1
138636716,0,1,0,0,1
138736520,0,1,0,0,1
138787924,0,1,0,0,1
138791529,0,1,0,0,1
138796188,0,1,0,0,1
138799094,1,0,0,0,1
138810807,1,0,0,0,1
138823266,1,0,0,0,1
138914237,0,1,0,0,1
138919086,0,1,0,0,1
138931518,0,1,0,0,1
138941165,0,1,0,0,1
139043518,1,0,0,0,1
139048483,0,1,0,0,1
139087714,0,1,0,0,1
139102873,1,0,0,0,1
139183512,0,1,0,0,1
139191912,0,1,0,0,1
139203187,0,1,0,0,1
139230824,0,1,0,0,1
139394774,1,0,0,0,1
139426974,0,1,0,0,1
139438186,0,1,0,0,1
138574577,0,1,0,0,1
138564091,0,1,0,0,1
138501631,0,1,0,0,1
138071935,0,1,0,0,1
137899058,0,1,0,0,1
137924618,0,1,0,0,1
137947143,0,1,0,0,1
138016168,0,1,0,0,1
138025303,0,1,0,0,1
138030893,0,1,0,0,1
138040369,0,1,0,0,1
138061906,0,1,0,0,1
138067207,0,1,0,0,1
138068425,0,1,0,0,1
138107545,0,1,0,0,1
138484376,0,1,0,0,1
138120322,0,1,0,0,1
138129394,0,1,0,0,1
138167036,0,1,0,0,1
138167741,0,1,0,0,1
138199827,0,1,0,0,1
138217270,0,1,0,0,1
138288718,0,1,0,0,1
138328636,0,0,1,0,1
138338548,0,1,0,0,1
138405965,0,1,0,0,1
142181151,0,1,0,0,1
142192521,0,1,0,0,1
142199212,0,1,0,0,1
146006843,0,1,0,0,1
146054388,0,1,0,0,1
146069184,0,1,0,0,1
146136196,0,1,0,0,1
146202399,0,1,0,0,1
146206169,0,1,0,0,1
146221437,0,0,0,1,1
146344699,0,0,0,1,1
146371099,0,1,0,0,1
146426074,0,1,0,0,1
146458407,0,1,0,0,1
146459979,0,1,0,0,1
146466247,0,1,0,0,1
146480653,1,0,0,0,1
146509596,0,1,0,0,1
146519291,0,1,0,0,1
146531876,1,0,0,0,1
146575768,0,1,0,0,1
146616376,0,1,0,0,1
146617123,0,1,0,0,1
146646613,0,1,0,0,1
146738509,0,1,0,0,1
146773417,0,1,0,0,1
146778013,0,0,0,1,1
146025339,1,0,0,0,1
145969561,0,1,0,0,1
142232218,0,1,0,0,1
145965094,0,1,0,0,1
145294175,1,0,0,0,1
145315146,0,1,0,0,1
145333388,0,0,0,1,1
145356994,1,0,0,0,1
145386067,0,1,0,0,1
145512686,1,0,0,0,1
145543551,0,1,0,0,1
145545092,0,1,0,0,1
145583282,0,1,0,0,1
145667162,0,1,0,0,1
145689039,0,1,0,0,1
145694784,0,1,0,0,1
145738343,0,1,0,0,1
145771120,0,1,0,0,1
145805879,0,1,0,0,1
145837415,0,1,0,0,1
145877208,0,1,0,0,1
145890109,0,1,0,0,1
145911447,0,1,0,0,1
145933158,1,0,0,0,1
145957719,1,0,0,0,1
145962245,1,0,0,0,1
145964318,0,1,0,0,1
146781802,0,1,0,0,1
146792473,1,0,0,0,1
146798359,0,1,0,0,1
146811592,0,1,0,0,1
147606149,1,0,0,0,1
147608115,0,1,0,0,1
147636875,0,1,0,0,1
147654699,0,1,0,0,1
147666891,0,1,0,0,1
147715676,0,1,0,0,1
147832672,0,1,0,0,1
147858554,0,1,0,0,1
147874891,0,0,0,1,1
147895417,0,1,0,0,1
147903006,0,1,0,0,1
147905208,0,1,0,0,1
147958900,0,1,0,0,1
147981924,0,1,0,0,1
148081102,0,1,0,0,1
148096595,0,1,0,0,1
148214680,0,1,0,0,1
148310600,0,1,0,0,1
148336385,0,1,0,0,1
148341326,0,1,0,0,1
148410945,0,1,0,0,1
148432455,0,1,0,0,1
148469866,0,1,0,0,1
147556835,1,0,0,0,1
147548693,1,0,0,0,1
147530070,0,1,0,0,1
147114617,0,1,0,0,1
146830257,0,1,0,0,1
146838595,0,1,0,0,1
146844552,1,0,0,0,1
146846407,0,1,0,0,1
146890664,0,1,0,0,1
146912712,1,0,0,0,1
146944048,0,1,0,0,1
147004862,0,1,0,0,1
147010847,0,1,0,0,1
147050573,0,1,0,0,1
147125416,0,1,0,0,1
147527441,0,1,0,0,1
147139078,0,1,0,0,1
147152185,0,1,0,0,1
147261691,0,1,0,0,1
147307343,0,1,0,0,1
147338768,0,1,0,0,1
147433385,0,1,0,0,1
147436270,0,1,0,0,1
147474466,0,1,0,0,1
147487601,0,1,0,0,1
147492703,0,1,0,0,1
145266351,0,1,0,0,1
145239300,0,1,0,0,1
145223145,0,1,0,0,1
143867085,0,1,0,0,1
142981466,0,0,1,0,1
143001133,1,0,0,0,1
143053442,0,1,0,0,1
143088658,0,1,0,0,1
143091928,1,0,0,0,1
143117257,0,1,0,0,1
143145727,0,1,0,0,1
143169070,1,0,0,0,1
143218073,0,1,0,0,1
143229949,0,1,0,0,1
143232040,0,1,0,0,1
143264776,0,1,0,0,1
143320253,0,1,0,0,1
143355700,1,0,0,0,1
143385649,0,1,0,0,1
143394570,1,0,0,0,1
143446959,0,1,0,0,1
143540388,0,1,0,0,1
143540525,0,1,0,0,1
143656358,0,1,0,0,1
143784147,1,0,0,0,1
143787693,0,1,0,0,1
143831347,0,1,0,0,1
142980856,0,1,0,0,1
142969888,0,1,0,0,1
142968348,1,0,0,0,1
142578994,0,1,0,0,1
142238984,0,1,0,0,1
142310839,0,1,0,0,1
142312027,0,0,0,1,1
142320045,0,1,0,0,1
142359714,0,1,0,0,1
142431656,0,1,0,0,1
142466539,0,1,0,0,1
142542762,0,1,0,0,1
142550194,0,1,0,0,1
142567423,0,1,0,0,1
142592638,0,1,0,0,1
142962707,0,1,0,0,1
142634548,0,1,0,0,1
142648475,0,1,0,0,1
142671652,0,1,0,0,1
142680634,0,1,0,0,1
142714477,0,1,0,0,1
142753131,1,0,0,0,1
142800242,0,1,0,0,1
142856087,0,1,0,0,1
142892946,0,1,0,0,1
142950299,0,1,0,0,1
143837906,0,1,0,0,1
143878450,0,1,0,0,1
145219172,0,1,0,0,1
143889254,0,1,0,0,1
144571052,0,1,0,0,1
144625905,0,1,0,0,1
144643223,0,1,0,0,1
144658323,0,1,0,0,1
144679546,0,1,0,0,1
144688957,0,1,0,0,1
144735035,0,1,0,0,1
144749482,0,1,0,0,1
144756705,0,1,0,0,1
144771276,0,1,0,0,1
144803897,1,0,0,0,1
144862259,1,0,0,0,1
144882755,1,0,0,0,1
144892453,0,0,1,0,1
144935003,0,1,0,0,1
144937036,0,1,0,0,1
144950916,1,0,0,0,1
144959861,0,1,0,0,1
145057072,0,1,0,0,1
145142932,0,1,0,0,1
145157217,0,1,0,0,1
145176904,1,0,0,0,1
145201060,1,0,0,0,1
144564702,0,1,0,0,1
144500268,0,1,0,0,1
144500227,1,0,0,0,1
144132348,1,0,0,0,1
143924221,0,1,0,0,1
143948642,0,1,0,0,1
143966306,0,1,0,0,1
143973106,0,1,0,0,1
144001110,0,1,0,0,1
144051113,0,1,0,0,1
144064743,0,1,0,0,1
144114283,0,1,0,0,1
144119463,1,0,0,0,1
144126297,1,0,0,0,1
144150729,1,0,0,0,1
144495052,0,1,0,0,1
144191307,0,1,0,0,1
144192648,0,1,0,0,1
144203392,1,0,0,0,1
144271397,0,1,0,0,1
144275780,0,1,0,0,1
144299439,0,1,0,0,1
144325733,0,1,0,0,1
144367491,0,1,0,0,1
144396993,1,0,0,0,1
144423516,0,1,0,0,1
136243339,1,0,0,0,1
136234413,0,0,1,0,1
136182001,0,1,0,0,1
126310412,0,1,0,0,1
126332399,0,1,0,0,1
126348333,0,1,0,0,1
126382471,0,1,0,0,1
126391623,0,1,0,0,1
126427514,0,1,0,0,1
126552330,0,1,0,0,1
126555101,1,0,0,0,1
126589128,0,1,0,0,1
126624159,0,1,0,0,1
126646851,0,1,0,0,1
126647633,0,1,0,0,1
126664025,0,1,0,0,1
126696840,0,1,0,0,1
126727689,0,1,0,0,1
126736704,0,1,0,0,1
126761623,1,0,0,0,1
126837822,0,1,0,0,1
126865219,0,1,0,0,1
126922685,0,1,0,0,1
126933179,0,1,0,0,1
126965787,0,1,0,0,1
126966942,0,1,0,0,1
127010716,0,1,0,0,1
126324292,1,0,0,0,1
126309085,0,1,0,0,1
129090494,0,1,0,0,1
126307156,0,1,0,0,1
125558959,1,0,0,0,1
125571954,0,1,0,0,1
125578376,0,1,0,0,1
125605685,0,1,0,0,1
125629353,0,1,0,0,1
125637889,0,1,0,0,1
125644710,0,1,0,0,1
125671338,0,1,0,0,1
125675838,0,0,1,0,1
125678619,0,1,0,0,1
125737792,1,0,0,0,1
125785294,0,1,0,0,1
125796135,0,1,0,0,1
125883302,0,1,0,0,1
125920442,0,1,0,0,1
125962010,0,1,0,0,1
126063132,0,1,0,0,1
126110034,0,1,0,0,1
126119741,1,0,0,0,1
126221154,0,1,0,0,1
126232593,0,1,0,0,1
126273935,0,1,0,0,1
126293619,0,1,0,0,1
127045367,0,1,0,0,1
127100889,0,1,0,0,1
127111603,0,0,1,0,1
127122957,0,1,0,0,1
128318688,1,0,0,0,1
128340418,0,1,0,0,1
128356728,0,1,0,0,1
128412871,0,1,0,0,1
128480603,0,1,0,0,1
128492747,0,0,0,1,1
128501373,0,1,0,0,1
128561551,0,1,0,0,1
128568642,1,0,0,0,1
128602183,1,0,0,0,1
128634987,1,0,0,0,1
128731856,0,1,0,0,1
128776689,0,0,0,1,1
128793300,1,0,0,0,1
128818803,1,0,0,0,1
128844685,0,1,0,0,1
128855697,0,1,0,0,1
128877139,0,1,0,0,1
128886971,1,0,0,0,1
128902251,0,1,0,0,1
128910123,1,0,0,0,1
128937492,0,1,0,0,1
128953725,0,1,0,0,1
128239367,0,1,0,0,1
128230851,0,1,0,0,1
128148767,0,1,0,0,1
127770394,0,1,0,0,1
127186219,1,0,0,0,1
127194040,0,1,0,0,1
127226237,0,1,0,0,1
127268003,0,1,0,0,1
127401674,0,1,0,0,1
127485158,0,1,0,0,1
127521203,1,0,0,0,1
127643425,0,1,0,0,1
127651984,0,1,0,0,1
127719381,1,0,0,0,1
127771633,1,0,0,0,1
128120704,0,1,0,0,1
127778179,0,1,0,0,1
127779439,0,1,0,0,1
127783447,0,1,0,0,1
127804180,0,0,0,1,1
127844175,0,1,0,0,1
127854790,0,0,0,1,1
127903626,0,1,0,0,1
127933237,0,1,0,0,1
127988145,0,1,0,0,1
128028443,0,1,0,0,1
125374717,0,1,0,0,1
125325092,0,1,0,0,1
125317939,0,1,0,0,1
123555017,0,1,0,0,1
123069733,0,1,0,0,1
123074807,0,1,0,0,1
123076504,0,1,0,0,1
123092304,0,1,0,0,1
123110535,1,0,0,0,1
123116661,0,1,0,0,1
123146690,0,1,0,0,1
123189444,0,1,0,0,1
123199049,0,1,0,0,1
123206289,0,0,1,0,1
123223802,1,0,0,0,1
123243143,0,1,0,0,1
123250750,1,0,0,0,1
123260463,0,1,0,0,1
123316355,0,1,0,0,1
123436955,1,0,0,0,1
123467117,0,1,0,0,1
123470711,0,1,0,0,1
123480722,0,1,0,0,1
123511378,0,1,0,0,1
123529967,0,1,0,0,1
123530549,0,1,0,0,1
123536206,0,1,0,0,1
123036487,1,0,0,0,1
123033227,0,0,0,1,1
123010214,0,1,0,0,1
122553592,0,1,0,0,1
122093621,1,0,0,0,1
122181219,0,1,0,0,1
122195564,0,1,0,0,1
122205213,0,1,0,0,1
122206961,0,1,0,0,1
122375189,0,1,0,0,1
122378861,0,1,0,0,1
122401256,0,1,0,0,1
122431081,0,0,0,1,1
122547110,0,1,0,0,1
122581608,0,1,0,0,1
123004723,1,0,0,0,1
122620379,0,1,0,0,1
122634155,0,1,0,0,1
122641603,0,1,0,0,1
122659025,0,1,0,0,1
122697145,0,1,0,0,1
122705071,0,1,0,0,1
122741906,1,0,0,0,1
122860763,1,0,0,0,1
122909660,0,1,0,0,1
122976255,1,0,0,0,1
123536610,0,1,0,0,1
123556100,0,1,0,0,1
125300190,0,1,0,0,1
123588351,0,1,0,0,1
124487827,1,0,0,0,1
124516100,0,1,0,0,1
124559168,0,1,0,0,1
124584369,0,1,0,0,1
124587401,0,1,0,0,1
124682909,0,1,0,0,1
124744116,0,1,0,0,1
124817318,0,1,0,0,1
124821320,0,1,0,0,1
124872571,0,0,0,1,1
124894337,0,1,0,0,1
124980024,0,1,0,0,1
124983518,0,1,0,0,1
125083731,0,0,0,1,1
125084220,0,1,0,0,1
125140189,0,1,0,0,1
125140859,0,1,0,0,1
125218969,0,1,0,0,1
125222265,1,0,0,0,1
125232290,0,1,0,0,1
125248923,0,1,0,0,1
125288401,0,1,0,0,1
125288902,1,0,0,0,1
124434445,0,1,0,0,1
124431116,0,1,0,0,1
124428317,0,1,0,0,1
124009352,0,1,0,0,1
123598974,1,0,0,0,1
123666369,0,1,0,0,1
123667272,0,0,1,0,1
123705296,0,1,0,0,1
123782285,1,0,0,0,1
123785614,0,1,0,0,1
123849507,1,0,0,0,1
123851279,1,0,0,0,1
123894552,0,1,0,0,1
123941092,1,0,0,0,1
124018174,0,0,0,1,1
124414039,1,0,0,0,1
124063645,0,1,0,0,1
124085267,0,1,0,0,1
124119573,0,1,0,0,1
124179030,0,1,0,0,1
124181995,0,1,0,0,1
124229982,0,1,0,0,1
124254913,0,1,0,0,1
124256573,1,0,0,0,1
124331079,0,1,0,0,1
124382601,0,0,1,0,1
129020968,1,0,0,0,1
129134665,0,1,0,0,1
136140626,0,1,0,0,1
133850232,0,0,0,1,1
133937371,0,1,0,0,1
133949759,0,1,0,0,1
133955593,0,1,0,0,1
133963570,0,1,0,0,1
134053233,0,1,0,0,1
134063000,0,1,0,0,1
134091343,0,1,0,0,1
134146975,1,0,0,0,1
134156060,0,0,1,0,1
134218902,0,1,0,0,1
134244455,0,1,0,0,1
134261467,0,1,0,0,1
134276876,0,1,0,0,1
134346721,0,1,0,0,1
134378300,1,0,0,0,1
134386867,0,1,0,0,1
134410458,0,1,0,0,1
134420071,0,1,0,0,1
134426005,0,1,0,0,1
134427727,0,1,0,0,1
134470988,0,1,0,0,1
134527393,0,1,0,0,1
134530053,0,1,0,0,1
133878064,0,1,0,0,1
133749597,0,1,0,0,1
129161583,0,1,0,0,1
133742451,0,1,0,0,1
132838252,1,0,0,0,1
132892544,1,0,0,0,1
132923966,0,1,0,0,1
132932849,1,0,0,0,1
132991604,0,1,0,0,1
133001635,0,1,0,0,1
133029267,0,1,0,0,1
133042082,0,1,0,0,1
133111282,0,1,0,0,1
133168811,0,1,0,0,1
133266924,0,1,0,0,1
133293292,0,1,0,0,1
133298514,0,1,0,0,1
133302867,0,1,0,0,1
133402351,0,1,0,0,1
133425959,0,1,0,0,1
133433789,0,1,0,0,1
133467627,0,1,0,0,1
133508884,0,1,0,0,1
133589299,0,1,0,0,1
133647925,0,1,0,0,1
133689315,0,1,0,0,1
133719477,0,1,0,0,1
134545496,0,0,0,1,1
134590955,0,1,0,0,1
134718234,0,1,0,0,1
134730632,0,1,0,0,1
135180047,0,1,0,0,1
135244353,0,1,0,0,1
135345978,0,1,0,0,1
135433469,0,1,0,0,1
135491629,1,0,0,0,1
135505652,0,1,0,0,1
135527018,0,1,0,0,1
135534164,0,1,0,0,1
135536498,0,0,0,1,1
135605509,0,1,0,0,1
135621892,0,1,0,0,1
135646754,0,1,0,0,1
135696485,0,1,0,0,1
135736593,0,1,0,0,1
135755402,0,1,0,0,1
135757838,0,1,0,0,1
135792262,0,1,0,0,1
135831511,0,1,0,0,1
135842103,0,1,0,0,1
135857224,0,1,0,0,1
136002754,0,1,0,0,1
136067278,0,1,0,0,1
136128796,0,1,0,0,1
135152411,0,1,0,0,1
135134030,0,1,0,0,1
135130197,1,0,0,0,1
134927467,0,1,0,0,1
134733234,0,1,0,0,1
134762042,0,1,0,0,1
134787605,0,1,0,0,1
134805749,0,1,0,0,1
134811760,0,1,0,0,1
134831715,1,0,0,0,1
134873541,0,1,0,0,1
134894877,0,1,0,0,1
134902940,0,1,0,0,1
134910210,0,1,0,0,1
134939618,1,0,0,0,1
135112906,0,1,0,0,1
134947814,0,1,0,0,1
135002272,0,1,0,0,1
135039082,0,1,0,0,1
135074882,0,1,0,0,1
135082178,0,1,0,0,1
135084124,0,0,0,1,1
135091808,0,1,0,0,1
135102757,0,1,0,0,1
135106081,0,1,0,0,1
135112790,0,1,0,0,1
132803193,1,0,0,0,1
132790504,0,1,0,0,1
132731075,0,1,0,0,1
131014567,0,1,0,0,1
130288146,0,1,0,0,1
130306475,0,1,0,0,1
130331187,0,1,0,0,1
130399684,0,1,0,0,1
130418499,0,1,0,0,1
130443508,0,1,0,0,1
130569578,0,1,0,0,1
130677830,0,1,0,0,1
130680228,0,1,0,0,1
130680873,0,1,0,0,1
130695192,1,0,0,0,1
130729105,0,0,0,1,1
130770255,0,1,0,0,1
130773554,0,0,1,0,1
130782799,0,1,0,0,1
130810049,0,1,0,0,1
130814828,1,0,0,0,1
130816178,0,1,0,0,1
130839698,0,1,0,0,1
130854690,0,1,0,0,1
130889789,0,1,0,0,1
130893259,0,1,0,0,1
130933286,0,1,0,0,1
130146738,0,1,0,0,1
130102395,1,0,0,0,1
130100547,0,1,0,0,1
129575768,0,1,0,0,1
129187433,0,1,0,0,1
129253658,1,0,0,0,1
129417956,0,1,0,0,1
129428499,0,1,0,0,1
129435307,0,1,0,0,1
129445208,0,1,0,0,1
129452741,0,0,1,0,1
129482966,0,1,0,0,1
129538928,0,1,0,0,1
129560181,0,1,0,0,1
129717292,0,1,0,0,1
130089037,0,1,0,0,1
129737717,0,0,1,0,1
129774250,0,1,0,0,1
129862107,0,1,0,0,1
129867408,0,1,0,0,1
129872723,0,1,0,0,1
129873699,0,1,0,0,1
129883520,0,1,0,0,1
129969062,0,1,0,0,1
129983690,0,0,1,0,1
130060730,0,1,0,0,1
130957260,0,1,0,0,1
131016061,0,1,0,0,1
132684749,0,1,0,0,1
131046519,1,0,0,0,1
131824025,1,0,0,0,1
131833693,0,1,0,0,1
131864934,0,1,0,0,1
131870741,0,1,0,0,1
131931779,0,1,0,0,1
131944283,1,0,0,0,1
131977092,1,0,0,0,1
132019215,0,1,0,0,1
132068972,0,0,1,0,1
132085916,0,1,0,0,1
132173727,0,1,0,0,1
132183460,0,1,0,0,1
132208358,0,1,0,0,1
132210378,0,1,0,0,1
132279870,0,1,0,0,1
132303814,0,1,0,0,1
132458793,1,0,0,0,1
132467998,0,1,0,0,1
132500963,0,1,0,0,1
132566855,0,1,0,0,1
132604961,0,1,0,0,1
132621891,0,1,0,0,1
132668682,0,1,0,0,1
131781623,0,1,0,0,1
131744843,0,1,0,0,1
131688150,0,1,0,0,1
131345011,0,1,0,0,1
131098200,0,1,0,0,1
131122101,0,1,0,0,1
131122231,0,1,0,0,1
131144188,0,1,0,0,1
131192086,0,1,0,0,1
131218230,1,0,0,0,1
131222025,0,1,0,0,1
131248798,0,0,1,0,1
131261572,0,1,0,0,1
131284137,0,1,0,0,1
131379230,0,1,0,0,1
131652293,0,1,0,0,1
131411841,1,0,0,0,1
131420171,0,1,0,0,1
131432836,0,1,0,0,1
131460484,1,0,0,0,1
131485226,1,0,0,0,1
131509396,0,1,0,0,1
131539909,0,1,0,0,1
131557285,0,0,0,1,1
131600005,0,1,0,0,1
131620708,0,1,0,0,1
148473506,1,0,0,0,1
148494665,0,1,0,0,1
148519189,1,0,0,0,1
171343201,0,1,0,0,1
171421295,0,1,0,0,1
171433095,0,1,0,0,1
171438173,0,1,0,0,1
171440419,0,1,0,0,1
171452014,0,1,0,0,1
171483023,0,1,0,0,1
171516916,0,1,0,0,1
171536226,0,1,0,0,1
171599151,0,1,0,0,1
171691424,0,1,0,0,1
171726996,0,1,0,0,1
171859533,0,1,0,0,1
171865747,0,1,0,0,1
171986263,0,1,0,0,1
171997301,1,0,0,0,1
172127510,0,1,0,0,1
172247680,1,0,0,0,1
172287021,1,0,0,0,1
172291034,0,1,0,0,1
172303144,0,1,0,0,1
172353234,0,0,0,1,1
172399876,0,1,0,0,1
172409114,1,0,0,0,1
171352856,0,1,0,0,1
171254778,1,0,0,0,1
175121449,1,0,0,0,1
171239512,1,0,0,0,1
170062616,0,1,0,0,1
170077999,1,0,0,0,1
170104346,0,0,0,1,1
170191342,0,1,0,0,1
170245432,0,1,0,0,1
170256509,0,1,0,0,1
170270344,1,0,0,0,1
170270505,1,0,0,0,1
170468112,0,0,0,1,1
170468627,0,1,0,0,1
170575526,0,1,0,0,1
170636831,0,1,0,0,1
170687597,0,1,0,0,1
170760960,1,0,0,0,1
170776388,0,1,0,0,1
170970930,1,0,0,0,1
171033180,0,1,0,0,1
171034761,0,1,0,0,1
171060458,0,1,0,0,1
171105641,0,0,1,0,1
171136307,0,1,0,0,1
171212452,0,0,0,1,1
171232928,1,0,0,0,1
172431020,0,0,1,0,1
172434834,0,1,0,0,1
172497487,0,1,0,0,1
172684374,0,1,0,0,1
173794059,0,1,0,0,1
173796573,0,1,0,0,1
173851341,0,1,0,0,1
173863690,0,1,0,0,1
174026753,0,1,0,0,1
174107430,1,0,0,0,1
174149862,0,1,0,0,1
174151920,0,1,0,0,1
174187408,0,1,0,0,1
174224195,0,1,0,0,1
174230433,1,0,0,0,1
174331774,0,1,0,0,1
174338151,0,1,0,0,1
174367907,0,1,0,0,1
174386075,0,1,0,0,1
174580875,0,0,0,1,1
174586099,0,1,0,0,1
174664298,0,1,0,0,1
174675574,1,0,0,0,1
174781906,0,1,0,0,1
174967696,0,1,0,0,1
174979549,0,1,0,0,1
175020976,0,1,0,0,1
173740217,0,1,0,0,1
173722990,0,1,0,0,1
173689906,0,1,0,0,1
173089246,0,1,0,0,1
172700129,0,1,0,0,1
172703263,0,1,0,0,1
172825435,1,0,0,0,1
172919169,0,1,0,0,1
172998865,0,1,0,0,1
173011678,0,1,0,0,1
173028801,1,0,0,0,1
173045846,0,1,0,0,1
173061418,0,1,0,0,1
173062825,0,1,0,0,1
173091743,0,1,0,0,1
173637034,0,1,0,0,1
173155721,0,1,0,0,1
173205274,0,1,0,0,1
173214590,0,1,0,0,1
173325906,0,1,0,0,1
173389451,0,1,0,0,1
173400596,0,1,0,0,1
173431221,0,1,0,0,1
173447125,0,1,0,0,1
173494564,0,1,0,0,1
173558911,0,1,0,0,1
170059951,0,1,0,0,1
170045502,0,1,0,0,1
169980486,0,1,0,0,1
168039506,0,1,0,0,1
166997906,0,1,0,0,1
167002854,0,1,0,0,1
167005327,1,0,0,0,1
167011606,0,1,0,0,1
167154454,0,1,0,0,1
167188248,0,1,0,0,1
167203130,0,1,0,0,1
167215355,0,0,0,1,1
167219977,0,1,0,0,1
167341241,0,1,0,0,1
167366840,0,1,0,0,1
167464841,0,1,0,0,1
167484107,0,1,0,0,1
167516886,0,1,0,0,1
167587312,0,1,0,0,1
167685779,0,1,0,0,1
167707114,0,0,1,0,1
167748473,0,1,0,0,1
167861205,0,0,0,1,1
167880876,0,1,0,0,1
167886751,1,0,0,0,1
167912829,0,1,0,0,1
167970253,0,1,0,0,1
166995076,0,1,0,0,1
166933991,0,0,0,1,1
166916915,1,0,0,0,1
166456010,0,1,0,0,1
165937270,0,1,0,0,1
166097821,0,1,0,0,1
166169193,0,1,0,0,1
166202391,0,1,0,0,1
166213858,0,1,0,0,1
166329578,0,1,0,0,1
166338304,0,1,0,0,1
166389152,0,1,0,0,1
166409248,0,1,0,0,1
166445655,0,0,1,0,1
166509243,0,0,1,0,1
166897186,0,1,0,0,1
166548719,1,0,0,0,1
166585184,0,0,1,0,1
166599720,0,1,0,0,1
166711595,0,1,0,0,1
166744811,0,1,0,0,1
166747282,1,0,0,0,1
166810357,0,1,0,0,1
166818991,0,1,0,0,1
166862046,1,0,0,0,1
166893565,0,1,0,0,1
167995911,0,1,0,0,1
168055029,0,1,0,0,1
169922564,1,0,0,0,1
168059166,0,1,0,0,1
168957120,0,1,0,0,1
168965231,1,0,0,0,1
169007798,0,1,0,0,1
169018517,1,0,0,0,1
169018939,0,1,0,0,1
169022645,0,1,0,0,1
169053712,0,1,0,0,1
169074686,0,1,0,0,1
169153270,0,1,0,0,1
169277228,0,1,0,0,1
169402311,0,1,0,0,1
169453441,1,0,0,0,1
169482632,0,1,0,0,1
169544102,0,0,0,1,1
169552929,1,0,0,0,1
169618955,0,1,0,0,1
169621466,0,1,0,0,1
169626752,0,1,0,0,1
169760711,0,1,0,0,1
169841651,0,1,0,0,1
169879795,0,1,0,0,1
169886262,0,1,0,0,1
169906565,0,1,0,0,1
168951314,0,1,0,0,1
168910853,1,0,0,0,1
168868503,0,1,0,0,1
168518075,0,1,0,0,1
168123888,0,1,0,0,1
168166837,1,0,0,0,1
168186507,0,1,0,0,1
168236765,0,1,0,0,1
168421424,0,1,0,0,1
168448254,0,1,0,0,1
168462417,1,0,0,0,1
168465418,1,0,0,0,1
168496442,0,1,0,0,1
168511028,1,0,0,0,1
168579579,0,1,0,0,1
168815269,0,1,0,0,1
168686173,0,1,0,0,1
168717945,0,1,0,0,1
168723093,0,1,0,0,1
168750396,0,1,0,0,1
168751604,0,1,0,0,1
168754949,0,1,0,0,1
168759892,1,0,0,0,1
168777472,0,1,0,0,1
168786227,1,0,0,0,1
168811642,0,1,0,0,1
175061055,0,1,0,0,1
175222030,0,1,0,0,1
165896483,0,1,0,0,1
180698414,1,0,0,0,1
180759736,0,1,0,0,1
180773178,1,0,0,0,1
180773532,0,1,0,0,1
180811300,0,1,0,0,1
181132221,0,0,0,1,1
181154635,0,1,0,0,1
181176604,0,1,0,0,1
181192330,0,1,0,0,1
181227918,0,1,0,0,1
181237082,0,1,0,0,1
181391018,0,1,0,0,1
181433154,0,1,0,0,1
181451070,1,0,0,0,1
181459969,0,1,0,0,1
181604038,1,0,0,0,1
181639291,0,1,0,0,1
181695653,0,1,0,0,1
181862971,0,1,0,0,1
181864948,0,1,0,0,1
181885395,0,1,0,0,1
181903760,1,0,0,0,1
182348834,0,1,0,0,1
182426359,1,0,0,0,1
180744698,0,1,0,0,1
180612400,0,1,0,0,1
175255682,1,0,0,0,1
180369737,0,1,0,0,1
179427300,0,1,0,0,1
179440947,0,0,1,0,1
179467207,0,1,0,0,1
179568487,0,1,0,0,1
179615814,0,1,0,0,1
179656314,0,1,0,0,1
179661469,0,1,0,0,1
179746237,0,1,0,0,1
179821249,0,1,0,0,1
179824212,0,1,0,0,1
179871830,0,0,0,1,1
179895345,1,0,0,0,1
179939366,0,1,0,0,1
179952145,0,1,0,0,1
179974853,0,0,0,1,1
179996184,0,1,0,0,1
180003885,0,1,0,0,1
180004098,0,1,0,0,1
180041704,0,1,0,0,1
180219914,0,1,0,0,1
180289847,0,1,0,0,1
180294540,0,0,0,1,1
180295269,0,1,0,0,1
182428160,1,0,0,0,1
182440062,0,1,0,0,1
182546088,0,1,0,0,1
182673233,0,1,0,0,1
183963069,0,1,0,0,1
183971253,1,0,0,0,1
184004650,0,1,0,0,1
184008283,0,1,0,0,1
184017607,0,1,0,0,1
184169744,0,1,0,0,1
184294512,1,0,0,0,1
184346759,1,0,0,0,1
184394329,0,1,0,0,1
184409207,0,1,0,0,1
184426604,0,1,0,0,1
184440554,0,1,0,0,1
184454532,0,1,0,0,1
184554428,0,1,0,0,1
184693222,0,1,0,0,1
184697340,0,1,0,0,1
184823979,0,1,0,0,1
184836889,0,1,0,0,1
184909703,0,1,0,0,1
184920912,0,1,0,0,1
184929350,0,1,0,0,1
185096948,0,1,0,0,1
185102549,0,1,0,0,1
183912188,0,0,1,0,1
183770461,0,0,1,0,1
183743367,0,1,0,0,1
182928053,0,1,0,0,1
182686121,0,1,0,0,1
182702866,0,0,1,0,1
182710135,0,1,0,0,1
182718188,0,1,0,0,1
182745210,0,1,0,0,1
182756630,0,1,0,0,1
182788844,0,1,0,0,1
182798435,0,1,0,0,1
182855127,0,1,0,0,1
182858230,0,1,0,0,1
183151216,1,0,0,0,1
183711743,0,1,0,0,1
183225768,1,0,0,0,1
183317755,0,1,0,0,1
183334236,0,1,0,0,1
183365747,0,1,0,0,1
183519173,1,0,0,0,1
183551697,0,1,0,0,1
183593910,0,1,0,0,1
183634860,0,1,0,0,1
183691077,0,1,0,0,1
183707487,1,0,0,0,1
179299706,0,1,0,0,1
179289287,0,1,0,0,1
179184044,0,1,0,0,1
177075716,0,1,0,0,1
176331617,1,0,0,0,1
176338867,0,1,0,0,1
176344103,1,0,0,0,1
176353018,0,1,0,0,1
176375006,0,1,0,0,1
176393434,0,1,0,0,1
176440539,0,1,0,0,1
176499731,0,1,0,0,1
176684894,0,1,0,0,1
176702549,0,1,0,0,1
176702658,1,0,0,0,1
176731155,0,1,0,0,1
176748762,0,1,0,0,1
176749951,0,1,0,0,1
176805694,0,1,0,0,1
176821287,0,1,0,0,1
176873502,0,1,0,0,1
176898784,0,1,0,0,1
176899376,0,1,0,0,1
176967422,0,0,0,1,1
177002784,0,1,0,0,1
177008505,0,1,0,0,1
177049815,0,1,0,0,1
176288729,0,1,0,0,1
176284364,0,1,0,0,1
176204962,0,1,0,0,1
175618247,0,0,0,1,1
175324607,0,1,0,0,1
175347951,0,1,0,0,1
175373575,0,1,0,0,1
175394485,0,0,1,0,1
175395458,1,0,0,0,1
175405201,0,0,0,1,1
175485198,0,1,0,0,1
175486166,0,1,0,0,1
175578413,0,1,0,0,1
175612701,0,1,0,0,1
175636815,0,1,0,0,1
176194660,0,1,0,0,1
175659674,0,1,0,0,1
175696725,0,1,0,0,1
175764026,0,0,1,0,1
175788143,0,1,0,0,1
175819184,0,1,0,0,1
175888182,0,1,0,0,1
175978930,0,1,0,0,1
176079706,1,0,0,0,1
176137405,0,1,0,0,1
176180751,0,1,0,0,1
177063485,1,0,0,0,1
177145633,0,1,0,0,1
179118309,0,1,0,0,1
177146550,0,0,0,1,1
178066944,1,0,0,0,1
178205270,0,1,0,0,1
178272621,0,1,0,0,1
178346527,0,1,0,0,1
178347269,0,1,0,0,1
178401545,0,1,0,0,1
178428618,0,1,0,0,1
178622953,0,1,0,0,1
178636787,0,1,0,0,1
178637642,0,1,0,0,1
178667919,0,1,0,0,1
178750769,0,1,0,0,1
178769737,0,1,0,0,1
178770014,0,1,0,0,1
178947924,1,0,0,0,1
179001568,0,1,0,0,1
179033490,0,1,0,0,1
179045131,0,1,0,0,1
179061645,0,1,0,0,1
179064874,0,1,0,0,1
179067771,0,1,0,0,1
179088440,0,1,0,0,1
179106488,0,1,0,0,1
178065941,0,1,0,0,1
177935434,0,1,0,0,1
177885648,1,0,0,0,1
177539058,0,1,0,0,1
177157771,0,1,0,0,1
177161108,0,0,0,1,1
177195882,0,1,0,0,1
177205920,0,1,0,0,1
177220083,0,1,0,0,1
177253191,0,1,0,0,1
177268133,1,0,0,0,1
177468091,0,1,0,0,1
177494387,0,1,0,0,1
177506460,0,1,0,0,1
177542029,0,1,0,0,1
177874458,0,1,0,0,1
177554833,0,1,0,0,1
177590367,0,1,0,0,1
177601187,0,1,0,0,1
177665957,1,0,0,0,1
177689116,0,1,0,0,1
177710529,1,0,0,0,1
177770962,0,0,0,1,1
177810804,1,0,0,0,1
177826238,0,1,0,0,1
177844447,0,1,0,0,1
165931669,0,1,0,0,1
165802632,0,1,0,0,1
148524608,0,1,0,0,1
153736469,0,1,0,0,1
153752764,0,1,0,0,1
153784445,1,0,0,0,1
153829484,0,1,0,0,1
153852492,0,1,0,0,1
153879033,0,1,0,0,1
153885833,1,0,0,0,1
153976607,0,1,0,0,1
154079228,0,1,0,0,1
154094089,1,0,0,0,1
154145135,0,1,0,0,1
154168156,0,1,0,0,1
154195050,0,1,0,0,1
154199825,0,1,0,0,1
154223624,0,1,0,0,1
154286764,0,1,0,0,1
154447110,0,1,0,0,1
154449900,0,1,0,0,1
154486236,0,1,0,0,1
154509513,0,1,0,0,1
154545301,0,1,0,0,1
154546567,0,1,0,0,1
154575265,0,1,0,0,1
154731190,1,0,0,0,1
153744667,1,0,0,0,1
153713959,0,1,0,0,1
156711530,0,1,0,0,1
153711665,0,1,0,0,1
152987130,0,1,0,0,1
153005749,0,1,0,0,1
153055067,0,1,0,0,1
153097670,0,1,0,0,1
153104578,0,1,0,0,1
153113248,0,1,0,0,1
153156175,0,1,0,0,1
153184526,0,0,0,1,1
153238735,0,1,0,0,1
153282873,0,1,0,0,1
153307041,0,1,0,0,1
153364566,1,0,0,0,1
153377072,0,1,0,0,1
153418933,0,1,0,0,1
153450118,0,1,0,0,1
153484497,0,1,0,0,1
153525524,0,1,0,0,1
153544744,0,1,0,0,1
153549212,0,1,0,0,1
153551465,0,1,0,0,1
153579408,0,1,0,0,1
153691434,0,1,0,0,1
153698769,0,1,0,0,1
154746652,0,1,0,0,1
154808415,0,1,0,0,1
154817057,0,1,0,0,1
154830217,1,0,0,0,1
156007837,0,1,0,0,1
156025103,0,1,0,0,1
156054333,0,1,0,0,1
156080099,0,1,0,0,1
156083615,0,1,0,0,1
156126182,0,1,0,0,1
156151999,0,1,0,0,1
156158362,0,1,0,0,1
156265126,0,1,0,0,1
156295299,0,1,0,0,1
156407479,0,1,0,0,1
156449480,0,1,0,0,1
156476793,0,1,0,0,1
156534716,0,1,0,0,1
156540927,0,1,0,0,1
156563765,1,0,0,0,1
156570677,0,1,0,0,1
156601094,1,0,0,0,1
156609144,1,0,0,0,1
156615283,0,1,0,0,1
156636476,1,0,0,0,1
156650033,0,1,0,0,1
156688723,0,1,0,0,1
156003977,0,1,0,0,1
155968076,0,1,0,0,1
155960741,0,1,0,0,1
155294132,1,0,0,0,1
154952124,0,1,0,0,1
155008970,0,0,1,0,1
155045917,0,1,0,0,1
155058199,0,1,0,0,1
155087602,0,1,0,0,1
155162246,1,0,0,0,1
155169049,0,1,0,0,1
155177727,0,1,0,0,1
155258899,0,1,0,0,1
155259562,0,1,0,0,1
155296412,0,1,0,0,1
155791113,0,1,0,0,1
155301684,0,1,0,0,1
155314703,0,1,0,0,1
155382946,0,1,0,0,1
155446979,0,1,0,0,1
155503146,1,0,0,0,1
155582936,0,1,0,0,1
155590921,1,0,0,0,1
155602936,0,1,0,0,1
155686383,0,1,0,0,1
155791020,0,1,0,0,1
152971224,0,1,0,0,1
152784951,0,1,0,0,1
152777059,1,0,0,0,1
150428453,0,1,0,0,1
149615279,0,1,0,0,1
149618388,0,1,0,0,1
149635633,0,1,0,0,1
149636192,0,1,0,0,1
149648240,0,1,0,0,1
149678871,0,1,0,0,1
149807216,0,1,0,0,1
149820714,0,1,0,0,1
149824990,0,1,0,0,1
149825135,0,1,0,0,1
149828047,0,1,0,0,1
149897785,0,1,0,0,1
149928949,0,1,0,0,1
149989083,0,1,0,0,1
150138241,0,1,0,0,1
150147781,0,0,0,1,1
150166141,0,1,0,0,1
150182520,0,1,0,0,1
150209920,0,1,0,0,1
150236521,0,0,0,1,1
150270241,1,0,0,0,1
150297314,0,1,0,0,1
150297377,0,1,0,0,1
149588989,0,1,0,0,1
149584092,0,1,0,0,1
149472407,0,1,0,0,1
148909356,0,1,0,0,1
148635347,0,1,0,0,1
148642979,0,1,0,0,1
148670109,0,1,0,0,1
148684323,1,0,0,0,1
148692717,1,0,0,0,1
148693793,0,1,0,0,1
148721135,0,1,0,0,1
148767090,0,1,0,0,1
148868804,0,1,0,0,1
148907701,0,1,0,0,1
148980672,0,1,0,0,1
149454784,0,1,0,0,1
148986741,0,1,0,0,1
149026603,0,1,0,0,1
149046013,0,1,0,0,1
149049098,0,1,0,0,1
149139424,0,1,0,0,1
149154411,0,1,0,0,1
149217589,1,0,0,0,1
149232416,0,1,0,0,1
149340471,0,1,0,0,1
149443609,0,1,0,0,1
150403320,0,1,0,0,1
150433165,1,0,0,0,1
152728743,0,1,0,0,1
150453253,0,1,0,0,1
151397410,0,1,0,0,1
151466442,0,1,0,0,1
151469102,0,1,0,0,1
151483245,1,0,0,0,1
151553236,0,1,0,0,1
151580630,0,1,0,0,1
151594759,0,1,0,0,1
151618707,0,1,0,0,1
151635845,0,1,0,0,1
151644259,0,1,0,0,1
151703313,0,1,0,0,1
151730854,0,1,0,0,1
151790196,1,0,0,0,1
152237175,0,1,0,0,1
152249248,0,1,0,0,1
152296029,0,1,0,0,1
152343270,0,1,0,0,1
152499321,1,0,0,0,1
152556292,0,1,0,0,1
152597263,0,1,0,0,1
152605147,0,1,0,0,1
152653481,0,1,0,0,1
152683439,0,1,0,0,1
151387351,1,0,0,0,1
151368942,0,1,0,0,1
151333434,0,1,0,0,1
150777984,0,1,0,0,1
150541526,0,1,0,0,1
150553383,0,1,0,0,1
150571433,1,0,0,0,1
150580132,1,0,0,0,1
150602205,0,1,0,0,1
150622752,0,1,0,0,1
150627680,1,0,0,0,1
150643492,0,1,0,0,1
150658741,0,1,0,0,1
150661180,0,1,0,0,1
150790003,0,1,0,0,1
151192931,0,1,0,0,1
150801110,1,0,0,0,1
150806346,1,0,0,0,1
150908428,1,0,0,0,1
150932315,0,1,0,0,1
150955779,0,1,0,0,1
151001716,0,0,0,1,1
151097395,1,0,0,0,1
151099792,0,1,0,0,1
151105620,0,0,1,0,1
151164932,1,0,0,0,1
156693179,0,1,0,0,1
156711553,0,1,0,0,1
165788474,0,1,0,0,1
162411004,0,1,0,0,1
162703209,0,1,0,0,1
162745140,0,1,0,0,1
162768074,0,1,0,0,1
162769774,0,1,0,0,1
162793259,0,1,0,0,1
162815311,0,1,0,0,1
162826918,0,1,0,0,1
162906267,0,1,0,0,1
162914212,1,0,0,0,1
162973085,1,0,0,0,1
162990756,0,1,0,0,1
163009576,0,1,0,0,1
163031745,0,1,0,0,1
163101542,1,0,0,0,1
163172305,0,1,0,0,1
163245863,0,1,0,0,1
163425293,0,1,0,0,1
163429021,0,1,0,0,1
163454545,1,0,0,0,1
163472346,0,0,0,1,1
163526437,0,1,0,0,1
163544724,0,1,0,0,1
163638084,0,1,0,0,1
162490837,0,1,0,0,1
162369733,0,1,0,0,1
156865167,0,1,0,0,1
162369330,0,1,0,0,1
161393079,0,1,0,0,1
161401235,0,1,0,0,1
161529856,0,1,0,0,1
161600852,0,1,0,0,1
161609945,0,1,0,0,1
161632686,1,0,0,0,1
161652621,1,0,0,0,1
161718433,0,1,0,0,1
161720947,1,0,0,0,1
161782637,0,1,0,0,1
161860425,0,1,0,0,1
161875107,0,1,0,0,1
161930947,0,1,0,0,1
161948093,0,1,0,0,1
161980775,1,0,0,0,1
161999616,0,1,0,0,1
162006198,0,1,0,0,1
162099682,1,0,0,0,1
162134784,1,0,0,0,1
162154515,0,1,0,0,1
162188760,0,1,0,0,1
162314850,0,0,1,0,1
162340974,1,0,0,0,1
163666662,0,1,0,0,1
163690266,0,1,0,0,1
163753561,0,1,0,0,1
163801780,1,0,0,0,1
164680728,0,1,0,0,1
164822151,0,1,0,0,1
164857403,0,1,0,0,1
164901870,0,1,0,0,1
164916132,0,1,0,0,1
164998344,0,1,0,0,1
165002582,0,1,0,0,1
165065814,0,1,0,0,1
165074835,0,1,0,0,1
165107933,0,1,0,0,1
165166168,0,1,0,0,1
165186678,0,1,0,0,1
165202993,1,0,0,0,1
165298304,1,0,0,0,1
165332825,1,0,0,0,1
165350359,0,1,0,0,1
165369323,0,0,0,1,1
165391492,0,1,0,0,1
165520993,0,0,1,0,1
165568092,0,1,0,0,1
165587141,0,1,0,0,1
165757953,0,1,0,0,1
165785767,0,1,0,0,1
164662925,0,1,0,0,1
164659058,0,1,0,0,1
164628357,0,1,0,0,1
164224534,0,1,0,0,1
163803876,0,1,0,0,1
163836054,0,1,0,0,1
163863948,0,1,0,0,1
163932481,0,1,0,0,1
164028615,1,0,0,0,1
164064757,0,1,0,0,1
164105224,0,1,0,0,1
164134798,0,1,0,0,1
164172525,0,1,0,0,1
164181846,0,1,0,0,1
164329648,0,1,0,0,1
164618196,0,1,0,0,1
164389022,1,0,0,0,1
164395376,0,1,0,0,1
164410735,1,0,0,0,1
164414404,0,1,0,0,1
164416840,0,0,1,0,1
164481907,0,1,0,0,1
164512098,0,1,0,0,1
164583861,0,1,0,0,1
164603006,0,1,0,0,1
164615561,0,1,0,0,1
161383956,0,0,1,0,1
161382841,0,1,0,0,1
161373503,0,1,0,0,1
159162961,0,1,0,0,1
157987904,0,1,0,0,1
158024484,0,1,0,0,1
158051081,0,1,0,0,1
158052278,0,1,0,0,1
158064037,0,1,0,0,1
158076849,1,0,0,0,1
158124377,0,1,0,0,1
158226297,0,1,0,0,1
158256675,0,1,0,0,1
158270113,0,1,0,0,1
158274231,0,1,0,0,1
158296172,1,0,0,0,1
158339565,1,0,0,0,1
158436901,0,1,0,0,1
158517384,0,1,0,0,1
158627416,0,1,0,0,1
158784265,0,1,0,0,1
158799998,0,1,0,0,1
158800651,0,1,0,0,1
158814304,0,1,0,0,1
159060536,1,0,0,0,1
159070184,0,1,0,0,1
159097160,0,1,0,0,1
157952243,0,1,0,0,1
157912575,1,0,0,0,1
157905241,0,1,0,0,1
157362503,0,1,0,0,1
156888577,1,0,0,0,1
156969671,0,0,1,0,1
157085842,0,1,0,0,1
157111280,0,1,0,0,1
157112089,0,1,0,0,1
157164980,0,1,0,0,1
157275504,0,1,0,0,1
157281957,0,1,0,0,1
157296433,0,1,0,0,1
157339338,0,1,0,0,1
157376418,0,1,0,0,1
157860233,0,1,0,0,1
157377186,0,0,0,1,1
157418359,0,1,0,0,1
157427114,0,1,0,0,1
157525113,1,0,0,0,1
157584536,0,1,0,0,1
157596832,0,1,0,0,1
157640864,1,0,0,0,1
157663600,0,1,0,0,1
157672863,0,1,0,0,1
157697050,0,1,0,0,1
159121077,0,1,0,0,1
159163741,0,1,0,0,1
161356121,0,1,0,0,1
159210423,0,1,0,0,1
160260834,0,1,0,0,1
160276594,1,0,0,0,1
160356437,0,1,0,0,1
160507445,0,1,0,0,1
160516359,0,1,0,0,1
160601152,0,1,0,0,1
160670234,0,1,0,0,1
160703953,0,1,0,0,1
160763702,0,1,0,0,1
160779618,1,0,0,0,1
160781450,0,1,0,0,1
160922141,0,1,0,0,1
160922375,0,1,0,0,1
160924317,0,1,0,0,1
160950245,0,1,0,0,1
161028353,0,1,0,0,1
161119633,0,1,0,0,1
161123873,0,0,0,1,1
161151263,0,1,0,0,1
161177378,0,1,0,0,1
161226001,0,1,0,0,1
161287287,0,1,0,0,1
161308987,1,0,0,0,1
160237380,0,1,0,0,1
160231860,0,1,0,0,1
160231102,0,1,0,0,1
159640080,1,0,0,0,1
159395433,0,1,0,0,1
159408065,0,1,0,0,1
159430096,0,1,0,0,1
159446302,0,1,0,0,1
159449059,0,1,0,0,1
159466747,0,1,0,0,1
159498852,0,1,0,0,1
159540538,0,1,0,0,1
159546597,0,1,0,0,1
159612702,0,1,0,0,1
159726676,0,1,0,0,1
160171772,0,1,0,0,1
159793601,0,1,0,0,1
159850827,0,1,0,0,1
159888314,0,1,0,0,1
159895276,0,1,0,0,1
159947103,0,1,0,0,1
160009909,0,1,0,0,1
160035129,0,1,0,0,1
160094161,0,1,0,0,1
160160155,0,1,0,0,1
160170359,0,1,0,0,1
122084857,0,0,0,1,1
121990498,0,1,0,0,1
121949981,0,1,0,0,1
85166040,0,1,0,0,1
85261082,0,1,0,0,1
85296204,1,0,0,0,1
85304401,0,1,0,0,1
85328224,0,1,0,0,1
85357075,0,0,0,1,1
85361100,0,1,0,0,1
85403737,1,0,0,0,1
85539438,0,1,0,0,1
85545472,0,1,0,0,1
85552167,0,0,1,0,1
85556534,0,1,0,0,1
85561059,0,1,0,0,1
85564057,1,0,0,0,1
85633383,1,0,0,0,1
85659105,0,1,0,0,1
85732400,0,1,0,0,1
85742690,0,1,0,0,1
85854396,1,0,0,0,1
85904597,0,1,0,0,1
86033619,0,1,0,0,1
86035137,0,1,0,0,1
86059409,0,1,0,0,1
86088576,0,1,0,0,1
85242766,0,1,0,0,1
85159842,0,1,0,0,1
88433460,0,1,0,0,1
85111830,0,1,0,0,1
84413839,0,1,0,0,1
84428267,1,0,0,0,1
84488836,0,1,0,0,1
84515908,0,1,0,0,1
84562297,0,1,0,0,1
84592732,0,1,0,0,1
84594449,0,1,0,0,1
84605935,0,1,0,0,1
84629817,0,1,0,0,1
84636977,0,1,0,0,1
84649780,0,1,0,0,1
84712235,0,1,0,0,1
84730364,0,1,0,0,1
84783101,0,1,0,0,1
84816162,0,1,0,0,1
84842549,0,1,0,0,1
84847293,0,1,0,0,1
84905839,0,1,0,0,1
84914909,0,1,0,0,1
84943360,0,1,0,0,1
84956005,0,1,0,0,1
85022449,0,1,0,0,1
85095581,0,1,0,0,1
86115470,0,1,0,0,1
86163193,0,1,0,0,1
86281317,0,1,0,0,1
86295370,0,1,0,0,1
87443437,0,1,0,0,1
87634880,0,0,1,0,1
87642907,0,1,0,0,1
87681306,0,1,0,0,1
87701379,0,1,0,0,1
87776681,0,1,0,0,1
87888260,0,1,0,0,1
87906549,0,1,0,0,1
87909658,0,1,0,0,1
87936282,0,1,0,0,1
87980263,0,1,0,0,1
88000004,0,1,0,0,1
88008169,1,0,0,0,1
88066625,1,0,0,0,1
88157952,1,0,0,0,1
88172310,0,1,0,0,1
88217952,0,1,0,0,1
88225027,0,1,0,0,1
88320350,0,1,0,0,1
88340526,0,1,0,0,1
88346887,0,1,0,0,1
88410947,0,1,0,0,1
88416890,0,1,0,0,1
87385810,0,1,0,0,1
87375432,0,1,0,0,1
87311826,0,1,0,0,1
86735440,1,0,0,0,1
86297056,0,1,0,0,1
86378661,1,0,0,0,1
86394840,0,1,0,0,1
86406068,0,1,0,0,1
86510835,0,1,0,0,1
86536938,0,1,0,0,1
86570092,0,0,0,1,1
86594572,0,1,0,0,1
86622682,0,0,1,0,1
86673473,0,1,0,0,1
86765771,1,0,0,0,1
87299861,0,1,0,0,1
86890181,0,1,0,0,1
86905387,0,1,0,0,1
86922832,0,1,0,0,1
86943059,0,1,0,0,1
86986349,0,1,0,0,1
86995535,0,1,0,0,1
87102001,1,0,0,0,1
87107632,1,0,0,0,1
87195500,0,1,0,0,1
87241071,1,0,0,0,1
84386062,1,0,0,0,1
84362159,0,1,0,0,1
84354581,0,1,0,0,1
82596487,0,1,0,0,1
81897295,0,1,0,0,1
81985430,0,1,0,0,1
82031081,0,1,0,0,1
82122629,0,1,0,0,1
82160648,0,1,0,0,1
82165892,0,1,0,0,1
82226899,0,1,0,0,1
82229841,0,1,0,0,1
82249065,0,1,0,0,1
82289882,0,1,0,0,1
82291638,0,0,1,0,1
82295411,0,1,0,0,1
82396376,0,1,0,0,1
82401499,0,1,0,0,1
82406315,1,0,0,0,1
82463462,1,0,0,0,1
82508263,0,1,0,0,1
82508290,0,1,0,0,1
82510486,1,0,0,0,1
82536746,0,1,0,0,1
82537931,0,1,0,0,1
82554640,0,1,0,0,1
82569781,0,1,0,0,1
81835737,0,1,0,0,1
81815821,0,1,0,0,1
81791882,0,1,0,0,1
81513471,0,0,0,1,1
80969776,0,1,0,0,1
81039613,0,1,0,0,1
81044180,1,0,0,0,1
81087250,0,0,0,1,1
81095320,0,1,0,0,1
81099518,0,1,0,0,1
81128061,0,1,0,0,1
81189195,0,1,0,0,1
81402378,0,1,0,0,1
81424447,1,0,0,0,1
81523752,0,1,0,0,1
81787573,1,0,0,0,1
81567834,0,1,0,0,1
81574975,1,0,0,0,1
81582883,0,1,0,0,1
81610046,0,1,0,0,1
81623631,0,1,0,0,1
81632752,0,1,0,0,1
81672762,0,1,0,0,1
81754660,0,1,0,0,1
81765076,0,1,0,0,1
81783500,0,1,0,0,1
82580810,0,1,0,0,1
82597250,0,1,0,0,1
84327729,0,1,0,0,1
82736523,0,0,1,0,1
83638959,1,0,0,0,1
83649148,0,0,1,0,1
83729160,0,1,0,0,1
83786347,0,1,0,0,1
83790477,1,0,0,0,1
83805201,0,1,0,0,1
83906632,0,1,0,0,1
83912394,0,1,0,0,1
83969065,0,1,0,0,1
83991601,0,1,0,0,1
84009375,0,1,0,0,1
84021206,0,1,0,0,1
84022994,1,0,0,0,1
84066414,0,1,0,0,1
84120893,0,1,0,0,1
84151353,0,1,0,0,1
84242258,0,0,1,0,1
84251527,0,1,0,0,1
84276572,1,0,0,0,1
84296381,0,1,0,0,1
84298049,0,1,0,0,1
84299071,0,1,0,0,1
84317780,1,0,0,0,1
83612643,0,1,0,0,1
83567236,0,0,0,1,1
83545495,1,0,0,0,1
83143648,0,1,0,0,1
82754730,0,1,0,0,1
82761210,1,0,0,0,1
82795397,0,1,0,0,1
82802529,0,1,0,0,1
82864350,0,1,0,0,1
82962350,0,1,0,0,1
83005634,0,0,0,1,1
83072954,0,0,1,0,1
83077766,0,1,0,0,1
83132487,1,0,0,0,1
83165162,0,1,0,0,1
83542774,0,1,0,0,1
83194466,0,1,0,0,1
83266737,0,1,0,0,1
83307582,1,0,0,0,1
83319527,0,1,0,0,1
83347439,0,1,0,0,1
83372602,1,0,0,0,1
83380319,0,1,0,0,1
83380760,1,0,0,0,1
83416651,0,1,0,0,1
83425992,0,1,0,0,1
88433309,0,1,0,0,1
88468026,0,1,0,0,1
80956414,0,1,0,0,1
92338232,0,1,0,0,1
92489760,0,1,0,0,1
92494063,0,1,0,0,1
92495927,0,1,0,0,1
92582157,1,0,0,0,1
92625594,0,0,0,1,1
92754318,0,1,0,0,1
92781871,1,0,0,0,1
92791096,1,0,0,0,1
92808302,0,1,0,0,1
92906977,0,1,0,0,1
92937005,0,1,0,0,1
93036577,0,1,0,0,1
93168741,0,1,0,0,1
93223785,0,1,0,0,1
93337925,1,0,0,0,1
93402007,0,1,0,0,1
93428055,0,1,0,0,1
93442923,0,1,0,0,1
93453617,1,0,0,0,1
93670378,0,0,0,1,1
93709130,0,1,0,0,1
93809560,0,1,0,0,1
93814553,0,1,0,0,1
92428811,0,1,0,0,1
92337666,0,1,0,0,1
88569305,0,1,0,0,1
92331168,1,0,0,0,1
91819980,0,1,0,0,1
91825724,0,1,0,0,1
91889391,0,1,0,0,1
91949939,0,1,0,0,1
91967332,0,1,0,0,1
91972040,0,1,0,0,1
92056459,0,1,0,0,1
92069598,0,0,1,0,1
92070182,1,0,0,0,1
92077429,0,1,0,0,1
92079122,1,0,0,0,1
92081454,0,1,0,0,1
92097603,0,1,0,0,1
92127364,0,1,0,0,1
92140315,0,1,0,0,1
92149105,0,1,0,0,1
92178923,0,1,0,0,1
92204682,0,1,0,0,1
92212465,0,1,0,0,1
92234072,0,1,0,0,1
92259244,1,0,0,0,1
92312218,1,0,0,0,1
92328660,0,1,0,0,1
93859563,1,0,0,0,1
93891664,0,0,1,0,1
93927234,0,1,0,0,1
93933550,0,1,0,0,1
94701614,0,1,0,0,1
94711741,0,1,0,0,1
94712057,0,1,0,0,1
94720654,0,1,0,0,1
94743372,0,1,0,0,1
94746121,0,1,0,0,1
94754404,0,0,1,0,1
94771641,1,0,0,0,1
94775908,0,1,0,0,1
94780782,0,1,0,0,1
94782331,0,1,0,0,1
94863500,0,1,0,0,1
94900143,0,1,0,0,1
94900280,0,1,0,0,1
94907375,0,1,0,0,1
94920244,0,1,0,0,1
94983411,0,0,0,1,1
94995566,1,0,0,0,1
95013206,0,1,0,0,1
95013677,0,0,0,1,1
95063967,0,1,0,0,1
95233761,0,0,0,1,1
95273297,0,1,0,0,1
94666050,0,1,0,0,1
94651049,0,1,0,0,1
94638231,0,1,0,0,1
94311718,0,1,0,0,1
94056089,0,1,0,0,1
94090282,0,1,0,0,1
94125598,0,0,1,0,1
94134477,0,1,0,0,1
94174493,0,1,0,0,1
94219760,0,1,0,0,1
94244538,0,1,0,0,1
94294187,0,1,0,0,1
94297983,0,1,0,0,1
94304099,0,1,0,0,1
94324331,0,1,0,0,1
94605949,0,1,0,0,1
94357278,0,1,0,0,1
94371154,0,1,0,0,1
94401193,0,1,0,0,1
94449292,0,1,0,0,1
94475876,1,0,0,0,1
94479434,0,1,0,0,1
94490783,1,0,0,0,1
94530861,0,0,1,0,1
94564535,1,0,0,0,1
94574638,1,0,0,0,1
91806637,1,0,0,0,1
91743065,0,0,0,1,1
91701735,0,1,0,0,1
90078043,1,0,0,0,1
89418864,0,1,0,0,1
89421094,1,0,0,0,1
89425138,0,1,0,0,1
89492112,0,1,0,0,1
89496700,0,1,0,0,1
89514154,0,1,0,0,1
89523636,0,1,0,0,1
89554031,0,1,0,0,1
89584864,0,1,0,0,1
89629964,0,1,0,0,1
89632885,0,1,0,0,1
89689777,0,1,0,0,1
89691874,0,1,0,0,1
89713182,0,1,0,0,1
89730885,0,1,0,0,1
89734590,0,1,0,0,1
89749566,1,0,0,0,1
89766727,0,1,0,0,1
89770205,0,1,0,0,1
89891849,1,0,0,0,1
89901329,1,0,0,0,1
89991475,0,1,0,0,1
90045487,0,1,0,0,1
89404644,0,1,0,0,1
89381794,0,1,0,0,1
89374296,0,1,0,0,1
88894683,0,1,0,0,1
88616587,0,1,0,0,1
88620084,0,1,0,0,1
88626132,0,1,0,0,1
88631766,0,1,0,0,1
88688568,1,0,0,0,1
88727673,0,1,0,0,1
88750139,1,0,0,0,1
88840699,0,1,0,0,1
88864342,0,1,0,0,1
88866732,0,1,0,0,1
88936998,0,0,0,1,1
89326729,0,1,0,0,1
88961920,0,1,0,0,1
89034684,0,1,0,0,1
89088166,0,1,0,0,1
89109298,0,1,0,0,1
89153863,0,1,0,0,1
89174111,0,1,0,0,1
89203052,0,1,0,0,1
89234696,0,1,0,0,1
89276096,0,1,0,0,1
89279651,0,1,0,0,1
90064646,0,1,0,0,1
90078121,0,1,0,0,1
91647723,0,1,0,0,1
90116806,0,1,0,0,1
91058790,0,1,0,0,1
91070048,0,0,1,0,1
91111179,0,1,0,0,1
91173193,0,1,0,0,1
91227441,0,1,0,0,1
91235097,0,1,0,0,1
91265023,0,1,0,0,1
91275133,0,1,0,0,1
91287498,0,0,0,1,1
91302233,0,1,0,0,1
91362202,0,0,1,0,1
91373859,0,1,0,0,1
91381288,0,1,0,0,1
91387432,0,0,0,1,1
91401895,0,1,0,0,1
91407592,0,1,0,0,1
91410785,0,1,0,0,1
91412181,0,1,0,0,1
91495563,0,1,0,0,1
91519966,0,1,0,0,1
91567047,0,1,0,0,1
91589462,0,1,0,0,1
91636556,0,1,0,0,1
91018302,1,0,0,0,1
90997415,0,1,0,0,1
90964240,0,1,0,0,1
90418998,0,1,0,0,1
90130152,0,1,0,0,1
90140234,0,1,0,0,1
90189760,0,1,0,0,1
90201628,0,1,0,0,1
90215547,0,0,1,0,1
90229590,0,1,0,0,1
90266182,0,1,0,0,1
90381147,0,1,0,0,1
90389307,0,1,0,0,1
90392844,1,0,0,0,1
90469604,1,0,0,0,1
90954373,0,1,0,0,1
90561226,0,1,0,0,1
90591438,1,0,0,0,1
90618800,0,1,0,0,1
90622873,1,0,0,0,1
90724590,0,1,0,0,1
90729662,0,1,0,0,1
90758945,0,1,0,0,1
90812944,1,0,0,0,1
90935040,0,1,0,0,1
90951317,0,1,0,0,1
80969766,0,0,0,1,1
80934233,0,1,0,0,1
95343224,0,1,0,0,1
72522293,0,1,0,0,1
72572737,0,1,0,0,1
72619274,0,1,0,0,1
72622403,0,1,0,0,1
72664422,0,1,0,0,1
72710947,0,1,0,0,1
72734641,1,0,0,0,1
72871068,0,1,0,0,1
73019262,0,1,0,0,1
73020847,1,0,0,0,1
73117060,0,1,0,0,1
73120098,0,1,0,0,1
73135907,1,0,0,0,1
73171523,0,1,0,0,1
73227909,0,1,0,0,1
73354326,0,1,0,0,1
73407166,0,1,0,0,1
73414501,0,1,0,0,1
73423118,0,1,0,0,1
73423767,0,1,0,0,1
73447711,0,1,0,0,1
73473840,0,1,0,0,1
73499753,1,0,0,0,1
73504577,0,0,0,1,1
72535697,0,1,0,0,1
72489682,0,1,0,0,1
75072295,0,1,0,0,1
72475426,0,1,0,0,1
71799995,0,1,0,0,1
71837048,0,1,0,0,1
71854768,1,0,0,0,1
71905774,0,1,0,0,1
71910539,1,0,0,0,1
71924446,0,1,0,0,1
71967175,0,1,0,0,1
71967860,0,1,0,0,1
72084823,0,1,0,0,1
72098839,0,1,0,0,1
72105624,0,0,0,1,1
72134237,0,1,0,0,1
72212103,0,1,0,0,1
72257694,0,1,0,0,1
72258220,0,1,0,0,1
72264685,0,1,0,0,1
72267917,0,1,0,0,1
72327315,0,1,0,0,1
72344055,0,1,0,0,1
72344674,0,0,0,1,1
72375067,0,1,0,0,1
72393588,0,1,0,0,1
72446689,0,1,0,0,1
73508425,0,1,0,0,1
73538863,0,1,0,0,1
73597568,0,1,0,0,1
73608541,0,1,0,0,1
74277916,0,1,0,0,1
74280862,0,1,0,0,1
74384094,0,1,0,0,1
74461933,0,1,0,0,1
74465540,0,0,1,0,1
74466126,0,1,0,0,1
74477700,1,0,0,0,1
74620364,0,1,0,0,1
74636607,0,1,0,0,1
74692000,0,1,0,0,1
74732948,0,1,0,0,1
74772621,0,1,0,0,1
74788069,0,1,0,0,1
74791051,0,1,0,0,1
74833453,0,1,0,0,1
74849688,0,1,0,0,1
74908966,0,1,0,0,1
74929586,0,1,0,0,1
74973573,0,1,0,0,1
74992242,0,1,0,0,1
74996671,0,1,0,0,1
75043425,0,1,0,0,1
75062994,0,1,0,0,1
74247064,0,1,0,0,1
74211236,0,1,0,0,1
74177869,0,1,0,0,1
73865215,1,0,0,0,1
73613523,1,0,0,0,1
73620003,0,1,0,0,1
73702672,1,0,0,0,1
73704586,0,1,0,0,1
73743940,0,1,0,0,1
73756583,0,1,0,0,1
73798292,1,0,0,0,1
73817341,0,1,0,0,1
73842695,0,1,0,0,1
73852523,0,1,0,0,1
73871028,0,1,0,0,1
74144130,0,1,0,0,1
73904441,1,0,0,0,1
73981839,0,1,0,0,1
74017335,0,1,0,0,1
74024003,0,1,0,0,1
74087132,0,1,0,0,1
74094787,0,1,0,0,1
74096574,1,0,0,0,1
74117627,0,1,0,0,1
74122488,0,1,0,0,1
74123117,0,1,0,0,1
71761060,0,1,0,0,1
71754340,0,1,0,0,1
71738264,0,0,0,1,1
70134459,1,0,0,0,1
69320935,0,0,1,0,1
69331411,0,1,0,0,1
69347615,1,0,0,0,1
69360421,0,1,0,0,1
69374174,0,1,0,0,1
69442077,0,1,0,0,1
69469074,0,1,0,0,1
69497938,0,1,0,0,1
69525697,0,1,0,0,1
69526711,0,1,0,0,1
69536042,0,1,0,0,1
69562435,0,1,0,0,1
69581148,0,1,0,0,1
69624957,0,1,0,0,1
69650768,0,1,0,0,1
69652467,0,0,0,1,1
69730304,0,0,1,0,1
69796918,0,1,0,0,1
69808438,0,1,0,0,1
69885937,0,1,0,0,1
69905853,0,0,1,0,1
69942212,0,1,0,0,1
70053677,0,1,0,0,1
69261534,1,0,0,0,1
69251239,0,1,0,0,1
69241286,1,0,0,0,1
68688122,0,1,0,0,1
68374542,0,1,0,0,1
68408115,0,1,0,0,1
68443093,0,1,0,0,1
68473090,1,0,0,0,1
68479592,1,0,0,0,1
68513525,0,1,0,0,1
68577152,1,0,0,0,1
68629836,0,1,0,0,1
68659511,0,1,0,0,1
68674749,0,1,0,0,1
68723557,0,1,0,0,1
69179381,0,1,0,0,1
68726759,0,0,0,1,1
68774942,0,1,0,0,1
68777980,0,1,0,0,1
68820198,0,1,0,0,1
68855713,0,1,0,0,1
68991446,1,0,0,0,1
69008841,0,1,0,0,1
69062771,0,1,0,0,1
69101303,0,1,0,0,1
69124283,0,1,0,0,1
70121421,0,1,0,0,1
70172342,0,1,0,0,1
71675383,0,1,0,0,1
70267377,0,1,0,0,1
70987554,0,1,0,0,1
70990633,0,1,0,0,1
70993640,0,1,0,0,1
71002481,0,1,0,0,1
71016010,0,1,0,0,1
71018570,0,1,0,0,1
71039774,0,1,0,0,1
71069753,0,1,0,0,1
71077281,0,0,1,0,1
71083444,0,1,0,0,1
71106254,1,0,0,0,1
71151452,0,1,0,0,1
71159629,1,0,0,0,1
71198807,0,1,0,0,1
71208456,0,1,0,0,1
71230717,0,1,0,0,1
71302263,0,1,0,0,1
71384704,0,1,0,0,1
71473989,0,1,0,0,1
71501347,0,1,0,0,1
71531135,1,0,0,0,1
71616512,0,1,0,0,1
71642639,0,1,0,0,1
70951016,0,1,0,0,1
70924945,0,1,0,0,1
70923547,1,0,0,0,1
70636243,0,1,0,0,1
70275406,0,1,0,0,1
70280790,0,1,0,0,1
70323153,0,1,0,0,1
70351382,0,1,0,0,1
70355674,1,0,0,0,1
70437535,1,0,0,0,1
70466918,0,1,0,0,1
70476200,0,1,0,0,1
70584999,0,1,0,0,1
70617758,0,1,0,0,1
70636670,0,1,0,0,1
70917489,0,0,0,1,1
70663338,0,1,0,0,1
70673267,1,0,0,0,1
70688093,0,0,0,1,1
70756930,1,0,0,0,1
70780573,0,1,0,0,1
70868867,0,1,0,0,1
70885552,0,1,0,0,1
70893904,0,1,0,0,1
70899716,1,0,0,0,1
70915879,0,1,0,0,1
75067369,1,0,0,0,1
75085015,0,1,0,0,1
80856376,1,0,0,0,1
78338060,0,1,0,0,1
78500483,0,1,0,0,1
78538393,1,0,0,0,1
78572595,0,1,0,0,1
78613838,0,0,0,1,1
78617789,0,1,0,0,1
78627903,0,1,0,0,1
78726207,0,1,0,0,1
78729964,1,0,0,0,1
78736760,0,1,0,0,1
78759565,0,1,0,0,1
78865479,0,1,0,0,1
78909374,1,0,0,0,1
78922882,0,1,0,0,1
79003009,0,1,0,0,1
79104959,0,1,0,0,1
79122406,1,0,0,0,1
79139359,0,1,0,0,1
79151761,0,1,0,0,1
79152139,0,1,0,0,1
79155847,0,1,0,0,1
79175176,0,1,0,0,1
79201672,0,1,0,0,1
79226232,0,1,0,0,1
78364507,0,1,0,0,1
78327645,0,1,0,0,1
75094316,0,1,0,0,1
78291079,0,1,0,0,1
77897357,0,1,0,0,1
77915683,0,1,0,0,1
77939847,0,1,0,0,1
77960494,0,1,0,0,1
77972630,0,1,0,0,1
77980183,0,1,0,0,1
77980315,0,1,0,0,1
77982518,0,1,0,0,1
77991720,0,1,0,0,1
77996226,0,1,0,0,1
77998852,1,0,0,0,1
78001877,0,1,0,0,1
78011087,0,1,0,0,1
78018164,1,0,0,0,1
78068372,0,1,0,0,1
78141541,0,1,0,0,1
78189547,1,0,0,0,1
78203905,0,1,0,0,1
78220554,0,1,0,0,1
78257001,0,1,0,0,1
78264316,1,0,0,0,1
78270596,0,1,0,0,1
78286903,0,1,0,0,1
79255048,0,1,0,0,1
79259231,0,1,0,0,1
79260733,0,1,0,0,1
79390949,0,1,0,0,1
80209307,0,0,1,0,1
80258765,1,0,0,0,1
80277568,0,1,0,0,1
80288429,0,1,0,0,1
80316246,1,0,0,0,1
80327790,0,1,0,0,1
80335659,0,1,0,0,1
80374593,0,1,0,0,1
80386915,0,1,0,0,1
80410951,0,1,0,0,1
80415997,0,1,0,0,1
80479781,0,1,0,0,1
80513760,0,1,0,0,1
80566397,0,1,0,0,1
80601341,0,1,0,0,1
80647615,0,1,0,0,1
80660401,0,1,0,0,1
80664701,0,1,0,0,1
80698046,0,1,0,0,1
80761919,1,0,0,0,1
80806206,0,1,0,0,1
80839565,0,1,0,0,1
80851077,1,0,0,0,1
80206349,0,1,0,0,1
80143165,0,1,0,0,1
80141146,0,1,0,0,1
79788586,0,1,0,0,1
79407921,0,1,0,0,1
79413267,0,1,0,0,1
79451279,0,1,0,0,1
79537527,0,0,0,1,1
79696673,0,1,0,0,1
79713976,0,1,0,0,1
79727562,0,1,0,0,1
79748670,0,1,0,0,1
79773639,0,1,0,0,1
79785647,0,1,0,0,1
79791572,0,1,0,0,1
80134378,0,1,0,0,1
79826441,0,0,0,1,1
79911135,0,1,0,0,1
79941708,1,0,0,0,1
79978865,0,1,0,0,1
80029584,0,1,0,0,1
80042362,0,1,0,0,1
80047434,0,1,0,0,1
80053769,1,0,0,0,1
80124239,0,1,0,0,1
80126559,0,1,0,0,1
77882081,0,1,0,0,1
77829444,0,1,0,0,1
77811058,0,1,0,0,1
76086336,0,1,0,0,1
75651408,0,1,0,0,1
75720099,0,1,0,0,1
75756253,1,0,0,0,1
75756291,1,0,0,0,1
75803942,0,1,0,0,1
75808186,0,1,0,0,1
75813236,0,1,0,0,1
75815729,1,0,0,0,1
75831293,0,1,0,0,1
75862834,0,1,0,0,1
75872723,1,0,0,0,1
75896481,0,1,0,0,1
75929422,0,1,0,0,1
75977801,0,1,0,0,1
75978805,0,1,0,0,1
75979672,0,1,0,0,1
75989092,0,0,0,1,1
75991766,0,1,0,0,1
76000182,0,1,0,0,1
76003090,0,1,0,0,1
76022821,0,0,0,1,1
76040186,0,1,0,0,1
76046616,0,1,0,0,1
75643176,0,1,0,0,1
75630518,0,1,0,0,1
75624498,0,1,0,0,1
75402027,1,0,0,0,1
75147136,0,1,0,0,1
75162898,0,1,0,0,1
75233951,0,1,0,0,1
75235195,0,1,0,0,1
75244047,0,1,0,0,1
75270129,1,0,0,0,1
75301845,0,1,0,0,1
75304724,0,1,0,0,1
75311315,1,0,0,0,1
75325644,0,1,0,0,1
75423904,0,1,0,0,1
75620849,1,0,0,0,1
75503562,1,0,0,0,1
75512474,1,0,0,0,1
75521540,0,1,0,0,1
75548233,0,1,0,0,1
75555664,0,1,0,0,1
75559710,0,1,0,0,1
75575621,0,1,0,0,1
75588797,1,0,0,0,1
75589463,0,0,1,0,1
75611918,0,1,0,0,1
76062208,0,1,0,0,1
76118347,1,0,0,0,1
77788936,0,1,0,0,1
76122464,0,1,0,0,1
77014467,0,1,0,0,1
77022529,1,0,0,0,1
77098881,0,1,0,0,1
77137967,1,0,0,0,1
77221466,0,1,0,0,1
77235394,0,1,0,0,1
77254498,1,0,0,0,1
77271044,0,1,0,0,1
77287511,0,1,0,0,1
77294676,0,1,0,0,1
77373417,0,1,0,0,1
77402801,0,1,0,0,1
77443384,0,0,1,0,1
77453740,0,1,0,0,1
77464236,0,1,0,0,1
77475546,0,1,0,0,1
77527136,0,1,0,0,1
77557222,0,1,0,0,1
77670648,0,0,0,1,1
77725521,0,1,0,0,1
77728011,0,1,0,0,1
77766584,0,1,0,0,1
77788517,0,1,0,0,1
76963575,0,1,0,0,1
76945925,0,1,0,0,1
76899453,0,0,1,0,1
76354720,0,1,0,0,1
76166616,0,1,0,0,1
76169009,1,0,0,0,1
76176139,0,1,0,0,1
76203377,0,1,0,0,1
76262752,0,1,0,0,1
76289558,0,1,0,0,1
76293652,0,1,0,0,1
76311005,0,0,0,1,1
76347427,0,1,0,0,1
76349851,1,0,0,0,1
76384339,0,1,0,0,1
76893270,0,1,0,0,1
76403984,0,1,0,0,1
76641627,1,0,0,0,1
76693160,0,1,0,0,1
76728457,0,1,0,0,1
76738781,0,1,0,0,1
76766589,0,1,0,0,1
76776993,0,1,0,0,1
76798300,0,1,0,0,1
76800652,0,1,0,0,1
76851173,0,1,0,0,1
95328958,0,1,0,0,1
95343914,0,1,0,0,1
121940548,0,1,0,0,1
112834740,0,1,0,0,1
112877670,0,1,0,0,1
112930278,0,1,0,0,1
112945596,0,1,0,0,1
112967516,1,0,0,0,1
112987899,0,1,0,0,1
112990729,1,0,0,0,1
113007994,0,1,0,0,1
113008619,0,1,0,0,1
113106271,0,1,0,0,1
113129819,1,0,0,0,1
113222967,0,1,0,0,1
113303931,1,0,0,0,1
113323501,0,1,0,0,1
113328787,1,0,0,0,1
113330262,0,1,0,0,1
113343617,0,1,0,0,1
113381564,0,0,1,0,1
113401290,1,0,0,0,1
113421978,0,1,0,0,1
113469506,0,1,0,0,1
113473775,0,1,0,0,1
113508154,0,1,0,0,1
113527072,0,1,0,0,1
112853261,0,1,0,0,1
112832339,0,1,0,0,1
114801773,1,0,0,0,1
112788455,0,1,0,0,1
112218826,0,1,0,0,1
112226424,0,1,0,0,1
112260777,0,1,0,0,1
112266695,0,1,0,0,1
112277308,0,1,0,0,1
112296207,0,1,0,0,1
112331469,0,1,0,0,1
112348072,0,1,0,0,1
112354863,0,1,0,0,1
112403797,0,1,0,0,1
112414403,0,1,0,0,1
112441516,0,1,0,0,1
112452738,1,0,0,0,1
112461349,0,1,0,0,1
112484525,0,1,0,0,1
112485569,0,0,0,1,1
112509872,0,1,0,0,1
112599346,0,0,0,1,1
112619729,0,1,0,0,1
112657100,0,1,0,0,1
112706790,0,1,0,0,1
112709628,0,0,0,1,1
112764200,1,0,0,0,1
113539502,0,0,0,1,1
113545575,0,1,0,0,1
113617076,0,1,0,0,1
113645880,0,1,0,0,1
114179718,0,1,0,0,1
114206202,0,1,0,0,1
114227598,0,1,0,0,1
114237801,1,0,0,0,1
114343134,0,0,1,0,1
114373275,0,1,0,0,1
114396174,0,1,0,0,1
114405815,1,0,0,0,1
114423236,0,1,0,0,1
114453786,0,0,1,0,1
114486337,0,1,0,0,1
114515908,0,1,0,0,1
114539601,0,1,0,0,1
114553996,1,0,0,0,1
114597372,0,1,0,0,1
114641609,0,1,0,0,1
114645587,0,1,0,0,1
114652277,0,0,0,1,1
114663423,1,0,0,0,1
114716461,1,0,0,0,1
114719312,1,0,0,0,1
114736108,0,1,0,0,1
114740648,0,1,0,0,1
114163082,0,1,0,0,1
114141768,0,0,1,0,1
114128620,1,0,0,0,1
113816960,0,1,0,0,1
113663377,1,0,0,0,1
113666095,1,0,0,0,1
113683718,0,1,0,0,1
113692093,0,1,0,0,1
113692177,0,1,0,0,1
113723157,0,1,0,0,1
113745335,1,0,0,0,1
113783218,0,1,0,0,1
113786557,0,1,0,0,1
113796155,0,1,0,0,1
113834489,1,0,0,0,1
114127411,0,1,0,0,1
113844248,0,1,0,0,1
113863839,0,1,0,0,1
113873024,0,1,0,0,1
113898492,1,0,0,0,1
113949971,0,1,0,0,1
113979042,0,1,0,0,1
113980085,0,1,0,0,1
114072495,1,0,0,0,1
114084421,0,1,0,0,1
114085514,0,1,0,0,1
112073983,0,0,1,0,1
111993069,1,0,0,0,1
111963820,1,0,0,0,1
110278426,0,1,0,0,1
109359747,1,0,0,0,1
109422867,0,1,0,0,1
109482960,0,1,0,0,1
109497166,0,1,0,0,1
109529786,0,1,0,0,1
109536111,0,1,0,0,1
109541550,0,1,0,0,1
109560084,0,1,0,0,1
109584315,0,1,0,0,1
109645871,1,0,0,0,1
109646321,0,1,0,0,1
109646971,0,1,0,0,1
109760393,0,0,0,1,1
109779638,0,1,0,0,1
109798300,1,0,0,0,1
109798326,0,1,0,0,1
109807666,1,0,0,0,1
109853188,0,1,0,0,1
109885579,0,1,0,0,1
109889048,0,1,0,0,1
109955467,0,1,0,0,1
109997406,0,1,0,0,1
110156710,0,1,0,0,1
109263116,0,1,0,0,1
109252028,0,1,0,0,1
109249525,0,1,0,0,1
108872154,0,1,0,0,1
108672269,0,1,0,0,1
108676387,0,1,0,0,1
108710651,0,1,0,0,1
108729059,0,1,0,0,1
108734964,0,1,0,0,1
108803355,0,0,1,0,1
108822145,0,1,0,0,1
108851064,1,0,0,0,1
108855132,0,1,0,0,1
108866382,0,1,0,0,1
108884213,1,0,0,0,1
109238654,0,1,0,0,1
108912248,1,0,0,0,1
108926598,0,1,0,0,1
108972859,0,1,0,0,1
108978475,0,1,0,0,1
108979962,0,1,0,0,1
109009318,0,1,0,0,1
109092941,1,0,0,0,1
109173924,0,1,0,0,1
109205134,0,1,0,0,1
109237222,0,1,0,0,1
110213124,0,1,0,0,1
110304438,0,1,0,0,1
111922973,0,1,0,0,1
110357482,0,1,0,0,1
110973977,0,1,0,0,1
111076143,0,1,0,0,1
111080620,1,0,0,0,1
111099872,0,1,0,0,1
111235322,1,0,0,0,1
111259162,0,1,0,0,1
111277678,0,0,0,1,1
111280826,0,1,0,0,1
111290139,0,1,0,0,1
111292554,0,1,0,0,1
111300039,0,1,0,0,1
111305247,0,1,0,0,1
111319128,0,1,0,0,1
111394815,0,1,0,0,1
111406740,0,1,0,0,1
111570285,0,1,0,0,1
111603357,1,0,0,0,1
111758020,1,0,0,0,1
111818423,0,1,0,0,1
111841506,0,1,0,0,1
111884733,0,1,0,0,1
111903594,0,1,0,0,1
111912425,0,1,0,0,1
110965951,1,0,0,0,1
110960447,0,1,0,0,1
110940178,0,1,0,0,1
110614547,0,1,0,0,1
110361522,0,1,0,0,1
110372659,0,1,0,0,1
110376224,0,1,0,0,1
110382715,0,1,0,0,1
110401449,1,0,0,0,1
110455026,0,0,0,1,1
110541323,1,0,0,0,1
110562940,1,0,0,0,1
110564027,0,1,0,0,1
110577550,0,1,0,0,1
110654085,0,1,0,0,1
110931070,0,1,0,0,1
110672142,1,0,0,0,1
110700381,0,1,0,0,1
110711579,0,0,0,1,1
110760694,0,1,0,0,1
110774602,0,1,0,0,1
110775645,0,1,0,0,1
110788195,0,1,0,0,1
110790607,1,0,0,0,1
110794402,0,1,0,0,1
110841061,0,0,0,1,1
114756224,0,1,0,0,1
114806561,0,1,0,0,1
108571883,0,1,0,0,1
119109005,1,0,0,0,1
119128488,0,1,0,0,1
119258967,0,1,0,0,1
119290982,0,1,0,0,1
119291288,1,0,0,0,1
119360400,0,1,0,0,1
119411796,0,1,0,0,1
119421558,1,0,0,0,1
119463267,0,1,0,0,1
119476959,0,1,0,0,1
119488175,1,0,0,0,1
119529003,0,1,0,0,1
119604663,0,1,0,0,1
119614684,0,1,0,0,1
119663904,0,1,0,0,1
119681137,0,1,0,0,1
119689518,0,1,0,0,1
119725697,0,1,0,0,1
119767049,0,1,0,0,1
119781337,0,1,0,0,1
119799898,0,1,0,0,1
119866844,0,1,0,0,1
119875943,0,1,0,0,1
119983139,0,1,0,0,1
119115852,0,1,0,0,1
119092452,0,1,0,0,1
115007319,0,1,0,0,1
119083792,0,1,0,0,1
118343070,0,1,0,0,1
118363962,1,0,0,0,1
118383850,0,0,0,1,1
118387438,1,0,0,0,1
118409619,0,1,0,0,1
118412129,0,1,0,0,1
118548055,0,1,0,0,1
118573963,0,1,0,0,1
118606886,0,1,0,0,1
118619816,0,1,0,0,1
118648356,0,1,0,0,1
118672262,0,1,0,0,1
118697480,0,1,0,0,1
118716414,1,0,0,0,1
118788479,1,0,0,0,1
118794259,0,0,1,0,1
118841303,0,1,0,0,1
118848256,0,0,1,0,1
118853123,0,1,0,0,1
118923484,0,1,0,0,1
118954303,0,1,0,0,1
118968740,0,1,0,0,1
118976253,0,1,0,0,1
120040211,0,0,0,1,1
120076016,1,0,0,0,1
120097919,0,1,0,0,1
120099843,0,1,0,0,1
121323967,0,1,0,0,1
121341168,0,1,0,0,1
121343502,0,1,0,0,1
121380391,0,1,0,0,1
121425243,0,0,0,1,1
121474549,1,0,0,0,1
121596770,0,1,0,0,1
121613028,0,1,0,0,1
121623125,0,1,0,0,1
121626795,0,1,0,0,1
121655640,0,1,0,0,1
121688973,0,1,0,0,1
121706561,0,1,0,0,1
121712728,0,1,0,0,1
121720847,0,1,0,0,1
121744693,0,1,0,0,1
121784526,0,1,0,0,1
121800066,0,0,1,0,1
121837378,0,1,0,0,1
121858095,0,1,0,0,1
121882401,0,1,0,0,1
121926224,0,1,0,0,1
121932578,0,1,0,0,1
121312056,0,1,0,0,1
121247673,0,1,0,0,1
121131345,0,1,0,0,1
120674657,0,1,0,0,1
120173004,0,1,0,0,1
120200013,0,1,0,0,1
120208602,0,1,0,0,1
120217992,0,1,0,0,1
120293772,0,1,0,0,1
120313351,0,0,0,1,1
120347538,0,1,0,0,1
120432102,0,1,0,0,1
120620640,0,1,0,0,1
120654358,0,1,0,0,1
120677954,1,0,0,0,1
121110181,1,0,0,0,1
120708944,0,1,0,0,1
120732742,0,1,0,0,1
120761472,0,1,0,0,1
120817754,0,1,0,0,1
120864602,0,1,0,0,1
120886557,0,1,0,0,1
120912023,0,1,0,0,1
120982518,0,1,0,0,1
121068543,0,0,0,1,1
121095902,0,1,0,0,1
118322771,0,0,0,1,1
118316297,1,0,0,0,1
118305805,0,1,0,0,1
116526848,1,0,0,0,1
115644795,0,1,0,0,1
115671825,0,1,0,0,1
115688059,0,1,0,0,1
115712272,0,0,0,1,1
115724102,0,1,0,0,1
115735112,0,1,0,0,1
115838163,0,1,0,0,1
115883210,0,1,0,0,1
115898895,0,1,0,0,1
115925451,1,0,0,0,1
115993637,0,1,0,0,1
116108738,0,1,0,0,1
116128692,0,1,0,0,1
116201536,0,1,0,0,1
116219246,0,1,0,0,1
116225917,0,1,0,0,1
116238955,0,1,0,0,1
116301504,0,1,0,0,1
116349096,1,0,0,0,1
116411993,0,1,0,0,1
116429818,1,0,0,0,1
116436588,0,1,0,0,1
116441082,0,1,0,0,1
115640466,1,0,0,0,1
115617632,0,1,0,0,1
115615350,0,1,0,0,1
115289758,0,1,0,0,1
115042743,1,0,0,0,1
115062715,0,1,0,0,1
115092035,0,1,0,0,1
115092998,0,1,0,0,1
115102164,0,1,0,0,1
115175546,0,1,0,0,1
115200602,0,1,0,0,1
115232840,0,1,0,0,1
115267161,1,0,0,0,1
115281619,0,1,0,0,1
115304914,0,1,0,0,1
115543145,1,0,0,0,1
115311408,0,1,0,0,1
115314818,0,1,0,0,1
115318618,0,1,0,0,1
115330659,0,1,0,0,1
115334548,0,1,0,0,1
115353871,0,1,0,0,1
115378843,0,1,0,0,1
115424840,0,1,0,0,1
115481066,0,1,0,0,1
115524404,0,1,0,0,1
116451098,0,1,0,0,1
116542112,0,1,0,0,1
118272507,0,1,0,0,1
116546072,1,0,0,0,1
117579935,0,1,0,0,1
117581438,0,1,0,0,1
117589245,0,1,0,0,1
117607618,0,1,0,0,1
117636793,0,1,0,0,1
117707519,0,1,0,0,1
117759023,0,1,0,0,1
117765565,0,1,0,0,1
117772607,0,1,0,0,1
117816558,0,1,0,0,1
117855675,0,1,0,0,1
117968618,0,0,0,1,1
117972117,0,1,0,0,1
117974424,1,0,0,0,1
118050392,1,0,0,0,1
118097149,0,0,0,1,1
118120792,0,1,0,0,1
118156990,0,1,0,0,1
118182690,0,1,0,0,1
118184874,0,1,0,0,1
118235819,0,1,0,0,1
118248039,0,0,0,1,1
118266819,0,0,0,1,1
117572991,0,1,0,0,1
117558789,1,0,0,0,1
117556066,0,1,0,0,1
117094663,0,1,0,0,1
116626219,0,1,0,0,1
116731902,0,1,0,0,1
116736779,0,1,0,0,1
116757354,0,1,0,0,1
116790990,0,0,0,1,1
116813717,0,1,0,0,1
116973162,1,0,0,0,1
117014465,0,1,0,0,1
117039978,0,1,0,0,1
117082732,1,0,0,0,1
117111677,0,1,0,0,1
117546401,0,1,0,0,1
117113707,0,1,0,0,1
117229954,0,1,0,0,1
117293062,0,1,0,0,1
117334686,1,0,0,0,1
117348988,0,1,0,0,1
117353433,0,1,0,0,1
117357722,1,0,0,0,1
117381644,0,1,0,0,1
117406047,1,0,0,0,1
117501440,1,0,0,0,1
108618593,0,1,0,0,1
108555285,1,0,0,0,1
95359845,0,1,0,0,1
99872786,0,1,0,0,1
99889745,0,1,0,0,1
99906184,0,0,0,1,1
99915852,0,1,0,0,1
99944372,0,1,0,0,1
99950475,0,1,0,0,1
99958721,0,1,0,0,1
100111175,0,1,0,0,1
100146454,0,1,0,0,1
100146627,1,0,0,0,1
100177038,1,0,0,0,1
100190609,1,0,0,0,1
100193675,0,1,0,0,1
100196428,0,1,0,0,1
100197741,0,0,0,1,1
100215015,0,1,0,0,1
100219442,0,0,0,1,1
100227548,0,1,0,0,1
100249934,0,1,0,0,1
100270731,1,0,0,0,1
100272817,0,1,0,0,1
100330475,0,1,0,0,1
100334279,0,1,0,0,1
100437782,0,1,0,0,1
99881762,0,1,0,0,1
99863005,0,1,0,0,1
102032290,0,1,0,0,1
99851779,0,1,0,0,1
99045069,0,1,0,0,1
99058050,0,1,0,0,1
99058208,0,1,0,0,1
99084861,0,1,0,0,1
99086843,0,1,0,0,1
99123648,0,1,0,0,1
99149977,0,1,0,0,1
99152720,0,1,0,0,1
99211020,0,1,0,0,1
99216621,0,1,0,0,1
99280520,0,1,0,0,1
99314589,0,1,0,0,1
99320073,0,1,0,0,1
99336573,0,1,0,0,1
99391748,0,1,0,0,1
99453991,0,1,0,0,1
99480074,0,1,0,0,1
99574814,0,1,0,0,1
99580901,0,1,0,0,1
99642858,0,1,0,0,1
99718143,0,1,0,0,1
99726513,1,0,0,0,1
99775649,0,1,0,0,1
100450919,1,0,0,0,1
100454553,1,0,0,0,1
100474364,1,0,0,0,1
100481551,0,1,0,0,1
101431855,0,1,0,0,1
101466318,0,1,0,0,1
101486624,0,1,0,0,1
101493122,0,1,0,0,1
101515100,0,1,0,0,1
101528620,0,1,0,0,1
101571726,0,1,0,0,1
101582462,0,1,0,0,1
101655614,0,1,0,0,1
101695974,0,1,0,0,1
101715057,0,1,0,0,1
101723708,1,0,0,0,1
101736272,0,1,0,0,1
101746041,1,0,0,0,1
101769370,0,1,0,0,1
101808867,0,1,0,0,1
101819827,0,1,0,0,1
101889708,0,1,0,0,1
101963422,0,1,0,0,1
101963990,1,0,0,0,1
101980274,0,1,0,0,1
101991328,0,1,0,0,1
102005157,0,1,0,0,1
101404234,0,1,0,0,1
101401070,0,1,0,0,1
101398790,0,1,0,0,1
100837760,0,1,0,0,1
100487712,0,0,0,1,1
100518857,0,1,0,0,1
100576762,0,1,0,0,1
100584893,1,0,0,0,1
100699279,0,1,0,0,1
100699293,0,1,0,0,1
100734346,0,1,0,0,1
100772286,1,0,0,0,1
100777667,0,1,0,0,1
100815308,0,1,0,0,1
100941307,0,1,0,0,1
101377184,0,1,0,0,1
100967336,0,1,0,0,1
101007407,0,1,0,0,1
101037742,0,1,0,0,1
101049138,0,1,0,0,1
101060235,0,1,0,0,1
101162171,0,1,0,0,1
101184249,0,1,0,0,1
101232688,0,1,0,0,1
101260615,0,1,0,0,1
101297431,0,1,0,0,1
98988115,0,1,0,0,1
98986981,0,1,0,0,1
98951170,0,1,0,0,1
96927772,0,1,0,0,1
96186964,0,1,0,0,1
96264036,0,1,0,0,1
96306802,1,0,0,0,1
96325100,1,0,0,0,1
96329672,0,1,0,0,1
96331433,0,1,0,0,1
96338535,0,1,0,0,1
96370583,0,1,0,0,1
96373793,0,1,0,0,1
96381625,0,1,0,0,1
96395029,0,1,0,0,1
96515533,1,0,0,0,1
96568180,0,1,0,0,1
96569219,0,1,0,0,1
96576495,0,1,0,0,1
96608454,0,1,0,0,1
96610795,0,1,0,0,1
96629338,0,1,0,0,1
96723827,0,1,0,0,1
96732881,0,1,0,0,1
96735798,0,1,0,0,1
96764193,1,0,0,0,1
96858637,0,1,0,0,1
96175094,0,1,0,0,1
96124271,0,1,0,0,1
96121744,0,1,0,0,1
95693952,0,1,0,0,1
95404309,0,1,0,0,1
95420785,0,1,0,0,1
95455218,0,1,0,0,1
95484032,0,1,0,0,1
95487937,0,1,0,0,1
95506280,0,1,0,0,1
95525309,0,1,0,0,1
95624653,0,1,0,0,1
95648025,0,1,0,0,1
95684088,0,0,0,1,1
95709558,0,1,0,0,1
96091391,0,1,0,0,1
95711283,1,0,0,0,1
95714609,0,1,0,0,1
95722681,0,1,0,0,1
95766810,0,1,0,0,1
95832868,0,1,0,0,1
95917642,0,1,0,0,1
95970639,0,1,0,0,1
95989802,0,1,0,0,1
96042723,0,1,0,0,1
96080864,0,1,0,0,1
96883732,0,1,0,0,1
96949139,0,1,0,0,1
98946119,0,1,0,0,1
96949319,0,1,0,0,1
98093631,0,1,0,0,1
98125947,0,1,0,0,1
98141700,1,0,0,0,1
98183599,0,1,0,0,1
98262703,0,1,0,0,1
98323712,0,1,0,0,1
98410465,0,1,0,0,1
98499700,0,1,0,0,1
98516074,0,1,0,0,1
98530531,0,1,0,0,1
98561597,0,1,0,0,1
98569914,0,1,0,0,1
98600829,0,1,0,0,1
98605924,0,1,0,0,1
98622782,0,1,0,0,1
98643022,0,1,0,0,1
98692757,0,1,0,0,1
98731504,0,1,0,0,1
98841396,0,1,0,0,1
98857314,1,0,0,0,1
98886662,0,1,0,0,1
98916203,0,1,0,0,1
98936604,0,1,0,0,1
98052221,0,1,0,0,1
98024125,0,1,0,0,1
97992197,0,1,0,0,1
97396504,0,1,0,0,1
97054224,1,0,0,0,1
97067282,0,1,0,0,1
97071813,0,1,0,0,1
97194841,0,1,0,0,1
97220386,0,1,0,0,1
97265871,0,1,0,0,1
97277531,0,1,0,0,1
97372193,0,0,1,0,1
97382927,0,1,0,0,1
97395496,1,0,0,0,1
97412451,0,1,0,0,1
97953438,0,0,0,1,1
97428500,1,0,0,0,1
97435195,0,1,0,0,1
97467241,1,0,0,0,1
97597668,0,1,0,0,1
97637025,0,1,0,0,1
97644544,0,1,0,0,1
97661497,1,0,0,0,1
97717985,0,1,0,0,1
97838133,1,0,0,0,1
97838640,0,1,0,0,1
102030250,0,1,0,0,1
102036670,0,1,0,0,1
108516518,0,1,0,0,1
106196890,1,0,0,0,1
106212390,0,0,1,0,1
106216257,0,1,0,0,1
106246833,0,1,0,0,1
106331667,1,0,0,0,1
106344720,0,1,0,0,1
106355106,0,1,0,0,1
106364433,0,1,0,0,1
106371668,0,0,1,0,1
106379935,0,1,0,0,1
106460489,0,1,0,0,1
106541612,0,1,0,0,1
106597990,0,0,1,0,1
106679202,0,1,0,0,1
106684952,0,0,0,1,1
106687417,1,0,0,0,1
106701083,1,0,0,0,1
106705968,0,1,0,0,1
106712313,0,1,0,0,1
106715604,1,0,0,0,1
106724705,0,1,0,0,1
106725571,0,1,0,0,1
106734442,0,0,0,1,1
106761614,1,0,0,0,1
106201725,0,1,0,0,1
106172542,1,0,0,0,1
102046942,0,1,0,0,1
106145583,0,1,0,0,1
105111646,0,1,0,0,1
105160063,0,1,0,0,1
105160303,0,1,0,0,1
105189186,0,1,0,0,1
105203658,0,1,0,0,1
105397850,1,0,0,0,1
105409353,0,1,0,0,1
105423146,1,0,0,0,1
105495447,0,1,0,0,1
105524552,0,1,0,0,1
105547960,0,1,0,0,1
105617611,0,1,0,0,1
105647145,0,1,0,0,1
105687653,1,0,0,0,1
105786034,0,1,0,0,1
105825321,0,1,0,0,1
105843121,0,1,0,0,1
105955076,0,1,0,0,1
105989350,0,0,1,0,1
105994478,0,1,0,0,1
106054068,0,1,0,0,1
106069848,0,1,0,0,1
106092407,0,1,0,0,1
106959301,0,1,0,0,1
106965378,1,0,0,0,1
106983586,0,1,0,0,1
106983960,0,1,0,0,1
107754833,0,1,0,0,1
107765797,0,1,0,0,1
107771100,0,1,0,0,1
107821564,0,1,0,0,1
107829521,0,1,0,0,1
107925533,0,0,1,0,1
107950821,1,0,0,0,1
107961628,0,1,0,0,1
107980774,0,1,0,0,1
108006063,0,1,0,0,1
108011059,1,0,0,0,1
108040146,1,0,0,0,1
108113052,0,1,0,0,1
108115046,0,1,0,0,1
108137794,1,0,0,0,1
108153550,0,1,0,0,1
108237667,0,1,0,0,1
108250247,0,1,0,0,1
108264490,0,1,0,0,1
108315052,0,1,0,0,1
108433648,0,1,0,0,1
108440105,0,1,0,0,1
108478671,1,0,0,0,1
107746083,0,1,0,0,1
107713244,0,0,0,1,1
107698905,0,1,0,0,1
107407835,0,1,0,0,1
106988600,0,1,0,0,1
106993974,0,1,0,0,1
107024927,0,1,0,0,1
107101952,0,1,0,0,1
107178199,0,1,0,0,1
107206108,0,0,1,0,1
107217696,0,1,0,0,1
107300289,0,1,0,0,1
107325537,0,1,0,0,1
107346759,0,1,0,0,1
107458635,0,1,0,0,1
107695848,0,1,0,0,1
107459088,1,0,0,0,1
107536871,0,1,0,0,1
107536882,0,1,0,0,1
107542814,0,1,0,0,1
107563743,1,0,0,0,1
107633113,0,1,0,0,1
107633776,0,1,0,0,1
107661203,0,1,0,0,1
107666012,0,1,0,0,1
107674943,0,1,0,0,1
105105906,0,1,0,0,1
105099077,0,1,0,0,1
105076384,0,1,0,0,1
103290156,1,0,0,0,1
102700306,0,1,0,0,1
102724407,0,1,0,0,1
102727978,0,1,0,0,1
102739480,0,1,0,0,1
102757230,0,1,0,0,1
102767142,0,1,0,0,1
102769345,1,0,0,0,1
102894829,1,0,0,0,1
102942387,0,0,1,0,1
102948877,0,1,0,0,1
102958652,0,1,0,0,1
102966407,1,0,0,0,1
102968278,0,1,0,0,1
102970708,0,0,0,1,1
102973770,0,1,0,0,1
102982653,0,1,0,0,1
103184127,0,1,0,0,1
103210804,0,1,0,0,1
103231091,0,1,0,0,1
103242520,0,1,0,0,1
103252875,0,1,0,0,1
103262306,0,1,0,0,1
103271345,1,0,0,0,1
102689517,0,1,0,0,1
102656769,0,1,0,0,1
102626298,0,1,0,0,1
102318556,0,1,0,0,1
102107192,0,1,0,0,1
102128926,1,0,0,0,1
102158128,0,1,0,0,1
102158193,0,1,0,0,1
102167938,0,1,0,0,1
102170818,0,1,0,0,1
102226802,0,0,1,0,1
102288019,0,1,0,0,1
102302604,0,0,1,0,1
102313420,0,1,0,0,1
102349974,0,0,0,1,1
102601663,0,1,0,0,1
102350655,0,1,0,0,1
102352297,1,0,0,0,1
102353662,0,1,0,0,1
102371170,0,1,0,0,1
102430791,1,0,0,0,1
102433630,0,1,0,0,1
102446928,0,1,0,0,1
102539102,0,1,0,0,1
102558898,0,1,0,0,1
102594136,0,0,0,1,1
103287854,0,1,0,0,1
103303685,1,0,0,0,1
105074462,1,0,0,0,1
103351214,0,1,0,0,1
104279571,0,1,0,0,1
104283875,0,1,0,0,1
104324598,0,1,0,0,1
104398034,1,0,0,0,1
104412853,1,0,0,0,1
104421613,0,1,0,0,1
104445344,0,1,0,0,1
104529625,0,1,0,0,1
104557686,0,1,0,0,1
104631223,0,0,1,0,1
104666688,0,1,0,0,1
104692585,0,1,0,0,1
104709864,0,1,0,0,1
104761688,0,1,0,0,1
104762048,0,1,0,0,1
104790454,0,1,0,0,1
104863325,0,1,0,0,1
104880011,0,1,0,0,1
104891204,0,1,0,0,1
104901592,0,1,0,0,1
104902655,0,1,0,0,1
104908667,0,1,0,0,1
105060678,0,1,0,0,1
104278607,0,0,1,0,1
104246773,0,1,0,0,1
104213424,0,1,0,0,1
103795395,0,1,0,0,1
103364978,0,1,0,0,1
103454568,1,0,0,0,1
103504279,0,1,0,0,1
103516223,0,1,0,0,1
103570264,0,1,0,0,1
103606843,0,1,0,0,1
103680159,0,1,0,0,1
103684273,0,1,0,0,1
103700891,0,1,0,0,1
103730903,0,1,0,0,1
103799502,0,1,0,0,1
104200854,0,1,0,0,1
103860070,0,1,0,0,1
103860738,1,0,0,0,1
103882208,0,1,0,0,1
103925679,1,0,0,0,1
103990842,0,1,0,0,1
104024701,0,1,0,0,1
104080919,0,1,0,0,1
104092221,1,0,0,0,1
104148129,0,1,0,0,1
104154949,1,0,0,0,1
532447248,0,1,0,0,1
532541352,0,0,0,1,1
4144720601,1,0,0,0,1
2662973791,0,1,0,0,1
2663485541,0,1,0,0,1
2663564862,0,1,0,0,1
2663984318,0,1,0,0,1
2664069967,1,0,0,0,1
2664240026,0,1,0,0,1
2664297194,1,0,0,0,1
2664830498,0,1,0,0,1
2665059555,0,1,0,0,1
2665396956,1,0,0,0,1
2665624309,0,1,0,0,1
2665699111,0,1,0,0,1
2666918082,0,1,0,0,1
2666948378,0,1,0,0,1
2667821193,0,1,0,0,1
2668034437,0,1,0,0,1
2668591131,0,1,0,0,1
2668870896,0,1,0,0,1
2669110378,0,1,0,0,1
2669379211,1,0,0,0,1
2670627368,0,1,0,0,1
2670663980,0,1,0,0,1
2670851674,0,1,0,0,1
2671861926,0,1,0,0,1
2663177558,1,0,0,0,1
2662850648,0,1,0,0,1
2655268552,1,0,0,0,1
2662706850,0,1,0,0,1
2656043916,0,1,0,0,1
2656530374,0,1,0,0,1
2656534602,1,0,0,0,1
2656818688,0,1,0,0,1
2656885860,0,1,0,0,1
2657018268,0,1,0,0,1
2657281706,0,1,0,0,1
2657763802,0,1,0,0,1
2658315128,0,1,0,0,1
2658525184,0,0,0,1,1
2658984031,0,1,0,0,1
2659247615,0,1,0,0,1
2659280730,0,1,0,0,1
2659333482,1,0,0,0,1
2659615770,1,0,0,0,1
2660662741,1,0,0,0,1
2660959205,0,1,0,0,1
2661046394,0,1,0,0,1
2661108945,1,0,0,0,1
2661296189,0,1,0,0,1
2661602502,1,0,0,0,1
2661628425,0,1,0,0,1
2661956287,0,0,0,1,1
2672123482,0,1,0,0,1
2672761181,1,0,0,0,1
2672941536,0,1,0,0,1
2673148178,0,1,0,0,1
2682217787,0,1,0,0,1
2682576448,0,1,0,0,1
2682610116,0,1,0,0,1
2682707190,0,1,0,0,1
2682726096,0,1,0,0,1
2682916121,0,1,0,0,1
2682960126,1,0,0,0,1
2683019506,0,1,0,0,1
2683192456,0,1,0,0,1
2684068090,0,1,0,0,1
2684460326,0,1,0,0,1
2684751818,1,0,0,0,1
2685278791,0,1,0,0,1
2685358045,0,1,0,0,1
2685429541,0,1,0,0,1
2685668448,0,0,1,0,1
2686007456,0,1,0,0,1
2686392594,0,1,0,0,1
2686491681,0,1,0,0,1
2686836109,1,0,0,0,1
2686880442,0,1,0,0,1
2686949653,0,1,0,0,1
2687370216,0,1,0,0,1
2682204937,0,1,0,0,1
2681750120,0,1,0,0,1
2681647628,0,1,0,0,1
2676812355,1,0,0,0,1
2674504934,0,1,0,0,1
2674614242,0,1,0,0,1
2674852447,0,1,0,0,1
2675223410,0,1,0,0,1
2675299839,0,1,0,0,1
2675720175,0,1,0,0,1
2675895195,0,1,0,0,1
2676373520,1,0,0,0,1
2676381692,0,1,0,0,1
2676799425,0,1,0,0,1
2676887238,1,0,0,0,1
2681266800,0,1,0,0,1
2676999241,0,1,0,0,1
2677115939,0,1,0,0,1
2678093280,1,0,0,0,1
2678475538,0,1,0,0,1
2678632959,0,1,0,0,1
2679700688,0,0,0,1,1
2679906612,1,0,0,0,1
2680308494,0,1,0,0,1
2680510714,0,1,0,0,1
2680925902,0,1,0,0,1
2655862562,0,1,0,0,1
2654761532,0,1,0,0,1
2531912532,1,0,0,0,1
2624190707,0,1,0,0,1
2628002973,0,1,0,0,1
2628027381,0,1,0,0,1
2628041741,0,1,0,0,1
2628892311,1,0,0,0,1
2628968824,0,1,0,0,1
2630654572,0,1,0,0,1
2630699435,1,0,0,0,1
2630893781,0,1,0,0,1
2631054142,0,1,0,0,1
2631114550,0,1,0,0,1
2631362338,0,1,0,0,1
2632610949,1,0,0,0,1
2632744456,0,1,0,0,1
2632956459,0,1,0,0,1
2633890422,0,1,0,0,1
2634666340,0,1,0,0,1
2635158856,0,1,0,0,1
2635279042,1,0,0,0,1
2635552693,0,0,0,1,1
2635825784,0,1,0,0,1
2637379192,0,1,0,0,1
2637575229,0,1,0,0,1
2637902301,0,1,0,0,1
2626448180,0,1,0,0,1
2623907871,0,1,0,0,1
2654490394,0,1,0,0,1
2623765905,0,1,0,0,1
2615849774,0,1,0,0,1
2616027422,0,1,0,0,1
2616299979,0,1,0,0,1
2616451129,0,1,0,0,1
2616603539,0,1,0,0,1
2617118672,0,1,0,0,1
2617242940,0,1,0,0,1
2617447717,0,1,0,0,1
2617781540,1,0,0,0,1
2618043851,0,1,0,0,1
2618338168,0,1,0,0,1
2618589655,0,1,0,0,1
2618845746,1,0,0,0,1
2619940126,0,1,0,0,1
2620042730,0,1,0,0,1
2620457801,0,1,0,0,1
2620554988,1,0,0,0,1
2620667924,0,1,0,0,1
2620715904,0,0,0,1,1
2621418480,0,1,0,0,1
2621532441,0,1,0,0,1
2622147148,0,1,0,0,1
2623434011,0,1,0,0,1
2638413803,0,1,0,0,1
2638466972,0,1,0,0,1
2638677952,0,0,1,0,1
2639991843,0,1,0,0,1
2649164186,0,1,0,0,1
2649346927,1,0,0,0,1
2649469216,1,0,0,0,1
2649730687,1,0,0,0,1
2649883955,0,1,0,0,1
2649962229,0,1,0,0,1
2650134840,0,1,0,0,1
2650274320,1,0,0,0,1
2650277041,1,0,0,0,1
2650383851,0,1,0,0,1
2650597416,0,1,0,0,1
2650837621,0,1,0,0,1
2650860005,0,1,0,0,1
2651258022,0,1,0,0,1
2651482038,0,1,0,0,1
2651946378,0,1,0,0,1
2652688818,1,0,0,0,1
2653016426,0,1,0,0,1
2653320247,0,1,0,0,1
2653504320,0,1,0,0,1
2653857800,0,0,0,1,1
2653960925,0,1,0,0,1
2653966371,0,1,0,0,1
2649129314,1,0,0,0,1
2648649574,0,1,0,0,1
2648086012,0,0,0,1,1
2644913928,0,1,0,0,1
2640269117,0,1,0,0,1
2640351381,0,1,0,0,1
2640460031,0,1,0,0,1
2640618115,0,1,0,0,1
2640728733,0,1,0,0,1
2640757351,0,1,0,0,1
2641965262,1,0,0,0,1
2643974890,0,1,0,0,1
2644192050,0,1,0,0,1
2644790171,0,1,0,0,1
2645357155,0,1,0,0,1
2647580905,1,0,0,0,1
2645488683,0,1,0,0,1
2645983362,1,0,0,0,1
2646166195,1,0,0,0,1
2646566078,0,1,0,0,1
2646600285,1,0,0,0,1
2646917971,1,0,0,0,1
2647112635,1,0,0,0,1
2647306188,0,1,0,0,1
2647310371,0,1,0,0,1
2647388976,0,1,0,0,1
2688706544,0,1,0,0,1
2689096890,0,1,0,0,1
2689102579,1,0,0,0,1
2722413266,1,0,0,0,1
2722830280,0,0,0,1,1
2723185873,0,1,0,0,1
2723211992,1,0,0,0,1
2723248551,0,0,0,1,1
2723441631,0,1,0,0,1
2723888811,0,1,0,0,1
2723900121,0,1,0,0,1
2724036111,0,1,0,0,1
2724149592,0,1,0,0,1
2724285841,0,1,0,0,1
2724479217,0,1,0,0,1
2724602010,0,1,0,0,1
2724633945,0,1,0,0,1
2724999670,0,1,0,0,1
2725045521,0,1,0,0,1
2725206249,1,0,0,0,1
2725211327,0,0,0,1,1
2725271517,0,1,0,0,1
2725407796,0,1,0,0,1
2725409757,1,0,0,0,1
2725701929,0,1,0,0,1
2725702508,0,1,0,0,1
2725956281,0,1,0,0,1
2722553930,0,1,0,0,1
2722136407,0,1,0,0,1
2689631780,0,1,0,0,1
2721878217,0,1,0,0,1
2717735699,0,1,0,0,1
2717935924,0,1,0,0,1
2718443368,0,1,0,0,1
2718492904,0,1,0,0,1
2718650871,0,1,0,0,1
2718879327,0,1,0,0,1
2718966222,0,1,0,0,1
2719335776,0,1,0,0,1
2719487870,0,1,0,0,1
2719517816,0,1,0,0,1
2719793368,0,1,0,0,1
2720049279,0,1,0,0,1
2720427742,0,1,0,0,1
2720443954,0,1,0,0,1
2720468176,0,1,0,0,1
2720491579,0,1,0,0,1
2720509305,0,1,0,0,1
2720685801,1,0,0,0,1
2720742831,0,1,0,0,1
2720913784,0,1,0,0,1
2721410838,0,1,0,0,1
2721759729,0,1,0,0,1
2721821405,1,0,0,0,1
2726065834,0,1,0,0,1
2726232719,0,1,0,0,1
2727305971,0,1,0,0,1
2727576837,0,1,0,0,1
2732184839,0,1,0,0,1
2732191635,0,1,0,0,1
2732370615,0,1,0,0,1
2732558449,0,1,0,0,1
2732610682,1,0,0,0,1
2732623797,0,1,0,0,1
2732751986,0,1,0,0,1
2733474617,1,0,0,0,1
2733639405,0,1,0,0,1
2733641424,0,1,0,0,1
2733648128,0,0,0,1,1
2733680853,1,0,0,0,1
2733720113,0,1,0,0,1
2734001194,0,1,0,0,1
2734060703,1,0,0,0,1
2734220318,0,1,0,0,1
2734411682,0,1,0,0,1
2734412365,1,0,0,0,1
2734417966,0,0,1,0,1
2734440741,0,1,0,0,1
2734454972,0,1,0,0,1
2734606141,0,1,0,0,1
2734653056,0,1,0,0,1
2732174785,1,0,0,0,1
2732061566,0,1,0,0,1
2732002565,0,1,0,0,1
2730676118,0,1,0,0,1
2728118754,0,1,0,0,1
2728313403,1,0,0,0,1
2728670977,0,1,0,0,1
2728871011,0,1,0,0,1
2729234229,0,1,0,0,1
2729245351,0,1,0,0,1
2729636523,0,1,0,0,1
2730462763,0,1,0,0,1
2730605314,1,0,0,0,1
2730670539,0,1,0,0,1
2730678400,0,1,0,0,1
2731970429,0,1,0,0,1
2730699849,0,1,0,0,1
2730815519,0,1,0,0,1
2730875151,0,1,0,0,1
2730888416,0,1,0,0,1
2731164801,0,1,0,0,1
2731242290,0,1,0,0,1
2731506262,1,0,0,0,1
2731702287,0,1,0,0,1
2731724031,0,1,0,0,1
2731882960,0,1,0,0,1
2717667046,0,1,0,0,1
2717664796,0,1,0,0,1
2717625146,0,1,0,0,1
2703045629,0,1,0,0,1
2695985232,0,1,0,0,1
2696289582,0,1,0,0,1
2696362436,0,1,0,0,1
2696569885,0,0,0,1,1
2696968765,0,1,0,0,1
2697002040,0,1,0,0,1
2697323343,0,1,0,0,1
2697635241,0,1,0,0,1
2697680952,0,1,0,0,1
2697682356,0,1,0,0,1
2697795660,1,0,0,0,1
2697987461,1,0,0,0,1
2698234600,0,1,0,0,1
2698456240,0,1,0,0,1
2698474748,0,1,0,0,1
2698945591,0,1,0,0,1
2700164311,0,1,0,0,1
2700452618,0,0,0,1,1
2700599192,1,0,0,0,1
2700923526,1,0,0,0,1
2701205484,0,1,0,0,1
2701586504,0,1,0,0,1
2702051917,0,1,0,0,1
2695892575,0,1,0,0,1
2695887009,0,1,0,0,1
2695679383,0,1,0,0,1
2692373729,0,1,0,0,1
2689900176,0,1,0,0,1
2690514504,0,1,0,0,1
2690658711,0,1,0,0,1
2690702964,0,1,0,0,1
2690956867,0,1,0,0,1
2691362874,0,1,0,0,1
2691557465,0,1,0,0,1
2691675349,0,1,0,0,1
2691775101,0,1,0,0,1
2692107152,0,1,0,0,1
2692415468,0,0,1,0,1
2695381315,1,0,0,0,1
2692787404,0,0,1,0,1
2692944263,0,1,0,0,1
2692977458,1,0,0,0,1
2693016583,0,0,0,1,1
2693028116,0,1,0,0,1
2693896519,0,1,0,0,1
2693996210,0,1,0,0,1
2694130448,0,1,0,0,1
2695311941,0,1,0,0,1
2695374849,1,0,0,0,1
2702091770,0,1,0,0,1
2703111597,0,1,0,0,1
2717573218,0,1,0,0,1
2703407290,0,1,0,0,1
2712584533,0,1,0,0,1
2712630406,1,0,0,0,1
2712702593,1,0,0,0,1
2712922415,0,1,0,0,1
2712980482,0,1,0,0,1
2713041584,0,1,0,0,1
2713303487,1,0,0,0,1
2713447567,0,1,0,0,1
2714044007,0,1,0,0,1
2715269983,1,0,0,0,1
2715315209,0,0,0,1,1
2715331594,0,1,0,0,1
2715414110,0,1,0,0,1
2715433513,1,0,0,0,1
2715440548,0,0,0,1,1
2716127379,0,1,0,0,1
2716418117,0,1,0,0,1
2716808053,0,1,0,0,1
2716983063,0,1,0,0,1
2717065787,0,1,0,0,1
2717181884,1,0,0,0,1
2717323097,1,0,0,0,1
2717456164,0,1,0,0,1
2712458746,0,1,0,0,1
2712402216,1,0,0,0,1
2712192532,0,1,0,0,1
2706336654,0,1,0,0,1
2703858451,1,0,0,0,1
2703924460,0,1,0,0,1
2704015075,0,1,0,0,1
2704435632,1,0,0,0,1
2704449420,0,0,0,1,1
2704487360,0,0,0,1,1
2704503677,0,1,0,0,1
2704819076,0,1,0,0,1
2705141833,0,1,0,0,1
2706247678,0,1,0,0,1
2706859828,1,0,0,0,1
2711555689,1,0,0,0,1
2707631319,0,1,0,0,1
2707681687,0,1,0,0,1
2708071882,0,1,0,0,1
2708576902,0,1,0,0,1
2708593927,0,1,0,0,1
2709603091,0,1,0,0,1
2710119149,0,1,0,0,1
2710279008,0,1,0,0,1
2710412905,0,1,0,0,1
2711134335,0,1,0,0,1
2615797298,0,0,1,0,1
2615785675,0,1,0,0,1
2615527728,0,1,0,0,1
2556926624,0,1,0,0,1
2557501404,0,1,0,0,1
2557744548,1,0,0,0,1
2558024182,0,1,0,0,1
2558719822,0,1,0,0,1
2558954339,0,1,0,0,1
2558993174,1,0,0,0,1
2559182718,0,0,0,1,1
2559227269,0,1,0,0,1
2559412349,0,1,0,0,1
2559543062,0,1,0,0,1
2559647343,0,1,0,0,1
2559779633,0,1,0,0,1
2560375609,0,1,0,0,1
2560637472,1,0,0,0,1
2560677732,0,1,0,0,1
2560931137,0,0,0,1,1
2560985545,0,1,0,0,1
2561024937,0,1,0,0,1
2561325835,0,1,0,0,1
2561533625,1,0,0,0,1
2561558633,1,0,0,0,1
2561626735,0,1,0,0,1
2561644698,0,1,0,0,1
2557050581,0,1,0,0,1
2556678800,0,1,0,0,1
2570907717,0,1,0,0,1
2556610439,0,1,0,0,1
2551005332,0,1,0,0,1
2551164217,1,0,0,0,1
2551213152,0,1,0,0,1
2551747426,0,1,0,0,1
2552435287,0,1,0,0,1
2552438448,0,1,0,0,1
2552480666,0,1,0,0,1
2552964054,0,1,0,0,1
2553803250,1,0,0,0,1
2554008074,0,1,0,0,1
2554088937,0,1,0,0,1
2554122372,0,1,0,0,1
2554295894,0,1,0,0,1
2554413704,0,1,0,0,1
2554967264,1,0,0,0,1
2554989588,0,1,0,0,1
2555626641,0,1,0,0,1
2555658936,1,0,0,0,1
2556376700,0,1,0,0,1
2556496194,0,1,0,0,1
2556499274,0,1,0,0,1
2556499370,0,1,0,0,1
2556511814,0,1,0,0,1
2562100723,1,0,0,0,1
2562144453,0,1,0,0,1
2562146146,0,1,0,0,1
2562207347,0,1,0,0,1
2566717877,0,1,0,0,1
2566749164,0,1,0,0,1
2566847455,1,0,0,0,1
2566961343,0,1,0,0,1
2567105806,0,1,0,0,1
2567181860,0,1,0,0,1
2567295538,0,1,0,0,1
2567526500,1,0,0,0,1
2567606051,0,1,0,0,1
2567688433,0,1,0,0,1
2567913765,0,1,0,0,1
2568004060,0,1,0,0,1
2568462252,0,1,0,0,1
2568632369,0,1,0,0,1
2568670367,1,0,0,0,1
2568803098,0,1,0,0,1
2568873085,0,1,0,0,1
2568955474,0,1,0,0,1
2569385551,0,1,0,0,1
2569449784,1,0,0,0,1
2569460005,0,1,0,0,1
2569653005,0,1,0,0,1
2570274991,0,1,0,0,1
2566662163,0,1,0,0,1
2566559777,0,1,0,0,1
2566363472,0,1,0,0,1
2563831391,0,1,0,0,1
2562270259,0,1,0,0,1
2562322928,0,1,0,0,1
2562463616,0,1,0,0,1
2563016869,0,1,0,0,1
2563200571,0,1,0,0,1
2563424191,1,0,0,0,1
2563521138,0,1,0,0,1
2563645187,1,0,0,0,1
2563719948,0,1,0,0,1
2563764720,0,1,0,0,1
2564013997,0,0,1,0,1
2566052425,0,1,0,0,1
2564061061,0,1,0,0,1
2564352425,0,1,0,0,1
2564845850,1,0,0,0,1
2565071201,0,1,0,0,1
2565100412,0,1,0,0,1
2565163533,0,0,0,1,1
2565223596,0,1,0,0,1
2565282110,0,1,0,0,1
2565559688,0,1,0,0,1
2565637814,0,1,0,0,1
2550486470,0,1,0,0,1
2550483787,1,0,0,0,1
2550421124,1,0,0,0,1
2540917064,0,1,0,0,1
2537420442,1,0,0,0,1
2537683380,0,1,0,0,1
2537846926,0,1,0,0,1
2537970578,0,1,0,0,1
2538053291,0,0,1,0,1
2538278704,0,1,0,0,1
2538280424,0,1,0,0,1
2538502848,1,0,0,0,1
2538806854,0,1,0,0,1
2538868502,1,0,0,0,1
2538874928,0,1,0,0,1
2539146489,0,1,0,0,1
2539220562,0,1,0,0,1
2539359172,0,1,0,0,1
2539396761,0,1,0,0,1
2539747665,0,1,0,0,1
2539945646,0,1,0,0,1
2540013980,0,1,0,0,1
2540301258,0,1,0,0,1
2540522779,0,1,0,0,1
2540692956,0,1,0,0,1
2540732324,0,0,0,1,1
2540803123,0,1,0,0,1
2537059803,0,1,0,0,1
2536945770,0,1,0,0,1
2536701195,0,1,0,0,1
2534120264,0,1,0,0,1
2532117865,0,0,0,1,1
2532388471,0,1,0,0,1
2532481815,0,1,0,0,1
2532578131,0,1,0,0,1
2532870419,0,1,0,0,1
2532996171,0,1,0,0,1
2533418664,0,1,0,0,1
2533440233,0,1,0,0,1
2533521896,0,1,0,0,1
2533546326,0,0,1,0,1
2534260998,1,0,0,0,1
2535689042,0,1,0,0,1
2534342832,0,1,0,0,1
2534375061,0,1,0,0,1
2534832643,0,1,0,0,1
2534963869,0,1,0,0,1
2535010418,1,0,0,0,1
2535174169,1,0,0,0,1
2535284572,0,1,0,0,1
2535346089,0,1,0,0,1
2535529657,0,1,0,0,1
2535616408,0,1,0,0,1
2540883569,0,1,0,0,1
2541012107,0,1,0,0,1
2550364214,0,1,0,0,1
2541133358,0,1,0,0,1
2545404669,0,1,0,0,1
2545415486,0,1,0,0,1
2545657261,0,1,0,0,1
2545958701,0,1,0,0,1
2546043757,1,0,0,0,1
2546344608,0,1,0,0,1
2546345400,0,1,0,0,1
2546525681,1,0,0,0,1
2546591798,0,1,0,0,1
2546747645,0,1,0,0,1
2547131127,0,1,0,0,1
2547204229,0,1,0,0,1
2547274780,0,1,0,0,1
2548109676,0,1,0,0,1
2548136754,0,1,0,0,1
2548244420,1,0,0,0,1
2548373630,0,1,0,0,1
2548410540,1,0,0,0,1
2548473960,1,0,0,0,1
2549528592,0,1,0,0,1
2549677832,0,1,0,0,1
2549893970,0,1,0,0,1
2549923796,0,1,0,0,1
2545404205,0,1,0,0,1
2544914191,1,0,0,0,1
2544860765,0,1,0,0,1
2542108870,0,1,0,0,1
2541151265,0,1,0,0,1
2541153266,0,1,0,0,1
2541206586,0,1,0,0,1
2541215570,1,0,0,0,1
2541216192,1,0,0,0,1
2541352994,0,1,0,0,1
2541465850,0,1,0,0,1
2541536046,0,1,0,0,1
2541789910,0,1,0,0,1
2541886296,0,1,0,0,1
2542119289,1,0,0,0,1
2544499352,1,0,0,0,1
2543050393,0,1,0,0,1
2543100733,0,0,1,0,1
2543219545,0,1,0,0,1
2543238762,0,1,0,0,1
2543422674,0,0,0,1,1
2543437785,0,1,0,0,1
2543513166,0,1,0,0,1
2543536107,0,1,0,0,1
2544150211,1,0,0,0,1
2544168038,0,1,0,0,1
2570509043,0,1,0,0,1
2571078931,0,1,0,0,1
2615424122,0,1,0,0,1
2598689906,1,0,0,0,1
2598826952,0,1,0,0,1
2598909691,0,1,0,0,1
2599327423,0,1,0,0,1
2599718869,1,0,0,0,1
2599945230,1,0,0,0,1
2600177252,0,1,0,0,1
2600215044,0,1,0,0,1
2600792906,0,1,0,0,1
2601818102,0,1,0,0,1
2601884965,0,1,0,0,1
2601956132,0,1,0,0,1
2601994257,0,1,0,0,1
2602053329,0,1,0,0,1
2602152509,0,1,0,0,1
2603176291,0,1,0,0,1
2603466796,0,1,0,0,1
2603561803,0,1,0,0,1
2603627102,0,1,0,0,1
2603740999,0,1,0,0,1
2603976602,0,1,0,0,1
2604380146,0,1,0,0,1
2604438029,1,0,0,0,1
2604951109,0,1,0,0,1
2598741434,0,1,0,0,1
2598526243,0,1,0,0,1
2571204840,0,1,0,0,1
2598508124,1,0,0,0,1
2592051637,0,1,0,0,1
2592764288,0,1,0,0,1
2592994442,0,1,0,0,1
2593270088,0,1,0,0,1
2593308836,0,1,0,0,1
2593332564,0,1,0,0,1
2594342833,0,1,0,0,1
2594584282,0,1,0,0,1
2594621363,0,1,0,0,1
2594823630,0,0,0,1,1
2595002355,0,1,0,0,1
2595110214,0,1,0,0,1
2595119586,0,1,0,0,1
2595254709,0,1,0,0,1
2596077174,1,0,0,0,1
2596218103,0,1,0,0,1
2596362229,0,1,0,0,1
2596383959,0,1,0,0,1
2596463598,0,1,0,0,1
2596607377,0,1,0,0,1
2597335424,1,0,0,0,1
2597652883,0,1,0,0,1
2597704727,0,1,0,0,1
2604977191,0,1,0,0,1
2605299197,0,1,0,0,1
2605706713,1,0,0,0,1
2605763047,0,1,0,0,1
2611935513,0,1,0,0,1
2612765558,0,1,0,0,1
2612798365,0,0,0,1,1
2612801228,1,0,0,0,1
2612957467,0,1,0,0,1
2613090119,0,1,0,0,1
2613117007,0,1,0,0,1
2613339578,0,1,0,0,1
2613395076,0,0,1,0,1
2613693917,0,1,0,0,1
2613700262,0,1,0,0,1
2613733784,1,0,0,0,1
2613749288,1,0,0,0,1
2613854792,0,1,0,0,1
2614151251,0,1,0,0,1
2614309947,0,1,0,0,1
2614576354,0,1,0,0,1
2614590522,0,1,0,0,1
2614913281,0,1,0,0,1
2614976910,0,1,0,0,1
2615157187,0,1,0,0,1
2615347449,0,1,0,0,1
2615418666,0,1,0,0,1
2611666449,0,1,0,0,1
2611510622,0,1,0,0,1
2611297671,0,1,0,0,1
2609537067,0,1,0,0,1
2605916636,1,0,0,0,1
2606134243,0,1,0,0,1
2607489989,0,1,0,0,1
2607559304,0,1,0,0,1
2607584593,0,1,0,0,1
2607663146,0,1,0,0,1
2608627800,0,1,0,0,1
2608886335,0,1,0,0,1
2608963512,0,1,0,0,1
2609169823,0,1,0,0,1
2609614046,0,1,0,0,1
2611218878,1,0,0,0,1
2609811626,0,1,0,0,1
2609902341,0,1,0,0,1
2609990336,1,0,0,0,1
2610009686,0,1,0,0,1
2610310328,0,1,0,0,1
2610791188,0,1,0,0,1
2610934743,0,1,0,0,1
2611091325,0,1,0,0,1
2611110554,0,1,0,0,1
2611154567,0,1,0,0,1
2591941143,0,1,0,0,1
2591804231,0,0,0,1,1
2591460341,0,1,0,0,1
2579595411,1,0,0,0,1
2575491828,0,1,0,0,1
2575523177,0,1,0,0,1
2575733947,1,0,0,0,1
2575749440,0,1,0,0,1
2575826927,0,1,0,0,1
2575870136,0,1,0,0,1
2576277354,0,1,0,0,1
2576440872,0,1,0,0,1
2576474411,0,1,0,0,1
2576605627,0,1,0,0,1
2576616835,0,1,0,0,1
2576630510,0,1,0,0,1
2577509021,1,0,0,0,1
2577561097,1,0,0,0,1
2577571106,0,1,0,0,1
2577602433,0,1,0,0,1
2577950161,1,0,0,0,1
2578097062,0,1,0,0,1
2578216838,0,1,0,0,1
2578250989,0,1,0,0,1
2578640593,0,1,0,0,1
2579325896,0,1,0,0,1
2579413010,0,1,0,0,1
2575432062,0,1,0,0,1
2575230903,0,1,0,0,1
2574632838,0,1,0,0,1
2572923405,0,1,0,0,1
2571457706,0,1,0,0,1
2571599331,0,1,0,0,1
2571999155,0,1,0,0,1
2572112909,0,1,0,0,1
2572211785,0,1,0,0,1
2572511263,0,1,0,0,1
2572556132,0,1,0,0,1
2572676555,0,1,0,0,1
2572778402,1,0,0,0,1
2572876135,0,1,0,0,1
2573194013,1,0,0,0,1
2574360291,0,0,1,0,1
2573260759,0,1,0,0,1
2573340881,0,1,0,0,1
2573422398,0,1,0,0,1
2573631168,0,1,0,0,1
2573821079,0,1,0,0,1
2573831060,0,1,0,0,1
2573949177,1,0,0,0,1
2574224688,0,0,1,0,1
2574239749,0,1,0,0,1
2574307763,0,1,0,0,1
2579572239,1,0,0,0,1
2579813682,0,1,0,0,1
2591245878,0,1,0,0,1
2580971699,0,1,0,0,1
2585958432,0,1,0,0,1
2586061640,0,1,0,0,1
2586111441,0,1,0,0,1
2586416186,0,1,0,0,1
2586877963,0,1,0,0,1
2587053629,0,1,0,0,1
2587427508,0,1,0,0,1
2587489417,0,0,0,1,1
2587663044,0,1,0,0,1
2587873773,0,1,0,0,1
2588106906,0,1,0,0,1
2588367733,0,1,0,0,1
2588951404,1,0,0,0,1
2589362156,0,1,0,0,1
2589437712,0,1,0,0,1
2589499940,0,1,0,0,1
2589832092,0,0,1,0,1
2590041657,0,1,0,0,1
2590163028,0,0,1,0,1
2590382024,0,1,0,0,1
2590693056,0,0,0,1,1
2590871384,0,1,0,0,1
2591237804,0,1,0,0,1
2585635813,0,1,0,0,1
2585518388,0,1,0,0,1
2585242575,0,1,0,0,1
2583463210,0,1,0,0,1
2581175170,0,1,0,0,1
2581222014,0,1,0,0,1
2581305665,0,1,0,0,1
2581779936,1,0,0,0,1
2581782373,0,1,0,0,1
2582079050,0,1,0,0,1
2582465372,1,0,0,0,1
2582911872,0,1,0,0,1
2583387846,0,1,0,0,1
2583422092,0,1,0,0,1
2583606590,0,1,0,0,1
2585113439,1,0,0,0,1
2583826549,0,1,0,0,1
2583995088,0,1,0,0,1
2584010864,0,1,0,0,1
2584106533,0,1,0,0,1
2584301776,1,0,0,0,1
2584399213,0,1,0,0,1
2584435860,0,1,0,0,1
2584455374,0,1,0,0,1
2584506702,0,1,0,0,1
2584810699,0,1,0,0,1
2734929005,0,1,0,0,1
2735070029,0,1,0,0,1
2735270322,0,1,0,0,1
2822879594,0,1,0,0,1
2823281561,0,1,0,0,1
2823618194,1,0,0,0,1
2824045928,0,1,0,0,1
2824113095,1,0,0,0,1
2824326980,0,1,0,0,1
2824423030,0,1,0,0,1
2824445396,0,1,0,0,1
2825190070,0,1,0,0,1
2825518543,0,1,0,0,1
2825937471,0,1,0,0,1
2825994461,0,1,0,0,1
2826504267,0,1,0,0,1
2827075803,0,1,0,0,1
2827743080,1,0,0,0,1
2827771400,0,1,0,0,1
2828263436,0,1,0,0,1
2828393029,0,1,0,0,1
2828412814,0,1,0,0,1
2828511838,0,1,0,0,1
2829104769,0,1,0,0,1
2829268825,0,0,0,1,1
2829529531,0,1,0,0,1
2829542327,0,1,0,0,1
2823253497,0,1,0,0,1
2822718004,0,1,0,0,1
2838156431,0,1,0,0,1
2822412920,0,1,0,0,1
2816482687,1,0,0,0,1
2816810558,0,1,0,0,1
2816913541,0,1,0,0,1
2817112446,0,1,0,0,1
2817280680,0,1,0,0,1
2817409472,0,1,0,0,1
2817566756,0,1,0,0,1
2818756536,0,1,0,0,1
2818822893,1,0,0,0,1
2819311226,0,1,0,0,1
2820153316,0,1,0,0,1
2820542098,0,1,0,0,1
2820722541,0,1,0,0,1
2820802163,0,1,0,0,1
2821196080,1,0,0,0,1
2821434011,1,0,0,0,1
2821862484,1,0,0,0,1
2821899379,0,1,0,0,1
2821946220,1,0,0,0,1
2822149298,1,0,0,0,1
2822209339,0,1,0,0,1
2822300560,0,1,0,0,1
2822326648,0,1,0,0,1
2829572867,0,1,0,0,1
2829605465,0,1,0,0,1
2829612111,0,1,0,0,1
2829678059,1,0,0,0,1
2833820049,0,1,0,0,1
2834136252,0,1,0,0,1
2834267636,0,1,0,0,1
2834374682,0,1,0,0,1
2834384526,0,1,0,0,1
2835005450,0,1,0,0,1
2835252577,0,0,0,1,1
2835388732,0,1,0,0,1
2835409266,0,1,0,0,1
2835432715,0,1,0,0,1
2835528502,0,1,0,0,1
2835785265,0,1,0,0,1
2835793758,0,1,0,0,1
2836170608,0,1,0,0,1
2836454584,0,1,0,0,1
2837122231,1,0,0,0,1
2837477980,0,1,0,0,1
2837614067,0,1,0,0,1
2837735869,0,1,0,0,1
2837868358,1,0,0,0,1
2837879525,0,1,0,0,1
2837994367,0,1,0,0,1
2838016768,0,1,0,0,1
2833757706,0,1,0,0,1
2833752835,1,0,0,0,1
2833704139,0,0,1,0,1
2831392101,1,0,0,0,1
2829712190,0,1,0,0,1
2829785981,0,1,0,0,1
2829876034,0,1,0,0,1
2830226242,0,1,0,0,1
2830718157,0,1,0,0,1
2830936513,0,1,0,0,1
2831132913,0,1,0,0,1
2831251553,0,1,0,0,1
2831365070,0,1,0,0,1
2831380371,0,0,0,1,1
2831677321,0,1,0,0,1
2833668406,0,1,0,0,1
2832127088,0,1,0,0,1
2832186625,0,1,0,0,1
2832266053,0,1,0,0,1
2832434689,0,1,0,0,1
2832592174,1,0,0,0,1
2832624916,0,1,0,0,1
2832718377,1,0,0,0,1
2832958672,1,0,0,0,1
2832963724,0,1,0,0,1
2833533815,1,0,0,0,1
2816349191,0,1,0,0,1
2816291746,0,1,0,0,1
2815423842,0,1,0,0,1
2806854206,0,1,0,0,1
2803395115,0,1,0,0,1
2803839485,1,0,0,0,1
2803944714,0,1,0,0,1
2804015987,0,1,0,0,1
2804098075,0,1,0,0,1
2804297433,0,1,0,0,1
2804417672,0,1,0,0,1
2804793420,0,1,0,0,1
2804961360,0,1,0,0,1
2804975859,0,1,0,0,1
2805127868,0,1,0,0,1
2805323180,0,0,0,1,1
2805367247,0,1,0,0,1
2805703487,0,1,0,0,1
2805755087,0,1,0,0,1
2805941172,0,1,0,0,1
2805948017,0,1,0,0,1
2806426492,0,1,0,0,1
2806458576,0,1,0,0,1
2806565152,0,1,0,0,1
2806566024,0,1,0,0,1
2806577558,0,1,0,0,1
2806674657,0,1,0,0,1
2803053519,0,1,0,0,1
2802888025,1,0,0,0,1
2802833517,0,1,0,0,1
2800838374,0,1,0,0,1
2799731600,1,0,0,0,1
2800109024,1,0,0,0,1
2800201640,1,0,0,0,1
2800219296,0,1,0,0,1
2800233846,0,1,0,0,1
2800243597,1,0,0,0,1
2800422459,0,0,1,0,1
2800562026,1,0,0,0,1
2800580700,0,1,0,0,1
2800729619,0,1,0,0,1
2800953536,0,1,0,0,1
2802710603,0,1,0,0,1
2800965137,0,1,0,0,1
2801424732,1,0,0,0,1
2801468913,0,1,0,0,1
2801476228,0,1,0,0,1
2801559513,0,1,0,0,1
2801663620,0,1,0,0,1
2801825484,0,1,0,0,1
2801996798,1,0,0,0,1
2802185040,0,1,0,0,1
2802431053,0,1,0,0,1
2806743555,0,0,0,1,1
2806962401,1,0,0,0,1
2815401849,0,1,0,0,1
2807182070,0,1,0,0,1
2811759678,0,1,0,0,1
2811885666,0,1,0,0,1
2811902502,0,1,0,0,1
2813094427,1,0,0,0,1
2813152363,0,1,0,0,1
2813315847,0,1,0,0,1
2813551324,1,0,0,0,1
2813951391,0,1,0,0,1
2814322532,1,0,0,0,1
2814473587,0,1,0,0,1
2814480490,0,1,0,0,1
2814484960,0,1,0,0,1
2814506955,0,1,0,0,1
2814514144,0,1,0,0,1
2814561515,0,1,0,0,1
2814608334,0,1,0,0,1
2814632428,0,1,0,0,1
2814916599,0,1,0,0,1
2814921437,0,1,0,0,1
2814924288,0,0,0,1,1
2814992618,0,1,0,0,1
2815174482,0,1,0,0,1
2815238742,0,1,0,0,1
2811584054,0,1,0,0,1
2811574511,0,1,0,0,1
2811563782,0,1,0,0,1
2809760601,0,1,0,0,1
2807333746,0,1,0,0,1
2807366015,0,1,0,0,1
2807506867,0,0,1,0,1
2808479699,0,1,0,0,1
2809172713,0,1,0,0,1
2809232564,0,1,0,0,1
2809453150,0,1,0,0,1
2809456204,0,1,0,0,1
2809632062,0,1,0,0,1
2809759612,1,0,0,0,1
2810041744,0,1,0,0,1
2811522621,1,0,0,0,1
2810324065,0,1,0,0,1
2810630287,0,1,0,0,1
2810753063,0,1,0,0,1
2810936374,0,1,0,0,1
2810987604,0,1,0,0,1
2811006577,0,1,0,0,1
2811048860,0,1,0,0,1
2811243122,0,1,0,0,1
2811292902,0,1,0,0,1
2811486416,1,0,0,0,1
2838078146,0,1,0,0,1
2838384823,0,1,0,0,1
2799669294,0,1,0,0,1
2863458602,0,1,0,0,1
2863638471,0,1,0,0,1
2863890754,0,1,0,0,1
2864185111,1,0,0,0,1
2864208463,0,1,0,0,1
2864237902,0,1,0,0,1
2864363708,0,0,0,1,1
2864560165,0,1,0,0,1
2864756987,1,0,0,0,1
2865205791,1,0,0,0,1
2865232250,1,0,0,0,1
2865290431,0,1,0,0,1
2865378834,0,1,0,0,1
2865412327,0,1,0,0,1
2865460355,0,1,0,0,1
2865573510,0,1,0,0,1
2865754497,0,1,0,0,1
2865788471,0,1,0,0,1
2866063289,1,0,0,0,1
2866219460,1,0,0,0,1
2866237990,0,1,0,0,1
2866514346,0,1,0,0,1
2866585688,0,1,0,0,1
2866691446,0,1,0,0,1
2863633107,0,1,0,0,1
2863374776,0,1,0,0,1
2838519241,0,1,0,0,1
2862947137,0,0,0,1,1
2858025183,1,0,0,0,1
2858287224,0,1,0,0,1
2858346796,0,1,0,0,1
2858362230,0,1,0,0,1
2858391995,0,0,1,0,1
2858606275,0,1,0,0,1
2859306182,1,0,0,0,1
2859362091,0,1,0,0,1
2859671466,0,1,0,0,1
2859775508,1,0,0,0,1
2859864726,0,1,0,0,1
2859996369,0,1,0,0,1
2860134909,0,1,0,0,1
2860193819,0,1,0,0,1
2860657959,0,0,1,0,1
2860679039,0,1,0,0,1
2860919995,0,1,0,0,1
2861003079,0,1,0,0,1
2861361313,0,1,0,0,1
2861444436,0,1,0,0,1
2861573302,0,0,0,1,1
2862177641,0,1,0,0,1
2862605020,0,1,0,0,1
2866868295,0,1,0,0,1
2866880481,0,1,0,0,1
2866884513,0,1,0,0,1
2866927656,0,1,0,0,1
2871521585,1,0,0,0,1
2871666697,0,1,0,0,1
2872001079,0,1,0,0,1
2872015331,0,1,0,0,1
2872402987,0,1,0,0,1
2872424213,0,1,0,0,1
2872574667,0,1,0,0,1
2872643741,0,1,0,0,1
2872863526,0,1,0,0,1
2873076772,0,1,0,0,1
2873112530,0,1,0,0,1
2873140506,0,1,0,0,1
2873200712,0,1,0,0,1
2873500778,0,1,0,0,1
2873519169,0,1,0,0,1
2873595324,0,1,0,0,1
2873738848,0,1,0,0,1
2873768027,0,1,0,0,1
2873865875,0,1,0,0,1
2873928115,0,1,0,0,1
2873930107,1,0,0,0,1
2873971317,0,1,0,0,1
2874106685,0,1,0,0,1
2870852284,0,0,1,0,1
2870848881,1,0,0,0,1
2870734967,0,1,0,0,1
2869058326,0,1,0,0,1
2867121669,0,1,0,0,1
2867145631,0,1,0,0,1
2867152335,0,1,0,0,1
2867828377,1,0,0,0,1
2868102646,1,0,0,0,1
2868318862,1,0,0,0,1
2868495751,0,0,0,1,1
2868543644,1,0,0,0,1
2868653259,0,1,0,0,1
2868739318,0,1,0,0,1
2869068710,1,0,0,0,1
2870730197,0,1,0,0,1
2869092366,0,1,0,0,1
2869099654,0,1,0,0,1
2869198136,1,0,0,0,1
2869343563,1,0,0,0,1
2869818758,0,1,0,0,1
2869965287,0,1,0,0,1
2870122343,1,0,0,0,1
2870246390,0,1,0,0,1
2870258353,0,1,0,0,1
2870691653,0,1,0,0,1
2857982071,1,0,0,0,1
2857799647,1,0,0,0,1
2857481346,0,1,0,0,1
2847276731,0,1,0,0,1
2842699200,1,0,0,0,1
2842766481,1,0,0,0,1
2842834395,1,0,0,0,1
2842982430,0,1,0,0,1
2843220654,1,0,0,0,1
2843347969,0,0,1,0,1
2843369053,0,1,0,0,1
2843581836,0,1,0,0,1
2843661748,0,1,0,0,1
2843903308,1,0,0,0,1
2844346078,0,1,0,0,1
2844569459,0,1,0,0,1
2845063565,0,1,0,0,1
2845070048,0,1,0,0,1
2845096887,0,1,0,0,1
2845174797,1,0,0,0,1
2845206706,0,1,0,0,1
2846066426,0,1,0,0,1
2846374287,0,0,0,1,1
2846453086,0,1,0,0,1
2846525855,0,0,0,1,1
2846701787,0,1,0,0,1
2846725425,1,0,0,0,1
2842611350,0,1,0,0,1
2842501074,0,1,0,0,1
2842288081,0,1,0,0,1
2839709115,0,1,0,0,1
2838641153,0,1,0,0,1
2838840147,0,1,0,0,1
2838855448,0,1,0,0,1
2839152672,0,1,0,0,1
2839224302,0,1,0,0,1
2839301674,0,1,0,0,1
2839476425,0,1,0,0,1
2839566441,0,1,0,0,1
2839591154,0,1,0,0,1
2839652886,1,0,0,0,1
2840368081,1,0,0,0,1
2842231945,1,0,0,0,1
2840651541,0,1,0,0,1
2840651715,1,0,0,0,1
2840930032,0,1,0,0,1
2841044030,0,1,0,0,1
2841046444,0,1,0,0,1
2841481141,1,0,0,0,1
2841589881,0,1,0,0,1
2841965568,0,1,0,0,1
2842105963,0,0,0,1,1
2842128814,0,1,0,0,1
2846972179,0,1,0,0,1
2847301557,0,1,0,0,1
2857267479,0,1,0,0,1
2847671851,0,1,0,0,1
2851012887,0,1,0,0,1
2851359505,0,1,0,0,1
2851680150,0,0,0,1,1
2851736511,0,1,0,0,1
2851914805,0,1,0,0,1
2851984919,0,1,0,0,1
2852020900,0,1,0,0,1
2852226506,0,0,0,1,1
2852638225,0,1,0,0,1
2852976007,0,0,0,1,1
2853280616,0,0,0,1,1
2853301799,1,0,0,0,1
2854045432,0,1,0,0,1
2854879798,0,1,0,0,1
2855248050,0,1,0,0,1
2855328968,0,1,0,0,1
2855332678,0,1,0,0,1
2855344554,0,1,0,0,1
2855461206,0,1,0,0,1
2855953230,0,0,0,1,1
2856414768,0,1,0,0,1
2856922144,0,1,0,0,1
2857223818,1,0,0,0,1
2850922517,0,1,0,0,1
2850310000,0,1,0,0,1
2850206870,0,1,0,0,1
2849357031,0,1,0,0,1
2847746838,0,1,0,0,1
2847759226,0,1,0,0,1
2848251417,0,1,0,0,1
2848430065,1,0,0,0,1
2848565574,1,0,0,0,1
2848684470,0,1,0,0,1
2848814289,0,1,0,0,1
2848844073,1,0,0,0,1
2849074382,0,1,0,0,1
2849188353,0,1,0,0,1
2849381945,0,1,0,0,1
2850173224,0,1,0,0,1
2849397124,0,1,0,0,1
2849444276,0,1,0,0,1
2849601589,0,1,0,0,1
2849666709,0,1,0,0,1
2849694667,0,0,0,1,1
2849714072,0,1,0,0,1
2849800153,0,1,0,0,1
2849840276,1,0,0,0,1
2849854766,1,0,0,0,1
2850082331,0,1,0,0,1
2799708717,0,1,0,0,1
2799436356,0,1,0,0,1
2735378643,0,1,0,0,1
2753667819,0,1,0,0,1
2754214535,0,1,0,0,1
2754469099,0,1,0,0,1
2754551730,0,0,0,1,1
2754855713,0,1,0,0,1
2754911440,0,1,0,0,1
2755034304,0,1,0,0,1
2755086856,1,0,0,0,1
2755266138,0,1,0,0,1
2755429755,0,0,0,1,1
2755693417,1,0,0,0,1
2755872231,0,1,0,0,1
2755930407,0,1,0,0,1
2755994112,0,1,0,0,1
2756347859,0,0,1,0,1
2756454620,0,1,0,0,1
2756508358,0,1,0,0,1
2756701079,1,0,0,0,1
2756721322,0,1,0,0,1
2756994291,0,1,0,0,1
2757312472,1,0,0,0,1
2757335554,0,1,0,0,1
2757597765,0,1,0,0,1
2757670483,1,0,0,0,1
2753793226,0,1,0,0,1
2753657311,0,1,0,0,1
2766261009,1,0,0,0,1
2753548685,1,0,0,0,1
2750772023,0,1,0,0,1
2750846885,0,1,0,0,1
2751043750,0,1,0,0,1
2751340434,0,1,0,0,1
2751340540,0,0,1,0,1
2751410952,0,1,0,0,1
2751558593,0,1,0,0,1
2751767462,0,1,0,0,1
2751771058,0,1,0,0,1
2751782307,0,1,0,0,1
2751783030,0,1,0,0,1
2751862141,0,1,0,0,1
2751996938,0,1,0,0,1
2752186471,0,1,0,0,1
2752224558,0,0,1,0,1
2752356097,0,1,0,0,1
2752388255,0,1,0,0,1
2752501347,0,1,0,0,1
2752754170,0,1,0,0,1
2753104319,0,1,0,0,1
2753104353,0,1,0,0,1
2753526137,0,1,0,0,1
2753540296,0,1,0,0,1
2757672207,0,1,0,0,1
2757932054,0,1,0,0,1
2758230756,0,1,0,0,1
2758251598,0,1,0,0,1
2761572221,0,1,0,0,1
2761651240,1,0,0,0,1
2761706161,0,1,0,0,1
2762026971,0,1,0,0,1
2762139569,0,1,0,0,1
2762536037,0,1,0,0,1
2762673295,0,1,0,0,1
2762952938,0,1,0,0,1
2763036228,0,1,0,0,1
2763565341,0,1,0,0,1
2763851350,0,1,0,0,1
2763950867,0,0,1,0,1
2763956080,0,1,0,0,1
2764617910,0,1,0,0,1
2765160552,0,0,0,1,1
2765170571,0,1,0,0,1
2765399802,0,1,0,0,1
2765580615,1,0,0,0,1
2765592959,0,1,0,0,1
2765632584,0,1,0,0,1
2765677965,0,1,0,0,1
2765735808,1,0,0,0,1
2765839550,0,1,0,0,1
2761521879,0,1,0,0,1
2761361549,0,1,0,0,1
2761164469,0,1,0,0,1
2759715311,1,0,0,0,1
2758364611,0,1,0,0,1
2758403809,0,1,0,0,1
2758652583,0,1,0,0,1
2758694512,1,0,0,0,1
2758762895,0,1,0,0,1
2758895366,0,1,0,0,1
2759051608,1,0,0,0,1
2759249945,1,0,0,0,1
2759484273,0,1,0,0,1
2759538671,0,1,0,0,1
2759890094,0,0,0,1,1
2760954268,0,1,0,0,1
2760033892,1,0,0,0,1
2760069404,0,1,0,0,1
2760388557,0,1,0,0,1
2760443140,0,1,0,0,1
2760584595,0,1,0,0,1
2760615849,0,1,0,0,1
2760616691,0,1,0,0,1
2760665212,0,1,0,0,1
2760749863,0,1,0,0,1
2760891690,0,1,0,0,1
2750524767,1,0,0,0,1
2750428132,0,1,0,0,1
2750292472,0,1,0,0,1
2742122012,1,0,0,0,1
2739167529,0,1,0,0,1
2739210285,1,0,0,0,1
2739376597,0,1,0,0,1
2739440388,0,1,0,0,1
2739824588,0,1,0,0,1
2740083001,0,0,1,0,1
2740128454,0,1,0,0,1
2740140493,0,1,0,0,1
2740216400,0,1,0,0,1
2740368063,0,1,0,0,1
2740591906,0,0,0,1,1
2740707708,0,1,0,0,1
2740760757,0,1,0,0,1
2741051515,0,1,0,0,1
2741122726,0,1,0,0,1
2741212869,1,0,0,0,1
2741243207,0,1,0,0,1
2741714149,0,1,0,0,1
2741714620,0,1,0,0,1
2741741512,0,1,0,0,1
2741744588,0,1,0,0,1
2741794989,0,1,0,0,1
2741861049,0,1,0,0,1
2739111831,0,1,0,0,1
2739091107,0,1,0,0,1
2739025521,0,1,0,0,1
2737517093,0,1,0,0,1
2735801802,0,1,0,0,1
2736098871,0,1,0,0,1
2736106305,0,1,0,0,1
2736229979,0,1,0,0,1
2736520019,0,1,0,0,1
2736587137,0,1,0,0,1
2736712274,0,1,0,0,1
2736855301,0,1,0,0,1
2736886935,0,1,0,0,1
2737066324,0,1,0,0,1
2737596163,0,1,0,0,1
2738967521,0,1,0,0,1
2737956142,0,1,0,0,1
2738016426,0,1,0,0,1
2738173443,0,1,0,0,1
2738188342,0,1,0,0,1
2738218835,0,1,0,0,1
2738224023,0,1,0,0,1
2738255031,0,1,0,0,1
2738287355,0,1,0,0,1
2738317486,0,1,0,0,1
2738388580,0,1,0,0,1
2742073712,0,0,0,1,1
2742255075,1,0,0,0,1
2749666384,0,1,0,0,1
2742446976,0,1,0,0,1
2746228947,0,1,0,0,1
2746266591,0,1,0,0,1
2746269801,0,1,0,0,1
2746439622,0,1,0,0,1
2746605341,0,1,0,0,1
2747199425,0,1,0,0,1
2747262309,1,0,0,0,1
2747410108,0,0,0,1,1
2748018323,0,1,0,0,1
2748240700,0,1,0,0,1
2748258949,1,0,0,0,1
2748336479,0,1,0,0,1
2748348838,1,0,0,0,1
2748450989,0,1,0,0,1
2748498486,0,1,0,0,1
2748835066,0,1,0,0,1
2748840583,0,1,0,0,1
2748845907,0,1,0,0,1
2748941509,1,0,0,0,1
2748948073,0,1,0,0,1
2749008268,0,1,0,0,1
2749115073,0,1,0,0,1
2749645400,0,1,0,0,1
2746157325,0,1,0,0,1
2745661100,0,1,0,0,1
2745539740,1,0,0,0,1
2743886495,0,1,0,0,1
2742458924,0,1,0,0,1
2742482134,0,1,0,0,1
2742518668,0,1,0,0,1
2742561422,1,0,0,0,1
2742580362,0,1,0,0,1
2742634966,0,1,0,0,1
2742974145,0,1,0,0,1
2743074378,0,1,0,0,1
2743108777,0,1,0,0,1
2743778591,0,1,0,0,1
2743900683,0,1,0,0,1
2745490245,0,1,0,0,1
2744367153,0,1,0,0,1
2744417207,0,1,0,0,1
2744736281,0,1,0,0,1
2744859976,0,1,0,0,1
2744913923,0,1,0,0,1
2744982104,0,1,0,0,1
2745088157,0,1,0,0,1
2745170855,0,1,0,0,1
2745197746,0,1,0,0,1
2745360179,0,1,0,0,1
2766100721,0,1,0,0,1
2766272438,0,1,0,0,1
2799123726,0,1,0,0,1
2786351875,1,0,0,0,1
2786448356,0,1,0,0,1
2786454896,0,1,0,0,1
2786512625,0,1,0,0,1
2787155674,0,1,0,0,1
2787406602,0,1,0,0,1
2787479703,0,1,0,0,1
2787504762,0,1,0,0,1
2787611424,0,1,0,0,1
2787669506,0,1,0,0,1
2788028640,0,1,0,0,1
2788035038,0,1,0,0,1
2788080217,0,1,0,0,1
2788260018,0,1,0,0,1
2788315649,0,1,0,0,1
2788941283,1,0,0,0,1
2788982544,0,1,0,0,1
2789095619,0,0,0,1,1
2789176227,0,1,0,0,1
2789353844,0,1,0,0,1
2789498408,0,1,0,0,1
2789692749,0,0,1,0,1
2789701550,0,1,0,0,1
2789832731,0,0,0,1,1
2786410243,0,1,0,0,1
2786350345,0,1,0,0,1
2766294190,1,0,0,0,1
2786291268,0,0,1,0,1
2783800722,0,1,0,0,1
2783830395,0,1,0,0,1
2784039356,0,1,0,0,1
2784154995,0,1,0,0,1
2784193669,0,0,1,0,1
2784402749,0,1,0,0,1
2784438552,1,0,0,0,1
2784519978,0,1,0,0,1
2784582685,0,1,0,0,1
2784900375,0,1,0,0,1
2784969896,0,1,0,0,1
2785021765,0,1,0,0,1
2785249768,0,1,0,0,1
2785371086,0,1,0,0,1
2785400779,0,1,0,0,1
2785422613,1,0,0,0,1
2785484205,0,1,0,0,1
2785545317,0,1,0,0,1
2785677077,0,1,0,0,1
2785963702,0,1,0,0,1
2786023047,0,1,0,0,1
2786024854,0,1,0,0,1
2786249846,0,1,0,0,1
2790021096,0,1,0,0,1
2790392436,0,1,0,0,1
2790514401,0,1,0,0,1
2790593127,1,0,0,0,1
2794791672,0,1,0,0,1
2795012298,0,1,0,0,1
2795102894,0,1,0,0,1
2795494556,0,1,0,0,1
2795637728,0,1,0,0,1
2795789888,0,1,0,0,1
2795888424,0,1,0,0,1
2796359344,0,1,0,0,1
2796435603,0,1,0,0,1
2796632427,0,1,0,0,1
2796863405,0,1,0,0,1
2797187865,0,1,0,0,1
2797294256,0,1,0,0,1
2797406472,0,1,0,0,1
2797449920,0,1,0,0,1
2797478794,0,1,0,0,1
2797485741,0,0,0,1,1
2797560096,0,1,0,0,1
2797571976,1,0,0,0,1
2797651271,0,1,0,0,1
2797764653,0,1,0,0,1
2798322882,0,1,0,0,1
2798947643,0,0,0,1,1
2794533457,0,1,0,0,1
2794508488,0,1,0,0,1
2794427732,0,1,0,0,1
2792617982,0,0,0,1,1
2790694296,0,1,0,0,1
2790701762,1,0,0,0,1
2790979810,0,1,0,0,1
2791302678,1,0,0,0,1
2791740888,1,0,0,0,1
2791953405,0,1,0,0,1
2791975879,1,0,0,0,1
2792197485,1,0,0,0,1
2792304470,0,1,0,0,1
2792595390,0,1,0,0,1
2792704009,0,1,0,0,1
2794312432,1,0,0,0,1
2792786363,0,1,0,0,1
2793182631,0,1,0,0,1
2793258024,0,0,0,1,1
2793665121,0,1,0,0,1
2793790826,0,1,0,0,1
2793796748,1,0,0,0,1
2793799071,0,1,0,0,1
2794003500,0,1,0,0,1
2794131351,0,1,0,0,1
51943,1,0,0,0,1
2783518339,0,1,0,0,1
2783492113,0,1,0,0,1
2782976749,0,1,0,0,1
2775402959,0,1,0,0,1
2770608698,1,0,0,0,1
2771193490,0,1,0,0,1
2771327900,0,1,0,0,1
2771731690,1,0,0,0,1
2771975505,0,1,0,0,1
2772094169,0,1,0,0,1
2772370219,0,1,0,0,1
2772541420,0,1,0,0,1
2772666447,0,1,0,0,1
2773004577,1,0,0,0,1
2773154583,0,1,0,0,1
2773191379,0,1,0,0,1
2773205240,0,1,0,0,1
2773356250,0,1,0,0,1
2773452550,1,0,0,0,1
2773597844,0,1,0,0,1
2773613225,0,1,0,0,1
2773771047,0,1,0,0,1
2774026856,0,1,0,0,1
2774095482,1,0,0,0,1
2774384600,0,1,0,0,1
2774397813,0,1,0,0,1
2774650967,0,1,0,0,1
2770212107,0,1,0,0,1
2770149953,0,1,0,0,1
2770018595,0,1,0,0,1
2768049243,0,1,0,0,1
2766581185,0,1,0,0,1
2766996761,0,1,0,0,1
2767113120,1,0,0,0,1
2767355746,0,1,0,0,1
2767356517,0,1,0,0,1
2767360247,0,1,0,0,1
2767500046,0,1,0,0,1
2767549468,0,1,0,0,1
2767916008,0,1,0,0,1
2767997207,0,1,0,0,1
2768129997,0,1,0,0,1
2770000178,0,1,0,0,1
2768613971,0,1,0,0,1
2768868083,0,1,0,0,1
2769025030,0,1,0,0,1
2769203479,0,1,0,0,1
2769280281,0,1,0,0,1
2769318273,0,1,0,0,1
2769412607,1,0,0,0,1
2769460895,1,0,0,0,1
2769551853,0,1,0,0,1
2769952600,0,1,0,0,1
2775113850,1,0,0,0,1
2775684286,0,1,0,0,1
2782630359,0,1,0,0,1
2775880430,0,1,0,0,1
2779415875,0,1,0,0,1
2779420524,0,1,0,0,1
2779662037,0,1,0,0,1
2780176515,0,1,0,0,1
2780302123,1,0,0,0,1
2780328363,0,1,0,0,1
2780341250,0,1,0,0,1
2780471987,1,0,0,0,1
2780480731,1,0,0,0,1
2780690500,0,1,0,0,1
2780805288,1,0,0,0,1
2780822360,1,0,0,0,1
2780987371,0,0,0,1,1
2781050284,0,1,0,0,1
2781516854,1,0,0,0,1
2781661461,0,1,0,0,1
2781999258,1,0,0,0,1
2782004636,0,1,0,0,1
2782094685,0,1,0,0,1
2782110509,0,1,0,0,1
2782250663,0,1,0,0,1
2782428593,0,1,0,0,1
2782514563,0,1,0,0,1
2779293687,0,1,0,0,1
2779095731,0,1,0,0,1
2778836865,0,1,0,0,1
2777180754,1,0,0,0,1
2775940841,0,1,0,0,1
2776012062,0,1,0,0,1
2776265942,0,1,0,0,1
2776278289,1,0,0,0,1
2776541941,0,1,0,0,1
2776778682,0,1,0,0,1
2777045644,0,1,0,0,1
2777047743,0,1,0,0,1
2777050400,0,1,0,0,1
2777175328,0,1,0,0,1
2777337133,0,1,0,0,1
2778755055,0,1,0,0,1
2777433478,0,1,0,0,1
2777522400,0,1,0,0,1
2777615043,1,0,0,0,1
2777794115,0,1,0,0,1
2777800699,0,1,0,0,1
2777826789,0,1,0,0,1
2778118076,0,1,0,0,1
2778256770,0,1,0,0,1
2778419620,0,1,0,0,1
2778448032,0,1,0,0,1
2532030397,1,0,0,0,1
2531648381,0,1,0,0,1
2874296485,0,1,0,0,1
2316595602,0,1,0,0,1
2316923238,1,0,0,0,1
2316977912,1,0,0,0,1
2317049839,0,1,0,0,1
2317163567,0,1,0,0,1
2317687224,1,0,0,0,1
2317799241,0,1,0,0,1
2317960734,0,1,0,0,1
2317962158,0,0,1,0,1
2317963898,0,1,0,0,1
2318092207,1,0,0,0,1
2318129449,0,1,0,0,1
2318201601,0,1,0,0,1
2318325215,1,0,0,0,1
2318553045,0,1,0,0,1
2318655082,0,1,0,0,1
2318706012,0,1,0,0,1
2318861083,0,1,0,0,1
2318864301,0,1,0,0,1
2318945958,0,1,0,0,1
2318991212,0,1,0,0,1
2319538167,1,0,0,0,1
2319672685,1,0,0,0,1
2319955076,0,1,0,0,1
2316732570,1,0,0,0,1
2316364208,0,1,0,0,1
2310899838,0,0,1,0,1
2316341156,0,1,0,0,1
2311586525,0,1,0,0,1
2311609376,0,1,0,0,1
2312087214,1,0,0,0,1
2312109122,0,1,0,0,1
2312112043,0,1,0,0,1
2312629443,0,1,0,0,1
2312719830,0,1,0,0,1
2312722555,1,0,0,0,1
2312872291,0,1,0,0,1
2312883528,1,0,0,0,1
2313067992,0,1,0,0,1
2313276139,0,1,0,0,1
2313897283,1,0,0,0,1
2313983601,0,1,0,0,1
2314621836,1,0,0,0,1
2314708276,0,1,0,0,1
2314779711,0,1,0,0,1
2314930304,1,0,0,0,1
2315053105,1,0,0,0,1
2315240724,1,0,0,0,1
2315300678,0,1,0,0,1
2315321343,0,1,0,0,1
2315834209,0,1,0,0,1
2320021809,0,1,0,0,1
2320117837,0,1,0,0,1
2320152155,0,1,0,0,1
2320562774,0,1,0,0,1
2324160008,0,1,0,0,1
2324166046,0,1,0,0,1
2324336464,0,0,0,1,1
2324887232,0,0,0,1,1
2325107037,1,0,0,0,1
2325893908,1,0,0,0,1
2325955967,1,0,0,0,1
2326072738,0,1,0,0,1
2326203306,0,1,0,0,1
2326569719,0,1,0,0,1
2326603568,0,1,0,0,1
2326648979,0,0,1,0,1
2326708141,0,0,1,0,1
2326762930,0,1,0,0,1
2326872970,0,1,0,0,1
2326925519,1,0,0,0,1
2326963987,0,1,0,0,1
2327111457,0,1,0,0,1
2327238466,0,1,0,0,1
2327266968,1,0,0,0,1
2327446438,0,1,0,0,1
2328183359,0,1,0,0,1
2328243420,1,0,0,0,1
2324097953,0,1,0,0,1
2323973382,0,1,0,0,1
2323918901,0,1,0,0,1
2321837739,0,1,0,0,1
2320580560,0,1,0,0,1
2320635590,1,0,0,0,1
2320815264,0,1,0,0,1
2320929617,0,0,1,0,1
2321114886,0,1,0,0,1
2321197453,0,1,0,0,1
2321330247,0,1,0,0,1
2321343097,0,0,1,0,1
2321430644,0,1,0,0,1
2321794675,1,0,0,0,1
2321927752,0,1,0,0,1
2323915634,1,0,0,0,1
2322022020,0,1,0,0,1
2322314041,1,0,0,0,1
2322629688,0,1,0,0,1
2322630958,0,1,0,0,1
2322663914,0,1,0,0,1
2322692293,1,0,0,0,1
2322842594,0,0,0,1,1
2323269360,1,0,0,0,1
2323487271,0,1,0,0,1
2323692216,0,1,0,0,1
2310977114,0,1,0,0,1
2310866585,0,1,0,0,1
2530007954,0,1,0,0,1
2296781690,0,1,0,0,1
2297254718,0,1,0,0,1
2297404615,1,0,0,0,1
2297456581,1,0,0,0,1
2297470252,0,1,0,0,1
2297520359,1,0,0,0,1
2297532511,0,1,0,0,1
2297585064,1,0,0,0,1
2297617398,0,1,0,0,1
2297707995,0,1,0,0,1
2297819478,0,1,0,0,1
2297972317,0,1,0,0,1
2298234441,0,1,0,0,1
2298635642,0,1,0,0,1
2298699218,0,1,0,0,1
2299047445,0,1,0,0,1
2299107475,0,0,1,0,1
2299137126,0,1,0,0,1
2299150239,0,1,0,0,1
2299200829,1,0,0,0,1
2299606633,0,1,0,0,1
2299815006,1,0,0,0,1
2299954394,1,0,0,0,1
2300144238,0,1,0,0,1
2296966583,0,1,0,0,1
2296659496,0,0,0,1,1
2310643489,0,1,0,0,1
2296573802,0,1,0,0,1
2291775291,0,1,0,0,1
2292383606,1,0,0,0,1
2292648025,0,1,0,0,1
2293013731,0,0,0,1,1
2293043658,0,1,0,0,1
2293443836,0,1,0,0,1
2293614910,0,1,0,0,1
2294153869,0,1,0,0,1
2294275172,0,1,0,0,1
2294280256,0,1,0,0,1
2294643157,1,0,0,0,1
2294850730,0,1,0,0,1
2294882079,0,1,0,0,1
2294922463,0,0,0,1,1
2294952883,0,1,0,0,1
2295226234,0,1,0,0,1
2295537033,0,1,0,0,1
2295568217,0,1,0,0,1
2295634581,0,1,0,0,1
2295701460,0,0,0,1,1
2295772560,0,1,0,0,1
2296386427,1,0,0,0,1
2296503103,1,0,0,0,1
2300195389,0,1,0,0,1
2300439672,1,0,0,0,1
2300548375,1,0,0,0,1
2300741222,0,1,0,0,1
2305319884,0,1,0,0,1
2305438117,0,1,0,0,1
2305645554,0,1,0,0,1
2305668056,0,1,0,0,1
2305844568,1,0,0,0,1
2306062265,0,0,0,1,1
2306666446,0,1,0,0,1
2306697258,0,1,0,0,1
2307207101,1,0,0,0,1
2307515265,0,1,0,0,1
2307711647,1,0,0,0,1
2307737799,0,1,0,0,1
2308202238,0,1,0,0,1
2308476888,0,1,0,0,1
2308509715,0,1,0,0,1
2308969400,0,1,0,0,1
2309283546,1,0,0,0,1
2309499537,0,1,0,0,1
2309919745,0,1,0,0,1
2310092557,0,1,0,0,1
2310366348,0,1,0,0,1
2310522888,0,1,0,0,1
2310624396,0,1,0,0,1
2305031558,0,1,0,0,1
2304890863,1,0,0,0,1
2304671512,0,1,0,0,1
2303018328,0,1,0,0,1
2300842615,0,1,0,0,1
2301179631,0,1,0,0,1
2301652460,0,1,0,0,1
2301843072,0,1,0,0,1
2301862686,1,0,0,0,1
2301892284,0,1,0,0,1
2301897142,0,1,0,0,1
2302009346,0,1,0,0,1
2302395129,0,1,0,0,1
2302542162,0,1,0,0,1
2303078498,0,1,0,0,1
2304563761,0,1,0,0,1
2303173662,0,1,0,0,1
2303410380,1,0,0,0,1
2303472063,0,1,0,0,1
2303542351,0,1,0,0,1
2303566986,0,1,0,0,1
2303833235,0,1,0,0,1
2303850930,0,1,0,0,1
2304035501,0,0,1,0,1
2304145562,0,1,0,0,1
2304440245,0,1,0,0,1
2328271236,0,1,0,0,1
2328292008,1,0,0,0,1
2328571634,1,0,0,0,1
2350761720,0,0,0,1,1
2351490420,0,1,0,0,1
2352049838,0,1,0,0,1
2352103808,0,1,0,0,1
2352182598,0,1,0,0,1
2352196464,0,1,0,0,1
2352332579,0,1,0,0,1
2352562387,0,1,0,0,1
2352779491,0,1,0,0,1
2352877507,0,1,0,0,1
2352931100,1,0,0,0,1
2352932324,1,0,0,0,1
2353252352,1,0,0,0,1
2353410098,0,1,0,0,1
2353448540,0,1,0,0,1
2353521769,1,0,0,0,1
2353772744,0,1,0,0,1
2354232001,0,1,0,0,1
2354563143,0,1,0,0,1
2354581284,0,0,0,1,1
2354616498,0,1,0,0,1
2354622078,0,1,0,0,1
2354785563,0,1,0,0,1
2354791910,0,1,0,0,1
2350913237,1,0,0,0,1
2350746685,0,1,0,0,1
2328631903,0,1,0,0,1
2350590103,1,0,0,0,1
2346654413,0,1,0,0,1
2346756910,0,1,0,0,1
2346982689,0,1,0,0,1
2347067106,0,1,0,0,1
2347086882,0,1,0,0,1
2347137681,0,1,0,0,1
2347336459,0,1,0,0,1
2347709386,0,1,0,0,1
2347955132,0,1,0,0,1
2348139990,0,1,0,0,1
2348156000,0,1,0,0,1
2348220980,0,1,0,0,1
2348240124,0,1,0,0,1
2348401574,0,1,0,0,1
2348802767,0,1,0,0,1
2348901577,0,1,0,0,1
2348995775,0,1,0,0,1
2349681720,0,1,0,0,1
2349687032,0,1,0,0,1
2349869821,0,0,0,1,1
2350221511,0,1,0,0,1
2350531227,0,1,0,0,1
2350577131,0,1,0,0,1
2355003128,0,1,0,0,1
2355008339,0,1,0,0,1
2355030013,1,0,0,0,1
2355177074,0,1,0,0,1
2359204686,0,1,0,0,1
2359224652,0,1,0,0,1
2359235741,0,1,0,0,1
2359271556,1,0,0,0,1
2359300338,1,0,0,0,1
2359370768,1,0,0,0,1
2359483840,0,1,0,0,1
2359674654,1,0,0,0,1
2359744579,1,0,0,0,1
2359834009,0,1,0,0,1
2360149560,0,1,0,0,1
2360400351,0,1,0,0,1
2360521515,0,1,0,0,1
2360546707,0,0,1,0,1
2360618461,0,1,0,0,1
2360770258,0,1,0,0,1
2360922127,0,1,0,0,1
2361035329,1,0,0,0,1
2361150502,0,1,0,0,1
2361158092,0,1,0,0,1
2361305564,0,1,0,0,1
2361795813,0,1,0,0,1
2361829127,0,1,0,0,1
2358928099,0,1,0,0,1
2358509347,0,1,0,0,1
2358402818,0,1,0,0,1
2357537334,0,1,0,0,1
2355177415,0,1,0,0,1
2355493537,0,1,0,0,1
2355581769,0,1,0,0,1
2356067228,0,1,0,0,1
2356210878,0,1,0,0,1
2356310243,0,1,0,0,1
2356340755,0,1,0,0,1
2356344886,0,1,0,0,1
2357286365,0,1,0,0,1
2357332300,0,1,0,0,1
2357556486,0,1,0,0,1
2358299761,0,1,0,0,1
2357587430,0,1,0,0,1
2357605077,1,0,0,0,1
2357623497,0,1,0,0,1
2357676812,0,1,0,0,1
2357795346,0,1,0,0,1
2357847728,0,1,0,0,1
2358098252,0,0,0,1,1
2358098395,0,1,0,0,1
2358124573,1,0,0,0,1
2358131448,1,0,0,0,1
2346606044,0,1,0,0,1
2346532627,0,1,0,0,1
2346183282,1,0,0,0,1
2334705027,0,1,0,0,1
2332166776,0,1,0,0,1
2332185522,0,1,0,0,1
2332308560,0,1,0,0,1
2332841774,0,1,0,0,1
2332884151,0,1,0,0,1
2332956434,0,1,0,0,1
2333006212,0,0,0,1,1
2333043124,1,0,0,0,1
2333176204,0,1,0,0,1
2333250559,1,0,0,0,1
2333256402,0,1,0,0,1
2333417380,0,1,0,0,1
2333611204,0,1,0,0,1
2333620068,0,1,0,0,1
2333653658,0,1,0,0,1
2333706258,0,1,0,0,1
2333802079,0,1,0,0,1
2333883524,0,0,0,1,1
2334135024,0,1,0,0,1
2334173268,0,1,0,0,1
2334178159,0,1,0,0,1
2334187626,0,1,0,0,1
2334273306,0,0,0,1,1
2332110332,0,1,0,0,1
2332038666,1,0,0,0,1
2331893145,0,1,0,0,1
2330211297,0,1,0,0,1
2328679191,0,1,0,0,1
2328740743,0,1,0,0,1
2328793673,0,1,0,0,1
2328931053,0,1,0,0,1
2329082592,0,1,0,0,1
2329372044,0,1,0,0,1
2329544108,0,0,1,0,1
2329566034,0,1,0,0,1
2329688792,0,1,0,0,1
2329770158,1,0,0,0,1
2330263268,0,1,0,0,1
2331747457,1,0,0,0,1
2330453494,0,1,0,0,1
2330481427,1,0,0,0,1
2330614753,0,1,0,0,1
2330775961,0,1,0,0,1
2331103761,0,1,0,0,1
2331109658,0,1,0,0,1
2331235970,1,0,0,0,1
2331334268,0,1,0,0,1
2331457486,0,1,0,0,1
2331469476,1,0,0,0,1
2334651606,0,1,0,0,1
2334805519,1,0,0,0,1
2345946708,0,1,0,0,1
2335125719,1,0,0,0,1
2342185012,0,1,0,0,1
2342408550,0,1,0,0,1
2342483387,0,1,0,0,1
2342524764,0,1,0,0,1
2343118079,0,1,0,0,1
2343225255,0,1,0,0,1
2343430251,0,1,0,0,1
2343474978,0,1,0,0,1
2343801661,0,1,0,0,1
2343872651,0,1,0,0,1
2343959922,0,1,0,0,1
2343994494,1,0,0,0,1
2344127426,0,1,0,0,1
2344837092,0,1,0,0,1
2344877839,0,1,0,0,1
2344913904,0,1,0,0,1
2345001097,1,0,0,0,1
2345334790,0,1,0,0,1
2345479837,0,1,0,0,1
2345579792,0,1,0,0,1
2345732674,0,1,0,0,1
2345872214,0,1,0,0,1
2345903802,0,1,0,0,1
2342090749,1,0,0,0,1
2342028536,0,1,0,0,1
2341748580,0,1,0,0,1
2337344604,0,1,0,0,1
2335178122,0,1,0,0,1
2335200572,0,1,0,0,1
2335529096,0,1,0,0,1
2336049340,1,0,0,0,1
2336140568,0,1,0,0,1
2336556793,0,1,0,0,1
2336848224,1,0,0,0,1
2336986856,0,1,0,0,1
2336998602,0,1,0,0,1
2337036676,0,1,0,0,1
2337483975,0,1,0,0,1
2341568119,1,0,0,0,1
2337846439,0,1,0,0,1
2338048561,0,1,0,0,1
2338338720,0,1,0,0,1
2338506481,0,1,0,0,1
2340048791,1,0,0,0,1
2340747483,0,1,0,0,1
2340812917,0,1,0,0,1
2341083257,0,1,0,0,1
2341327854,0,1,0,0,1
2341426232,0,1,0,0,1
2291497802,0,1,0,0,1
2291476435,1,0,0,0,1
2291456464,0,1,0,0,1
2240018450,0,1,0,0,1
2240209188,0,1,0,0,1
2240249238,0,1,0,0,1
2240365320,0,1,0,0,1
2240387503,0,1,0,0,1
2240545398,0,1,0,0,1
2240686866,0,1,0,0,1
2241594340,0,1,0,0,1
2241751753,1,0,0,0,1
2241809218,0,1,0,0,1
2241978086,1,0,0,0,1
2242438423,1,0,0,0,1
2242553484,0,0,1,0,1
2242737217,0,1,0,0,1
2242825508,0,1,0,0,1
2243200838,0,1,0,0,1
2243490855,0,1,0,0,1
2243532568,0,1,0,0,1
2243657346,0,1,0,0,1
2243785218,0,1,0,0,1
2244618760,0,1,0,0,1
2245182109,0,1,0,0,1
2245399752,0,1,0,0,1
2245582398,0,1,0,0,1
2240182548,0,1,0,0,1
2239497228,0,1,0,0,1
2255059133,0,0,1,0,1
2239468784,0,1,0,0,1
2235444004,0,1,0,0,1
2235790885,0,0,1,0,1
2235799094,0,1,0,0,1
2235856910,1,0,0,0,1
2236010026,0,1,0,0,1
2236352803,1,0,0,0,1
2236600231,0,0,0,1,1
2236761427,0,1,0,0,1
2237086243,0,1,0,0,1
2237178240,0,1,0,0,1
2237244291,0,1,0,0,1
2237386848,0,1,0,0,1
2237517263,0,1,0,0,1
2237581969,0,1,0,0,1
2237590525,1,0,0,0,1
2237802138,0,1,0,0,1
2237931124,0,1,0,0,1
2238099501,0,1,0,0,1
2238662362,0,1,0,0,1
2238672066,0,1,0,0,1
2239119668,0,1,0,0,1
2239281536,0,1,0,0,1
2239468682,0,1,0,0,1
2245797112,0,1,0,0,1
2245906563,0,1,0,0,1
2245928652,0,1,0,0,1
2246184436,0,1,0,0,1
2251567251,1,0,0,0,1
2251619396,0,1,0,0,1
2251623588,1,0,0,0,1
2251656066,0,1,0,0,1
2251807837,0,1,0,0,1
2251965140,1,0,0,0,1
2252025671,0,1,0,0,1
2252393244,0,1,0,0,1
2252397206,0,1,0,0,1
2252508086,0,1,0,0,1
2252509113,0,1,0,0,1
2252974998,0,1,0,0,1
2253098721,0,1,0,0,1
2253130465,1,0,0,0,1
2253165734,0,1,0,0,1
2253351241,0,0,1,0,1
2253501315,0,1,0,0,1
2254028459,0,1,0,0,1
2254059191,0,1,0,0,1
2254063149,0,1,0,0,1
2254164436,0,1,0,0,1
2254251620,0,0,0,1,1
2254626906,0,1,0,0,1
2251530702,0,1,0,0,1
2250881554,0,1,0,0,1
2250642826,0,1,0,0,1
2247869230,0,1,0,0,1
2246488948,0,1,0,0,1
2246675666,0,1,0,0,1
2247483085,0,1,0,0,1
2247493010,0,1,0,0,1
2247523105,0,1,0,0,1
2247600716,0,1,0,0,1
2247677688,0,1,0,0,1
2247708770,0,1,0,0,1
2247798150,0,1,0,0,1
2247825636,0,1,0,0,1
2248055895,0,1,0,0,1
2250622285,0,0,0,1,1
2248468338,1,0,0,0,1
2249692549,1,0,0,0,1
2249711324,0,1,0,0,1
2249914379,0,0,0,1,1
2250140766,0,1,0,0,1
2250174402,0,1,0,0,1
2250193009,1,0,0,0,1
2250247718,0,0,1,0,1
2250298345,0,1,0,0,1
2250352080,0,1,0,0,1
2235410248,0,1,0,0,1
2235382185,0,0,0,1,1
2235288949,0,1,0,0,1
2226127117,0,0,0,1,1
2221693068,0,1,0,0,1
2221770924,0,1,0,0,1
2222105617,1,0,0,0,1
2222267293,1,0,0,0,1
2222626199,0,1,0,0,1
2222768225,1,0,0,0,1
2223034503,1,0,0,0,1
2223241693,0,1,0,0,1
2223263976,0,1,0,0,1
2223490351,0,1,0,0,1
2223498628,0,1,0,0,1
2223913487,0,1,0,0,1
2224317068,0,1,0,0,1
2224405021,0,1,0,0,1
2224406833,0,1,0,0,1
2224429806,0,1,0,0,1
2224693695,1,0,0,0,1
2224724551,0,1,0,0,1
2224752913,0,1,0,0,1
2225202657,0,1,0,0,1
2225465337,0,1,0,0,1
2225622864,0,1,0,0,1
2226104486,0,1,0,0,1
2221618932,1,0,0,0,1
2221510760,1,0,0,0,1
2221376334,0,0,1,0,1
2219321389,0,1,0,0,1
2217010890,1,0,0,0,1
2217304727,0,1,0,0,1
2217478717,0,1,0,0,1
2217651821,0,1,0,0,1
2217862420,0,1,0,0,1
2218258581,0,1,0,0,1
2218276472,0,1,0,0,1
2218500560,0,1,0,0,1
2218742450,0,1,0,0,1
2219020149,0,1,0,0,1
2219324889,0,1,0,0,1
2221095269,1,0,0,0,1
2219475688,0,1,0,0,1
2219593358,0,1,0,0,1
2219731562,0,1,0,0,1
2219790688,1,0,0,0,1
2219821589,0,1,0,0,1
2219821721,1,0,0,0,1
2219954400,0,1,0,0,1
2220220323,0,1,0,0,1
2220291312,0,1,0,0,1
2220305220,1,0,0,0,1
2226114267,0,1,0,0,1
2226158758,0,1,0,0,1
2235262024,0,0,0,1,1
2226173657,0,1,0,0,1
2231114442,1,0,0,0,1
2231222515,0,1,0,0,1
2231406593,0,1,0,0,1
2231469444,1,0,0,0,1
2231626878,0,1,0,0,1
2231853109,0,1,0,0,1
2231964794,1,0,0,0,1
2232117852,0,1,0,0,1
2232241450,0,1,0,0,1
2232536173,0,0,0,1,1
2232660313,0,1,0,0,1
2232683874,0,1,0,0,1
2233084011,0,1,0,0,1
2233200536,0,1,0,0,1
2233231645,1,0,0,0,1
2233271315,0,1,0,0,1
2233423045,0,1,0,0,1
2233845821,0,1,0,0,1
2233968932,0,1,0,0,1
2234170082,0,1,0,0,1
2234189967,1,0,0,0,1
2234571420,0,1,0,0,1
2234670824,1,0,0,0,1
2230772866,0,1,0,0,1
2230396460,0,1,0,0,1
2230388154,0,1,0,0,1
2228020669,0,0,0,1,1
2226695562,0,1,0,0,1
2226861025,0,1,0,0,1
2227135020,0,1,0,0,1
2227146003,0,1,0,0,1
2227280432,0,1,0,0,1
2227354697,1,0,0,0,1
2227488127,0,1,0,0,1
2227681235,0,1,0,0,1
2227902373,1,0,0,0,1
2228012232,0,1,0,0,1
2228083261,0,1,0,0,1
2230186897,0,0,0,1,1
2228116250,1,0,0,0,1
2228357358,0,1,0,0,1
2229063668,0,1,0,0,1
2229241488,1,0,0,0,1
2229434286,0,1,0,0,1
2229513470,0,1,0,0,1
2229586598,0,1,0,0,1
2229595652,0,1,0,0,1
2229718093,0,1,0,0,1
2230137894,0,1,0,0,1
2254779152,0,1,0,0,1
2255802015,0,1,0,0,1
2291398700,0,1,0,0,1
2279014686,0,1,0,0,1
2279091664,0,1,0,0,1
2279201796,0,1,0,0,1
2279336216,1,0,0,0,1
2279375599,0,1,0,0,1
2279491738,0,1,0,0,1
2279593975,0,1,0,0,1
2280210907,0,1,0,0,1
2280330452,0,1,0,0,1
2280369704,0,1,0,0,1
2280409224,0,1,0,0,1
2280559488,1,0,0,0,1
2280663331,1,0,0,0,1
2280877459,0,1,0,0,1
2281140840,0,1,0,0,1
2281423802,0,1,0,0,1
2281582659,0,1,0,0,1
2282082739,0,1,0,0,1
2282317296,0,1,0,0,1
2282365522,0,1,0,0,1
2282855059,0,1,0,0,1
2282863950,0,1,0,0,1
2282959412,0,1,0,0,1
2283009811,0,1,0,0,1
2279085575,0,1,0,0,1
2278979910,1,0,0,0,1
2255933213,0,1,0,0,1
2278968056,0,1,0,0,1
2274798636,0,1,0,0,1
2274822141,0,1,0,0,1
2274879692,0,0,1,0,1
2275195015,0,1,0,0,1
2275331414,0,1,0,0,1
2275476615,0,1,0,0,1
2275644295,0,1,0,0,1
2276004580,0,1,0,0,1
2276066905,1,0,0,0,1
2276124481,1,0,0,0,1
2276335519,1,0,0,0,1
2276447029,0,1,0,0,1
2276505650,0,1,0,0,1
2276566617,0,1,0,0,1
2276713440,0,1,0,0,1
2277152714,0,0,1,0,1
2277342956,0,1,0,0,1
2277548311,1,0,0,0,1
2277709777,0,1,0,0,1
2278209985,0,1,0,0,1
2278336118,0,1,0,0,1
2278739467,0,1,0,0,1
2278768903,1,0,0,0,1
2283201632,0,1,0,0,1
2283277578,0,1,0,0,1
2283568716,0,1,0,0,1
2283570181,0,1,0,0,1
2287473749,1,0,0,0,1
2287487594,0,1,0,0,1
2287644291,0,1,0,0,1
2287767855,0,1,0,0,1
2288188394,0,1,0,0,1
2288193259,0,1,0,0,1
2288400286,0,1,0,0,1
2288482238,0,1,0,0,1
2288515392,1,0,0,0,1
2288609017,0,1,0,0,1
2288693980,0,1,0,0,1
2289042561,0,1,0,0,1
2289109550,0,1,0,0,1
2289169484,0,1,0,0,1
2289222920,0,1,0,0,1
2289724413,0,1,0,0,1
2289824455,0,1,0,0,1
2290247365,0,1,0,0,1
2290519909,1,0,0,0,1
2290708108,0,1,0,0,1
2290720760,0,1,0,0,1
2290850979,0,1,0,0,1
2291004332,1,0,0,0,1
2287406312,0,0,0,1,1
2287387226,0,1,0,0,1
2287192201,0,1,0,0,1
2285019716,0,1,0,0,1
2283596156,0,1,0,0,1
2283796556,0,1,0,0,1
2283806648,0,1,0,0,1
2283917927,0,1,0,0,1
2283962508,0,1,0,0,1
2283999349,0,1,0,0,1
2284236776,0,1,0,0,1
2284429180,0,1,0,0,1
2284833920,0,1,0,0,1
2284924063,0,1,0,0,1
2285179724,0,1,0,0,1
2286985856,0,1,0,0,1
2285209364,0,1,0,0,1
2285396137,1,0,0,0,1
2285433054,1,0,0,0,1
2285813462,0,1,0,0,1
2286002744,0,1,0,0,1
2286335782,1,0,0,0,1
2286603997,0,1,0,0,1
2286711835,0,1,0,0,1
2286807202,0,1,0,0,1
2286933924,0,1,0,0,1
2274744805,0,1,0,0,1
2274515473,0,1,0,0,1
2274282468,1,0,0,0,1
2264633331,1,0,0,0,1
2260625942,0,1,0,0,1
2260916422,0,1,0,0,1
2260926252,0,0,0,1,1
2261127930,0,1,0,0,1
2261300162,0,1,0,0,1
2261358530,0,1,0,0,1
2261407591,0,1,0,0,1
2261423075,0,1,0,0,1
2261592464,0,0,0,1,1
2261664719,0,1,0,0,1
2261697469,0,1,0,0,1
2262033315,0,1,0,0,1
2262623145,1,0,0,0,1
2262672047,0,1,0,0,1
2262746478,0,1,0,0,1
2263277105,0,1,0,0,1
2263309039,0,1,0,0,1
2263537004,0,1,0,0,1
2263896333,0,1,0,0,1
2264091236,0,1,0,0,1
2264094349,0,1,0,0,1
2264244880,0,1,0,0,1
2264299917,0,1,0,0,1
2260623020,0,1,0,0,1
2260610296,0,1,0,0,1
2260156285,1,0,0,0,1
2257479812,1,0,0,0,1
2256189711,0,1,0,0,1
2256343022,0,1,0,0,1
2256535349,0,1,0,0,1
2256577999,0,1,0,0,1
2256664812,0,1,0,0,1
2256758676,0,1,0,0,1
2256808534,0,1,0,0,1
2256844112,1,0,0,0,1
2257050779,0,1,0,0,1
2257399241,0,1,0,0,1
2257729962,0,0,0,1,1
2259883019,0,1,0,0,1
2258029963,0,1,0,0,1
2258530956,1,0,0,0,1
2258578862,0,1,0,0,1
2258656136,1,0,0,0,1
2259136370,1,0,0,0,1
2259260850,0,1,0,0,1
2259278233,0,1,0,0,1
2259290058,0,1,0,0,1
2259291457,0,1,0,0,1
2259400236,0,1,0,0,1
2264368740,0,1,0,0,1
2264963942,0,1,0,0,1
2274191227,1,0,0,0,1
2265389035,0,1,0,0,1
2270430701,0,1,0,0,1
2270485208,0,1,0,0,1
2270776643,1,0,0,0,1
2271203799,0,1,0,0,1
2271266281,0,1,0,0,1
2271308180,1,0,0,0,1
2271496906,0,1,0,0,1
2271722924,1,0,0,0,1
2271745569,0,1,0,0,1
2271821448,1,0,0,0,1
2271853409,0,1,0,0,1
2271871099,0,1,0,0,1
2272140763,1,0,0,0,1
2272532133,0,1,0,0,1
2272653169,0,1,0,0,1
2272682382,0,1,0,0,1
2272857968,1,0,0,0,1
2273235625,0,1,0,0,1
2273281265,0,1,0,0,1
2273854980,0,1,0,0,1
2273872578,1,0,0,0,1
2274010004,0,1,0,0,1
2274064880,0,1,0,0,1
2269997563,0,1,0,0,1
2269816479,0,1,0,0,1
2269773287,0,1,0,0,1
2267200253,0,1,0,0,1
2265444174,0,1,0,0,1
2265740082,1,0,0,0,1
2265752738,0,1,0,0,1
2265838652,0,1,0,0,1
2266321302,1,0,0,0,1
2266507087,0,0,0,1,1
2266771237,0,1,0,0,1
2266847354,0,1,0,0,1
2266878650,0,1,0,0,1
2267049964,0,1,0,0,1
2267257792,0,1,0,0,1
2269428282,0,1,0,0,1
2267355079,0,1,0,0,1
2267421440,0,1,0,0,1
2267533428,0,0,1,0,1
2268278591,0,1,0,0,1
2268300327,0,1,0,0,1
2268377358,0,1,0,0,1
2268762519,0,1,0,0,1
2268785065,0,1,0,0,1
2268907010,0,1,0,0,1
2269148401,0,1,0,0,1
2361931375,0,1,0,0,1
2362020732,1,0,0,0,1
2362459472,0,1,0,0,1
2472625590,0,1,0,0,1
2472768241,0,1,0,0,1
2472794269,0,1,0,0,1
2472836318,0,1,0,0,1
2472901279,0,1,0,0,1
2472929239,0,1,0,0,1
2472933518,0,0,1,0,1
2473086906,0,1,0,0,1
2473593680,0,1,0,0,1
2473653708,0,1,0,0,1
2473688136,0,1,0,0,1
2473979328,0,1,0,0,1
2474045003,0,1,0,0,1
2474075587,0,1,0,0,1
2474248237,0,1,0,0,1
2474306678,0,1,0,0,1
2474327690,0,1,0,0,1
2474488859,0,1,0,0,1
2474993916,0,1,0,0,1
2475132354,0,1,0,0,1
2475136310,0,1,0,0,1
2475871507,0,1,0,0,1
2476665800,0,1,0,0,1
2476694326,0,1,0,0,1
2472634306,0,1,0,0,1
2472226650,0,1,0,0,1
2487139573,0,1,0,0,1
2471362375,0,1,0,0,1
2467660081,0,1,0,0,1
2467755562,0,1,0,0,1
2467819825,0,1,0,0,1
2468099712,0,0,1,0,1
2468188848,0,1,0,0,1
2468270414,0,1,0,0,1
2468613438,0,1,0,0,1
2468772421,1,0,0,0,1
2468772704,0,1,0,0,1
2468814350,0,1,0,0,1
2468974362,1,0,0,0,1
2469019154,0,1,0,0,1
2469119023,0,1,0,0,1
2469226585,0,1,0,0,1
2469659936,0,1,0,0,1
2469688502,0,1,0,0,1
2469818706,0,1,0,0,1
2469955999,0,1,0,0,1
2470385046,0,1,0,0,1
2470571581,0,1,0,0,1
2470607375,0,1,0,0,1
2470654450,0,1,0,0,1
2470885686,0,0,1,0,1
2476741068,0,1,0,0,1
2476791859,0,1,0,0,1
2476955115,0,1,0,0,1
2477045054,0,1,0,0,1
2481667891,0,1,0,0,1
2481729036,0,1,0,0,1
2482165058,0,1,0,0,1
2482273187,0,1,0,0,1
2482662199,0,1,0,0,1
2482753098,0,1,0,0,1
2483001517,1,0,0,0,1
2483480456,0,1,0,0,1
2483514674,0,1,0,0,1
2483722260,0,1,0,0,1
2483916618,0,1,0,0,1
2484359377,1,0,0,0,1
2484469382,0,1,0,0,1
2484582918,0,1,0,0,1
2484653909,1,0,0,0,1
2484732322,0,1,0,0,1
2485002769,0,0,1,0,1
2485350541,0,1,0,0,1
2485455396,1,0,0,0,1
2485595705,0,1,0,0,1
2485652904,0,1,0,0,1
2485943929,1,0,0,0,1
2486714888,0,1,0,0,1
2481531408,1,0,0,0,1
2481284955,0,1,0,0,1
2480827290,0,1,0,0,1
2478436560,0,1,0,0,1
2477246450,0,1,0,0,1
2477450310,0,1,0,0,1
2477767495,0,1,0,0,1
2477801042,1,0,0,0,1
2477815694,0,1,0,0,1
2477877351,0,1,0,0,1
2478227383,0,1,0,0,1
2478249674,0,1,0,0,1
2478388759,0,1,0,0,1
2478419321,0,1,0,0,1
2478466331,0,1,0,0,1
2480341400,0,1,0,0,1
2478605490,0,1,0,0,1
2478688363,0,1,0,0,1
2478828037,0,1,0,0,1
2478834007,0,1,0,0,1
2478979537,1,0,0,0,1
2479129304,0,1,0,0,1
2479355117,0,1,0,0,1
2479497972,0,1,0,0,1
2479551114,0,1,0,0,1
2479714748,0,1,0,0,1
2467367264,0,1,0,0,1
2467160474,0,1,0,0,1
2467149814,0,1,0,0,1
2459263417,1,0,0,0,1
2451423853,0,1,0,0,1
2451521104,0,1,0,0,1
2451715509,0,0,0,1,1
2451745256,0,1,0,0,1
2451829627,0,1,0,0,1
2452003635,0,1,0,0,1
2452228477,1,0,0,0,1
2452228946,1,0,0,0,1
2453030837,0,1,0,0,1
2453363600,0,1,0,0,1
2453542814,0,1,0,0,1
2453655560,0,1,0,0,1
2453951322,0,1,0,0,1
2454374396,0,1,0,0,1
2454702073,1,0,0,0,1
2455747939,0,1,0,0,1
2455922660,1,0,0,0,1
2456187824,0,1,0,0,1
2456193296,0,1,0,0,1
2456481103,0,1,0,0,1
2456705701,0,1,0,0,1
2457455335,0,1,0,0,1
2457921453,0,1,0,0,1
2451419160,1,0,0,0,1
2451078174,0,1,0,0,1
2451032582,0,1,0,0,1
2449325702,0,1,0,0,1
2447821566,0,1,0,0,1
2447945598,0,1,0,0,1
2448017844,0,1,0,0,1
2448047580,0,1,0,0,1
2448873247,0,0,0,1,1
2448902354,0,1,0,0,1
2449086234,0,1,0,0,1
2449116398,0,1,0,0,1
2449197925,0,1,0,0,1
2449303087,0,1,0,0,1
2449488088,0,1,0,0,1
2450573117,0,1,0,0,1
2449585777,0,1,0,0,1
2449685190,0,1,0,0,1
2449993868,1,0,0,0,1
2450052127,0,1,0,0,1
2450143446,0,1,0,0,1
2450165395,0,0,0,1,1
2450265194,0,1,0,0,1
2450370147,1,0,0,0,1
2450395196,0,1,0,0,1
2450569328,0,0,1,0,1
2458381672,1,0,0,0,1
2459359045,0,0,0,1,1
2467069506,0,1,0,0,1
2459484445,0,1,0,0,1
2464525653,0,1,0,0,1
2464554291,0,1,0,0,1
2464723792,0,1,0,0,1
2464749917,0,1,0,0,1
2464865196,0,1,0,0,1
2464962619,0,1,0,0,1
2465023798,0,1,0,0,1
2465179476,0,1,0,0,1
2465185994,0,1,0,0,1
2465192153,0,1,0,0,1
2465366594,0,1,0,0,1
2465564594,0,1,0,0,1
2465907259,0,1,0,0,1
2465959009,0,1,0,0,1
2465973843,0,1,0,0,1
2466260730,1,0,0,0,1
2466392412,0,1,0,0,1
2466535273,0,1,0,0,1
2466642260,1,0,0,0,1
2466649536,0,1,0,0,1
2466650316,0,1,0,0,1
2466792789,0,1,0,0,1
2467006961,0,1,0,0,1
2464329204,0,1,0,0,1
2464181361,0,1,0,0,1
2464089779,0,1,0,0,1
2462099926,0,1,0,0,1
2459498750,0,0,0,1,1
2459612753,0,1,0,0,1
2459930668,0,1,0,0,1
2459998865,0,1,0,0,1
2460188635,0,1,0,0,1
2460217522,0,1,0,0,1
2460631121,0,1,0,0,1
2460645168,0,1,0,0,1
2461086096,0,1,0,0,1
2461135749,0,1,0,0,1
2462209320,0,1,0,0,1
2463674797,1,0,0,0,1
2462223424,0,1,0,0,1
2462360928,0,1,0,0,1
2462814708,1,0,0,0,1
2462820596,1,0,0,0,1
2462840540,0,1,0,0,1
2462982160,1,0,0,0,1
2463173106,0,1,0,0,1
2463421981,0,1,0,0,1
2463434401,0,1,0,0,1
2463502856,0,1,0,0,1
2486762587,0,1,0,0,1
2487312195,0,1,0,0,1
2447574735,0,1,0,0,1
2511788401,0,1,0,0,1
2512259486,0,1,0,0,1
2512281381,0,1,0,0,1
2512285442,1,0,0,0,1
2512305747,0,1,0,0,1
2512527336,0,1,0,0,1
2512829383,0,1,0,0,1
2512884929,0,1,0,0,1
2513251249,0,1,0,0,1
2513272961,0,1,0,0,1
2513659550,0,1,0,0,1
2514247237,0,0,0,1,1
2514594099,0,1,0,0,1
2514842049,0,1,0,0,1
2514919253,0,0,0,1,1
2515374132,0,1,0,0,1
2515381248,0,1,0,0,1
2515384483,0,1,0,0,1
2515501114,0,1,0,0,1
2515762442,0,1,0,0,1
2516002008,0,1,0,0,1
2516303313,0,1,0,0,1
2516977057,0,1,0,0,1
2517222948,1,0,0,0,1
2511877655,0,1,0,0,1
2511624918,1,0,0,0,1
2487353270,0,1,0,0,1
2511591120,0,1,0,0,1
2507680435,0,1,0,0,1
2507735329,0,1,0,0,1
2507858702,0,0,0,1,1
2508149231,0,1,0,0,1
2508183978,0,1,0,0,1
2508434451,1,0,0,0,1
2508715440,0,1,0,0,1
2508956972,0,1,0,0,1
2508964161,0,1,0,0,1
2509059331,1,0,0,0,1
2509637626,0,0,0,1,1
2509792734,0,1,0,0,1
2509815646,0,0,0,1,1
2510370751,0,1,0,0,1
2510406727,0,1,0,0,1
2510866183,1,0,0,0,1
2510918743,0,1,0,0,1
2511027073,1,0,0,0,1
2511033825,1,0,0,0,1
2511106503,0,1,0,0,1
2511400660,0,1,0,0,1
2511540612,0,1,0,0,1
2511591006,0,1,0,0,1
2517300188,0,1,0,0,1
2518293889,0,1,0,0,1
2518608312,0,1,0,0,1
2518656367,1,0,0,0,1
2526210542,0,1,0,0,1
2526548580,0,1,0,0,1
2526701431,0,1,0,0,1
2526839006,0,0,0,1,1
2526918456,0,1,0,0,1
2526981853,0,0,0,1,1
2527274479,0,1,0,0,1
2527442347,0,1,0,0,1
2527581375,0,1,0,0,1
2527861154,0,1,0,0,1
2527884243,0,1,0,0,1
2528015815,1,0,0,0,1
2528152951,0,1,0,0,1
2528260089,0,0,1,0,1
2528422458,0,1,0,0,1
2528485523,0,1,0,0,1
2528629351,0,1,0,0,1
2528937404,0,1,0,0,1
2528956477,0,1,0,0,1
2529300740,0,0,0,1,1
2529620106,0,1,0,0,1
2529782803,1,0,0,0,1
2529975848,0,1,0,0,1
2526209393,0,1,0,0,1
2525725480,0,1,0,0,1
2525555750,0,1,0,0,1
2521957351,0,1,0,0,1
2518995455,0,1,0,0,1
2519314310,1,0,0,0,1
2519690888,1,0,0,0,1
2519881621,0,1,0,0,1
2520338473,0,0,0,1,1
2521085857,0,1,0,0,1
2521199910,1,0,0,0,1
2521250059,0,1,0,0,1
2521748297,0,1,0,0,1
2521875850,0,1,0,0,1
2522137987,1,0,0,0,1
2525213951,0,1,0,0,1
2522420166,0,1,0,0,1
2522676683,0,1,0,0,1
2522786789,0,1,0,0,1
2523082609,1,0,0,0,1
2523670254,0,1,0,0,1
2524417230,0,1,0,0,1
2524463203,0,1,0,0,1
2524635256,0,1,0,0,1
2525037225,0,1,0,0,1
2525205426,0,1,0,0,1
2507515393,0,0,1,0,1
2507476278,0,1,0,0,1
2507436594,0,1,0,0,1
2499057926,0,1,0,0,1
2494671634,0,1,0,0,1
2494825562,0,1,0,0,1
2494885987,1,0,0,0,1
2494903650,0,1,0,0,1
2495314252,0,1,0,0,1
2495514099,0,1,0,0,1
2495781058,0,1,0,0,1
2495833864,0,1,0,0,1
2495871908,0,1,0,0,1
2496039721,0,1,0,0,1
2496146816,0,1,0,0,1
2496712704,0,1,0,0,1
2496940087,0,1,0,0,1
2497076026,0,1,0,0,1
2497278727,0,1,0,0,1
2497408796,0,1,0,0,1
2497624522,0,1,0,0,1
2497782795,0,1,0,0,1
2497785842,0,1,0,0,1
2497816482,0,1,0,0,1
2498419316,1,0,0,0,1
2498778206,1,0,0,0,1
2498789521,1,0,0,0,1
2494652328,0,1,0,0,1
2494496909,0,0,1,0,1
2494389378,0,1,0,0,1
2491202886,0,1,0,0,1
2487819390,0,1,0,0,1
2488714124,0,1,0,0,1
2489743364,1,0,0,0,1
2490204899,0,0,0,1,1
2490271783,1,0,0,0,1
2490300228,0,1,0,0,1
2490349278,0,1,0,0,1
2490393199,0,1,0,0,1
2490420633,0,1,0,0,1
2490589963,0,1,0,0,1
2491210862,1,0,0,0,1
2494306641,1,0,0,0,1
2491647301,0,1,0,0,1
2491929925,0,1,0,0,1
2492170019,0,1,0,0,1
2492409644,0,1,0,0,1
2492659458,0,1,0,0,1
2492928696,0,1,0,0,1
2493200410,0,1,0,0,1
2493575114,0,1,0,0,1
2493641888,0,1,0,0,1
2494199648,0,1,0,0,1
2499000032,0,1,0,0,1
2499166676,0,1,0,0,1
2507326184,1,0,0,0,1
2499186157,0,1,0,0,1
2503711753,0,1,0,0,1
2504116062,0,1,0,0,1
2504265204,0,1,0,0,1
2504333137,0,1,0,0,1
2504669124,1,0,0,0,1
2504676696,1,0,0,0,1
2504861719,0,1,0,0,1
2504987015,0,1,0,0,1
2505201949,0,1,0,0,1
2505220368,0,1,0,0,1
2505310080,1,0,0,0,1
2505526325,1,0,0,0,1
2505706561,0,1,0,0,1
2505724730,0,1,0,0,1
2506209671,0,1,0,0,1
2506657652,0,1,0,0,1
2506724073,0,1,0,0,1
2506747449,1,0,0,0,1
2506812323,0,1,0,0,1
2506931443,0,1,0,0,1
2506947489,0,1,0,0,1
2506952625,0,1,0,0,1
2507159743,0,0,1,0,1
2503632811,0,1,0,0,1
2503314593,0,1,0,0,1
2503226454,0,1,0,0,1
2501204183,0,1,0,0,1
2499199819,0,1,0,0,1
2499488566,0,1,0,0,1
2499721377,1,0,0,0,1
2499885546,0,1,0,0,1
2500030837,0,1,0,0,1
2500126551,0,0,0,1,1
2500325279,0,1,0,0,1
2500384687,1,0,0,0,1
2500869889,0,1,0,0,1
2501179660,0,1,0,0,1
2501264892,0,1,0,0,1
2502954064,1,0,0,0,1
2501355202,0,1,0,0,1
2501902683,0,1,0,0,1
2502127908,0,1,0,0,1
2502131693,0,1,0,0,1
2502242470,0,1,0,0,1
2502264072,1,0,0,0,1
2502264252,0,1,0,0,1
2502342116,0,1,0,0,1
2502400476,1,0,0,0,1
2502418510,0,1,0,0,1
2447675676,0,1,0,0,1
2447544176,0,1,0,0,1
2362647106,0,1,0,0,1
2386237696,0,1,0,0,1
2386507988,1,0,0,0,1
2386593975,0,1,0,0,1
2386704499,0,1,0,0,1
2386972507,0,1,0,0,1
2387168466,0,1,0,0,1
2387427039,0,1,0,0,1
2387467231,0,1,0,0,1
2387776356,0,1,0,0,1
2387835708,0,1,0,0,1
2387882450,0,1,0,0,1
2387942455,0,1,0,0,1
2387949241,0,0,0,1,1
2388162619,0,1,0,0,1
2388368948,0,1,0,0,1
2388384529,0,1,0,0,1
2388751302,0,0,1,0,1
2389237039,0,1,0,0,1
2389613881,0,1,0,0,1
2389659202,0,0,0,1,1
2389841292,0,1,0,0,1
2389901221,0,1,0,0,1
2390095113,1,0,0,0,1
2390365909,0,1,0,0,1
2386445247,0,1,0,0,1
2386146357,0,1,0,0,1
2403255554,0,1,0,0,1
2386024680,0,1,0,0,1
2381913703,0,1,0,0,1
2382134646,1,0,0,0,1
2382672926,1,0,0,0,1
2382690786,0,0,0,1,1
2382763088,0,1,0,0,1
2382921032,0,1,0,0,1
2383377214,0,1,0,0,1
2383658384,0,0,0,1,1
2383682650,0,1,0,0,1
2383839007,0,1,0,0,1
2383869451,0,1,0,0,1
2383880276,0,1,0,0,1
2384128561,0,1,0,0,1
2384260436,0,1,0,0,1
2384328217,0,1,0,0,1
2384856998,0,1,0,0,1
2385073670,0,1,0,0,1
2385108672,0,1,0,0,1
2385365143,0,1,0,0,1
2385562807,1,0,0,0,1
2385687729,1,0,0,0,1
2385772675,0,1,0,0,1
2385822686,0,1,0,0,1
2390789186,0,1,0,0,1
2390896625,0,1,0,0,1
2391074729,0,1,0,0,1
2391138650,0,0,0,1,1
2399335266,0,1,0,0,1
2399374704,0,1,0,0,1
2399391152,0,0,0,1,1
2399658622,0,1,0,0,1
2399908477,0,1,0,0,1
2399918244,0,1,0,0,1
2400091544,0,1,0,0,1
2400394072,0,1,0,0,1
2400512797,0,1,0,0,1
2401187007,0,1,0,0,1
2402084455,0,1,0,0,1
2402139452,0,1,0,0,1
2402173582,1,0,0,0,1
2402175344,0,1,0,0,1
2402229505,1,0,0,0,1
2402494129,0,1,0,0,1
2402586186,0,1,0,0,1
2402653372,0,1,0,0,1
2402674131,0,1,0,0,1
2402881315,0,1,0,0,1
2402985913,0,0,1,0,1
2402993234,0,1,0,0,1
2403145499,0,1,0,0,1
2399070859,0,1,0,0,1
2398942983,0,1,0,0,1
2398621638,0,1,0,0,1
2394774110,0,0,0,1,1
2391873054,0,1,0,0,1
2391909106,0,1,0,0,1
2392288916,0,1,0,0,1
2392434442,0,1,0,0,1
2392590146,0,1,0,0,1
2392708685,0,1,0,0,1
2392873407,0,1,0,0,1
2393548910,0,1,0,0,1
2394041364,0,1,0,0,1
2394241402,0,1,0,0,1
2395029696,1,0,0,0,1
2398008568,0,1,0,0,1
2395127166,0,1,0,0,1
2395808032,0,1,0,0,1
2396207054,0,1,0,0,1
2396320800,0,1,0,0,1
2396711000,1,0,0,0,1
2396853595,0,1,0,0,1
2397194341,0,1,0,0,1
2397396445,0,1,0,0,1
2397591205,0,1,0,0,1
2397957276,0,1,0,0,1
2381548147,0,1,0,0,1
2380832109,0,1,0,0,1
2380365501,1,0,0,0,1
2370681942,0,1,0,0,1
2366792465,0,1,0,0,1
2366807751,1,0,0,0,1
2366853071,0,1,0,0,1
2366913864,0,1,0,0,1
2367438343,0,1,0,0,1
2367505849,0,1,0,0,1
2367593677,0,1,0,0,1
2367794635,0,1,0,0,1
2368341941,0,1,0,0,1
2368423954,0,1,0,0,1
2368538599,0,1,0,0,1
2368593176,0,1,0,0,1
2368644872,0,1,0,0,1
2368671830,0,1,0,0,1
2368921068,0,1,0,0,1
2369011878,0,1,0,0,1
2369240843,1,0,0,0,1
2369369958,0,1,0,0,1
2369526422,0,1,0,0,1
2369670836,0,1,0,0,1
2369912503,1,0,0,0,1
2370211525,0,0,1,0,1
2370318217,0,1,0,0,1
2366777941,0,1,0,0,1
2366714006,0,0,0,1,1
2366685349,0,1,0,0,1
2363941092,0,1,0,0,1
2362671020,0,1,0,0,1
2362866481,1,0,0,0,1
2363018685,0,1,0,0,1
2363023779,0,1,0,0,1
2363327379,1,0,0,0,1
2363638812,0,1,0,0,1
2363695327,0,1,0,0,1
2363748305,1,0,0,0,1
2363814434,0,1,0,0,1
2363838193,1,0,0,0,1
2364381623,0,1,0,0,1
2365977277,0,1,0,0,1
2364522544,0,1,0,0,1
2364557679,0,1,0,0,1
2364766740,0,1,0,0,1
2364926660,0,0,0,1,1
2365056612,0,1,0,0,1
2365298148,0,1,0,0,1
2365596017,0,1,0,0,1
2365678914,0,1,0,0,1
2365686348,1,0,0,0,1
2365961882,0,1,0,0,1
2370582704,0,1,0,0,1
2370712162,0,1,0,0,1
2380140919,0,1,0,0,1
2370857077,0,0,0,1,1
2375399655,0,1,0,0,1
2376116731,0,1,0,0,1
2376159683,0,1,0,0,1
2376598304,0,1,0,0,1
2377029420,0,1,0,0,1
2377140720,1,0,0,0,1
2377143224,0,1,0,0,1
2377209624,0,1,0,0,1
2377212589,0,1,0,0,1
2377218397,0,1,0,0,1
2377610209,0,1,0,0,1
2377674404,0,1,0,0,1
2378033804,0,1,0,0,1
2378134122,1,0,0,0,1
2378536310,0,1,0,0,1
2378607517,1,0,0,0,1
2378654494,0,1,0,0,1
2378920887,0,1,0,0,1
2378971314,0,1,0,0,1
2379112663,0,1,0,0,1
2379521413,0,1,0,0,1
2379676557,0,1,0,0,1
2379908842,1,0,0,0,1
2375393844,1,0,0,0,1
2375387906,0,1,0,0,1
2375366956,0,1,0,0,1
2373403225,0,1,0,0,1
2371036584,0,1,0,0,1
2371372388,0,1,0,0,1
2371587797,0,1,0,0,1
2372236614,0,1,0,0,1
2372605484,1,0,0,0,1
2372786791,0,1,0,0,1
2373038332,0,1,0,0,1
2373174403,1,0,0,0,1
2373190128,0,0,0,1,1
2373315960,0,0,0,1,1
2373431331,0,0,0,1,1
2374393724,0,1,0,0,1
2373506335,0,1,0,0,1
2373616566,0,1,0,0,1
2373690437,0,1,0,0,1
2373773624,0,1,0,0,1
2373784386,0,1,0,0,1
2373859070,0,1,0,0,1
2373893311,0,1,0,0,1
2373973558,0,1,0,0,1
2374160929,0,1,0,0,1
2374283540,0,1,0,0,1
2403205521,0,1,0,0,1
2403281177,0,1,0,0,1
2447447610,0,1,0,0,1
2430921445,0,1,0,0,1
2431269208,0,1,0,0,1
2431323279,0,1,0,0,1
2431416650,0,1,0,0,1
2431588123,0,1,0,0,1
2431852476,0,1,0,0,1
2432205906,0,1,0,0,1
2432331804,0,1,0,0,1
2432783488,0,1,0,0,1
2432834201,0,1,0,0,1
2433028296,0,1,0,0,1
2433382874,0,1,0,0,1
2433727884,1,0,0,0,1
2433739450,0,1,0,0,1
2433823210,0,1,0,0,1
2433868354,0,1,0,0,1
2433877307,0,1,0,0,1
2434183047,0,1,0,0,1
2434393119,0,1,0,0,1
2435217661,0,1,0,0,1
2435351292,0,1,0,0,1
2435414300,0,1,0,0,1
2435512668,0,0,0,1,1
2435561884,0,1,0,0,1
2431110584,1,0,0,0,1
2430853637,0,1,0,0,1
2403738209,0,1,0,0,1
2430834649,0,0,0,1,1
2425089821,0,1,0,0,1
2425182377,0,1,0,0,1
2425222690,0,1,0,0,1
2425767181,1,0,0,0,1
2426158287,0,1,0,0,1
2426305526,0,1,0,0,1
2426316045,0,1,0,0,1
2426475636,0,1,0,0,1
2426623708,0,1,0,0,1
2426872409,1,0,0,0,1
2426965062,1,0,0,0,1
2426971554,0,1,0,0,1
2427052340,0,1,0,0,1
2427670752,0,1,0,0,1
2428483130,1,0,0,0,1
2428704609,0,1,0,0,1
2428772213,0,1,0,0,1
2428971865,0,1,0,0,1
2429413841,1,0,0,0,1
2429449978,0,1,0,0,1
2429558571,0,1,0,0,1
2429672762,0,1,0,0,1
2430047996,0,1,0,0,1
2435725677,0,1,0,0,1
2436068857,0,1,0,0,1
2436119769,0,1,0,0,1
2436278386,0,1,0,0,1
2442212803,0,1,0,0,1
2442360146,0,1,0,0,1
2443275278,1,0,0,0,1
2443435536,1,0,0,0,1
2443698369,0,1,0,0,1
2444363703,0,1,0,0,1
2444682264,0,1,0,0,1
2444862195,1,0,0,0,1
2444963203,1,0,0,0,1
2445077768,0,1,0,0,1
2445222570,0,1,0,0,1
2445418620,0,1,0,0,1
2445509408,0,1,0,0,1
2445653082,0,1,0,0,1
2445726763,0,1,0,0,1
2445971846,0,1,0,0,1
2446306509,0,1,0,0,1
2446549729,0,1,0,0,1
2446934911,0,1,0,0,1
2447022181,0,1,0,0,1
2447055177,0,0,0,1,1
2447122007,1,0,0,0,1
2447362848,1,0,0,0,1
2442064505,0,1,0,0,1
2441714982,0,1,0,0,1
2441610590,1,0,0,0,1
2437809702,0,1,0,0,1
2436512806,0,1,0,0,1
2436520975,1,0,0,0,1
2436739682,0,1,0,0,1
2436741505,0,1,0,0,1
2436923719,0,1,0,0,1
2437178138,0,1,0,0,1
2437240579,0,1,0,0,1
2437311741,0,1,0,0,1
2437384901,0,1,0,0,1
2437423753,0,1,0,0,1
2437839837,0,1,0,0,1
2440783717,0,1,0,0,1
2437846648,0,1,0,0,1
2437950918,0,1,0,0,1
2438003936,0,1,0,0,1
2438116632,1,0,0,0,1
2439073296,0,1,0,0,1
2439346147,0,1,0,0,1
2439722702,0,1,0,0,1
2439776175,1,0,0,0,1
2439958333,0,1,0,0,1
2440158972,0,1,0,0,1
2424615826,0,1,0,0,1
2424114098,0,1,0,0,1
2424107875,0,1,0,0,1
2415068406,0,1,0,0,1
2411271308,1,0,0,0,1
2411320620,0,1,0,0,1
2411320964,0,1,0,0,1
2411473356,0,1,0,0,1
2411537598,0,1,0,0,1
2412089690,1,0,0,0,1
2412315966,1,0,0,0,1
2412584690,0,1,0,0,1
2412686438,1,0,0,0,1
2412706352,0,1,0,0,1
2412756068,0,1,0,0,1
2412860162,0,1,0,0,1
2412870858,0,1,0,0,1
2412989286,0,1,0,0,1
2413022950,0,1,0,0,1
2413030483,1,0,0,0,1
2413045485,0,1,0,0,1
2413234485,0,1,0,0,1
2413574683,0,1,0,0,1
2413688631,1,0,0,0,1
2413970027,0,1,0,0,1
2414648101,1,0,0,0,1
2414713532,0,1,0,0,1
2411206019,0,1,0,0,1
2411152557,0,1,0,0,1
2410849735,1,0,0,0,1
2406717112,0,1,0,0,1
2403880774,0,1,0,0,1
2404298500,0,1,0,0,1
2404881510,0,1,0,0,1
2404888189,0,1,0,0,1
2404980073,1,0,0,0,1
2404997083,0,1,0,0,1
2405243947,0,1,0,0,1
2405422557,0,1,0,0,1
2405528638,0,1,0,0,1
2406546630,0,1,0,0,1
2407320660,0,1,0,0,1
2409663512,0,1,0,0,1
2407368374,0,1,0,0,1
2407949937,0,0,0,1,1
2408295092,0,1,0,0,1
2408435707,0,1,0,0,1
2408546011,0,1,0,0,1
2408640540,1,0,0,0,1
2408645694,0,1,0,0,1
2409181701,0,1,0,0,1
2409411403,0,1,0,0,1
2409420534,0,1,0,0,1
2415024589,0,1,0,0,1
2415267258,0,1,0,0,1
2423744552,0,1,0,0,1
2415388806,0,1,0,0,1
2419541171,0,1,0,0,1
2420205766,0,1,0,0,1
2420425050,1,0,0,0,1
2420486797,0,1,0,0,1
2420541194,0,0,1,0,1
2420656748,0,1,0,0,1
2420823542,0,1,0,0,1
2420905471,0,1,0,0,1
2421006655,0,1,0,0,1
2421064800,0,0,0,1,1
2421600773,0,1,0,0,1
2421774721,0,1,0,0,1
2422190667,1,0,0,0,1
2422422430,0,1,0,0,1
2422430825,0,1,0,0,1
2422514959,0,1,0,0,1
2422521248,0,1,0,0,1
2422806722,0,1,0,0,1
2423190623,0,1,0,0,1
2423528178,1,0,0,0,1
2423559186,0,1,0,0,1
2423695730,0,1,0,0,1
2423702108,0,1,0,0,1
2419504946,0,1,0,0,1
2419468447,0,1,0,0,1
2419305001,0,1,0,0,1
2417032128,1,0,0,0,1
2415470018,0,1,0,0,1
2415647611,0,1,0,0,1
2415733782,0,1,0,0,1
2415860137,0,1,0,0,1
2415920530,0,1,0,0,1
2416148012,0,1,0,0,1
2416436384,0,1,0,0,1
2416451020,1,0,0,0,1
2416743114,0,1,0,0,1
2416982561,0,1,0,0,1
2417035495,1,0,0,0,1
2419198779,0,1,0,0,1
2417123252,0,1,0,0,1
2417616398,0,1,0,0,1
2417855922,0,1,0,0,1
2417969813,0,1,0,0,1
2418030808,0,1,0,0,1
2418111534,0,1,0,0,1
2418187372,0,1,0,0,1
2418905506,0,1,0,0,1
2419148504,0,1,0,0,1
2419167690,0,1,0,0,1
2874265362,0,1,0,0,1
2874965028,0,1,0,0,1
532553464,0,0,1,0,1
3309727802,0,1,0,0,1
3310201109,0,1,0,0,1
3310374827,0,1,0,0,1
3310403261,0,1,0,0,1
3310478290,0,1,0,0,1
3310578565,0,1,0,0,1
3310772423,1,0,0,0,1
3310803258,1,0,0,0,1
3310906207,1,0,0,0,1
3311071158,0,1,0,0,1
3311592270,1,0,0,0,1
3311714123,0,1,0,0,1
3311800595,1,0,0,0,1
3311800598,1,0,0,0,1
3311803986,0,1,0,0,1
3311996924,0,1,0,0,1
3312021522,1,0,0,0,1
3312046786,0,1,0,0,1
3312116015,0,1,0,0,1
3312470749,0,1,0,0,1
3312583238,0,1,0,0,1
3312629042,0,1,0,0,1
3312828959,0,1,0,0,1
3313089595,1,0,0,0,1
3309862246,0,1,0,0,1
3309643305,0,1,0,0,1
3306982572,0,1,0,0,1
3309547186,0,1,0,0,1
3307187853,0,1,0,0,1
3307268249,0,1,0,0,1
3307276258,0,0,0,1,1
3307289295,0,1,0,0,1
3307298837,0,1,0,0,1
3307372746,0,1,0,0,1
3307378794,0,1,0,0,1
3307471248,0,1,0,0,1
3307706899,0,1,0,0,1
3307838948,0,0,1,0,1
3307955321,0,1,0,0,1
3308013113,0,1,0,0,1
3308327506,0,1,0,0,1
3308346623,0,1,0,0,1
3308390319,0,1,0,0,1
3308440339,0,1,0,0,1
3308620394,0,1,0,0,1
3308732142,0,1,0,0,1
3309206981,0,1,0,0,1
3309250552,0,1,0,0,1
3309294560,0,1,0,0,1
3309317009,0,1,0,0,1
3309408444,0,1,0,0,1
3313133581,0,1,0,0,1
3313543661,0,1,0,0,1
3313585580,1,0,0,0,1
3313771939,0,1,0,0,1
3315998082,0,1,0,0,1
3316042968,0,1,0,0,1
3316226920,0,1,0,0,1
3316249615,0,1,0,0,1
3316287392,0,1,0,0,1
3316481627,0,1,0,0,1
3316635461,0,1,0,0,1
3316840988,1,0,0,0,1
3316939524,0,1,0,0,1
3316990527,0,1,0,0,1
3317763991,0,1,0,0,1
3317796878,0,1,0,0,1
3318001662,1,0,0,0,1
3318013650,1,0,0,0,1
3318028454,0,1,0,0,1
3318284751,0,1,0,0,1
3318561116,0,1,0,0,1
3318602304,0,1,0,0,1
3318620187,0,1,0,0,1
3318660564,0,1,0,0,1
3318927789,0,1,0,0,1
3319045595,1,0,0,0,1
3319057949,1,0,0,0,1
3315907938,1,0,0,0,1
3315882474,0,1,0,0,1
3315861019,1,0,0,0,1
3314610607,0,1,0,0,1
3313839752,0,1,0,0,1
3313935401,0,1,0,0,1
3314068426,0,1,0,0,1
3314101734,1,0,0,0,1
3314222881,0,1,0,0,1
3314243165,0,0,0,1,1
3314249224,0,1,0,0,1
3314337312,1,0,0,0,1
3314488359,0,1,0,0,1
3314534888,0,1,0,0,1
3314747397,0,1,0,0,1
3315816630,1,0,0,0,1
3314771290,0,1,0,0,1
3314909265,0,1,0,0,1
3314954395,0,1,0,0,1
3315031004,0,1,0,0,1
3315084449,0,1,0,0,1
3315097882,0,1,0,0,1
3315256392,0,1,0,0,1
3315302919,0,1,0,0,1
3315328100,1,0,0,0,1
3315495547,0,1,0,0,1
3307046855,0,1,0,0,1
3306863237,0,1,0,0,1
3209007574,1,0,0,0,1
3298819932,0,0,1,0,1
3299053135,1,0,0,0,1
3299092223,0,1,0,0,1
3299117627,0,1,0,0,1
3299333404,0,1,0,0,1
3299612681,0,1,0,0,1
3299713251,1,0,0,0,1
3299759597,0,1,0,0,1
3299875091,0,1,0,0,1
3300104280,0,1,0,0,1
3300157779,0,1,0,0,1
3300305647,1,0,0,0,1
3300441531,0,1,0,0,1
3300548692,0,0,0,1,1
3300658463,0,1,0,0,1
3300678283,0,1,0,0,1
3300806078,0,1,0,0,1
3300895721,0,1,0,0,1
3301029083,0,1,0,0,1
3301289517,0,1,0,0,1
3301322347,0,1,0,0,1
3301332866,0,1,0,0,1
3301355979,0,1,0,0,1
3301377557,0,1,0,0,1
3298985147,0,1,0,0,1
3298740073,0,1,0,0,1
3306860610,0,1,0,0,1
3298437530,0,1,0,0,1
3296457095,0,1,0,0,1
3296464576,0,1,0,0,1
3296472506,1,0,0,0,1
3296511971,0,1,0,0,1
3297032671,0,1,0,0,1
3297079468,0,1,0,0,1
3297114970,0,1,0,0,1
3297189661,1,0,0,0,1
3297195009,0,1,0,0,1
3297317648,0,1,0,0,1
3297374444,0,1,0,0,1
3297690524,0,1,0,0,1
3297702074,0,1,0,0,1
3297703851,0,1,0,0,1
3297902210,1,0,0,0,1
3297978439,0,1,0,0,1
3298002319,0,1,0,0,1
3298060184,0,1,0,0,1
3298222278,0,1,0,0,1
3298248830,0,1,0,0,1
3298285169,0,1,0,0,1
3298315943,0,1,0,0,1
3298390857,0,1,0,0,1
3301541810,0,1,0,0,1
3301734099,0,1,0,0,1
3302067354,0,1,0,0,1
3302127616,0,1,0,0,1
3304210462,1,0,0,0,1
3304232958,0,1,0,0,1
3304336544,1,0,0,0,1
3304432449,0,1,0,0,1
3304713601,0,1,0,0,1
3304838266,0,1,0,0,1
3304897869,0,1,0,0,1
3305002097,0,1,0,0,1
3305053163,0,1,0,0,1
3305055448,0,1,0,0,1
3305062775,0,1,0,0,1
3305087134,0,0,1,0,1
3305158857,0,1,0,0,1
3305338080,0,1,0,0,1
3305489249,0,1,0,0,1
3305585188,1,0,0,0,1
3305623947,0,1,0,0,1
3305793443,0,1,0,0,1
3305939879,0,1,0,0,1
3306147239,0,1,0,0,1
3306459627,0,1,0,0,1
3306518436,0,0,0,1,1
3306801540,0,1,0,0,1
3304096510,0,1,0,0,1
3304053544,0,1,0,0,1
3303913519,0,1,0,0,1
3303046883,0,1,0,0,1
3302144728,0,1,0,0,1
3302299171,0,1,0,0,1
3302517342,1,0,0,0,1
3302537465,0,1,0,0,1
3302579826,0,1,0,0,1
3302629824,0,1,0,0,1
3302736231,0,1,0,0,1
3302765147,0,1,0,0,1
3302986371,0,1,0,0,1
3302993783,0,1,0,0,1
3303129078,1,0,0,0,1
3303835993,0,1,0,0,1
3303181048,1,0,0,0,1
3303232436,1,0,0,0,1
3303293662,0,1,0,0,1
3303303337,0,1,0,0,1
3303446533,1,0,0,0,1
3303495765,0,1,0,0,1
3303676273,0,1,0,0,1
3303679706,1,0,0,0,1
3303684435,0,1,0,0,1
3303788258,0,0,0,1,1
3319263113,0,1,0,0,1
3319387244,0,1,0,0,1
3319493236,0,1,0,0,1
3356074519,1,0,0,0,1
3356459590,0,1,0,0,1
3356831399,0,1,0,0,1
3357158518,0,1,0,0,1
3357468221,0,1,0,0,1
3358241381,1,0,0,0,1
3358258769,0,1,0,0,1
3358510833,0,1,0,0,1
3358770113,0,1,0,0,1
3358837827,1,0,0,0,1
3359113018,0,1,0,0,1
3359172526,0,1,0,0,1
3359210548,0,1,0,0,1
3360277557,0,1,0,0,1
3360465189,0,1,0,0,1
3360855627,0,1,0,0,1
3361091849,0,1,0,0,1
3361542617,0,1,0,0,1
3361648877,0,1,0,0,1
3362540759,0,1,0,0,1
3362747501,0,1,0,0,1
3363474886,0,1,0,0,1
3363513515,0,1,0,0,1
3363534472,0,1,0,0,1
3356417331,0,0,0,1,1
3355504205,0,1,0,0,1
3319514550,0,1,0,0,1
3355177589,0,1,0,0,1
3350527383,0,1,0,0,1
3350707834,0,1,0,0,1
3350719606,1,0,0,0,1
3351017776,0,1,0,0,1
3351139985,0,1,0,0,1
3351345863,0,1,0,0,1
3351347833,0,1,0,0,1
3351534099,0,1,0,0,1
3351929609,0,1,0,0,1
3352283091,1,0,0,0,1
3352469909,0,1,0,0,1
3352512124,0,1,0,0,1
3352912754,0,1,0,0,1
3352942109,0,1,0,0,1
3352969947,0,1,0,0,1
3353015060,1,0,0,0,1
3353213543,0,1,0,0,1
3353218108,0,1,0,0,1
3353528518,0,0,0,1,1
3353541892,0,1,0,0,1
3353758575,0,1,0,0,1
3354733865,0,1,0,0,1
3354833179,0,1,0,0,1
3363833139,0,1,0,0,1
3364171407,0,1,0,0,1
3364185674,0,1,0,0,1
3364345761,0,1,0,0,1
3370817673,0,1,0,0,1
3371359162,0,1,0,0,1
3371654507,0,1,0,0,1
3372274023,0,0,0,1,1
3372340929,0,1,0,0,1
3372804328,1,0,0,0,1
3372934815,0,1,0,0,1
3372980219,0,1,0,0,1
3373018467,0,1,0,0,1
3373644183,0,1,0,0,1
3373849420,0,1,0,0,1
3373872058,0,1,0,0,1
3374107066,0,1,0,0,1
3374317312,0,1,0,0,1
3374589077,0,1,0,0,1
3374720487,0,1,0,0,1
3375445834,1,0,0,0,1
3375604709,1,0,0,0,1
3375733799,0,1,0,0,1
3376145139,0,1,0,0,1
3376990961,0,1,0,0,1
3377018061,0,1,0,0,1
3377170853,0,1,0,0,1
3370733723,1,0,0,0,1
3370714355,0,1,0,0,1
3369774821,0,1,0,0,1
3366765759,0,1,0,0,1
3364496728,0,1,0,0,1
3364683527,0,1,0,0,1
3365451077,0,1,0,0,1
3365607269,0,1,0,0,1
3365615643,1,0,0,0,1
3365636475,0,1,0,0,1
3365856166,1,0,0,0,1
3366015177,0,1,0,0,1
3366016546,0,1,0,0,1
3366505227,0,1,0,0,1
3367259110,0,1,0,0,1
3369146355,1,0,0,0,1
3367331512,0,1,0,0,1
3367425912,1,0,0,0,1
3367549504,0,1,0,0,1
3367634500,0,1,0,0,1
3367901769,1,0,0,0,1
3368031521,0,0,0,1,1
3368351885,0,1,0,0,1
3368775521,0,1,0,0,1
3368933626,0,1,0,0,1
3369062751,0,1,0,0,1
3350489751,0,1,0,0,1
3349607200,0,1,0,0,1
3349425333,0,1,0,0,1
3334932527,0,1,0,0,1
3327166976,0,1,0,0,1
3327187565,1,0,0,0,1
3327805900,0,1,0,0,1
3327898288,0,1,0,0,1
3328095446,0,1,0,0,1
3328678096,0,1,0,0,1
3329100561,0,1,0,0,1
3330201252,0,0,0,1,1
3330776271,0,1,0,0,1
3330826312,0,0,0,1,1
3330902079,0,1,0,0,1
3331016993,1,0,0,0,1
3331120762,0,1,0,0,1
3331358039,0,1,0,0,1
3331488951,1,0,0,0,1
3331492330,0,1,0,0,1
3331518525,0,1,0,0,1
3331558673,0,1,0,0,1
3332450949,1,0,0,0,1
3332976185,0,1,0,0,1
3334249509,0,1,0,0,1
3334482124,0,1,0,0,1
3334543193,1,0,0,0,1
3327089536,0,1,0,0,1
3326962510,0,1,0,0,1
3326923708,0,1,0,0,1
3321579341,0,1,0,0,1
3319592771,0,1,0,0,1
3319704256,0,1,0,0,1
3319952768,0,1,0,0,1
3320023446,0,1,0,0,1
3320509424,0,1,0,0,1
3320556755,1,0,0,0,1
3320643354,0,1,0,0,1
3320759432,0,1,0,0,1
3320961185,0,1,0,0,1
3321120243,0,1,0,0,1
3322517898,0,1,0,0,1
3326848228,0,1,0,0,1
3322747335,0,1,0,0,1
3323424839,0,1,0,0,1
3324387016,0,1,0,0,1
3324475009,1,0,0,0,1
3324487856,1,0,0,0,1
3324839500,0,1,0,0,1
3324951836,0,1,0,0,1
3325218490,0,1,0,0,1
3325852210,0,1,0,0,1
3326211988,0,1,0,0,1
3334815113,0,1,0,0,1
3335014212,0,1,0,0,1
3348686512,0,1,0,0,1
3335307873,0,1,0,0,1
3342925083,0,1,0,0,1
3343018437,1,0,0,0,1
3343828817,0,0,0,1,1
3343975102,1,0,0,0,1
3344597092,1,0,0,0,1
3344660715,0,1,0,0,1
3344689690,0,0,1,0,1
3345030189,0,1,0,0,1
3345252851,0,1,0,0,1
3345653272,0,1,0,0,1
3345694203,1,0,0,0,1
3346004654,1,0,0,0,1
3346017558,1,0,0,0,1
3346089999,0,1,0,0,1
3346509473,0,1,0,0,1
3346735510,0,1,0,0,1
3347061891,0,1,0,0,1
3347308121,0,1,0,0,1
3347460832,0,1,0,0,1
3347508124,0,1,0,0,1
3347836834,0,1,0,0,1
3348334160,0,1,0,0,1
3348684113,0,1,0,0,1
3342712156,0,1,0,0,1
3342672460,1,0,0,0,1
3342619011,0,1,0,0,1
3339051305,0,0,0,1,1
3335332702,0,1,0,0,1
3335515967,1,0,0,0,1
3335705116,0,1,0,0,1
3335853375,0,1,0,0,1
3336895696,0,1,0,0,1
3337094663,0,0,0,1,1
3337391140,0,1,0,0,1
3338537302,0,1,0,0,1
3338678517,0,1,0,0,1
3338841913,0,1,0,0,1
3339293957,0,1,0,0,1
3342602537,0,1,0,0,1
3339465477,1,0,0,0,1
3339876651,0,1,0,0,1
3341148963,0,1,0,0,1
3341390952,1,0,0,0,1
3341460550,0,1,0,0,1
3341706461,0,1,0,0,1
3341755432,0,1,0,0,1
3342223647,0,1,0,0,1
3342557165,0,1,0,0,1
3342590704,0,1,0,0,1
3296426793,0,1,0,0,1
3296381705,0,1,0,0,1
3296322847,0,1,0,0,1
3240788775,0,1,0,0,1
3240918797,1,0,0,0,1
3240981327,0,1,0,0,1
3241122189,0,1,0,0,1
3241159855,0,1,0,0,1
3241590919,0,1,0,0,1
3241714363,0,1,0,0,1
3241731517,0,1,0,0,1
3241803811,0,1,0,0,1
3241960001,0,1,0,0,1
3242069940,0,1,0,0,1
3242124845,0,1,0,0,1
3242456182,0,1,0,0,1
3242649768,1,0,0,0,1
3242965789,0,1,0,0,1
3243165724,0,1,0,0,1
3243320557,0,0,0,1,1
3243615928,0,1,0,0,1
3243631896,0,1,0,0,1
3243677896,0,1,0,0,1
3243967009,0,1,0,0,1
3244149949,1,0,0,0,1
3244160646,0,1,0,0,1
3244364513,0,1,0,0,1
3240891924,0,1,0,0,1
3240787723,0,1,0,0,1
3251463408,0,1,0,0,1
3240762727,1,0,0,0,1
3237723258,0,1,0,0,1
3238135235,0,1,0,0,1
3238197760,0,1,0,0,1
3238200588,0,1,0,0,1
3238209355,0,0,0,1,1
3238258023,0,1,0,0,1
3238459861,0,1,0,0,1
3238524760,0,1,0,0,1
3238569336,1,0,0,0,1
3238580524,0,1,0,0,1
3238790925,0,1,0,0,1
3238848565,0,1,0,0,1
3239012507,1,0,0,0,1
3239067227,0,1,0,0,1
3239116041,0,1,0,0,1
3239264797,1,0,0,0,1
3239302884,0,1,0,0,1
3240027539,0,1,0,0,1
3240186948,1,0,0,0,1
3240275754,0,1,0,0,1
3240552438,0,1,0,0,1
3240592840,1,0,0,0,1
3240695788,0,1,0,0,1
3244498499,0,1,0,0,1
3244762474,0,1,0,0,1
3244789627,0,1,0,0,1
3244966667,0,1,0,0,1
3247588611,0,0,0,1,1
3247658845,0,1,0,0,1
3247738220,0,1,0,0,1
3247807329,0,1,0,0,1
3247976580,1,0,0,0,1
3248093669,0,0,1,0,1
3248163353,0,1,0,0,1
3248469663,0,1,0,0,1
3248863686,0,1,0,0,1
3249092386,0,1,0,0,1
3249166429,0,1,0,0,1
3249298631,0,1,0,0,1
3249387808,0,1,0,0,1
3249519409,0,1,0,0,1
3249970767,0,1,0,0,1
3250043960,0,1,0,0,1
3250352737,0,1,0,0,1
3250509294,0,0,0,1,1
3250706089,0,1,0,0,1
3250823912,0,1,0,0,1
3250879110,0,1,0,0,1
3251155044,1,0,0,0,1
3251210694,0,0,0,1,1
3247584825,0,1,0,0,1
3247512558,1,0,0,0,1
3247390800,1,0,0,0,1
3246221459,0,1,0,0,1
3244986793,0,1,0,0,1
3245132488,0,1,0,0,1
3245158203,0,1,0,0,1
3245189635,0,1,0,0,1
3245455199,1,0,0,0,1
3245504280,0,0,0,1,1
3245610391,1,0,0,0,1
3245668003,0,1,0,0,1
3246136964,0,1,0,0,1
3246188111,0,1,0,0,1
3246242167,0,1,0,0,1
3246938070,0,1,0,0,1
3246262666,0,1,0,0,1
3246415438,0,1,0,0,1
3246440410,0,1,0,0,1
3246547042,0,1,0,0,1
3246577666,1,0,0,0,1
3246686933,0,1,0,0,1
3246793157,0,1,0,0,1
3246850355,0,1,0,0,1
3246872449,0,1,0,0,1
3246895189,0,1,0,0,1
3237448981,0,1,0,0,1
3237368690,0,1,0,0,1
3237134990,1,0,0,0,1
3227124656,0,1,0,0,1
3222348199,0,1,0,0,1
3222725309,0,1,0,0,1
3222853416,1,0,0,0,1
3223100431,0,1,0,0,1
3223611678,1,0,0,0,1
3224250852,0,0,1,0,1
3224265427,0,1,0,0,1
3224472828,0,1,0,0,1
3224799588,1,0,0,0,1
3225002221,0,1,0,0,1
3225054691,1,0,0,0,1
3225226330,0,1,0,0,1
3225465556,0,1,0,0,1
3225971279,0,1,0,0,1
3225994675,0,1,0,0,1
3226074255,0,1,0,0,1
3226086054,1,0,0,0,1
3226384326,0,1,0,0,1
3226405122,0,1,0,0,1
3226406964,0,1,0,0,1
3226536033,0,1,0,0,1
3226885812,0,1,0,0,1
3226984811,0,1,0,0,1
3221998899,1,0,0,0,1
3221638844,0,1,0,0,1
3221601608,0,1,0,0,1
3218648986,0,1,0,0,1
3211979429,0,1,0,0,1
3214247871,0,1,0,0,1
3214631291,0,1,0,0,1
3215362205,1,0,0,0,1
3216874215,0,1,0,0,1
3216895937,0,1,0,0,1
3217047856,0,0,0,1,1
3217363858,0,1,0,0,1
3217997176,0,1,0,0,1
3218503154,0,1,0,0,1
3218804716,0,1,0,0,1
3221030231,0,1,0,0,1
3219006324,0,1,0,0,1
3219320422,0,1,0,0,1
3219618882,0,1,0,0,1
3220084519,1,0,0,0,1
3220138404,0,1,0,0,1
3220162815,0,1,0,0,1
3220172342,1,0,0,0,1
3220207194,0,1,0,0,1
3220616372,0,1,0,0,1
3220923038,0,1,0,0,1
3226993738,0,1,0,0,1
3227156772,0,1,0,0,1
3237106130,0,1,0,0,1
3227320148,0,1,0,0,1
3232375266,1,0,0,0,1
3232458668,0,1,0,0,1
3232519898,0,1,0,0,1
3232933347,0,0,1,0,1
3232953732,1,0,0,0,1
3233049033,0,1,0,0,1
3233078216,1,0,0,0,1
3233340404,0,1,0,0,1
3233420426,0,1,0,0,1
3233612905,0,1,0,0,1
3233773634,1,0,0,0,1
3233795130,0,1,0,0,1
3233855177,0,1,0,0,1
3234168044,1,0,0,0,1
3234491738,0,1,0,0,1
3234690618,0,1,0,0,1
3234945076,0,1,0,0,1
3235052610,0,1,0,0,1
3235553991,0,1,0,0,1
3235944931,0,1,0,0,1
3236548277,1,0,0,0,1
3236559560,0,0,0,1,1
3236721880,0,1,0,0,1
3232331983,1,0,0,0,1
3232151762,0,1,0,0,1
3231884948,0,1,0,0,1
3229569589,1,0,0,0,1
3227517953,0,1,0,0,1
3227968166,0,1,0,0,1
3227984671,1,0,0,0,1
3228200860,0,1,0,0,1
3228522684,0,1,0,0,1
3228676637,0,1,0,0,1
3228678176,0,0,0,1,1
3229462695,0,1,0,0,1
3229528810,0,1,0,0,1
3229530087,0,1,0,0,1
3229651423,0,1,0,0,1
3231860148,0,0,0,1,1
3230033286,0,1,0,0,1
3230155410,0,1,0,0,1
3230198245,0,0,0,1,1
3230297905,1,0,0,0,1
3230633964,0,1,0,0,1
3230759033,0,1,0,0,1
3230844613,0,1,0,0,1
3231435562,1,0,0,0,1
3231533366,0,1,0,0,1
3231725643,0,1,0,0,1
3251356100,0,1,0,0,1
3251656531,0,1,0,0,1
3296153684,1,0,0,0,1
3284291892,0,1,0,0,1
3284626376,0,1,0,0,1
3285074988,0,1,0,0,1
3285343843,0,1,0,0,1
3285816720,1,0,0,0,1
3286172004,0,1,0,0,1
3286468093,0,1,0,0,1
3286788714,1,0,0,0,1
3286813292,0,1,0,0,1
3286895916,0,1,0,0,1
3286931312,0,1,0,0,1
3287146724,0,1,0,0,1
3287183244,0,0,1,0,1
3287593334,1,0,0,0,1
3287990902,0,1,0,0,1
3288091105,0,1,0,0,1
3288174238,0,1,0,0,1
3288343366,0,1,0,0,1
3288513350,1,0,0,0,1
3288684484,0,1,0,0,1
3288851298,0,1,0,0,1
3288977492,1,0,0,0,1
3289222161,0,1,0,0,1
3289367810,0,1,0,0,1
3284579772,1,0,0,0,1
3283913606,0,1,0,0,1
3251813418,0,1,0,0,1
3283841472,0,1,0,0,1
3278493134,0,1,0,0,1
3278691954,0,1,0,0,1
3278805482,1,0,0,0,1
3278841919,0,1,0,0,1
3279475253,0,1,0,0,1
3279785892,0,1,0,0,1
3280725409,1,0,0,0,1
3281105022,0,1,0,0,1
3281374831,0,1,0,0,1
3281471096,0,1,0,0,1
3281507268,0,1,0,0,1
3281682906,0,1,0,0,1
3281720809,0,1,0,0,1
3281831000,1,0,0,0,1
3281851634,0,1,0,0,1
3281906419,0,1,0,0,1
3281940962,0,0,1,0,1
3282248108,1,0,0,0,1
3283120807,0,0,0,1,1
3283459513,0,1,0,0,1
3283541461,0,1,0,0,1
3283656254,0,1,0,0,1
3283670011,0,1,0,0,1
3289436637,0,1,0,0,1
3289654909,1,0,0,0,1
3289662832,0,1,0,0,1
3289945349,0,1,0,0,1
3293956650,1,0,0,0,1
3294101302,0,0,0,1,1
3294442177,0,1,0,0,1
3294592228,0,1,0,0,1
3294661467,0,1,0,0,1
3294671526,0,1,0,0,1
3294739832,0,1,0,0,1
3294780283,1,0,0,0,1
3294913856,0,1,0,0,1
3294990922,0,1,0,0,1
3294994802,0,1,0,0,1
3295067753,0,1,0,0,1
3295142873,1,0,0,0,1
3295173025,0,1,0,0,1
3295256450,0,1,0,0,1
3295268870,0,1,0,0,1
3295302710,0,1,0,0,1
3295310992,0,1,0,0,1
3295348486,0,1,0,0,1
3295459363,0,1,0,0,1
3295576167,0,1,0,0,1
3295824553,0,1,0,0,1
3295907277,0,1,0,0,1
3293667483,0,0,1,0,1
3293643338,1,0,0,0,1
3293359231,0,1,0,0,1
3291305583,0,1,0,0,1
3290032039,1,0,0,0,1
3290302472,0,1,0,0,1
3290419568,0,1,0,0,1
3290602420,1,0,0,0,1
3290912293,0,1,0,0,1
3290963938,0,1,0,0,1
3290986091,1,0,0,0,1
3291127601,0,1,0,0,1
3291178217,0,1,0,0,1
3291291624,1,0,0,0,1
3291376751,0,1,0,0,1
3293297285,1,0,0,0,1
3291753758,1,0,0,0,1
3291907229,0,1,0,0,1
3291953359,1,0,0,0,1
3292273938,0,1,0,0,1
3292298330,0,1,0,0,1
3292531118,0,1,0,0,1
3293040525,1,0,0,0,1
3293082108,0,1,0,0,1
3293145892,1,0,0,0,1
3293238833,0,1,0,0,1
3278447552,0,1,0,0,1
3278353267,0,1,0,0,1
3278304505,0,1,0,0,1
3261147882,1,0,0,0,1
3257561502,0,1,0,0,1
3257578512,0,1,0,0,1
3258500314,0,1,0,0,1
3258542215,0,1,0,0,1
3258785922,1,0,0,0,1
3259075664,0,1,0,0,1
3259234585,0,1,0,0,1
3259301780,0,1,0,0,1
3259311950,0,1,0,0,1
3259323762,0,1,0,0,1
3259686729,0,1,0,0,1
3259891121,0,1,0,0,1
3259979507,0,1,0,0,1
3259996902,0,1,0,0,1
3260033753,1,0,0,0,1
3260277057,0,1,0,0,1
3260332466,0,1,0,0,1
3260410286,0,1,0,0,1
3260752997,0,1,0,0,1
3260863859,1,0,0,0,1
3260959870,0,1,0,0,1
3261117908,0,1,0,0,1
3261123280,0,1,0,0,1
3257464300,0,1,0,0,1
3257240667,0,1,0,0,1
3256863476,0,1,0,0,1
3253891346,0,1,0,0,1
3251814086,1,0,0,0,1
3252097491,0,1,0,0,1
3252129919,0,1,0,0,1
3252341329,0,1,0,0,1
3252545131,0,1,0,0,1
3253345791,0,1,0,0,1
3253389526,0,1,0,0,1
3253696867,1,0,0,0,1
3253760836,1,0,0,0,1
3253792716,0,1,0,0,1
3254565601,0,1,0,0,1
3256770805,0,1,0,0,1
3254725570,0,1,0,0,1
3254825596,0,1,0,0,1
3255036332,0,1,0,0,1
3255109188,0,1,0,0,1
3255161238,0,1,0,0,1
3255547238,0,1,0,0,1
3255651163,1,0,0,0,1
3255832605,0,1,0,0,1
3256137729,0,1,0,0,1
3256585297,1,0,0,0,1
3261142548,0,1,0,0,1
3261809316,0,1,0,0,1
3278219426,1,0,0,0,1
3262307943,0,1,0,0,1
3271685886,1,0,0,0,1
3272301115,1,0,0,0,1
3273162730,0,1,0,0,1
3273797599,1,0,0,0,1
3273905960,0,1,0,0,1
3273933157,0,1,0,0,1
3274251432,0,0,0,1,1
3274419409,1,0,0,0,1
3274611930,1,0,0,0,1
3274705376,0,1,0,0,1
3275279150,0,1,0,0,1
3275527363,1,0,0,0,1
3276065040,0,1,0,0,1
3276401924,1,0,0,0,1
3277006309,0,1,0,0,1
3277098061,1,0,0,0,1
3277138278,0,1,0,0,1
3277167452,0,1,0,0,1
3277191192,0,1,0,0,1
3277379090,0,1,0,0,1
3277698536,0,1,0,0,1
3277756314,0,1,0,0,1
3277926595,0,1,0,0,1
3271609435,0,1,0,0,1
3271580798,0,1,0,0,1
3271176822,1,0,0,0,1
3266899542,1,0,0,0,1
3262746109,1,0,0,0,1
3263607700,0,1,0,0,1
3263902741,0,1,0,0,1
3264706705,1,0,0,0,1
3264854842,1,0,0,0,1
3265139400,0,1,0,0,1
3265153547,0,1,0,0,1
3266223954,0,1,0,0,1
3266303779,0,0,1,0,1
3266716105,0,0,0,1,1
3267329191,0,1,0,0,1
3271072020,1,0,0,0,1
3268267046,0,1,0,0,1
3268480692,0,1,0,0,1
3268843548,0,1,0,0,1
3268884751,0,1,0,0,1
3269146495,1,0,0,0,1
3269184912,0,1,0,0,1
3270231211,0,1,0,0,1
3270796980,0,1,0,0,1
3270925988,0,1,0,0,1
3271058400,0,1,0,0,1
3377617438,0,1,0,0,1
3377653684,1,0,0,0,1
3378006755,1,0,0,0,1
3878661161,0,1,0,0,1
3880979355,0,1,0,0,1
3881310563,0,1,0,0,1
3881364855,0,1,0,0,1
3882601054,1,0,0,0,1
3883423812,0,1,0,0,1
3884325279,0,1,0,0,1
3885266254,0,1,0,0,1
3885803654,0,0,0,1,1
3886404915,0,1,0,0,1
3889346892,0,1,0,0,1
3889942576,0,1,0,0,1
3891665359,0,0,0,1,1
3892113987,0,1,0,0,1
3892191633,0,1,0,0,1
3893010854,1,0,0,0,1
3897533747,0,1,0,0,1
3898234097,0,1,0,0,1
3899052552,1,0,0,0,1
3899296754,0,1,0,0,1
3900087194,0,1,0,0,1
3901538001,0,1,0,0,1
3902797936,0,1,0,0,1
3903130646,0,1,0,0,1
3880451897,0,1,0,0,1
3878231848,0,1,0,0,1
3960217638,0,1,0,0,1
3875991073,0,1,0,0,1
3855013529,0,1,0,0,1
3855164597,0,1,0,0,1
3859499183,0,1,0,0,1
3859640961,0,1,0,0,1
3860390243,0,1,0,0,1
3861096742,0,1,0,0,1
3861168022,0,1,0,0,1
3861447880,0,1,0,0,1
3862258455,0,1,0,0,1
3862936762,0,1,0,0,1
3863978428,0,1,0,0,1
3864977061,0,1,0,0,1
3865717839,0,1,0,0,1
3869085497,0,1,0,0,1
3869540955,0,1,0,0,1
3871280184,0,0,0,1,1
3871364427,0,1,0,0,1
3871454008,0,1,0,0,1
3871460536,1,0,0,0,1
3871948878,0,1,0,0,1
3872247603,0,1,0,0,1
3872802133,0,1,0,0,1
3874863388,0,1,0,0,1
3903268779,0,1,0,0,1
3903855625,1,0,0,0,1
3904299264,0,1,0,0,1
3905007254,0,1,0,0,1
3936327556,0,1,0,0,1
3936452597,0,1,0,0,1
3936618372,0,1,0,0,1
3937324753,0,1,0,0,1
3937481236,1,0,0,0,1
3939977537,0,1,0,0,1
3940284374,0,1,0,0,1
3943921039,1,0,0,0,1
3944712676,0,1,0,0,1
3944866093,0,0,1,0,1
3945796486,0,1,0,0,1
3946650674,0,1,0,0,1
3946901356,0,1,0,0,1
3947136616,0,1,0,0,1
3947680851,0,1,0,0,1
3947830036,0,1,0,0,1
3948536080,0,1,0,0,1
3948995117,0,1,0,0,1
3950479048,0,0,1,0,1
3950618658,1,0,0,0,1
3953165158,1,0,0,0,1
3955088297,0,1,0,0,1
3956527576,0,1,0,0,1
3935885053,0,1,0,0,1
3934913833,0,1,0,0,1
3932043521,0,1,0,0,1
3920610854,0,1,0,0,1
3905333963,1,0,0,0,1
3905944538,0,1,0,0,1
3906975915,0,1,0,0,1
3910799063,0,1,0,0,1
3911186813,0,1,0,0,1
3913720572,0,1,0,0,1
3916218801,0,1,0,0,1
3916725613,0,1,0,0,1
3918050112,0,1,0,0,1
3918169933,0,1,0,0,1
3921185416,0,1,0,0,1
3931247294,1,0,0,0,1
3921407187,0,1,0,0,1
3923228177,0,1,0,0,1
3924294313,0,1,0,0,1
3925332143,0,1,0,0,1
3925758915,0,1,0,0,1
3926629815,0,1,0,0,1
3927576761,0,1,0,0,1
3929395073,0,1,0,0,1
3929656229,0,1,0,0,1
3930142937,0,1,0,0,1
3855006795,0,1,0,0,1
3854653503,0,1,0,0,1
3854424616,0,1,0,0,1
3796483337,0,1,0,0,1
3771110537,0,1,0,0,1
3771278544,0,1,0,0,1
3772032133,0,1,0,0,1
3773914643,0,1,0,0,1
3774694152,1,0,0,0,1
3774782896,0,1,0,0,1
3775547774,0,1,0,0,1
3778207452,1,0,0,0,1
3780096254,0,1,0,0,1
3780915614,1,0,0,0,1
3780972556,0,1,0,0,1
3781140621,0,1,0,0,1
3782108566,0,1,0,0,1
3784751745,0,0,0,1,1
3785154513,0,1,0,0,1
3786439047,0,1,0,0,1
3786994273,0,1,0,0,1
3787738576,0,1,0,0,1
3788413588,0,1,0,0,1
3791313922,0,0,1,0,1
3791498539,0,1,0,0,1
3792260657,0,1,0,0,1
3795812063,0,1,0,0,1
3769323263,1,0,0,0,1
3769150814,1,0,0,0,1
3768765255,0,1,0,0,1
3757136116,0,1,0,0,1
3743065222,0,1,0,0,1
3745175172,1,0,0,0,1
3747980838,0,1,0,0,1
3748684341,0,1,0,0,1
3749736197,0,1,0,0,1
3750445475,0,1,0,0,1
3750814593,0,1,0,0,1
3751599497,0,1,0,0,1
3751681774,0,1,0,0,1
3755375178,0,1,0,0,1
3758686092,0,1,0,0,1
3765890838,1,0,0,0,1
3759460276,0,1,0,0,1
3759803532,0,1,0,0,1
3760985472,0,1,0,0,1
3760989197,0,1,0,0,1
3762380713,0,1,0,0,1
3762458717,0,1,0,0,1
3762620848,0,1,0,0,1
3762716356,0,1,0,0,1
3762761236,0,1,0,0,1
3764862615,0,1,0,0,1
3796144275,0,1,0,0,1
3797275401,1,0,0,0,1
3854136371,0,1,0,0,1
3799025354,0,1,0,0,1
3828344608,0,1,0,0,1
3830346567,1,0,0,0,1
3831674953,0,1,0,0,1
3832918154,0,1,0,0,1
3833105602,0,1,0,0,1
3833468308,0,1,0,0,1
3833476815,1,0,0,0,1
3834156387,0,1,0,0,1
3835644258,0,1,0,0,1
3835659073,1,0,0,0,1
3836707756,0,1,0,0,1
3843239363,0,1,0,0,1
3843934858,0,1,0,0,1
3845692035,0,1,0,0,1
3846355754,1,0,0,0,1
3846396334,0,1,0,0,1
3848846242,1,0,0,0,1
3849769355,1,0,0,0,1
3850812974,1,0,0,0,1
3851791575,0,1,0,0,1
3851823496,0,1,0,0,1
3852010996,0,1,0,0,1
3853881087,0,1,0,0,1
3828109996,0,1,0,0,1
3827340195,0,1,0,0,1
3826973541,0,1,0,0,1
3814847555,0,1,0,0,1
3799243460,0,1,0,0,1
3799397653,0,0,0,1,1
3801038175,0,1,0,0,1
3801622152,0,1,0,0,1
3803394496,0,1,0,0,1
3805266915,1,0,0,0,1
3805683798,0,1,0,0,1
3808556479,0,1,0,0,1
3810724519,1,0,0,0,1
3813235755,1,0,0,0,1
3814991122,0,1,0,0,1
3826118303,0,1,0,0,1
3815112501,0,1,0,0,1
3816538397,0,1,0,0,1
3817129697,0,1,0,0,1
3820482132,0,1,0,0,1
3820696392,1,0,0,0,1
3821663237,0,1,0,0,1
3823450154,1,0,0,0,1
3823606834,0,1,0,0,1
3824930895,0,1,0,0,1
3825392770,0,1,0,0,1
3956803044,0,1,0,0,1
3960338835,0,1,0,0,1
3740631685,0,1,0,0,1
4076636783,0,1,0,0,1
4080578895,0,0,0,1,1
4080862339,0,1,0,0,1
4080884120,0,1,0,0,1
4081004295,1,0,0,0,1
4081368862,1,0,0,0,1
4081574596,0,1,0,0,1
4082139924,1,0,0,0,1
4082329814,0,1,0,0,1
4085517021,0,1,0,0,1
4085707755,0,1,0,0,1
4085784401,1,0,0,0,1
4086821594,0,1,0,0,1
4089359207,0,1,0,0,1
4090714941,0,0,1,0,1
4092373672,0,0,0,1,1
4092415342,0,1,0,0,1
4093685892,0,1,0,0,1
4095184738,0,1,0,0,1
4095752715,0,1,0,0,1
4096771642,0,1,0,0,1
4097672367,0,1,0,0,1
4099022122,0,1,0,0,1
4099033708,0,1,0,0,1
4076853622,0,1,0,0,1
4076324253,0,1,0,0,1
3961009101,0,1,0,0,1
4076217434,0,1,0,0,1
4061430072,1,0,0,0,1
4062035777,0,1,0,0,1
4063183588,0,1,0,0,1
4063329262,0,1,0,0,1
4064335367,1,0,0,0,1
4066488139,0,0,0,1,1
4067629349,1,0,0,0,1
4067911757,0,1,0,0,1
4068905716,0,1,0,0,1
4070361912,0,1,0,0,1
4070487449,0,1,0,0,1
4071710357,0,1,0,0,1
4073671827,0,1,0,0,1
4074215901,0,1,0,0,1
4074480388,1,0,0,0,1
4074720329,0,1,0,0,1
4074792743,0,1,0,0,1
4075215863,0,1,0,0,1
4075245198,0,1,0,0,1
4075272914,0,1,0,0,1
4075670488,1,0,0,0,1
4076123238,0,1,0,0,1
4076215821,0,1,0,0,1
4099129109,0,0,0,1,1
4099188973,0,1,0,0,1
4099462277,0,1,0,0,1
4099836328,0,1,0,0,1
4127854935,0,1,0,0,1
4128420977,1,0,0,0,1
4128439392,1,0,0,0,1
4131597493,1,0,0,0,1
4133535919,0,1,0,0,1
4133664358,0,0,0,1,1
4134137548,0,1,0,0,1
4135078145,1,0,0,0,1
4136465594,0,1,0,0,1
4136557223,0,1,0,0,1
4136692168,0,1,0,0,1
4136938053,0,1,0,0,1
4137780562,0,1,0,0,1
4140058703,0,1,0,0,1
4141337236,0,1,0,0,1
4141970673,0,1,0,0,1
4142056998,0,1,0,0,1
4142128632,0,1,0,0,1
4142329282,0,1,0,0,1
4142497173,0,1,0,0,1
4143399299,0,1,0,0,1
4144147515,0,1,0,0,1
4144689256,0,1,0,0,1
4127188037,0,1,0,0,1
4126984275,0,1,0,0,1
4124370507,0,1,0,0,1
4111726709,0,1,0,0,1
4100489122,0,0,0,1,1
4100727619,0,1,0,0,1
4102766300,0,1,0,0,1
4104255916,0,1,0,0,1
4104724996,0,1,0,0,1
4104811689,1,0,0,0,1
4105408671,0,0,0,1,1
4107184143,0,1,0,0,1
4107258492,0,1,0,0,1
4111102846,0,1,0,0,1
4112278641,0,1,0,0,1
4124299633,0,1,0,0,1
4112852957,1,0,0,0,1
4113815834,0,1,0,0,1
4114020543,1,0,0,0,1
4115931239,0,1,0,0,1
4116097690,0,1,0,0,1
4118565081,0,1,0,0,1
4118787500,0,1,0,0,1
4119607821,1,0,0,0,1
4119914571,0,0,1,0,1
4124068818,1,0,0,0,1
4060572399,0,1,0,0,1
4060262775,0,1,0,0,1
4058444739,0,1,0,0,1
4013034261,0,1,0,0,1
3988535243,0,1,0,0,1
3989171893,0,1,0,0,1
3992803042,0,1,0,0,1
3996005973,0,1,0,0,1
3996901187,0,1,0,0,1
3997182141,1,0,0,0,1
3999179774,0,1,0,0,1
3999214884,0,1,0,0,1
3999280034,0,1,0,0,1
3999759904,0,1,0,0,1
4000493609,0,1,0,0,1
4001261596,0,1,0,0,1
4001942119,1,0,0,0,1
4002052701,0,1,0,0,1
4002347654,1,0,0,0,1
4002578795,0,1,0,0,1
4003518615,0,1,0,0,1
4003621094,0,1,0,0,1
4007040737,0,1,0,0,1
4007931819,0,1,0,0,1
4009196902,0,0,0,1,1
4010887869,0,1,0,0,1
4012914473,0,1,0,0,1
3987740902,0,0,1,0,1
3987673639,0,1,0,0,1
3986260780,0,1,0,0,1
3973104981,0,1,0,0,1
3961150516,0,1,0,0,1
3963389300,0,1,0,0,1
3963556517,0,1,0,0,1
3965325201,0,1,0,0,1
3966345024,0,1,0,0,1
3969732439,0,1,0,0,1
3971029692,1,0,0,0,1
3971115137,1,0,0,0,1
3971344888,1,0,0,0,1
3971661820,0,1,0,0,1
3973175285,0,1,0,0,1
3986131877,0,1,0,0,1
3975756309,0,1,0,0,1
3975842548,0,1,0,0,1
3976021402,1,0,0,0,1
3976855396,0,1,0,0,1
3977951957,0,1,0,0,1
3978479782,0,1,0,0,1
3978785980,0,1,0,0,1
3983733256,0,1,0,0,1
3983913323,0,1,0,0,1
3985802354,1,0,0,0,1
4013009186,1,0,0,0,1
4014460393,0,1,0,0,1
4058071933,1,0,0,0,1
4014676096,0,1,0,0,1
4034568374,0,1,0,0,1
4034780779,1,0,0,0,1
4035087915,0,0,0,1,1
4036527737,0,1,0,0,1
4038770392,0,1,0,0,1
4039079053,0,1,0,0,1
4039367953,0,1,0,0,1
4039642719,0,1,0,0,1
4040477379,0,1,0,0,1
4040547988,0,1,0,0,1
4040557235,0,0,0,1,1
4041507016,0,1,0,0,1
4042799534,0,1,0,0,1
4047583572,0,1,0,0,1
4047791609,0,0,0,1,1
4051669155,1,0,0,0,1
4052656295,0,1,0,0,1
4052870112,0,1,0,0,1
4053472454,1,0,0,0,1
4054515560,0,1,0,0,1
4055129729,0,1,0,0,1
4056208462,0,1,0,0,1
4056789796,0,1,0,0,1
4033702811,0,1,0,0,1
4033609814,0,1,0,0,1
4032642012,0,1,0,0,1
4019910797,0,1,0,0,1
4015531093,0,1,0,0,1
4016298674,0,1,0,0,1
4016688852,0,1,0,0,1
4016708417,0,0,0,1,1
4017053003,0,1,0,0,1
4017149243,0,1,0,0,1
4017640275,0,1,0,0,1
4017982456,1,0,0,0,1
4018056135,0,1,0,0,1
4018431615,0,1,0,0,1
4020063075,0,0,1,0,1
4031973389,0,1,0,0,1
4022095205,0,1,0,0,1
4022277621,1,0,0,0,1
4023097029,0,1,0,0,1
4024032261,0,1,0,0,1
4025445795,0,1,0,0,1
4025653636,0,1,0,0,1
4025805745,0,1,0,0,1
4026014954,0,1,0,0,1
4031096237,0,1,0,0,1
4031636687,0,1,0,0,1
3742469667,0,1,0,0,1
3740367976,0,0,1,0,1
3378490175,0,1,0,0,1
3414661203,0,1,0,0,1
3415258077,0,1,0,0,1
3415616537,0,1,0,0,1
3416078933,0,1,0,0,1
3416119072,0,1,0,0,1
3416577934,1,0,0,0,1
3416673492,0,1,0,0,1
3416981505,1,0,0,0,1
3418151453,0,1,0,0,1
3418642394,0,1,0,0,1
3418678497,0,1,0,0,1
3418836193,0,1,0,0,1
3419266333,1,0,0,0,1
3419749648,0,1,0,0,1
3421638071,0,1,0,0,1
3422084050,0,1,0,0,1
3422370767,1,0,0,0,1
3422534909,0,1,0,0,1
3422707169,0,1,0,0,1
3423983597,0,1,0,0,1
3424185417,1,0,0,0,1
3424427715,0,1,0,0,1
3424509033,0,1,0,0,1
3424613835,0,1,0,0,1
3414805754,0,1,0,0,1
3413928658,0,1,0,0,1
3439917381,0,1,0,0,1
3413902311,0,1,0,0,1
3406500304,0,1,0,0,1
3406864085,0,1,0,0,1
3407039297,0,1,0,0,1
3407157313,0,1,0,0,1
3407920589,0,1,0,0,1
3408044932,0,1,0,0,1
3408369875,0,1,0,0,1
3408633628,0,1,0,0,1
3408723364,0,1,0,0,1
3408807429,0,1,0,0,1
3409250313,0,1,0,0,1
3409273551,0,1,0,0,1
3410324614,0,1,0,0,1
3410404338,0,1,0,0,1
3411197722,0,1,0,0,1
3411352737,0,1,0,0,1
3412092358,0,1,0,0,1
3412933049,0,1,0,0,1
3412937404,0,1,0,0,1
3412996481,0,1,0,0,1
3413082995,0,1,0,0,1
3413375722,0,1,0,0,1
3413889172,0,1,0,0,1
3425284701,0,1,0,0,1
3425373879,0,1,0,0,1
3427581171,0,1,0,0,1
3428197126,0,1,0,0,1
3435436377,0,1,0,0,1
3435458741,1,0,0,0,1
3435711018,0,1,0,0,1
3435793168,0,1,0,0,1
3435805204,0,1,0,0,1
3435888792,1,0,0,0,1
3435952169,0,1,0,0,1
3436227309,0,1,0,0,1
3436531816,0,1,0,0,1
3437022261,0,1,0,0,1
3437048853,0,1,0,0,1
3437406106,1,0,0,0,1
3437582967,0,1,0,0,1
3437986144,0,1,0,0,1
3438043463,0,1,0,0,1
3438309453,1,0,0,0,1
3438402723,0,1,0,0,1
3438529882,0,1,0,0,1
3438878145,0,1,0,0,1
3438997817,1,0,0,0,1
3439014689,1,0,0,0,1
3439441864,0,1,0,0,1
3439799752,0,1,0,0,1
3435313889,0,1,0,0,1
3435300809,0,1,0,0,1
3435277660,0,1,0,0,1
3432495027,0,1,0,0,1
3428911174,0,1,0,0,1
3429711725,0,1,0,0,1
3429769306,1,0,0,0,1
3430362687,0,1,0,0,1
3431263853,0,1,0,0,1
3431587941,0,1,0,0,1
3431730136,0,1,0,0,1
3431749055,0,1,0,0,1
3432192760,1,0,0,0,1
3432232354,0,1,0,0,1
3432758981,0,1,0,0,1
3435269363,0,1,0,0,1
3432907167,0,1,0,0,1
3433069438,1,0,0,0,1
3433311865,1,0,0,0,1
3433460549,0,1,0,0,1
3433985387,0,1,0,0,1
3434482721,0,1,0,0,1
3434485996,1,0,0,0,1
3434664100,0,1,0,0,1
3434671799,0,1,0,0,1
3434791216,0,1,0,0,1
3406369175,0,1,0,0,1
3405578458,0,1,0,0,1
3405445451,1,0,0,0,1
3392634312,0,1,0,0,1
3385802992,0,1,0,0,1
3385941825,0,1,0,0,1
3386861445,0,1,0,0,1
3387117191,0,1,0,0,1
3387146903,0,1,0,0,1
3387434938,0,1,0,0,1
3387506345,0,1,0,0,1
3387820065,0,1,0,0,1
3387908063,0,1,0,0,1
3388112829,0,1,0,0,1
3388348018,0,1,0,0,1
3388542029,0,1,0,0,1
3389206094,0,1,0,0,1
3389342001,0,1,0,0,1
3389675308,1,0,0,0,1
3389695869,0,1,0,0,1
3389782461,0,1,0,0,1
3389942932,0,1,0,0,1
3390005061,1,0,0,0,1
3391581177,1,0,0,0,1
3391666313,0,1,0,0,1
3391900162,0,1,0,0,1
3391945996,1,0,0,0,1
3385718254,0,1,0,0,1
3385643619,0,1,0,0,1
3384821806,0,1,0,0,1
3381469265,0,1,0,0,1
3378773866,0,1,0,0,1
3378796144,0,1,0,0,1
3379587765,0,1,0,0,1
3379925835,0,1,0,0,1
3380148717,0,1,0,0,1
3380524985,0,1,0,0,1
3380805329,0,1,0,0,1
3380999405,0,1,0,0,1
3381204311,0,1,0,0,1
3381468885,0,1,0,0,1
3381757779,0,1,0,0,1
3384413391,0,1,0,0,1
3381759747,0,1,0,0,1
3382045445,1,0,0,0,1
3382882391,0,1,0,0,1
3383305235,0,1,0,0,1
3383480079,1,0,0,0,1
3383777997,0,1,0,0,1
3383925711,0,1,0,0,1
3384312793,0,1,0,0,1
3384398488,0,1,0,0,1
3384402953,1,0,0,0,1
3392331843,0,1,0,0,1
3392867343,0,1,0,0,1
3404943808,0,1,0,0,1
3393266327,0,1,0,0,1
3398909811,0,1,0,0,1
3398912525,0,1,0,0,1
3398954193,0,1,0,0,1
3399344860,1,0,0,0,1
3399424287,0,1,0,0,1
3399492909,0,1,0,0,1
3399921575,0,1,0,0,1
3400949524,0,1,0,0,1
3400999215,0,1,0,0,1
3401019695,1,0,0,0,1
3401228961,0,1,0,0,1
3401272425,1,0,0,0,1
3401411925,1,0,0,0,1
3401501613,0,1,0,0,1
3401523262,0,1,0,0,1
3402147191,0,1,0,0,1
3402336653,0,1,0,0,1
3402485463,0,1,0,0,1
3403429635,0,1,0,0,1
3403475361,0,1,0,0,1
3403601577,1,0,0,0,1
3404249171,0,1,0,0,1
3404749444,0,1,0,0,1
3398870566,0,1,0,0,1
3398583689,0,1,0,0,1
3398520663,0,1,0,0,1
3395628442,0,1,0,0,1
3393285502,1,0,0,0,1
3393429681,0,0,0,1,1
3393862702,0,1,0,0,1
3393891207,0,1,0,0,1
3393971015,0,1,0,0,1
3394209316,0,1,0,0,1
3394247451,0,1,0,0,1
3394463679,0,1,0,0,1
3395162459,0,1,0,0,1
3395389299,0,1,0,0,1
3395709340,0,1,0,0,1
3397664350,0,1,0,0,1
3395723001,0,0,1,0,1
3396225867,0,1,0,0,1
3396322756,0,1,0,0,1
3396581255,1,0,0,0,1
3396637774,0,1,0,0,1
3396952060,0,1,0,0,1
3397010013,0,1,0,0,1
3397089436,0,1,0,0,1
3397283639,1,0,0,0,1
3397536429,0,1,0,0,1
3439877607,0,1,0,0,1
3439943896,0,1,0,0,1
3731569996,0,1,0,0,1
3640697841,0,1,0,0,1
3641750008,1,0,0,0,1
3642305595,0,1,0,0,1
3642310752,0,1,0,0,1
3644290485,0,1,0,0,1
3644437216,0,1,0,0,1
3644445617,1,0,0,0,1
3648015855,0,1,0,0,1
3648612193,1,0,0,0,1
3648659413,1,0,0,0,1
3648998236,0,1,0,0,1
3649041314,0,1,0,0,1
3650364195,0,1,0,0,1
3650985014,0,1,0,0,1
3652474754,1,0,0,0,1
3653017042,0,1,0,0,1
3655388853,0,1,0,0,1
3656256873,0,1,0,0,1
3657007875,1,0,0,0,1
3661287073,0,1,0,0,1
3663708262,0,1,0,0,1
3664554797,0,1,0,0,1
3665966897,0,1,0,0,1
3667889776,0,1,0,0,1
3641375595,0,1,0,0,1
3637801765,1,0,0,0,1
3442646235,0,1,0,0,1
3635875155,0,1,0,0,1
3606457698,0,1,0,0,1
3607432815,0,1,0,0,1
3607506854,1,0,0,0,1
3611233998,0,1,0,0,1
3612574576,0,1,0,0,1
3614617339,0,0,0,1,1
3615505878,1,0,0,0,1
3617336472,0,1,0,0,1
3620071276,0,1,0,0,1
3620108656,0,1,0,0,1
3622748717,1,0,0,0,1
3624773477,0,1,0,0,1
3625505116,0,1,0,0,1
3626299576,0,1,0,0,1
3627327200,0,1,0,0,1
3627579915,0,1,0,0,1
3627796513,0,1,0,0,1
3629540595,0,1,0,0,1
3630737413,1,0,0,0,1
3631698554,0,1,0,0,1
3631883301,1,0,0,0,1
3632173215,0,1,0,0,1
3632203692,0,1,0,0,1
3668114774,0,1,0,0,1
3668375175,0,1,0,0,1
3671331135,0,1,0,0,1
3671745616,0,1,0,0,1
3697262189,0,1,0,0,1
3697497497,0,1,0,0,1
3698699303,0,1,0,0,1
3699754157,0,1,0,0,1
3701537955,0,1,0,0,1
3702612315,0,0,0,1,1
3704064672,0,1,0,0,1
3705040216,0,0,0,1,1
3705136155,0,1,0,0,1
3706790713,0,1,0,0,1
3709713922,0,1,0,0,1
3710763916,0,1,0,0,1
3712334653,0,1,0,0,1
3716730621,0,1,0,0,1
3716924894,0,1,0,0,1
3718546215,0,1,0,0,1
3719392344,0,1,0,0,1
3719967982,0,1,0,0,1
3724624758,0,1,0,0,1
3727643371,1,0,0,0,1
3728420657,0,1,0,0,1
3729379755,0,1,0,0,1
3730853837,0,1,0,0,1
3696178818,1,0,0,0,1
3695193447,0,0,0,1,1
3694786936,0,1,0,0,1
3682910233,0,1,0,0,1
3672337635,0,1,0,0,1
3673090758,0,1,0,0,1
3673301717,0,1,0,0,1
3673842262,1,0,0,0,1
3675941481,1,0,0,0,1
3676171996,0,1,0,0,1
3676768753,0,1,0,0,1
3678170472,0,1,0,0,1
3678441072,0,1,0,0,1
3679114162,0,1,0,0,1
3682959614,0,1,0,0,1
3694054096,0,1,0,0,1
3684397469,0,1,0,0,1
3684638661,1,0,0,0,1
3686054239,0,1,0,0,1
3686306973,0,1,0,0,1
3686338637,0,1,0,0,1
3687608434,0,1,0,0,1
3687793932,0,1,0,0,1
3688076363,0,1,0,0,1
3690103635,0,1,0,0,1
3692776517,0,0,0,1,1
3606131842,1,0,0,0,1
3603930792,0,0,0,1,1
3603221237,0,1,0,0,1
3524920332,1,0,0,0,1
3485696597,1,0,0,0,1
3486292642,0,1,0,0,1
3491350512,0,1,0,0,1
3491518592,0,1,0,0,1
3493331956,0,1,0,0,1
3494285181,0,1,0,0,1
3495822137,0,1,0,0,1
3496462517,0,1,0,0,1
3497404516,0,1,0,0,1
3498720620,0,1,0,0,1
3502101738,0,1,0,0,1
3503082322,0,1,0,0,1
3503098997,0,1,0,0,1
3503877393,0,1,0,0,1
3504850881,0,1,0,0,1
3505626200,0,1,0,0,1
3507902352,0,1,0,0,1
3511000694,0,1,0,0,1
3513516210,1,0,0,0,1
3513875362,0,1,0,0,1
3520227436,0,1,0,0,1
3522646995,0,1,0,0,1
3523359616,0,1,0,0,1
3485329274,0,1,0,0,1
3484436296,0,1,0,0,1
3484355843,0,1,0,0,1
3458068047,0,1,0,0,1
3445162458,1,0,0,0,1
3445270094,0,1,0,0,1
3446989285,0,1,0,0,1
3447955217,0,1,0,0,1
3448152856,0,1,0,0,1
3448421657,0,1,0,0,1
3449176932,1,0,0,0,1
3453884595,0,1,0,0,1
3454699575,0,1,0,0,1
3456525673,0,1,0,0,1
3459549804,1,0,0,0,1
3482306901,0,1,0,0,1
3461934993,0,1,0,0,1
3463683077,0,1,0,0,1
3469787352,0,1,0,0,1
3471978972,0,1,0,0,1
3472874901,0,1,0,0,1
3473839034,0,1,0,0,1
3476515576,0,0,1,0,1
3478001667,0,1,0,0,1
3481150221,1,0,0,0,1
3481684463,1,0,0,0,1
3523638194,0,1,0,0,1
3525608237,0,1,0,0,1
3602670012,1,0,0,0,1
3526384157,0,1,0,0,1
3561921927,0,1,0,0,1
3563185456,0,1,0,0,1
3568294035,0,1,0,0,1
3568948155,0,1,0,0,1
3569468727,1,0,0,0,1
3573336134,0,1,0,0,1
3573719481,0,1,0,0,1
3573856813,0,1,0,0,1
3577687576,0,1,0,0,1
3577887675,0,1,0,0,1
3579072494,0,1,0,0,1
3579677195,0,1,0,0,1
3579899783,0,1,0,0,1
3587809996,0,1,0,0,1
3592183813,0,1,0,0,1
3592508061,0,1,0,0,1
3595957524,0,1,0,0,1
3599687057,0,1,0,0,1
3601307074,0,1,0,0,1
3601491732,0,1,0,0,1
3601612697,0,1,0,0,1
3601741997,0,1,0,0,1
3601771756,0,1,0,0,1
3560812815,0,1,0,0,1
3559373715,0,1,0,0,1
3558248473,1,0,0,0,1
3535205415,1,0,0,0,1
3526890977,0,1,0,0,1
3527746517,0,0,0,1,1
3531023775,0,1,0,0,1
3531549017,0,0,0,1,1
3531994695,0,1,0,0,1
3533176217,0,0,0,1,1
3533365633,0,1,0,0,1
3533731575,0,1,0,0,1
3534035121,0,1,0,0,1
3534104115,0,1,0,0,1
3536240602,1,0,0,0,1
3558177675,0,1,0,0,1
3544836201,0,1,0,0,1
3545477960,1,0,0,0,1
3547362441,0,1,0,0,1
3548610141,0,1,0,0,1
3550514712,0,1,0,0,1
3553108817,0,1,0,0,1
3554364023,0,1,0,0,1
3555188712,0,1,0,0,1
3556538720,0,1,0,0,1
3558136573,0,1,0,0,1
3211894853,0,1,0,0,1
3208707549,0,1,0,0,1
2875146653,0,1,0,0,1
2958275979,0,1,0,0,1
2958409661,1,0,0,0,1
2958441350,0,1,0,0,1
2958654062,1,0,0,0,1
2958822726,0,1,0,0,1
2958947552,0,1,0,0,1
2959151677,1,0,0,0,1
2959254933,0,1,0,0,1
2959733018,1,0,0,0,1
2959809710,0,1,0,0,1
2959834088,0,1,0,0,1
2959886385,0,1,0,0,1
2959924530,0,1,0,0,1
2960187717,0,1,0,0,1
2960557096,0,1,0,0,1
2960761761,0,1,0,0,1
2960972699,0,1,0,0,1
2961642627,0,1,0,0,1
2961846203,0,1,0,0,1
2961956555,0,1,0,0,1
2962245277,0,0,0,1,1
2962423176,1,0,0,0,1
2962644973,0,1,0,0,1
2962706566,0,1,0,0,1
2958388811,0,1,0,0,1
2958248532,1,0,0,0,1
2953637481,0,0,1,0,1
2958151728,0,0,0,1,1
2954018276,1,0,0,0,1
2954529697,1,0,0,0,1
2954736490,0,1,0,0,1
2954794618,0,1,0,0,1
2954839282,0,1,0,0,1
2954887807,0,1,0,0,1
2954968366,0,1,0,0,1
2955064812,0,1,0,0,1
2955131358,0,1,0,0,1
2955171952,1,0,0,0,1
2955181760,0,1,0,0,1
2955233225,0,1,0,0,1
2955280915,1,0,0,0,1
2955432069,1,0,0,0,1
2955789098,0,1,0,0,1
2955870122,0,1,0,0,1
2956201225,0,1,0,0,1
2956435219,0,1,0,0,1
2956489459,0,1,0,0,1
2956921729,1,0,0,0,1
2957374932,0,1,0,0,1
2957761768,0,1,0,0,1
2958094843,0,1,0,0,1
2963093308,0,1,0,0,1
2963552386,1,0,0,0,1
2963709996,0,1,0,0,1
2964374716,0,1,0,0,1
2969719672,0,1,0,0,1
2970193905,0,1,0,0,1
2970386285,0,1,0,0,1
2970518764,1,0,0,0,1
2970623835,1,0,0,0,1
2970663664,0,1,0,0,1
2970760177,0,1,0,0,1
2971085351,0,1,0,0,1
2971660913,0,1,0,0,1
2971738589,0,1,0,0,1
2971837252,0,1,0,0,1
2972116907,1,0,0,0,1
2972422545,1,0,0,0,1
2973237375,0,1,0,0,1
2973403097,0,1,0,0,1
2973411382,0,1,0,0,1
2973548776,0,1,0,0,1
2973666300,1,0,0,0,1
2973721235,1,0,0,0,1
2973971083,0,1,0,0,1
2975271999,0,1,0,0,1
2975353565,1,0,0,0,1
2975446578,0,1,0,0,1
2969282946,0,1,0,0,1
2968091837,0,1,0,0,1
2968001607,0,1,0,0,1
2966006285,0,1,0,0,1
2964634744,0,1,0,0,1
2964669058,0,1,0,0,1
2964722259,0,1,0,0,1
2964735753,0,1,0,0,1
2965115278,0,1,0,0,1
2965207333,0,1,0,0,1
2965348491,0,1,0,0,1
2965708547,0,1,0,0,1
2965715531,0,1,0,0,1
2965896311,0,0,1,0,1
2966295357,0,1,0,0,1
2967976767,0,1,0,0,1
2966392481,0,1,0,0,1
2966537951,0,1,0,0,1
2966678248,0,1,0,0,1
2966709412,0,0,0,1,1
2966757340,0,1,0,0,1
2966860624,0,1,0,0,1
2966986589,0,1,0,0,1
2967450592,0,1,0,0,1
2967463302,0,1,0,0,1
2967476632,0,1,0,0,1
2953911406,0,1,0,0,1
2953566175,0,1,0,0,1
3207859331,0,1,0,0,1
2938900584,0,1,0,0,1
2939154966,1,0,0,0,1
2939315619,1,0,0,0,1
2939523010,0,1,0,0,1
2939716115,0,1,0,0,1
2939809518,1,0,0,0,1
2939942884,0,1,0,0,1
2940278544,1,0,0,0,1
2940379005,0,1,0,0,1
2940459112,0,1,0,0,1
2940781038,0,0,1,0,1
2940844229,0,1,0,0,1
2940877263,0,1,0,0,1
2941102857,0,1,0,0,1
2941109467,0,1,0,0,1
2941334931,0,1,0,0,1
2941484378,0,1,0,0,1
2941558656,1,0,0,0,1
2941915384,0,1,0,0,1
2941987033,0,1,0,0,1
2942066485,1,0,0,0,1
2942212827,0,1,0,0,1
2942219296,0,1,0,0,1
2942644795,0,1,0,0,1
2938983090,0,1,0,0,1
2938490505,0,1,0,0,1
2953201990,0,1,0,0,1
2938408655,0,1,0,0,1
2935618351,0,1,0,0,1
2935633935,0,1,0,0,1
2935693734,0,1,0,0,1
2935842292,0,1,0,0,1
2935967851,1,0,0,0,1
2936028801,0,1,0,0,1
2936517999,0,1,0,0,1
2936722470,1,0,0,0,1
2936802204,0,1,0,0,1
2936847821,0,1,0,0,1
2936908680,1,0,0,0,1
2936936297,0,1,0,0,1
2936990758,0,1,0,0,1
2937131360,1,0,0,0,1
2937204458,0,0,1,0,1
2937367394,0,1,0,0,1
2937709773,0,1,0,0,1
2937719377,1,0,0,0,1
2937789269,1,0,0,0,1
2937977355,0,1,0,0,1
2938109319,0,1,0,0,1
2938116839,0,1,0,0,1
2938364362,1,0,0,0,1
2942805180,0,1,0,0,1
2943130035,0,1,0,0,1
2943233053,0,1,0,0,1
2943279970,0,1,0,0,1
2949914041,0,1,0,0,1
2950201023,0,1,0,0,1
2950512341,0,1,0,0,1
2950714775,0,1,0,0,1
2950783095,0,1,0,0,1
2950923111,0,1,0,0,1
2950996919,0,1,0,0,1
2951027582,1,0,0,0,1
2951215268,0,1,0,0,1
2951277981,0,1,0,0,1
2951396574,0,1,0,0,1
2951402492,0,0,1,0,1
2951488664,0,1,0,0,1
2951764143,0,1,0,0,1
2951819713,1,0,0,0,1
2951836275,0,1,0,0,1
2951873399,0,1,0,0,1
2951887116,0,1,0,0,1
2952038530,0,1,0,0,1
2952276905,0,1,0,0,1
2952501849,0,1,0,0,1
2952571373,0,1,0,0,1
2953153218,0,1,0,0,1
2949582049,1,0,0,0,1
2949176934,0,1,0,0,1
2949158317,0,1,0,0,1
2946130395,1,0,0,0,1
2943391978,0,1,0,0,1
2943471270,0,1,0,0,1
2943622677,0,1,0,0,1
2943682546,0,1,0,0,1
2943975435,0,1,0,0,1
2944917276,0,1,0,0,1
2945145631,0,1,0,0,1
2945547448,0,1,0,0,1
2945710371,0,1,0,0,1
2945912786,0,1,0,0,1
2946162522,0,1,0,0,1
2949091801,0,1,0,0,1
2946238946,0,1,0,0,1
2946289725,0,1,0,0,1
2946587449,0,1,0,0,1
2946651220,0,1,0,0,1
2946728802,1,0,0,0,1
2946792636,0,1,0,0,1
2947591773,0,1,0,0,1
2948503767,0,1,0,0,1
2948614682,0,1,0,0,1
2949028829,0,1,0,0,1
2975517433,0,0,0,1,1
2975827557,0,1,0,0,1
2975949616,0,1,0,0,1
2997628781,0,1,0,0,1
2997788288,0,0,1,0,1
2997932378,0,1,0,0,1
2997933594,0,1,0,0,1
2997986504,0,1,0,0,1
2998254334,0,1,0,0,1
2998381101,0,1,0,0,1
2998447245,0,1,0,0,1
2998489233,0,1,0,0,1
2998606846,0,1,0,0,1
2998664108,1,0,0,0,1
2998786775,0,1,0,0,1
2998960614,0,1,0,0,1
2999183545,0,1,0,0,1
2999187127,0,1,0,0,1
2999586113,0,1,0,0,1
2999590987,1,0,0,0,1
3000741559,0,1,0,0,1
3000752486,0,1,0,0,1
3000754656,0,1,0,0,1
3000921380,0,1,0,0,1
3000955993,0,1,0,0,1
3001153192,1,0,0,0,1
3001338652,0,1,0,0,1
2997721967,0,1,0,0,1
2997549258,1,0,0,0,1
2975988110,1,0,0,0,1
2997380925,0,1,0,0,1
2993879963,0,1,0,0,1
2993906559,0,1,0,0,1
2993979984,0,1,0,0,1
2994000333,1,0,0,0,1
2994092950,0,0,0,1,1
2994145258,0,1,0,0,1
2994228435,0,1,0,0,1
2994457375,1,0,0,0,1
2994782621,0,1,0,0,1
2995398629,0,1,0,0,1
2995632241,0,1,0,0,1
2995639077,0,1,0,0,1
2995734297,0,1,0,0,1
2995976177,0,1,0,0,1
2995976978,0,1,0,0,1
2996328683,0,1,0,0,1
2996564866,0,0,0,1,1
2996572037,0,1,0,0,1
2996633765,0,1,0,0,1
2996699588,1,0,0,0,1
2996710642,0,1,0,0,1
2997344185,0,1,0,0,1
2997352478,0,1,0,0,1
3001347990,0,1,0,0,1
3001556591,1,0,0,0,1
3001599916,0,1,0,0,1
3002097339,0,1,0,0,1
3006999397,0,1,0,0,1
3007144852,0,1,0,0,1
3007384016,0,1,0,0,1
3007408271,1,0,0,0,1
3007423281,0,1,0,0,1
3007423315,0,1,0,0,1
3007461938,1,0,0,0,1
3007905773,0,1,0,0,1
3007925428,0,0,0,1,1
3007964693,0,1,0,0,1
3008225510,0,1,0,0,1
3008295420,0,1,0,0,1
3009011638,0,1,0,0,1
3009016224,0,1,0,0,1
3009461184,0,1,0,0,1
3010096511,0,1,0,0,1
3010192850,0,1,0,0,1
3010279074,0,1,0,0,1
3010552077,0,1,0,0,1
3010833922,0,1,0,0,1
3011004728,0,1,0,0,1
3011133061,0,1,0,0,1
3011276116,1,0,0,0,1
3006717596,1,0,0,0,1
3006178599,0,1,0,0,1
3005847047,0,1,0,0,1
3004056070,0,0,1,0,1
3002291385,1,0,0,0,1
3002385860,0,1,0,0,1
3002562189,1,0,0,0,1
3002852831,0,1,0,0,1
3002927703,0,0,0,1,1
3003186330,0,1,0,0,1
3003497989,0,1,0,0,1
3003644438,0,1,0,0,1
3003702268,0,1,0,0,1
3003854120,0,1,0,0,1
3004094126,0,1,0,0,1
3005333747,0,1,0,0,1
3004108919,0,1,0,0,1
3004219894,1,0,0,0,1
3004358299,1,0,0,0,1
3004594222,1,0,0,0,1
3004931943,0,1,0,0,1
3005077058,1,0,0,0,1
3005175041,0,1,0,0,1
3005226743,0,1,0,0,1
3005319460,0,1,0,0,1
3005325681,0,1,0,0,1
2993841853,0,1,0,0,1
2993817528,0,1,0,0,1
2993557417,1,0,0,0,1
2984413245,0,1,0,0,1
2980467874,0,1,0,0,1
2980684566,0,1,0,0,1
2980790159,0,1,0,0,1
2981014091,0,1,0,0,1
2981015463,1,0,0,0,1
2981108381,0,1,0,0,1
2981109581,0,1,0,0,1
2981545459,0,1,0,0,1
2981656487,0,1,0,0,1
2981765176,0,1,0,0,1
2981997021,0,1,0,0,1
2982040313,0,1,0,0,1
2982225015,0,1,0,0,1
2982324369,0,1,0,0,1
2982440403,0,0,1,0,1
2982559851,1,0,0,0,1
2982632691,0,1,0,0,1
2982741914,0,0,1,0,1
2983557797,0,1,0,0,1
2984138246,0,0,1,0,1
2984161780,0,1,0,0,1
2984190263,0,1,0,0,1
2984247814,0,1,0,0,1
2980319539,0,1,0,0,1
2980241731,0,1,0,0,1
2980220824,0,1,0,0,1
2978206095,0,0,1,0,1
2976229972,0,1,0,0,1
2976290225,0,1,0,0,1
2976550517,0,1,0,0,1
2976950473,1,0,0,0,1
2977102350,0,1,0,0,1
2977328077,0,1,0,0,1
2977660431,0,1,0,0,1
2977779485,0,1,0,0,1
2977790012,0,1,0,0,1
2978163593,0,1,0,0,1
2978221714,0,1,0,0,1
2979784756,0,1,0,0,1
2978476075,0,1,0,0,1
2978616281,0,1,0,0,1
2978684405,0,0,0,1,1
2978805595,0,1,0,0,1
2978828511,0,1,0,0,1
2978929853,0,0,1,0,1
2979146893,0,1,0,0,1
2979555790,0,1,0,0,1
2979705074,1,0,0,0,1
2979737987,0,1,0,0,1
2984347412,0,1,0,0,1
2984536203,0,1,0,0,1
2993534871,0,1,0,0,1
2984610092,0,1,0,0,1
2990133024,0,1,0,0,1
2990209500,0,1,0,0,1
2990226977,0,1,0,0,1
2990255143,1,0,0,0,1
2990313797,0,1,0,0,1
2990600388,1,0,0,0,1
2990890231,1,0,0,0,1
2990941925,0,1,0,0,1
2990973864,0,1,0,0,1
2990994441,1,0,0,0,1
2991006930,0,1,0,0,1
2991156819,0,1,0,0,1
2991481202,0,1,0,0,1
2991666946,0,1,0,0,1
2991795547,0,1,0,0,1
2991814779,0,0,0,1,1
2991920091,1,0,0,0,1
2992361364,0,1,0,0,1
2992469967,1,0,0,0,1
2992478841,0,1,0,0,1
2992520953,0,1,0,0,1
2992645047,1,0,0,0,1
2992953260,0,1,0,0,1
2989853173,1,0,0,0,1
2989793753,1,0,0,0,1
2989503115,0,1,0,0,1
2986699430,1,0,0,0,1
2985359755,0,1,0,0,1
2985486263,0,1,0,0,1
2985647891,0,1,0,0,1
2985707731,0,1,0,0,1
2985877266,0,1,0,0,1
2985954933,0,1,0,0,1
2986195098,0,1,0,0,1
2986314615,0,1,0,0,1
2986509244,0,1,0,0,1
2986622123,0,1,0,0,1
2987055700,0,1,0,0,1
2989409618,0,1,0,0,1
2987278909,1,0,0,0,1
2987522191,0,1,0,0,1
2988032829,0,1,0,0,1
2988197549,1,0,0,0,1
2988330056,0,1,0,0,1
2988361163,0,1,0,0,1
2988636325,0,1,0,0,1
2988775633,0,1,0,0,1
2989185136,0,1,0,0,1
2989225292,0,1,0,0,1
2935340205,0,1,0,0,1
2935281960,0,1,0,0,1
2934947016,0,1,0,0,1
2894555682,0,1,0,0,1
2894660804,0,1,0,0,1
2894863678,0,1,0,0,1
2894989310,1,0,0,0,1
2895031258,1,0,0,0,1
2895142545,1,0,0,0,1
2895400479,0,1,0,0,1
2895496501,0,1,0,0,1
2895573237,0,1,0,0,1
2895637387,0,1,0,0,1
2895742966,0,1,0,0,1
2895781408,0,1,0,0,1
2895857502,0,1,0,0,1
2896055658,0,0,1,0,1
2896104038,0,1,0,0,1
2896275981,1,0,0,0,1
2896315021,0,1,0,0,1
2896371568,0,1,0,0,1
2896381276,0,1,0,0,1
2896442298,1,0,0,0,1
2896702122,1,0,0,0,1
2896769155,0,1,0,0,1
2896801541,0,1,0,0,1
2897562935,1,0,0,0,1
2894633509,1,0,0,0,1
2894467116,0,1,0,0,1
2904449345,1,0,0,0,1
2894433811,0,1,0,0,1
2892527686,0,1,0,0,1
2892599386,0,1,0,0,1
2892609245,0,1,0,0,1
2892727417,0,1,0,0,1
2892862589,0,1,0,0,1
2892878217,0,1,0,0,1
2892915205,0,1,0,0,1
2892947058,0,1,0,0,1
2892974031,0,1,0,0,1
2893060584,0,1,0,0,1
2893086248,0,1,0,0,1
2893138857,0,1,0,0,1
2893318251,0,1,0,0,1
2893370711,1,0,0,0,1
2893627803,0,1,0,0,1
2893653197,0,0,0,1,1
2893660395,0,0,1,0,1
2893749034,0,0,1,0,1
2894077713,0,1,0,0,1
2894103350,0,1,0,0,1
2894149905,0,1,0,0,1
2894317233,0,1,0,0,1
2894388371,0,1,0,0,1
2897634218,0,1,0,0,1
2897727896,1,0,0,0,1
2897919564,1,0,0,0,1
2898238766,0,1,0,0,1
2902539499,0,0,0,1,1
2902614277,1,0,0,0,1
2902656148,0,1,0,0,1
2902716917,0,0,0,1,1
2902856265,0,1,0,0,1
2903119641,0,1,0,0,1
2903249977,0,1,0,0,1
2903329194,0,1,0,0,1
2903450601,0,1,0,0,1
2903462075,0,1,0,0,1
2903531998,0,1,0,0,1
2903590302,0,1,0,0,1
2903781842,0,1,0,0,1
2904021276,0,1,0,0,1
2904048388,0,1,0,0,1
2904107582,0,1,0,0,1
2904114668,1,0,0,0,1
2904251350,0,1,0,0,1
2904252337,0,1,0,0,1
2904272352,0,1,0,0,1
2904281265,1,0,0,0,1
2904292760,0,1,0,0,1
2904317034,0,1,0,0,1
2902092937,0,1,0,0,1
2902080532,0,1,0,0,1
2901761683,1,0,0,0,1
2899884312,0,1,0,0,1
2898275414,0,1,0,0,1
2898464636,1,0,0,0,1
2898647658,0,1,0,0,1
2898991328,1,0,0,0,1
2899083971,0,1,0,0,1
2899205968,0,1,0,0,1
2899330766,0,1,0,0,1
2899501820,0,1,0,0,1
2899694748,1,0,0,0,1
2899719034,0,1,0,0,1
2900005939,1,0,0,0,1
2901261142,1,0,0,0,1
2900057850,1,0,0,0,1
2900314014,0,1,0,0,1
2900363757,0,1,0,0,1
2900440468,1,0,0,0,1
2900445588,0,1,0,0,1
2900469203,0,1,0,0,1
2900500716,0,1,0,0,1
2900656634,0,1,0,0,1
2900902876,0,1,0,0,1
2901210997,0,1,0,0,1
2892513879,0,1,0,0,1
2892511779,0,1,0,0,1
2892374915,0,1,0,0,1
2885340999,0,1,0,0,1
2880904304,0,1,0,0,1
2881221703,0,1,0,0,1
2881325909,0,1,0,0,1
2881390656,1,0,0,0,1
2881445474,0,1,0,0,1
2881470501,0,1,0,0,1
2881607051,1,0,0,0,1
2881853948,0,1,0,0,1
2882145800,0,1,0,0,1
2882598022,0,1,0,0,1
2882801678,0,1,0,0,1
2882890181,0,1,0,0,1
2882971410,1,0,0,0,1
2883047594,0,0,0,1,1
2883176115,0,1,0,0,1
2883258879,0,1,0,0,1
2884074459,1,0,0,0,1
2884438508,0,1,0,0,1
2884474248,0,1,0,0,1
2884537596,0,1,0,0,1
2884808095,0,1,0,0,1
2885016270,0,1,0,0,1
2885247263,1,0,0,0,1
2880618363,0,1,0,0,1
2880495098,0,1,0,0,1
2880486633,0,1,0,0,1
2877179937,0,1,0,0,1
2875154563,0,1,0,0,1
2875590639,0,1,0,0,1
2876249524,0,1,0,0,1
2876572859,0,1,0,0,1
2876582498,0,1,0,0,1
2876820868,1,0,0,0,1
2876880845,0,1,0,0,1
2876883538,0,1,0,0,1
2876896441,0,1,0,0,1
2877104890,0,1,0,0,1
2877500357,0,1,0,0,1
2880019992,1,0,0,0,1
2877823792,0,1,0,0,1
2878028046,0,1,0,0,1
2878255611,0,1,0,0,1
2878951723,0,1,0,0,1
2879262969,1,0,0,0,1
2879270203,0,1,0,0,1
2879311065,0,1,0,0,1
2879408557,0,0,1,0,1
2879941406,0,1,0,0,1
2879969184,0,1,0,0,1
2885313632,0,1,0,0,1
2885610535,0,1,0,0,1
2892329182,0,1,0,0,1
2885610993,1,0,0,0,1
2889221200,0,1,0,0,1
2889428368,0,1,0,0,1
2889519856,0,1,0,0,1
2889651373,1,0,0,0,1
2889794155,0,1,0,0,1
2889940639,0,1,0,0,1
2890091570,0,1,0,0,1
2890388095,0,1,0,0,1
2890452576,0,1,0,0,1
2890546175,0,1,0,0,1
2890574095,0,1,0,0,1
2890632919,1,0,0,0,1
2890762312,0,1,0,0,1
2890782736,0,1,0,0,1
2891446843,0,1,0,0,1
2891483473,0,1,0,0,1
2891533714,0,1,0,0,1
2891606631,1,0,0,0,1
2891885714,1,0,0,0,1
2891905222,0,1,0,0,1
2891917756,1,0,0,0,1
2892066391,0,1,0,0,1
2892251292,0,1,0,0,1
2889101253,0,1,0,0,1
2889094668,0,1,0,0,1
2888896072,0,1,0,0,1
2887174009,0,1,0,0,1
2885638479,0,0,1,0,1
2885784466,0,1,0,0,1
2885898861,0,1,0,0,1
2886329326,0,1,0,0,1
2886608184,0,0,1,0,1
2886630249,0,1,0,0,1
2886840382,0,1,0,0,1
2886853479,0,1,0,0,1
2886911556,0,1,0,0,1
2886948909,1,0,0,0,1
2887293508,0,1,0,0,1
2888861027,0,1,0,0,1
2887373951,0,1,0,0,1
2887542734,0,1,0,0,1
2887582760,0,0,0,1,1
2887705292,1,0,0,0,1
2887810131,0,1,0,0,1
2888050816,0,1,0,0,1
2888152751,0,1,0,0,1
2888216538,0,1,0,0,1
2888334022,0,1,0,0,1
2888755970,0,1,0,0,1
2904368954,1,0,0,0,1
2904577324,0,1,0,0,1
2934295452,0,1,0,0,1
2922873913,0,1,0,0,1
2923004656,0,1,0,0,1
2923282958,0,1,0,0,1
2923633786,0,1,0,0,1
2923772594,0,1,0,0,1
2924029345,0,1,0,0,1
2924177605,0,1,0,0,1
2924366173,0,1,0,0,1
2924419184,0,1,0,0,1
2924475447,0,1,0,0,1
2924923814,0,1,0,0,1
2925147413,0,1,0,0,1
2925172281,0,1,0,0,1
2925686451,0,1,0,0,1
2925787775,0,1,0,0,1
2926067233,0,1,0,0,1
2926107302,0,1,0,0,1
2926270598,1,0,0,0,1
2926636541,0,1,0,0,1
2926706368,0,1,0,0,1
2927168563,0,0,1,0,1
2927290219,0,1,0,0,1
2927383202,0,1,0,0,1
2927453708,0,1,0,0,1
2922975874,0,1,0,0,1
2922730015,0,1,0,0,1
2904724569,0,1,0,0,1
2922567982,0,1,0,0,1
2918090942,0,1,0,0,1
2918460357,0,0,1,0,1
2918475800,0,1,0,0,1
2918965584,0,1,0,0,1
2918994034,0,1,0,0,1
2919453322,0,1,0,0,1
2919729334,0,1,0,0,1
2919741760,0,1,0,0,1
2919966962,1,0,0,0,1
2920202794,0,1,0,0,1
2920225534,0,1,0,0,1
2920639333,0,1,0,0,1
2920925750,0,1,0,0,1
2921031816,0,1,0,0,1
2921089734,0,1,0,0,1
2921160878,0,1,0,0,1
2921232190,0,1,0,0,1
2921374757,0,1,0,0,1
2921514418,0,1,0,0,1
2921558074,0,1,0,0,1
2921667184,0,0,0,1,1
2921948057,0,1,0,0,1
2922305297,1,0,0,0,1
2927831973,1,0,0,0,1
2927864819,0,1,0,0,1
2927880162,1,0,0,0,1
2928038439,0,1,0,0,1
2931846855,0,1,0,0,1
2931952633,0,1,0,0,1
2931979610,0,1,0,0,1
2932060849,0,1,0,0,1
2932135062,1,0,0,0,1
2932257260,0,1,0,0,1
2932407149,0,1,0,0,1
2932430619,0,1,0,0,1
2932528904,0,0,1,0,1
2932618493,1,0,0,0,1
2932706485,0,1,0,0,1
2932718307,1,0,0,0,1
2933116427,0,1,0,0,1
2933229227,0,1,0,0,1
2933382538,0,1,0,0,1
2933445257,0,1,0,0,1
2933449537,0,1,0,0,1
2933717709,0,1,0,0,1
2933748781,1,0,0,0,1
2933940689,0,1,0,0,1
2934012000,0,1,0,0,1
2934071194,0,1,0,0,1
2934162671,0,0,0,1,1
2931830812,0,0,1,0,1
2931813280,0,1,0,0,1
2931767230,0,1,0,0,1
2930416047,0,1,0,0,1
2928863198,0,1,0,0,1
2929336494,1,0,0,0,1
2929525296,0,1,0,0,1
2929577955,0,1,0,0,1
2929673360,0,0,1,0,1
2929710467,0,1,0,0,1
2929748058,0,1,0,0,1
2929783562,1,0,0,0,1
2930396271,1,0,0,0,1
2930398999,0,1,0,0,1
2930427863,0,1,0,0,1
2931675751,0,1,0,0,1
2930596676,0,1,0,0,1
2930826322,1,0,0,0,1
2931064062,0,1,0,0,1
2931101323,0,0,1,0,1
2931348899,0,1,0,0,1
2931379531,0,1,0,0,1
2931524177,1,0,0,0,1
2931545066,0,1,0,0,1
2931565657,0,1,0,0,1
2931645236,0,1,0,0,1
2917925133,1,0,0,0,1
2917909011,0,0,0,1,1
2917884258,0,1,0,0,1
2911462977,0,1,0,0,1
2907965414,0,1,0,0,1
2908009022,0,0,1,0,1
2908258045,0,1,0,0,1
2908657045,0,1,0,0,1
2908657253,0,1,0,0,1
2908786640,1,0,0,0,1
2908966960,0,1,0,0,1
2909091092,0,1,0,0,1
2909437403,0,1,0,0,1
2909619869,0,1,0,0,1
2909709471,0,1,0,0,1
2909822261,0,1,0,0,1
2909843729,0,1,0,0,1
2909860952,0,1,0,0,1
2910062244,0,1,0,0,1
2910331113,0,1,0,0,1
2910480119,1,0,0,0,1
2910589173,0,1,0,0,1
2910602169,0,1,0,0,1
2910978173,0,1,0,0,1
2911032296,0,1,0,0,1
2911170184,0,1,0,0,1
2911207380,0,1,0,0,1
2907907678,0,1,0,0,1
2907873262,0,1,0,0,1
2907858438,0,1,0,0,1
2906065652,1,0,0,0,1
2904794398,0,1,0,0,1
2905034873,0,1,0,0,1
2905109354,1,0,0,0,1
2905174279,0,1,0,0,1
2905374912,0,1,0,0,1
2905424987,0,1,0,0,1
2905543839,1,0,0,0,1
2905801640,0,1,0,0,1
2905947917,0,1,0,0,1
2905956330,0,1,0,0,1
2906146191,0,1,0,0,1
2907836870,1,0,0,0,1
2906191008,0,1,0,0,1
2906493387,0,1,0,0,1
2906758937,0,1,0,0,1
2906833726,0,1,0,0,1
2906981395,0,1,0,0,1
2907432807,0,1,0,0,1
2907553660,0,1,0,0,1
2907596571,0,1,0,0,1
2907661707,0,1,0,0,1
2907673717,0,1,0,0,1
2911272797,0,1,0,0,1
2911551366,1,0,0,0,1
2917790712,0,1,0,0,1
2911634523,0,1,0,0,1
2914955048,0,0,1,0,1
2915121657,0,1,0,0,1
2915238204,0,1,0,0,1
2915475260,1,0,0,0,1
2915591694,0,1,0,0,1
2915668241,1,0,0,0,1
2915748417,0,1,0,0,1
2915918746,0,1,0,0,1
2916411103,0,1,0,0,1
2916511922,1,0,0,0,1
2916530022,0,1,0,0,1
2916792717,0,1,0,0,1
2916801399,0,1,0,0,1
2916973112,0,1,0,0,1
2917050759,0,1,0,0,1
2917063313,0,1,0,0,1
2917086928,1,0,0,0,1
2917116386,0,1,0,0,1
2917172336,0,1,0,0,1
2917338731,0,1,0,0,1
2917461981,0,1,0,0,1
2917503313,0,1,0,0,1
2917639031,0,1,0,0,1
2914597730,0,1,0,0,1
2914586138,0,1,0,0,1
2914419775,1,0,0,0,1
2912826073,1,0,0,0,1
2911656608,0,1,0,0,1
2911659019,0,1,0,0,1
2911659108,1,0,0,0,1
2911673788,0,1,0,0,1
2911769959,0,0,1,0,1
2912116190,1,0,0,0,1
2912434793,0,1,0,0,1
2912508683,0,1,0,0,1
2912612255,0,1,0,0,1
2912755142,0,1,0,0,1
2912879575,0,1,0,0,1
2914303918,0,1,0,0,1
2913035525,0,1,0,0,1
2913181754,0,1,0,0,1
2913271410,0,1,0,0,1
2913322462,0,0,0,1,1
2913341641,0,0,1,0,1
2913430894,0,1,0,0,1
2913442732,0,0,0,1,1
2913698573,0,1,0,0,1
2914119548,1,0,0,0,1
2914178395,1,0,0,0,1
3011509986,0,1,0,0,1
3011590092,0,0,1,0,1
3011923403,0,1,0,0,1
3133696249,0,1,0,0,1
3134037724,1,0,0,0,1
3134924580,0,1,0,0,1
3135051814,0,1,0,0,1
3135124499,0,1,0,0,1
3135254439,0,1,0,0,1
3135324675,0,1,0,0,1
3135459912,0,1,0,0,1
3135581128,0,0,0,1,1
3136455713,0,1,0,0,1
3136487077,1,0,0,0,1
3136965942,0,1,0,0,1
3137179114,0,1,0,0,1
3138740529,0,1,0,0,1
3138780815,0,1,0,0,1
3138823518,0,1,0,0,1
3139283358,0,1,0,0,1
3139371336,0,1,0,0,1
3139558693,0,1,0,0,1
3139712669,0,1,0,0,1
3139811543,0,1,0,0,1
3140189778,0,1,0,0,1
3140677096,0,1,0,0,1
3141114562,0,1,0,0,1
3133854146,0,1,0,0,1
3133678730,0,1,0,0,1
3155480626,0,1,0,0,1
3133669557,0,1,0,0,1
3129732922,0,1,0,0,1
3129784420,0,1,0,0,1
3130115467,0,1,0,0,1
3130421673,0,1,0,0,1
3130602509,0,1,0,0,1
3130778513,0,0,0,1,1
3131083463,0,1,0,0,1
3131110703,0,1,0,0,1
3131187676,0,1,0,0,1
3131211530,0,1,0,0,1
3131236979,0,1,0,0,1
3131247251,0,1,0,0,1
3131294675,0,1,0,0,1
3131367471,0,1,0,0,1
3131608006,0,1,0,0,1
3131617043,0,1,0,0,1
3131658887,1,0,0,0,1
3131678237,0,1,0,0,1
3131863959,0,1,0,0,1
3132336618,0,1,0,0,1
3133497048,0,1,0,0,1
3133597866,0,1,0,0,1
3133622513,0,1,0,0,1
3141398249,0,1,0,0,1
3141427487,0,1,0,0,1
3141640196,0,1,0,0,1
3141717871,1,0,0,0,1
3149629362,1,0,0,0,1
3149637583,0,0,0,1,1
3150040049,1,0,0,0,1
3150397051,0,1,0,0,1
3150826473,0,1,0,0,1
3150907938,0,1,0,0,1
3151283031,0,1,0,0,1
3151763239,0,1,0,0,1
3151821750,0,1,0,0,1
3151881658,0,1,0,0,1
3151959490,0,1,0,0,1
3152100283,0,1,0,0,1
3152196171,0,1,0,0,1
3152460296,0,0,0,1,1
3152872133,0,1,0,0,1
3152877863,0,1,0,0,1
3153068623,0,1,0,0,1
3153180924,0,1,0,0,1
3153232566,1,0,0,0,1
3153243034,0,1,0,0,1
3153696794,0,1,0,0,1
3154001129,0,1,0,0,1
3154413784,0,1,0,0,1
3149581884,0,0,1,0,1
3149409752,1,0,0,0,1
3148577966,0,1,0,0,1
3145258625,1,0,0,0,1
3141904089,0,1,0,0,1
3143127642,0,1,0,0,1
3143453232,0,1,0,0,1
3143838538,0,1,0,0,1
3144491853,0,1,0,0,1
3144523534,0,1,0,0,1
3144570869,0,1,0,0,1
3144679483,1,0,0,0,1
3145037701,0,1,0,0,1
3145121096,0,1,0,0,1
3145412988,0,1,0,0,1
3148543100,0,1,0,0,1
3145479256,0,1,0,0,1
3145485666,0,1,0,0,1
3145706030,0,1,0,0,1
3145943785,0,1,0,0,1
3146089686,1,0,0,0,1
3146543182,0,1,0,0,1
3146695094,0,0,0,1,1
3147424338,0,1,0,0,1
3147663438,0,0,0,1,1
3147798639,0,1,0,0,1
3129677055,0,1,0,0,1
3129639230,0,1,0,0,1
3129492947,0,1,0,0,1
3118741109,0,1,0,0,1
3112664551,0,1,0,0,1
3112679188,0,0,0,1,1
3113235136,0,1,0,0,1
3113260291,1,0,0,0,1
3113832826,0,1,0,0,1
3114038976,0,1,0,0,1
3114168946,0,1,0,0,1
3114386024,0,1,0,0,1
3114526133,0,0,1,0,1
3114582360,0,1,0,0,1
3114733043,0,1,0,0,1
3115066527,1,0,0,0,1
3115140380,0,1,0,0,1
3115301592,0,1,0,0,1
3115383475,0,1,0,0,1
3115457975,1,0,0,0,1
3115830582,0,1,0,0,1
3116664597,0,1,0,0,1
3116837629,0,1,0,0,1
3117188765,1,0,0,0,1
3117244866,1,0,0,0,1
3117453029,0,1,0,0,1
3117520911,0,1,0,0,1
3112547276,0,1,0,0,1
3112362741,0,1,0,0,1
3112251066,0,1,0,0,1
3108077745,0,1,0,0,1
3104649918,1,0,0,0,1
3104785370,0,1,0,0,1
3106529610,1,0,0,0,1
3106670010,1,0,0,0,1
3107033274,0,1,0,0,1
3107204555,0,1,0,0,1
3107236772,0,1,0,0,1
3107676213,0,1,0,0,1
3107800583,1,0,0,0,1
3107847121,0,1,0,0,1
3108187851,0,1,0,0,1
3112181916,0,1,0,0,1
3108193582,0,1,0,0,1
3108372409,0,1,0,0,1
3108470398,0,1,0,0,1
3108470707,1,0,0,0,1
3108647641,0,1,0,0,1
3108758529,0,1,0,0,1
3109499066,0,1,0,0,1
3110599917,0,0,1,0,1
3110889040,0,1,0,0,1
3111676144,0,1,0,0,1
3118638724,0,1,0,0,1
3118752772,0,1,0,0,1
3129179281,0,1,0,0,1
3119099256,0,1,0,0,1
3125111583,0,1,0,0,1
3125114757,0,1,0,0,1
3125400740,0,1,0,0,1
3125444515,0,1,0,0,1
3125606747,1,0,0,0,1
3125614616,0,1,0,0,1
3125843433,0,1,0,0,1
3126073283,0,1,0,0,1
3126246557,0,0,0,1,1
3126283059,0,1,0,0,1
3126416737,0,1,0,0,1
3126587129,0,1,0,0,1
3126602684,0,1,0,0,1
3127122100,0,1,0,0,1
3127511609,0,1,0,0,1
3127665366,0,1,0,0,1
3127728177,0,1,0,0,1
3127833669,0,1,0,0,1
3127981019,0,1,0,0,1
3128001426,0,1,0,0,1
3128462763,0,0,0,1,1
3128563494,0,1,0,0,1
3128919813,0,1,0,0,1
3125072375,0,1,0,0,1
3124607571,0,1,0,0,1
3123680887,1,0,0,0,1
3120916094,0,1,0,0,1
3119359600,0,1,0,0,1
3119382693,0,1,0,0,1
3119414304,0,1,0,0,1
3119531992,0,1,0,0,1
3119540935,0,1,0,0,1
3120129297,0,1,0,0,1
3120186180,0,1,0,0,1
3120491960,0,1,0,0,1
3120720189,0,1,0,0,1
3120728523,0,1,0,0,1
3121117435,0,1,0,0,1
3123670311,1,0,0,0,1
3121183866,0,1,0,0,1
3121235783,0,1,0,0,1
3121347064,0,0,0,1,1
3121522183,0,1,0,0,1
3121681372,0,1,0,0,1
3121721580,0,1,0,0,1
3121969575,0,0,1,0,1
3122010290,0,1,0,0,1
3123140973,0,1,0,0,1
3123589949,1,0,0,0,1
3154561882,0,1,0,0,1
3155565918,0,1,0,0,1
3104561303,0,0,0,1,1
3188819034,0,1,0,0,1
3189362358,0,1,0,0,1
3189757004,1,0,0,0,1
3189787423,0,1,0,0,1
3189837311,0,0,0,1,1
3190199284,0,1,0,0,1
3190220909,0,1,0,0,1
3190423934,0,1,0,0,1
3190772178,0,1,0,0,1
3190796787,0,0,1,0,1
3190893976,0,1,0,0,1
3190917764,0,1,0,0,1
3191035196,0,1,0,0,1
3191534998,0,1,0,0,1
3191631137,1,0,0,0,1
3191644272,0,1,0,0,1
3192035132,0,1,0,0,1
3192053621,0,1,0,0,1
3192519022,0,1,0,0,1
3192562641,0,1,0,0,1
3192743784,0,1,0,0,1
3193017207,0,1,0,0,1
3193063794,0,1,0,0,1
3193164032,0,0,0,1,1
3188982498,0,1,0,0,1
3188586506,0,1,0,0,1
3155615212,0,0,0,1,1
3188521101,0,1,0,0,1
3184243024,0,1,0,0,1
3184345740,0,1,0,0,1
3184524272,0,1,0,0,1
3184825319,0,1,0,0,1
3185423318,0,1,0,0,1
3185575687,0,1,0,0,1
3185631834,0,1,0,0,1
3185725238,0,1,0,0,1
3185875232,1,0,0,0,1
3185951855,1,0,0,0,1
3186012895,1,0,0,0,1
3186192385,0,1,0,0,1
3186401790,0,1,0,0,1
3186421663,0,1,0,0,1
3186466794,0,1,0,0,1
3186626977,0,1,0,0,1
3186698820,1,0,0,0,1
3187291594,0,1,0,0,1
3187436611,1,0,0,0,1
3187628060,0,1,0,0,1
3187815032,0,1,0,0,1
3188142070,0,1,0,0,1
3188173885,1,0,0,0,1
3193236092,0,1,0,0,1
3193273434,0,1,0,0,1
3193389270,1,0,0,0,1
3193949636,0,0,0,1,1
3197829937,0,1,0,0,1
3198059384,0,1,0,0,1
3198751664,0,1,0,0,1
3198797304,0,1,0,0,1
3198947865,0,1,0,0,1
3199008611,0,1,0,0,1
3199058082,0,1,0,0,1
3200580082,0,1,0,0,1
3201623247,0,1,0,0,1
3201841515,1,0,0,0,1
3201923692,0,1,0,0,1
3202005994,0,1,0,0,1
3202129871,0,1,0,0,1
3203258375,0,0,1,0,1
3203446481,0,1,0,0,1
3203636333,0,1,0,0,1
3203751953,0,1,0,0,1
3204821706,0,1,0,0,1
3204856275,0,0,0,1,1
3204912748,0,1,0,0,1
3205909242,1,0,0,0,1
3205955609,0,1,0,0,1
3206310917,1,0,0,0,1
3197703347,0,1,0,0,1
3197560711,0,1,0,0,1
3197364792,0,1,0,0,1
3195625387,0,1,0,0,1
3194039222,0,1,0,0,1
3194069415,0,1,0,0,1
3194567885,0,1,0,0,1
3194616732,0,1,0,0,1
3194652807,1,0,0,0,1
3194674171,0,1,0,0,1
3195133967,0,1,0,0,1
3195217656,0,1,0,0,1
3195327686,1,0,0,0,1
3195404083,0,1,0,0,1
3195675314,0,1,0,0,1
3197297225,0,1,0,0,1
3195745904,0,1,0,0,1
3195919056,0,0,1,0,1
3196204714,0,1,0,0,1
3196296753,0,1,0,0,1
3196709017,0,1,0,0,1
3196766160,0,1,0,0,1
3196854194,1,0,0,0,1
3197099078,0,1,0,0,1
3197099220,1,0,0,0,1
3197150678,1,0,0,0,1
3183964994,1,0,0,0,1
3183836234,0,1,0,0,1
3183776023,0,1,0,0,1
3169922447,0,1,0,0,1
3162964304,0,1,0,0,1
3163389721,0,1,0,0,1
3163396957,0,1,0,0,1
3163466412,0,1,0,0,1
3163580637,1,0,0,0,1
3163777245,1,0,0,0,1
3164250734,0,1,0,0,1
3164442037,1,0,0,0,1
3164618335,1,0,0,0,1
3164817212,0,1,0,0,1
3164972067,0,0,0,1,1
3165094650,1,0,0,0,1
3165202646,1,0,0,0,1
3165356299,1,0,0,0,1
3166184250,1,0,0,0,1
3167524092,0,1,0,0,1
3167535227,0,1,0,0,1
3168299886,0,1,0,0,1
3168431688,0,1,0,0,1
3168759061,0,1,0,0,1
3168991656,0,1,0,0,1
3169166219,1,0,0,0,1
3169454868,0,1,0,0,1
3162850335,1,0,0,0,1
3162322156,0,1,0,0,1
3161606503,0,1,0,0,1
3158783440,0,1,0,0,1
3155924554,0,1,0,0,1
3156551402,0,1,0,0,1
3157041061,0,1,0,0,1
3157624149,0,1,0,0,1
3157689971,0,1,0,0,1
3158124987,0,1,0,0,1
3158142765,0,1,0,0,1
3158148483,1,0,0,0,1
3158153520,0,1,0,0,1
3158642949,0,1,0,0,1
3158852767,0,1,0,0,1
3160945719,0,1,0,0,1
3158946787,0,1,0,0,1
3159176749,0,1,0,0,1
3159209522,0,1,0,0,1
3159354738,0,1,0,0,1
3159908034,0,1,0,0,1
3159957392,1,0,0,0,1
3159984862,0,1,0,0,1
3160523256,0,1,0,0,1
3160656591,0,1,0,0,1
3160836110,0,1,0,0,1
3169683286,0,1,0,0,1
3169967493,0,1,0,0,1
3183622886,1,0,0,0,1
3170659204,0,1,0,0,1
3178289620,0,1,0,0,1
3178316440,0,1,0,0,1
3178512260,0,1,0,0,1
3178621751,0,1,0,0,1
3178908600,0,0,1,0,1
3179040269,0,1,0,0,1
3179745714,0,1,0,0,1
3180037684,0,1,0,0,1
3180484900,1,0,0,0,1
3180592852,0,1,0,0,1
3180624144,0,1,0,0,1
3180936961,0,1,0,0,1
3181028668,0,1,0,0,1
3181738972,0,1,0,0,1
3181809282,0,1,0,0,1
3181944462,0,1,0,0,1
3181957586,0,1,0,0,1
3181984969,0,1,0,0,1
3182195190,0,1,0,0,1
3182602679,0,1,0,0,1
3183071114,0,1,0,0,1
3183273054,0,0,1,0,1
3183338303,0,1,0,0,1
3178183945,0,1,0,0,1
3178171501,0,1,0,0,1
3177880529,0,1,0,0,1
3172852341,0,1,0,0,1
3170826418,0,1,0,0,1
3171206376,1,0,0,0,1
3171399020,0,1,0,0,1
3171640467,0,1,0,0,1
3171738458,1,0,0,0,1
3171943158,0,1,0,0,1
3172120543,0,1,0,0,1
3172318159,0,1,0,0,1
3172343660,1,0,0,0,1
3172738911,0,1,0,0,1
3173348733,0,1,0,0,1
3177206460,1,0,0,0,1
3174068463,0,1,0,0,1
3174161937,0,1,0,0,1
3174694625,0,1,0,0,1
3175178637,0,1,0,0,1
3175298550,0,1,0,0,1
3175308721,0,1,0,0,1
3175743626,0,1,0,0,1
3176270849,0,1,0,0,1
3176594760,0,1,0,0,1
3176982199,0,0,1,0,1
3104601609,0,1,0,0,1
3103974972,1,0,0,0,1
3012106130,0,1,0,0,1
3036279077,1,0,0,0,1
3036426069,1,0,0,0,1
3036474262,0,1,0,0,1
3036725405,0,1,0,0,1
3036821003,0,1,0,0,1
3036828719,0,1,0,0,1
3037090385,0,1,0,0,1
3037303078,0,1,0,0,1
3037643774,0,1,0,0,1
3037844759,1,0,0,0,1
3038078693,0,1,0,0,1
3038110577,0,1,0,0,1
3038173067,0,1,0,0,1
3038187020,0,1,0,0,1
3038344736,0,0,1,0,1
3038507127,0,1,0,0,1
3038546955,0,1,0,0,1
3038767451,1,0,0,0,1
3038794923,0,1,0,0,1
3038796952,0,1,0,0,1
3038905638,0,1,0,0,1
3038984527,1,0,0,0,1
3039002325,0,1,0,0,1
3039133508,0,1,0,0,1
3036368395,0,1,0,0,1
3035309915,0,1,0,0,1
3050618241,1,0,0,0,1
3035239944,0,1,0,0,1
3030485232,0,1,0,0,1
3030610869,0,1,0,0,1
3030642845,1,0,0,0,1
3031112463,0,1,0,0,1
3031290876,0,1,0,0,1
3031641994,0,1,0,0,1
3031719666,0,1,0,0,1
3031911653,1,0,0,0,1
3031980975,1,0,0,0,1
3032387464,0,1,0,0,1
3033154947,0,1,0,0,1
3033291575,0,1,0,0,1
3033404531,0,1,0,0,1
3033461943,0,1,0,0,1
3033491158,0,1,0,0,1
3033742076,0,1,0,0,1
3033801688,0,1,0,0,1
3033838273,0,1,0,0,1
3034233785,0,1,0,0,1
3034883817,0,1,0,0,1
3034966551,0,1,0,0,1
3035017855,1,0,0,0,1
3035153345,0,1,0,0,1
3039138849,0,1,0,0,1
3039499130,0,1,0,0,1
3039699201,0,0,0,1,1
3039994386,1,0,0,0,1
3044826633,0,1,0,0,1
3044856195,0,1,0,0,1
3044871157,0,1,0,0,1
3044985770,1,0,0,0,1
3045064943,0,1,0,0,1
3045237247,1,0,0,0,1
3045973495,0,1,0,0,1
3046037880,1,0,0,0,1
3046126324,0,1,0,0,1
3046612293,0,1,0,0,1
3047174519,0,1,0,0,1
3047320515,0,1,0,0,1
3047642955,0,1,0,0,1
3047701652,1,0,0,0,1
3047802378,0,1,0,0,1
3048935619,0,1,0,0,1
3049486428,0,1,0,0,1
3049556136,0,1,0,0,1
3049824551,0,1,0,0,1
3049844819,0,1,0,0,1
3049925671,0,1,0,0,1
3050183838,0,1,0,0,1
3050379720,0,1,0,0,1
3044513567,0,1,0,0,1
3044451834,1,0,0,0,1
3044436490,0,0,0,1,1
3042234836,0,0,1,0,1
3040676661,0,1,0,0,1
3040733235,1,0,0,0,1
3040794619,1,0,0,0,1
3040811027,1,0,0,0,1
3041104203,0,1,0,0,1
3041243193,0,1,0,0,1
3041547725,0,1,0,0,1
3042056534,0,1,0,0,1
3042064527,0,1,0,0,1
3042076917,1,0,0,0,1
3042312886,0,1,0,0,1
3044090461,0,0,0,1,1
3042556612,0,1,0,0,1
3042581286,1,0,0,0,1
3043023821,0,1,0,0,1
3043287870,0,1,0,0,1
3043422327,0,1,0,0,1
3043467476,0,1,0,0,1
3043587914,0,1,0,0,1
3043739687,0,1,0,0,1
3043778191,0,1,0,0,1
3043868867,0,1,0,0,1
3030380108,0,1,0,0,1
3030280916,0,1,0,0,1
3030044289,0,1,0,0,1
3020171922,0,1,0,0,1
3016618421,0,1,0,0,1
3016793908,0,1,0,0,1
3016827651,1,0,0,0,1
3016920034,0,1,0,0,1
3017066854,1,0,0,0,1
3017169941,0,1,0,0,1
3017281269,0,1,0,0,1
3017591084,0,1,0,0,1
3017688093,0,1,0,0,1
3017900584,0,1,0,0,1
3018181641,0,1,0,0,1
3018478780,1,0,0,0,1
3018541319,0,1,0,0,1
3018551264,0,1,0,0,1
3018553171,0,1,0,0,1
3018736132,0,1,0,0,1
3018759968,0,1,0,0,1
3018960919,0,1,0,0,1
3019086767,0,1,0,0,1
3019105883,0,1,0,0,1
3019325803,0,1,0,0,1
3019521837,0,1,0,0,1
3019991087,1,0,0,0,1
3016552854,1,0,0,0,1
3016551894,0,1,0,0,1
3016503823,0,1,0,0,1
3013490082,0,1,0,0,1
3012139211,0,1,0,0,1
3012281627,0,1,0,0,1
3012284041,0,1,0,0,1
3012317224,0,1,0,0,1
3012329072,1,0,0,0,1
3012534790,0,1,0,0,1
3012803715,0,1,0,0,1
3012987939,0,1,0,0,1
3013292726,0,1,0,0,1
3013338327,0,1,0,0,1
3013858587,0,1,0,0,1
3016297693,1,0,0,0,1
3014195299,0,1,0,0,1
3014240350,0,1,0,0,1
3014316035,0,1,0,0,1
3014539354,0,1,0,0,1
3014837783,0,1,0,0,1
3015352738,1,0,0,0,1
3015822969,1,0,0,0,1
3015936652,0,1,0,0,1
3016007603,0,1,0,0,1
3016021397,0,1,0,0,1
3020070156,0,1,0,0,1
3020600637,0,1,0,0,1
3029646471,0,1,0,0,1
3020963702,0,1,0,0,1
3024874490,0,1,0,0,1
3024934385,0,1,0,0,1
3024951753,0,1,0,0,1
3025113509,0,1,0,0,1
3025361637,0,1,0,0,1
3025369433,0,1,0,0,1
3025431836,0,1,0,0,1
3025467966,0,1,0,0,1
3025678395,1,0,0,0,1
3025720166,0,1,0,0,1
3025763112,1,0,0,0,1
3026288418,0,1,0,0,1
3026297434,0,1,0,0,1
3026329848,0,1,0,0,1
3026611738,0,1,0,0,1
3026943627,0,1,0,0,1
3027035187,0,1,0,0,1
3027077878,0,1,0,0,1
3027151602,0,1,0,0,1
3027729455,0,1,0,0,1
3027846725,0,1,0,0,1
3028480741,0,0,0,1,1
3029507140,1,0,0,0,1
3024541446,1,0,0,0,1
3024453665,0,1,0,0,1
3024188449,1,0,0,0,1
3021998549,1,0,0,0,1
3020971482,0,0,0,1,1
3021221962,0,1,0,0,1
3021338683,1,0,0,0,1
3021390624,0,1,0,0,1
3021559157,0,1,0,0,1
3021652073,0,1,0,0,1
3021688267,0,0,0,1,1
3021818241,0,0,0,1,1
3021883369,0,1,0,0,1
3021907059,1,0,0,0,1
3022013850,0,1,0,0,1
3024155475,0,1,0,0,1
3022226992,0,0,1,0,1
3022615733,0,1,0,0,1
3022990940,0,1,0,0,1
3023028725,0,1,0,0,1
3023080144,1,0,0,0,1
3023234692,0,1,0,0,1
3023249458,0,1,0,0,1
3023264902,0,1,0,0,1
3023440067,0,1,0,0,1
3023574014,0,1,0,0,1
3050398433,0,1,0,0,1
3050746034,0,1,0,0,1
3103748006,0,1,0,0,1
3083459410,0,1,0,0,1
3084146813,0,1,0,0,1
3084835930,0,1,0,0,1
3085020840,0,1,0,0,1
3085024589,0,1,0,0,1
3085042042,0,1,0,0,1
3085368789,0,1,0,0,1
3086147049,0,1,0,0,1
3086643972,0,0,1,0,1
3086825392,0,0,0,1,1
3087131109,1,0,0,0,1
3087293089,0,1,0,0,1
3088062733,0,1,0,0,1
3088256973,0,1,0,0,1
3088411810,0,1,0,0,1
3088946711,0,1,0,0,1
3089126030,1,0,0,0,1
3089695959,0,1,0,0,1
3089699983,0,1,0,0,1
3089720009,1,0,0,0,1
3089890759,0,1,0,0,1
3089963783,0,1,0,0,1
3090638809,1,0,0,0,1
3090725828,0,1,0,0,1
3084071431,0,1,0,0,1
3082917173,0,1,0,0,1
3051155838,0,1,0,0,1
3082550428,1,0,0,0,1
3078018831,0,1,0,0,1
3078168298,0,1,0,0,1
3078402187,0,1,0,0,1
3079101958,0,0,1,0,1
3079198755,0,1,0,0,1
3079226392,0,1,0,0,1
3079387495,0,1,0,0,1
3079389340,0,1,0,0,1
3079434286,0,1,0,0,1
3079453121,0,1,0,0,1
3079486599,0,1,0,0,1
3080306834,0,1,0,0,1
3080419187,0,1,0,0,1
3080595337,0,1,0,0,1
3080845011,0,1,0,0,1
3080865428,0,1,0,0,1
3080955422,0,1,0,0,1
3081756893,0,1,0,0,1
3081815591,0,1,0,0,1
3081918173,0,1,0,0,1
3081968445,0,1,0,0,1
3082157305,0,1,0,0,1
3082342169,0,1,0,0,1
3091335684,0,1,0,0,1
3091696919,0,1,0,0,1
3091717211,0,1,0,0,1
3091998845,0,1,0,0,1
3099324596,0,1,0,0,1
3099438544,0,1,0,0,1
3099487159,0,1,0,0,1
3099595437,0,1,0,0,1
3099619700,0,1,0,0,1
3099834428,0,1,0,0,1
3100056556,1,0,0,0,1
3100642919,0,1,0,0,1
3101158424,0,1,0,0,1
3101388106,1,0,0,0,1
3101436878,1,0,0,0,1
3101480342,0,1,0,0,1
3101693390,1,0,0,0,1
3101920511,0,1,0,0,1
3102058983,0,1,0,0,1
3102082395,0,0,0,1,1
3102328086,0,1,0,0,1
3102416297,0,1,0,0,1
3102770961,0,1,0,0,1
3103172558,1,0,0,0,1
3103253336,0,1,0,0,1
3103338081,0,0,0,1,1
3103383644,0,1,0,0,1
3098631231,0,1,0,0,1
3098382247,0,1,0,0,1
3098328486,0,1,0,0,1
3094376408,0,1,0,0,1
3092106910,0,1,0,0,1
3092217233,0,1,0,0,1
3092569415,1,0,0,0,1
3092979284,0,1,0,0,1
3093131728,0,1,0,0,1
3093508031,0,1,0,0,1
3093633077,1,0,0,0,1
3093832556,0,1,0,0,1
3093865972,0,1,0,0,1
3094006407,0,1,0,0,1
3094759706,0,1,0,0,1
3098042880,0,1,0,0,1
3094961541,0,1,0,0,1
3095065732,1,0,0,0,1
3095384644,0,1,0,0,1
3095494827,0,1,0,0,1
3095705035,0,1,0,0,1
3095930695,0,1,0,0,1
3096357919,0,1,0,0,1
3096891718,0,1,0,0,1
3096999631,0,1,0,0,1
3097899392,0,1,0,0,1
3078002432,0,1,0,0,1
3077316664,0,1,0,0,1
3076709387,0,1,0,0,1
3064658141,0,1,0,0,1
3061081141,0,1,0,0,1
3061279887,0,1,0,0,1
3061311382,0,1,0,0,1
3061434852,0,1,0,0,1
3061731978,0,1,0,0,1
3061789866,1,0,0,0,1
3061817558,0,1,0,0,1
3062007831,0,1,0,0,1
3062073533,0,1,0,0,1
3062132336,0,1,0,0,1
3062200533,0,1,0,0,1
3062646609,0,1,0,0,1
3062742404,1,0,0,0,1
3063079737,0,1,0,0,1
3063428433,0,1,0,0,1
3063631648,0,1,0,0,1
3063714687,0,1,0,0,1
3064083894,0,1,0,0,1
3064216746,0,0,0,1,1
3064389376,0,1,0,0,1
3064479857,1,0,0,0,1
3064509869,0,1,0,0,1
3064546912,0,1,0,0,1
3060614292,1,0,0,0,1
3060560090,0,1,0,0,1
3060370140,0,1,0,0,1
3055581646,0,1,0,0,1
3051821313,0,1,0,0,1
3052213220,1,0,0,0,1
3052291273,1,0,0,0,1
3052500837,0,1,0,0,1
3052661757,0,1,0,0,1
3052859256,0,0,0,1,1
3052952222,0,1,0,0,1
3053107588,0,1,0,0,1
3053191731,0,1,0,0,1
3053793493,0,1,0,0,1
3055877658,1,0,0,0,1
3060359595,1,0,0,0,1
3055910100,0,1,0,0,1
3056012845,0,1,0,0,1
3056099429,0,1,0,0,1
3056433065,0,1,0,0,1
3056905180,0,1,0,0,1
3057366684,0,1,0,0,1
3058632892,0,1,0,0,1
3059618239,0,1,0,0,1
3059772668,0,0,0,1,1
3060128840,1,0,0,0,1
3064615713,0,1,0,0,1
3064761747,1,0,0,0,1
3076370824,0,0,0,1,1
3064770651,0,1,0,0,1
3070059946,0,1,0,0,1
3071030320,0,1,0,0,1
3071637732,0,1,0,0,1
3071694998,0,1,0,0,1
3071703890,0,1,0,0,1
3071758790,0,1,0,0,1
3072074301,1,0,0,0,1
3072220088,1,0,0,0,1
3072477117,1,0,0,0,1
3072506027,0,1,0,0,1
3072828345,0,1,0,0,1
3073112858,0,1,0,0,1
3073149684,1,0,0,0,1
3073396236,0,1,0,0,1
3073484161,0,1,0,0,1
3074336787,0,1,0,0,1
3075010899,0,1,0,0,1
3075215943,1,0,0,0,1
3075352602,0,1,0,0,1
3075453035,0,1,0,0,1
3076052058,0,1,0,0,1
3076122844,0,1,0,0,1
3076151920,0,1,0,0,1
3069802377,0,1,0,0,1
3069779468,0,1,0,0,1
3068908864,0,1,0,0,1
3066331262,0,1,0,0,1
3064897937,0,1,0,0,1
3065217101,0,1,0,0,1
3065240792,1,0,0,0,1
3065315550,0,1,0,0,1
3065321058,0,0,0,1,1
3065435701,0,1,0,0,1
3065453737,1,0,0,0,1
3065667052,0,1,0,0,1
3066098495,0,1,0,0,1
3066100060,0,1,0,0,1
3066811764,0,0,1,0,1
3068737030,1,0,0,0,1
3067398923,0,1,0,0,1
3067399870,1,0,0,0,1
3067480305,0,1,0,0,1
3067535679,0,1,0,0,1
3067681541,0,1,0,0,1
3068048304,1,0,0,0,1
3068129638,0,1,0,0,1
3068185418,0,1,0,0,1
3068265064,0,1,0,0,1
3068543631,1,0,0,0,1
2216376218,0,1,0,0,1
2216324556,0,1,0,0,1
2216260287,1,0,0,0,1
844753856,1,0,0,0,1
844858159,0,1,0,0,1
844890546,0,1,0,0,1
845062140,1,0,0,0,1
845449460,0,1,0,0,1
845482176,1,0,0,0,1
845603275,0,1,0,0,1
845650616,0,1,0,0,1
845729760,0,1,0,0,1
845763522,0,1,0,0,1
845804107,0,1,0,0,1
845926405,0,1,0,0,1
846140389,0,1,0,0,1
846391208,0,1,0,0,1
846453536,0,1,0,0,1
846692936,1,0,0,0,1
846937712,0,1,0,0,1
846956298,1,0,0,0,1
847217432,0,1,0,0,1
847305104,1,0,0,0,1
847381345,0,1,0,0,1
847383781,1,0,0,0,1
847409322,0,1,0,0,1
847827854,0,1,0,0,1
844833200,0,1,0,0,1
844447350,0,1,0,0,1
839737280,0,1,0,0,1
844421166,0,1,0,0,1
839946486,0,1,0,0,1
840044472,0,1,0,0,1
840169130,0,1,0,0,1
840233712,0,1,0,0,1
840269208,0,1,0,0,1
840346950,0,1,0,0,1
841117746,0,1,0,0,1
841302194,0,1,0,0,1
841405472,0,0,1,0,1
841595802,0,1,0,0,1
841602278,0,1,0,0,1
841806960,0,1,0,0,1
841856742,0,1,0,0,1
841937101,0,1,0,0,1
842244414,0,1,0,0,1
842330930,0,1,0,0,1
843056838,0,1,0,0,1
843410610,0,1,0,0,1
843461725,0,1,0,0,1
843753968,0,1,0,0,1
843756246,0,1,0,0,1
843934333,1,0,0,0,1
844311936,0,1,0,0,1
847890205,1,0,0,0,1
848063647,0,1,0,0,1
848483551,0,1,0,0,1
848795863,0,1,0,0,1
853576458,0,1,0,0,1
853775238,0,1,0,0,1
854057856,1,0,0,0,1
854247668,0,1,0,0,1
854337294,0,1,0,0,1
854534342,0,1,0,0,1
854772446,0,1,0,0,1
854837803,0,0,0,1,1
854941448,0,1,0,0,1
854996534,0,1,0,0,1
855048062,0,0,0,1,1
855125486,0,1,0,0,1
855253381,0,0,0,1,1
855370375,0,1,0,0,1
855628410,0,1,0,0,1
855786607,1,0,0,0,1
855829884,0,1,0,0,1
855963462,0,1,0,0,1
855989113,1,0,0,0,1
856303752,0,1,0,0,1
856377626,0,1,0,0,1
856520821,0,1,0,0,1
856722662,0,1,0,0,1
853547736,1,0,0,0,1
853518462,0,1,0,0,1
853243416,0,1,0,0,1
850997796,0,1,0,0,1
848840672,0,1,0,0,1
849184188,0,1,0,0,1
849252343,0,1,0,0,1
849256663,0,1,0,0,1
849355040,1,0,0,0,1
849783061,0,1,0,0,1
849869413,0,1,0,0,1
850653054,0,1,0,0,1
850817036,0,1,0,0,1
850923385,0,1,0,0,1
851324840,1,0,0,0,1
852909200,0,1,0,0,1
851375646,0,1,0,0,1
851636138,0,1,0,0,1
851707033,0,1,0,0,1
851810072,0,1,0,0,1
851835762,0,1,0,0,1
851856259,0,1,0,0,1
852152114,1,0,0,0,1
852207218,1,0,0,0,1
852708408,0,1,0,0,1
852881424,0,0,1,0,1
839859379,0,0,0,1,1
839582298,0,1,0,0,1
739958990,0,1,0,0,1
824919836,0,1,0,0,1
825445747,0,1,0,0,1
825496094,0,1,0,0,1
825616663,0,1,0,0,1
825830047,0,1,0,0,1
825847554,0,1,0,0,1
825856394,0,1,0,0,1
826085886,0,1,0,0,1
826124450,0,1,0,0,1
826510034,1,0,0,0,1
826564332,0,1,0,0,1
826619148,0,1,0,0,1
827045184,0,1,0,0,1
827077093,0,1,0,0,1
827439919,0,1,0,0,1
827517182,1,0,0,0,1
827541950,0,1,0,0,1
827950530,1,0,0,0,1
828186254,0,1,0,0,1
828222632,0,1,0,0,1
828285944,0,1,0,0,1
828476264,0,1,0,0,1
828502928,0,1,0,0,1
828880957,0,1,0,0,1
825305006,0,1,0,0,1
824867100,1,0,0,0,1
839355457,0,1,0,0,1
824715949,0,1,0,0,1
820081890,0,1,0,0,1
820489201,1,0,0,0,1
820495327,0,0,0,1,1
820894273,0,1,0,0,1
820976594,1,0,0,0,1
821120252,1,0,0,0,1
821163457,0,1,0,0,1
821347506,0,1,0,0,1
821353904,0,1,0,0,1
822188696,0,1,0,0,1
822208530,0,1,0,0,1
822592602,0,1,0,0,1
822687860,0,0,1,0,1
823025580,0,1,0,0,1
823073366,0,1,0,0,1
823299192,1,0,0,0,1
823302295,0,1,0,0,1
823511948,0,1,0,0,1
823577479,0,1,0,0,1
824173764,0,1,0,0,1
824201510,0,1,0,0,1
824518304,0,1,0,0,1
824538018,0,1,0,0,1
828881340,0,1,0,0,1
828944377,0,1,0,0,1
828989340,0,1,0,0,1
829327326,0,1,0,0,1
834882379,0,1,0,0,1
834906560,0,1,0,0,1
834979704,0,1,0,0,1
835149794,0,1,0,0,1
835239487,0,1,0,0,1
835430096,0,1,0,0,1
835458739,1,0,0,0,1
835698582,1,0,0,0,1
835761240,0,1,0,0,1
835821300,0,1,0,0,1
835996939,0,1,0,0,1
836196590,1,0,0,0,1
836362045,0,1,0,0,1
836890308,0,1,0,0,1
837319184,0,1,0,0,1
837376136,0,0,0,1,1
837597564,0,1,0,0,1
837602282,0,1,0,0,1
838156963,1,0,0,0,1
838725914,0,0,1,0,1
838815492,0,1,0,0,1
838868810,0,1,0,0,1
839063761,1,0,0,0,1
834090486,0,1,0,0,1
834019122,0,1,0,0,1
833930173,0,1,0,0,1
831170642,0,1,0,0,1
829586960,0,1,0,0,1
829975465,0,1,0,0,1
829991767,0,1,0,0,1
830285262,0,1,0,0,1
830551573,0,1,0,0,1
830582101,1,0,0,0,1
830783257,0,1,0,0,1
830871289,1,0,0,0,1
831012882,1,0,0,0,1
831019171,0,1,0,0,1
831250248,0,1,0,0,1
833853176,0,1,0,0,1
831394776,1,0,0,0,1
831476972,0,1,0,0,1
831850086,0,1,0,0,1
831853230,0,1,0,0,1
831933240,0,1,0,0,1
832405118,0,1,0,0,1
832603274,0,0,1,0,1
832606177,0,1,0,0,1
832688857,0,1,0,0,1
832689572,1,0,0,0,1
856822406,1,0,0,0,1
856828998,1,0,0,0,1
856850431,0,1,0,0,1
877608504,0,1,0,0,1
877678597,1,0,0,0,1
877726514,0,0,1,0,1
877871868,0,1,0,0,1
877959421,0,0,0,1,1
878151420,0,1,0,0,1
878151816,1,0,0,0,1
878245380,1,0,0,0,1
878320177,0,1,0,0,1
878343660,0,1,0,0,1
878634900,0,1,0,0,1
878938238,0,1,0,0,1
879023473,0,1,0,0,1
879468560,0,1,0,0,1
879819888,0,1,0,0,1
880212992,0,1,0,0,1
880329397,0,1,0,0,1
880354410,0,1,0,0,1
880788092,1,0,0,0,1
881237755,0,1,0,0,1
882025478,0,1,0,0,1
882195156,0,1,0,0,1
882226993,0,1,0,0,1
882617448,1,0,0,0,1
877642218,0,1,0,0,1
877421204,1,0,0,0,1
856852010,0,1,0,0,1
877419326,0,1,0,0,1
873468943,0,1,0,0,1
873603842,0,1,0,0,1
873843786,0,1,0,0,1
873853603,0,1,0,0,1
874299061,0,1,0,0,1
874350008,0,1,0,0,1
874428955,0,1,0,0,1
874553484,0,0,0,1,1
874706821,0,1,0,0,1
874856671,0,1,0,0,1
875111322,0,1,0,0,1
875556799,0,1,0,0,1
875627293,0,1,0,0,1
875706384,0,1,0,0,1
875826350,1,0,0,0,1
875974507,0,1,0,0,1
876121093,0,1,0,0,1
876215228,0,1,0,0,1
876426037,0,1,0,0,1
876931212,0,1,0,0,1
877252453,0,1,0,0,1
877287445,0,1,0,0,1
877295154,1,0,0,0,1
882658154,0,1,0,0,1
882804270,1,0,0,0,1
882915290,0,1,0,0,1
882977353,0,1,0,0,1
888944472,0,1,0,0,1
888985316,0,1,0,0,1
889003326,1,0,0,0,1
889340780,1,0,0,0,1
889405652,0,1,0,0,1
889528578,1,0,0,0,1
889552730,1,0,0,0,1
889610958,1,0,0,0,1
889646916,0,0,1,0,1
889684940,0,1,0,0,1
890017790,0,1,0,0,1
890113062,0,1,0,0,1
890398592,0,1,0,0,1
890924354,1,0,0,0,1
891025566,0,1,0,0,1
891414355,0,0,1,0,1
891434018,0,1,0,0,1
891464396,0,1,0,0,1
891670309,0,1,0,0,1
891925470,0,1,0,0,1
892219807,0,1,0,0,1
892317596,0,0,1,0,1
893017652,0,1,0,0,1
888800600,1,0,0,0,1
888627637,0,1,0,0,1
888281088,0,1,0,0,1
886307107,0,1,0,0,1
883195724,0,1,0,0,1
883768160,0,1,0,0,1
883978771,0,1,0,0,1
884035987,0,1,0,0,1
884059272,0,1,0,0,1
884385566,1,0,0,0,1
885182784,0,1,0,0,1
885319118,0,1,0,0,1
885512018,0,1,0,0,1
885601772,0,1,0,0,1
886348597,0,1,0,0,1
888257310,0,1,0,0,1
886399867,1,0,0,0,1
886731582,0,1,0,0,1
886894818,0,1,0,0,1
886925197,0,1,0,0,1
886975994,0,1,0,0,1
887379049,0,0,1,0,1
887482009,0,1,0,0,1
887748344,0,1,0,0,1
887925458,0,1,0,0,1
888081906,0,1,0,0,1
873404174,0,1,0,0,1
873396403,1,0,0,0,1
873296804,0,1,0,0,1
864724470,0,1,0,0,1
861647964,0,1,0,0,1
861737647,0,1,0,0,1
861821388,0,1,0,0,1
861898021,0,1,0,0,1
861953796,0,1,0,0,1
862446498,0,1,0,0,1
862486130,0,1,0,0,1
862507459,1,0,0,0,1
862604442,0,1,0,0,1
862885892,0,1,0,0,1
863226590,1,0,0,0,1
863296196,0,1,0,0,1
863311616,1,0,0,0,1
863465594,0,1,0,0,1
863467417,0,1,0,0,1
863515891,0,1,0,0,1
863827532,0,1,0,0,1
864152388,0,1,0,0,1
864230353,0,1,0,0,1
864488586,0,1,0,0,1
864550753,1,0,0,0,1
864670946,0,1,0,0,1
864675889,1,0,0,0,1
861471552,0,0,0,1,1
861103902,0,1,0,0,1
860983225,0,1,0,0,1
858591182,0,1,0,0,1
857086333,0,1,0,0,1
857339100,0,1,0,0,1
857422182,0,1,0,0,1
857873401,0,1,0,0,1
858120182,0,1,0,0,1
858190446,0,1,0,0,1
858199741,0,1,0,0,1
858361650,0,1,0,0,1
858408553,1,0,0,0,1
858564704,1,0,0,0,1
858672732,0,1,0,0,1
860954984,0,1,0,0,1
858791358,0,1,0,0,1
859715748,0,1,0,0,1
859719169,0,1,0,0,1
860121212,0,1,0,0,1
860266686,0,1,0,0,1
860512369,0,1,0,0,1
860550708,0,1,0,0,1
860584230,0,1,0,0,1
860707854,0,1,0,0,1
860918658,1,0,0,0,1
864697980,0,1,0,0,1
864999576,0,1,0,0,1
873054968,0,1,0,0,1
865188541,0,1,0,0,1
869234466,1,0,0,0,1
869245170,0,1,0,0,1
869369718,0,1,0,0,1
869417562,0,1,0,0,1
869435252,0,1,0,0,1
869519706,1,0,0,0,1
869561688,1,0,0,0,1
870394272,0,0,0,1,1
870844843,0,1,0,0,1
870899834,0,1,0,0,1
871190334,0,1,0,0,1
871280228,0,1,0,0,1
871458434,0,1,0,0,1
871516856,1,0,0,0,1
871537657,1,0,0,0,1
871660705,0,1,0,0,1
871831784,0,1,0,0,1
871951087,0,1,0,0,1
871981262,1,0,0,0,1
872371680,0,1,0,0,1
872477366,0,1,0,0,1
872497027,0,1,0,0,1
873035155,0,0,0,1,1
869209736,0,1,0,0,1
869187336,0,1,0,0,1
869013536,0,1,0,0,1
867042174,0,1,0,0,1
865550167,0,1,0,0,1
865634100,1,0,0,0,1
865741488,0,1,0,0,1
865905607,0,1,0,0,1
865922833,0,1,0,0,1
866024455,1,0,0,0,1
866212982,1,0,0,0,1
866422585,0,1,0,0,1
866511362,1,0,0,0,1
866648414,0,1,0,0,1
867068918,0,1,0,0,1
868813891,0,1,0,0,1
867594614,0,1,0,0,1
867965864,0,1,0,0,1
868094924,0,1,0,0,1
868175383,0,1,0,0,1
868176223,0,1,0,0,1
868248517,0,1,0,0,1
868453879,0,1,0,0,1
868582242,1,0,0,0,1
868703178,1,0,0,0,1
868758151,0,1,0,0,1
819999540,0,1,0,0,1
819951686,0,1,0,0,1
819942043,0,1,0,0,1
765685147,0,1,0,0,1
766298262,0,1,0,0,1
766356822,0,1,0,0,1
766387015,0,1,0,0,1
767045136,0,1,0,0,1
767054844,0,1,0,0,1
767251980,0,1,0,0,1
767270527,0,1,0,0,1
767318288,0,0,0,1,1
767426532,0,1,0,0,1
767673360,0,1,0,0,1
767866915,0,1,0,0,1
768231882,1,0,0,0,1
768285344,1,0,0,0,1
768801805,0,1,0,0,1
768923960,1,0,0,0,1
769130881,0,1,0,0,1
769231729,0,0,1,0,1
769329896,0,1,0,0,1
769453994,0,0,0,1,1
769490815,0,1,0,0,1
769665422,0,1,0,0,1
769750494,0,1,0,0,1
769962458,0,1,0,0,1
766025702,0,1,0,0,1
765564104,0,1,0,0,1
780633300,0,1,0,0,1
765527634,0,0,1,0,1
761727086,0,1,0,0,1
761942042,0,1,0,0,1
761963347,0,1,0,0,1
761996611,0,1,0,0,1
762011533,0,1,0,0,1
762050802,0,1,0,0,1
762195182,0,1,0,0,1
762390996,1,0,0,0,1
762458066,1,0,0,0,1
763206852,0,1,0,0,1
763441436,0,1,0,0,1
764067894,0,1,0,0,1
764189886,0,1,0,0,1
764286601,0,1,0,0,1
764344267,0,1,0,0,1
764361331,1,0,0,0,1
764450048,0,1,0,0,1
764622636,0,1,0,0,1
765126115,0,1,0,0,1
765283633,0,1,0,0,1
765292238,0,1,0,0,1
765312679,0,1,0,0,1
765328662,0,1,0,0,1
770047008,0,1,0,0,1
770137332,0,0,1,0,1
770271157,0,1,0,0,1
770393102,1,0,0,0,1
775538154,0,1,0,0,1
775608978,0,1,0,0,1
775701289,0,1,0,0,1
776021216,0,1,0,0,1
776029604,0,1,0,0,1
776193944,0,1,0,0,1
776247715,0,1,0,0,1
776416926,0,1,0,0,1
776703823,0,1,0,0,1
777001555,1,0,0,0,1
777163243,0,1,0,0,1
777924583,0,1,0,0,1
778134193,0,1,0,0,1
778174316,1,0,0,0,1
778447291,0,1,0,0,1
778569860,1,0,0,0,1
778997108,0,1,0,0,1
779583055,0,1,0,0,1
779813154,0,1,0,0,1
779954702,0,1,0,0,1
780108938,0,1,0,0,1
780461406,0,1,0,0,1
780521989,0,1,0,0,1
775506804,0,1,0,0,1
775452882,0,1,0,0,1
775297291,0,1,0,0,1
771873738,0,1,0,0,1
770472084,0,1,0,0,1
770525916,0,1,0,0,1
770681766,0,1,0,0,1
770998309,0,1,0,0,1
771433158,0,1,0,0,1
771504469,0,0,0,1,1
771573984,0,1,0,0,1
771680190,0,1,0,0,1
771712237,0,1,0,0,1
771724272,0,0,0,1,1
772008294,0,1,0,0,1
775260660,0,1,0,0,1
772358954,0,0,0,1,1
772366328,0,1,0,0,1
772600938,0,1,0,0,1
773090034,0,1,0,0,1
773517722,0,1,0,0,1
774160099,0,1,0,0,1
774166152,0,1,0,0,1
774695186,0,1,0,0,1
774747528,0,1,0,0,1
775169868,0,1,0,0,1
761672414,1,0,0,0,1
761496438,0,1,0,0,1
761458292,0,1,0,0,1
751366544,0,1,0,0,1
746343295,0,1,0,0,1
746446928,0,1,0,0,1
746952624,0,1,0,0,1
747026946,0,1,0,0,1
747169662,0,0,0,1,1
747782180,0,1,0,0,1
747823410,0,1,0,0,1
748744249,0,1,0,0,1
748841251,0,1,0,0,1
748869596,0,1,0,0,1
748980740,0,1,0,0,1
748987434,0,0,0,1,1
749093220,1,0,0,0,1
749329033,0,0,0,1,1
749401964,1,0,0,0,1
749664462,0,1,0,0,1
749735114,0,1,0,0,1
749736708,0,1,0,0,1
749803002,1,0,0,0,1
750436706,0,1,0,0,1
750742952,0,1,0,0,1
751100988,0,0,0,1,1
751198052,0,1,0,0,1
745859972,0,1,0,0,1
745813315,0,1,0,0,1
745647212,0,0,0,1,1
742114626,0,1,0,0,1
740222040,0,1,0,0,1
740514487,1,0,0,0,1
740730300,0,1,0,0,1
740813521,0,1,0,0,1
740816474,0,1,0,0,1
740824586,0,1,0,0,1
740859138,0,1,0,0,1
741070106,1,0,0,0,1
741600229,0,1,0,0,1
741771734,0,1,0,0,1
742371822,1,0,0,0,1
745614566,0,1,0,0,1
742412430,0,1,0,0,1
742740487,0,1,0,0,1
743168821,0,1,0,0,1
743183856,0,1,0,0,1
743481342,0,1,0,0,1
743712685,0,1,0,0,1
743815513,0,1,0,0,1
743939850,0,1,0,0,1
745022653,1,0,0,0,1
745505562,0,1,0,0,1
751222999,0,1,0,0,1
751414368,0,1,0,0,1
761370516,1,0,0,0,1
751491312,0,1,0,0,1
756861037,0,0,0,1,1
756991376,0,1,0,0,1
757171202,0,1,0,0,1
757228968,0,1,0,0,1
757557517,1,0,0,0,1
757633219,0,1,0,0,1
757815397,0,1,0,0,1
758042588,0,1,0,0,1
758512920,0,1,0,0,1
759024036,0,1,0,0,1
759331920,0,1,0,0,1
759403320,0,1,0,0,1
759581804,0,1,0,0,1
759597414,0,1,0,0,1
759611834,0,1,0,0,1
759690998,1,0,0,0,1
760103383,0,1,0,0,1
760131480,1,0,0,0,1
760471256,0,1,0,0,1
760806589,0,1,0,0,1
760869378,0,1,0,0,1
761130344,0,1,0,0,1
761319828,0,1,0,0,1
756800748,0,1,0,0,1
756574357,0,0,0,1,1
756285120,0,1,0,0,1
753769514,0,1,0,0,1
751531128,0,1,0,0,1
751606969,0,1,0,0,1
752022834,0,1,0,0,1
752538788,0,1,0,0,1
752670642,0,1,0,0,1
752773506,1,0,0,0,1
752953046,0,1,0,0,1
753141932,0,1,0,0,1
753432234,0,1,0,0,1
753464376,0,1,0,0,1
753790777,0,1,0,0,1
756223628,0,1,0,0,1
754331053,0,1,0,0,1
754416690,0,1,0,0,1
754599145,1,0,0,0,1
755197819,0,1,0,0,1
755345552,1,0,0,0,1
755402455,0,1,0,0,1
755568780,0,1,0,0,1
755718452,0,1,0,0,1
755839472,0,1,0,0,1
755861528,1,0,0,0,1
780605642,0,1,0,0,1
780816756,1,0,0,0,1
819359124,1,0,0,0,1
806023134,0,1,0,0,1
806183545,0,1,0,0,1
806396120,0,0,1,0,1
806615749,0,1,0,0,1
806644794,0,1,0,0,1
806749988,1,0,0,0,1
806876550,0,1,0,0,1
807135324,0,0,1,0,1
807189282,0,1,0,0,1
807307590,1,0,0,0,1
807495648,0,1,0,0,1
807509786,0,1,0,0,1
807591872,0,1,0,0,1
807641192,0,1,0,0,1
807646458,0,1,0,0,1
808114182,0,1,0,0,1
808322138,1,0,0,0,1
808430947,0,1,0,0,1
808589462,0,1,0,0,1
808895000,0,1,0,0,1
808994845,0,1,0,0,1
809039148,0,1,0,0,1
809255509,1,0,0,0,1
809555082,0,1,0,0,1
806097793,1,0,0,0,1
805147519,0,1,0,0,1
780822493,0,1,0,0,1
804927673,0,1,0,0,1
800628444,0,1,0,0,1
800635004,0,1,0,0,1
800811247,0,1,0,0,1
800899440,0,1,0,0,1
801144649,1,0,0,0,1
801293096,0,1,0,0,1
801330528,0,1,0,0,1
801592669,0,1,0,0,1
801972914,0,1,0,0,1
802147668,1,0,0,0,1
802301054,0,1,0,0,1
802307419,0,1,0,0,1
802329870,0,1,0,0,1
802465542,0,1,0,0,1
802583814,1,0,0,0,1
802971942,0,0,0,1,1
803174863,0,1,0,0,1
803250523,0,0,0,1,1
803365566,0,1,0,0,1
803921318,0,1,0,0,1
804131473,0,1,0,0,1
804833880,1,0,0,0,1
804886838,0,1,0,0,1
809697980,0,1,0,0,1
810014432,0,1,0,0,1
810115482,0,1,0,0,1
810697255,0,0,1,0,1
815249731,0,1,0,0,1
815294808,0,1,0,0,1
815348754,0,1,0,0,1
815715120,0,1,0,0,1
815998256,0,1,0,0,1
816015445,0,1,0,0,1
816209965,0,1,0,0,1
816258596,0,1,0,0,1
816757657,0,1,0,0,1
816815868,0,1,0,0,1
816880574,0,1,0,0,1
817116121,0,1,0,0,1
817141482,0,1,0,0,1
817198536,0,1,0,0,1
817455782,0,1,0,0,1
817880610,0,1,0,0,1
817994738,0,1,0,0,1
818093388,0,1,0,0,1
818100121,0,1,0,0,1
818453510,0,1,0,0,1
818524621,0,1,0,0,1
818786293,1,0,0,0,1
819168282,1,0,0,0,1
815205990,0,1,0,0,1
815097354,0,1,0,0,1
814890098,1,0,0,0,1
812953429,0,1,0,0,1
811189136,0,1,0,0,1
811487005,0,1,0,0,1
811663568,0,1,0,0,1
811756273,0,1,0,0,1
811972657,0,1,0,0,1
812324040,0,0,0,1,1
812463721,0,1,0,0,1
812635448,0,1,0,0,1
812764116,1,0,0,0,1
812900376,0,1,0,0,1
813060523,1,0,0,0,1
814687081,0,1,0,0,1
813239700,1,0,0,0,1
813515185,1,0,0,0,1
813610087,0,1,0,0,1
813769878,0,1,0,0,1
813866478,1,0,0,0,1
814061798,0,1,0,0,1
814270393,0,1,0,0,1
814472004,0,1,0,0,1
814488318,0,1,0,0,1
814555626,0,1,0,0,1
800618490,0,1,0,0,1
800475517,0,1,0,0,1
800353080,0,1,0,0,1
789189354,0,0,0,1,1
785724704,0,1,0,0,1
785750900,0,1,0,0,1
785877198,0,1,0,0,1
786092527,1,0,0,0,1
786103284,1,0,0,0,1
786178297,1,0,0,0,1
786209354,1,0,0,0,1
786492625,1,0,0,0,1
786514981,0,1,0,0,1
786573170,0,1,0,0,1
786756799,0,1,0,0,1
786833424,0,1,0,0,1
787389452,0,1,0,0,1
787421658,0,1,0,0,1
787467474,0,1,0,0,1
787527614,1,0,0,0,1
787763130,0,1,0,0,1
787774580,0,1,0,0,1
787953517,0,1,0,0,1
788539292,0,1,0,0,1
788620920,0,0,1,0,1
788734602,0,1,0,0,1
789059095,0,1,0,0,1
785587046,0,1,0,0,1
785121492,0,1,0,0,1
785046122,0,1,0,0,1
782522216,0,1,0,0,1
780918271,1,0,0,0,1
781113200,0,0,1,0,1
781228166,0,1,0,0,1
781287576,0,1,0,0,1
781367156,1,0,0,0,1
781531262,0,1,0,0,1
781541575,0,1,0,0,1
781552890,1,0,0,0,1
782238919,0,1,0,0,1
782444046,0,1,0,0,1
782635242,0,1,0,0,1
784563380,0,1,0,0,1
782654594,0,1,0,0,1
782875394,0,1,0,0,1
782954198,0,1,0,0,1
783469490,0,1,0,0,1
783585740,0,1,0,0,1
783591013,0,1,0,0,1
783604656,0,1,0,0,1
783631693,0,1,0,0,1
784400588,1,0,0,0,1
784476668,1,0,0,0,1
789080990,0,1,0,0,1
789720378,0,1,0,0,1
799927880,0,1,0,0,1
789729499,0,1,0,0,1
794032279,0,1,0,0,1
794112367,0,1,0,0,1
794258904,0,1,0,0,1
794344700,0,1,0,0,1
794422999,0,1,0,0,1
794481524,0,1,0,0,1
794520876,0,1,0,0,1
794619690,0,0,1,0,1
794646384,0,1,0,0,1
794663258,0,1,0,0,1
795053250,0,1,0,0,1
795426571,0,1,0,0,1
795639793,0,1,0,0,1
795764726,0,1,0,0,1
795850249,0,1,0,0,1
796279322,0,0,1,0,1
797146382,0,1,0,0,1
797408396,0,1,0,0,1
798031410,0,1,0,0,1
798056203,0,1,0,0,1
798654342,0,1,0,0,1
798737298,0,1,0,0,1
798839389,0,1,0,0,1
794010199,0,1,0,0,1
793970022,0,1,0,0,1
793934851,0,1,0,0,1
792194988,0,1,0,0,1
789871802,0,1,0,0,1
789882379,0,1,0,0,1
789967129,0,1,0,0,1
790836414,0,1,0,0,1
790917535,0,1,0,0,1
791052446,0,1,0,0,1
791353278,0,1,0,0,1
791656543,0,1,0,0,1
791894209,0,1,0,0,1
791968759,0,1,0,0,1
792252524,0,1,0,0,1
793643840,0,1,0,0,1
792337081,0,1,0,0,1
792389701,0,1,0,0,1
792446161,0,1,0,0,1
792672097,0,1,0,0,1
792732522,0,1,0,0,1
792773636,0,1,0,0,1
792829748,0,1,0,0,1
792927937,1,0,0,0,1
793199797,0,1,0,0,1
793363933,1,0,0,0,1
893210042,0,1,0,0,1
893785999,0,1,0,0,1
894264793,0,1,0,0,1
1003813814,0,1,0,0,1
1004120576,0,1,0,0,1
1004306197,0,1,0,0,1
1004818328,0,1,0,0,1
1005374414,0,1,0,0,1
1005473929,0,1,0,0,1
1005603637,0,1,0,0,1
1005973507,0,1,0,0,1
1006089188,0,1,0,0,1
1006093339,1,0,0,0,1
1006116469,0,1,0,0,1
1006256096,0,1,0,0,1
1006371960,0,1,0,0,1
1006781378,0,1,0,0,1
1007115822,0,1,0,0,1
1007137820,0,1,0,0,1
1007252041,0,1,0,0,1
1007471874,0,1,0,0,1
1007532097,1,0,0,0,1
1007556175,0,1,0,0,1
1007878028,1,0,0,0,1
1008166050,1,0,0,0,1
1008642943,0,1,0,0,1
1009082208,0,1,0,0,1
1003997311,0,1,0,0,1
1003670820,1,0,0,0,1
1021997750,0,1,0,0,1
1003622683,0,1,0,0,1
998580949,0,1,0,0,1
998765240,0,1,0,0,1
999103525,0,1,0,0,1
999108979,0,1,0,0,1
999224689,0,1,0,0,1
999792548,0,1,0,0,1
999830958,0,1,0,0,1
999864060,0,1,0,0,1
999886501,0,1,0,0,1
1000012573,0,1,0,0,1
1000981814,1,0,0,0,1
1001025116,0,1,0,0,1
1001459108,0,1,0,0,1
1001605716,0,1,0,0,1
1001658270,0,1,0,0,1
1001784714,1,0,0,0,1
1001906983,0,1,0,0,1
1002131796,0,1,0,0,1
1002798878,1,0,0,0,1
1003065859,0,1,0,0,1
1003379274,0,1,0,0,1
1003387591,0,1,0,0,1
1003448503,1,0,0,0,1
1009703539,0,1,0,0,1
1010001727,0,1,0,0,1
1010222264,0,1,0,0,1
1010347903,0,0,0,1,1
1014972516,0,0,1,0,1
1015101955,0,1,0,0,1
1015684488,0,1,0,0,1
1015791920,0,1,0,0,1
1015834099,0,1,0,0,1
1016470651,0,1,0,0,1
1017005305,0,1,0,0,1
1017075000,0,1,0,0,1
1017278816,0,1,0,0,1
1017538927,1,0,0,0,1
1017767113,0,1,0,0,1
1018331581,0,0,0,1,1
1018358011,0,1,0,0,1
1018775652,0,1,0,0,1
1018782811,0,1,0,0,1
1019190019,0,1,0,0,1
1019845927,1,0,0,0,1
1020284467,0,1,0,0,1
1020359030,0,1,0,0,1
1020395138,0,1,0,0,1
1020523352,0,1,0,0,1
1020807872,0,1,0,0,1
1021343419,0,1,0,0,1
1014859568,0,1,0,0,1
1014288565,0,1,0,0,1
1014138156,1,0,0,0,1
1012172108,0,0,1,0,1
1010673596,1,0,0,0,1
1010772800,0,1,0,0,1
1010786702,0,1,0,0,1
1010932712,0,1,0,0,1
1010960088,0,1,0,0,1
1011213764,0,1,0,0,1
1011285060,0,1,0,0,1
1011754902,0,0,1,0,1
1011785448,0,1,0,0,1
1011800360,0,1,0,0,1
1012572284,0,1,0,0,1
1014076969,0,1,0,0,1
1012825057,0,1,0,0,1
1012864742,0,1,0,0,1
1012966219,0,1,0,0,1
1013089309,0,1,0,0,1
1013161778,0,1,0,0,1
1013340979,0,1,0,0,1
1013561366,0,1,0,0,1
1013678474,0,1,0,0,1
1013889588,0,1,0,0,1
1013900934,0,1,0,0,1
998478944,1,0,0,0,1
998199445,0,1,0,0,1
998087052,0,1,0,0,1
985107805,1,0,0,0,1
980660072,0,1,0,0,1
980661691,0,1,0,0,1
980705089,0,1,0,0,1
980785736,0,1,0,0,1
980965830,0,1,0,0,1
980995958,0,1,0,0,1
981333847,0,1,0,0,1
981396888,0,0,1,0,1
981431143,0,1,0,0,1
981876115,0,1,0,0,1
982108272,0,1,0,0,1
982260624,0,1,0,0,1
982505100,0,1,0,0,1
982570164,0,1,0,0,1
982588692,0,1,0,0,1
982662270,1,0,0,0,1
983231798,0,1,0,0,1
983236405,0,1,0,0,1
983286319,0,1,0,0,1
983288317,0,1,0,0,1
983352720,0,1,0,0,1
983950016,1,0,0,0,1
984546290,0,1,0,0,1
980555424,1,0,0,0,1
980350832,0,1,0,0,1
980074483,0,1,0,0,1
978344635,0,1,0,0,1
976248246,0,1,0,0,1
976607833,1,0,0,0,1
977001734,0,1,0,0,1
977137116,0,1,0,0,1
977429166,0,1,0,0,1
977538488,0,1,0,0,1
977619834,0,1,0,0,1
977704807,0,1,0,0,1
978218047,0,1,0,0,1
978232536,0,1,0,0,1
978344803,0,1,0,0,1
979748941,0,1,0,0,1
978372152,0,1,0,0,1
978760532,0,1,0,0,1
979008384,0,0,1,0,1
979155132,1,0,0,0,1
979326804,1,0,0,0,1
979378898,1,0,0,0,1
979412274,0,1,0,0,1
979472198,1,0,0,0,1
979616616,0,1,0,0,1
979621957,0,1,0,0,1
984732265,0,1,0,0,1
985187502,0,1,0,0,1
997905211,0,1,0,0,1
985468063,0,1,0,0,1
992092530,1,0,0,0,1
992105480,0,1,0,0,1
992621143,0,1,0,0,1
993079812,0,1,0,0,1
993085004,0,1,0,0,1
993319417,1,0,0,0,1
993590959,0,1,0,0,1
993612530,0,1,0,0,1
993669996,0,1,0,0,1
993706747,0,1,0,0,1
994109310,0,1,0,0,1
994130395,0,1,0,0,1
994892442,0,0,0,1,1
994922768,1,0,0,0,1
995139330,1,0,0,0,1
995291552,0,1,0,0,1
995448325,0,1,0,0,1
995468490,0,1,0,0,1
995611801,0,0,0,1,1
996172538,1,0,0,0,1
996188196,0,1,0,0,1
997117603,0,1,0,0,1
997874617,0,1,0,0,1
991509049,0,1,0,0,1
991485278,0,1,0,0,1
991203535,0,1,0,0,1
987278238,0,1,0,0,1
985822626,0,1,0,0,1
985860788,0,1,0,0,1
986140489,0,1,0,0,1
986170033,0,1,0,0,1
986280961,0,1,0,0,1
986453844,0,1,0,0,1
986623676,0,1,0,0,1
986811270,0,1,0,0,1
986821530,0,1,0,0,1
987060368,0,1,0,0,1
987852054,0,1,0,0,1
990652260,0,1,0,0,1
988432496,0,1,0,0,1
988706748,1,0,0,0,1
988772702,0,1,0,0,1
988858957,0,1,0,0,1
989337026,0,1,0,0,1
989495563,0,1,0,0,1
989741419,0,1,0,0,1
989762120,0,1,0,0,1
990299288,0,1,0,0,1
990439434,1,0,0,0,1
1021807586,0,1,0,0,1
1022590184,0,1,0,0,1
976089769,0,1,0,0,1
1050002628,0,1,0,0,1
1050320636,0,1,0,0,1
1050348630,1,0,0,0,1
1050645330,0,1,0,0,1
1050648530,0,1,0,0,1
1050877250,0,1,0,0,1
1050905863,1,0,0,0,1
1051340126,0,1,0,0,1
1051462536,0,1,0,0,1
1051746434,0,1,0,0,1
1052276510,0,1,0,0,1
1052306029,0,1,0,0,1
1052340438,0,1,0,0,1
1052458370,0,1,0,0,1
1052899254,1,0,0,0,1
1053515394,0,1,0,0,1
1053520435,0,1,0,0,1
1053581263,1,0,0,0,1
1053636708,0,1,0,0,1
1054696590,0,1,0,0,1
1054702988,1,0,0,0,1
1054780406,1,0,0,0,1
1054798700,0,1,0,0,1
1055018898,0,1,0,0,1
1050065988,0,1,0,0,1
1049876438,0,1,0,0,1
1022616805,0,1,0,0,1
1049335435,0,1,0,0,1
1043427210,0,1,0,0,1
1043825064,0,1,0,0,1
1044366156,1,0,0,0,1
1044461352,0,1,0,0,1
1045210680,0,1,0,0,1
1045312052,1,0,0,0,1
1045532142,0,1,0,0,1
1045741370,0,1,0,0,1
1045790366,0,0,1,0,1
1045904684,0,1,0,0,1
1046697362,0,1,0,0,1
1047108708,0,1,0,0,1
1047260832,1,0,0,0,1
1047296796,0,1,0,0,1
1047826945,0,1,0,0,1
1047990986,0,0,1,0,1
1048031624,0,1,0,0,1
1048116848,0,1,0,0,1
1048276382,0,1,0,0,1
1048440224,0,1,0,0,1
1048556906,0,1,0,0,1
1048564069,0,1,0,0,1
1048924272,0,1,0,0,1
1055504041,0,1,0,0,1
1055631578,0,1,0,0,1
1055908099,0,1,0,0,1
1056074720,0,1,0,0,1
1060972698,0,1,0,0,1
1061238288,0,1,0,0,1
1061272465,0,1,0,0,1
1061986591,0,1,0,0,1
1062173510,0,1,0,0,1
1062326875,0,1,0,0,1
1062575948,0,1,0,0,1
1062733591,0,1,0,0,1
1062735139,0,1,0,0,1
1062866010,0,1,0,0,1
1063095618,0,1,0,0,1
1063195278,0,1,0,0,1
1063284266,0,0,0,1,1
1063354549,0,1,0,0,1
1063480220,0,1,0,0,1
1063545793,1,0,0,0,1
1063594232,0,1,0,0,1
1063595094,1,0,0,0,1
1063817586,0,1,0,0,1
1063923588,0,1,0,0,1
1064263010,0,1,0,0,1
1064360856,0,1,0,0,1
1064685536,0,1,0,0,1
1060805605,0,1,0,0,1
1060634198,0,1,0,0,1
1060625406,0,1,0,0,1
1059721718,0,1,0,0,1
1056089406,0,1,0,0,1
1056209246,0,1,0,0,1
1056793147,0,1,0,0,1
1057375435,0,1,0,0,1
1057783129,0,1,0,0,1
1057791368,1,0,0,0,1
1058075826,0,1,0,0,1
1058423304,0,1,0,0,1
1059384192,0,1,0,0,1
1059650366,0,1,0,0,1
1059767917,0,1,0,0,1
1060589563,1,0,0,0,1
1059892920,0,1,0,0,1
1059907440,0,1,0,0,1
1059952688,0,1,0,0,1
1059988674,0,0,0,1,1
1060080895,0,1,0,0,1
1060085888,0,1,0,0,1
1060241106,0,1,0,0,1
1060381268,0,1,0,0,1
1060433245,0,1,0,0,1
1060501687,1,0,0,0,1
1043142756,0,1,0,0,1
1043066406,0,1,0,0,1
1043045551,0,1,0,0,1
1031573911,0,0,1,0,1
1027351218,0,1,0,0,1
1027515074,0,1,0,0,1
1027544636,0,1,0,0,1
1027709982,0,1,0,0,1
1027858765,0,1,0,0,1
1028171688,0,1,0,0,1
1028389213,0,1,0,0,1
1029086551,0,1,0,0,1
1029138654,0,1,0,0,1
1029319316,0,1,0,0,1
1029604470,0,1,0,0,1
1030444711,1,0,0,0,1
1030449162,0,1,0,0,1
1030477771,1,0,0,0,1
1030484784,1,0,0,0,1
1030488180,0,1,0,0,1
1030503859,0,1,0,0,1
1030895245,0,1,0,0,1
1031019048,0,1,0,0,1
1031091390,0,1,0,0,1
1031252766,0,1,0,0,1
1031322624,0,1,0,0,1
1031340716,0,1,0,0,1
1027311948,0,1,0,0,1
1027019358,0,1,0,0,1
1026954914,0,1,0,0,1
1024664072,0,1,0,0,1
1022712324,0,1,0,0,1
1022898930,0,1,0,0,1
1023549961,0,1,0,0,1
1023912660,0,1,0,0,1
1024020260,0,1,0,0,1
1024124778,0,1,0,0,1
1024144338,0,1,0,0,1
1024334706,0,1,0,0,1
1024397450,0,1,0,0,1
1024603447,1,0,0,0,1
1025041897,0,1,0,0,1
1026775778,0,1,0,0,1
1025121422,0,1,0,0,1
1025284219,1,0,0,0,1
1025629868,0,1,0,0,1
1026152742,0,1,0,0,1
1026418206,0,1,0,0,1
1026429103,0,1,0,0,1
1026471709,0,1,0,0,1
1026569455,0,1,0,0,1
1026733832,0,1,0,0,1
1026762360,0,1,0,0,1
1031512796,0,1,0,0,1
1032065802,0,1,0,0,1
1042984886,0,1,0,0,1
1032081918,0,1,0,0,1
1039071877,0,1,0,0,1
1039357297,0,1,0,0,1
1039384628,0,1,0,0,1
1039391928,0,1,0,0,1
1039524578,0,1,0,0,1
1039905625,0,1,0,0,1
1039933669,0,1,0,0,1
1039957796,0,1,0,0,1
1040264394,0,1,0,0,1
1040408522,0,1,0,0,1
1040469494,0,1,0,0,1
1040483641,0,1,0,0,1
1040649882,0,1,0,0,1
1040713939,0,1,0,0,1
1040724282,0,1,0,0,1
1040885508,0,1,0,0,1
1041224630,1,0,0,0,1
1041419094,0,1,0,0,1
1041922903,0,0,1,0,1
1042172358,0,1,0,0,1
1042270058,0,1,0,0,1
1042591638,0,1,0,0,1
1042680990,0,1,0,0,1
1039036934,1,0,0,0,1
1038810788,0,1,0,0,1
1038257431,0,1,0,0,1
1034794736,0,1,0,0,1
1032580694,0,1,0,0,1
1032965844,1,0,0,0,1
1033324159,0,1,0,0,1
1033488919,0,1,0,0,1
1033987015,0,1,0,0,1
1034034044,0,1,0,0,1
1034189616,1,0,0,0,1
1034528964,0,1,0,0,1
1034601482,0,1,0,0,1
1034779686,0,1,0,0,1
1035710197,0,1,0,0,1
1038067555,1,0,0,0,1
1036304196,0,1,0,0,1
1036790443,0,1,0,0,1
1036818793,0,1,0,0,1
1037055602,0,1,0,0,1
1037462839,1,0,0,0,1
1037543858,0,1,0,0,1
1037747598,0,1,0,0,1
1037878088,0,1,0,0,1
1037981756,0,1,0,0,1
1038034098,0,1,0,0,1
976246688,0,1,0,0,1
974874043,0,1,0,0,1
894960434,0,1,0,0,1
917200717,0,1,0,0,1
917592218,0,1,0,0,1
917611704,0,1,0,0,1
917834707,0,1,0,0,1
917937186,0,1,0,0,1
918389017,0,1,0,0,1
918553206,0,1,0,0,1
919169922,0,1,0,0,1
919212780,0,1,0,0,1
919351723,1,0,0,0,1
919417542,0,1,0,0,1
919467126,0,1,0,0,1
919816928,1,0,0,0,1
919900393,0,1,0,0,1
919914043,0,1,0,0,1
919991268,0,0,0,1,1
920006779,0,1,0,0,1
920009538,0,1,0,0,1
920081160,0,1,0,0,1
920159366,0,1,0,0,1
920398344,0,0,0,1,1
920449940,0,1,0,0,1
920741143,0,1,0,0,1
920795941,0,1,0,0,1
917265524,0,1,0,0,1
916957525,0,1,0,0,1
932013242,0,1,0,0,1
916770066,0,1,0,0,1
911935596,0,1,0,0,1
912209396,0,1,0,0,1
912307352,0,1,0,0,1
912445296,0,1,0,0,1
912876607,1,0,0,0,1
913020270,0,1,0,0,1
913159314,0,1,0,0,1
913200781,0,0,0,1,1
913542072,0,1,0,0,1
913587770,0,1,0,0,1
913968792,0,1,0,0,1
914233002,0,1,0,0,1
914784798,0,1,0,0,1
914892955,0,1,0,0,1
915142940,0,1,0,0,1
915144948,0,1,0,0,1
915600672,0,1,0,0,1
915639510,0,1,0,0,1
916076864,0,1,0,0,1
916194522,0,1,0,0,1
916256142,0,1,0,0,1
916267825,1,0,0,0,1
916644583,0,1,0,0,1
920871955,0,1,0,0,1
920904890,0,1,0,0,1
921603271,1,0,0,0,1
921736873,0,1,0,0,1
927767510,0,1,0,0,1
927818390,0,1,0,0,1
928113726,0,1,0,0,1
928200012,0,1,0,0,1
928298840,0,1,0,0,1
928363536,0,1,0,0,1
929248933,1,0,0,0,1
929370756,0,1,0,0,1
930004020,0,1,0,0,1
930164354,0,1,0,0,1
930225853,1,0,0,0,1
930289064,0,1,0,0,1
930403147,0,1,0,0,1
930411162,1,0,0,0,1
930645648,0,1,0,0,1
931115610,0,1,0,0,1
931157856,0,1,0,0,1
931159134,0,1,0,0,1
931310588,0,1,0,0,1
931391678,0,1,0,0,1
931627141,0,1,0,0,1
931688736,0,1,0,0,1
931780752,0,1,0,0,1
927706670,0,1,0,0,1
927690864,0,1,0,0,1
927676398,1,0,0,0,1
924593480,0,1,0,0,1
921965882,0,1,0,0,1
921990186,0,1,0,0,1
922018501,0,0,0,1,1
922429830,0,1,0,0,1
923082517,0,1,0,0,1
923702221,0,1,0,0,1
923947808,0,1,0,0,1
924005617,0,1,0,0,1
924149022,0,1,0,0,1
924358291,0,1,0,0,1
924705229,1,0,0,0,1
927399679,0,1,0,0,1
924866335,0,1,0,0,1
924979843,0,1,0,0,1
925091100,0,1,0,0,1
925437350,0,1,0,0,1
925476691,0,0,1,0,1
925521126,0,1,0,0,1
925581380,1,0,0,0,1
927269112,0,1,0,0,1
927344629,1,0,0,0,1
927368856,0,1,0,0,1
911645287,0,0,0,1,1
911166625,0,1,0,0,1
910683680,0,1,0,0,1
902747923,0,1,0,0,1
899609180,0,1,0,0,1
899649138,0,1,0,0,1
899713417,1,0,0,0,1
899747828,0,1,0,0,1
899947195,0,0,1,0,1
900067584,0,1,0,0,1
900192578,0,1,0,0,1
900260389,1,0,0,0,1
900547382,0,1,0,0,1
900610915,0,1,0,0,1
900630816,0,1,0,0,1
900649542,0,1,0,0,1
900729397,0,1,0,0,1
900961818,1,0,0,0,1
901014006,0,1,0,0,1
901595412,0,1,0,0,1
901766354,0,1,0,0,1
901857284,0,1,0,0,1
901888753,0,0,0,1,1
901889641,0,1,0,0,1
902275746,0,1,0,0,1
902284195,0,1,0,0,1
902470927,1,0,0,0,1
899597232,0,1,0,0,1
899019716,0,1,0,0,1
898851000,0,1,0,0,1
896526175,1,0,0,0,1
895053938,0,1,0,0,1
895074662,0,1,0,0,1
895217460,0,1,0,0,1
895290402,1,0,0,0,1
895587697,1,0,0,0,1
895676682,0,1,0,0,1
896011879,0,1,0,0,1
896064787,0,1,0,0,1
896101364,0,1,0,0,1
896293872,0,1,0,0,1
896732144,0,1,0,0,1
898845630,0,1,0,0,1
896942900,0,1,0,0,1
896982355,0,1,0,0,1
897053616,0,1,0,0,1
897336896,0,1,0,0,1
897433250,0,1,0,0,1
897448394,0,1,0,0,1
897972763,0,1,0,0,1
898330346,0,1,0,0,1
898562276,0,1,0,0,1
898795968,0,1,0,0,1
902625660,0,1,0,0,1
902773724,0,1,0,0,1
910678652,1,0,0,0,1
903242558,0,1,0,0,1
906097958,0,1,0,0,1
906386684,1,0,0,0,1
906456175,0,1,0,0,1
906612331,0,1,0,0,1
906672931,0,1,0,0,1
906838327,0,1,0,0,1
907282908,0,1,0,0,1
907407704,0,1,0,0,1
907506626,1,0,0,0,1
908061248,0,1,0,0,1
908081221,1,0,0,0,1
908170921,0,1,0,0,1
908261012,0,1,0,0,1
908670446,0,1,0,0,1
908746993,0,1,0,0,1
908963659,0,1,0,0,1
909498673,0,1,0,0,1
909573344,0,1,0,0,1
909689520,0,1,0,0,1
909924157,0,1,0,0,1
910175222,0,1,0,0,1
910212278,0,1,0,0,1
910437895,0,1,0,0,1
906063968,0,1,0,0,1
906015259,0,1,0,0,1
905890987,0,1,0,0,1
904515164,0,1,0,0,1
903391266,1,0,0,0,1
903430362,0,1,0,0,1
903604994,0,0,1,0,1
903682339,0,1,0,0,1
903761856,0,1,0,0,1
903825607,1,0,0,0,1
903918768,0,1,0,0,1
904011619,0,1,0,0,1
904167876,0,1,0,0,1
904316352,0,1,0,0,1
904576578,0,1,0,0,1
905665081,1,0,0,0,1
904620750,0,1,0,0,1
904916876,0,1,0,0,1
905125375,0,1,0,0,1
905228856,1,0,0,0,1
905235816,0,1,0,0,1
905242908,0,1,0,0,1
905261466,0,1,0,0,1
905272266,0,1,0,0,1
905547434,0,1,0,0,1
905631068,0,1,0,0,1
931970364,0,1,0,0,1
932177088,0,1,0,0,1
974637030,1,0,0,0,1
957105582,0,1,0,0,1
957239257,0,1,0,0,1
957306920,0,1,0,0,1
957367154,0,1,0,0,1
957602882,0,1,0,0,1
957708259,0,1,0,0,1
958010360,0,1,0,0,1
958083324,0,1,0,0,1
958261814,0,1,0,0,1
960427146,0,1,0,0,1
960452990,1,0,0,0,1
960524154,1,0,0,0,1
960783986,0,1,0,0,1
960877903,0,1,0,0,1
960945246,0,1,0,0,1
961054086,0,1,0,0,1
961231092,1,0,0,0,1
961393604,0,1,0,0,1
961403988,0,1,0,0,1
961675524,0,1,0,0,1
961703480,0,1,0,0,1
961891362,0,1,0,0,1
962000227,0,1,0,0,1
962012592,0,1,0,0,1
957224466,0,1,0,0,1
956939179,0,1,0,0,1
932434057,0,1,0,0,1
956533460,1,0,0,0,1
953328350,0,1,0,0,1
953492220,0,1,0,0,1
953558582,0,1,0,0,1
953672840,1,0,0,0,1
954098540,0,1,0,0,1
954109670,0,1,0,0,1
954148879,1,0,0,0,1
954236227,0,1,0,0,1
954542503,0,1,0,0,1
954701264,0,1,0,0,1
954760976,0,1,0,0,1
954839778,0,0,0,1,1
954879392,0,1,0,0,1
954975278,1,0,0,0,1
955051243,0,1,0,0,1
955303740,0,1,0,0,1
955377991,0,1,0,0,1
955420297,0,1,0,0,1
955583712,0,1,0,0,1
955808743,0,1,0,0,1
955921351,0,0,0,1,1
956206459,0,1,0,0,1
956316403,0,1,0,0,1
962017286,0,1,0,0,1
962086034,0,1,0,0,1
962389531,0,1,0,0,1
962726928,0,1,0,0,1
968779932,0,1,0,0,1
969040753,0,1,0,0,1
969277796,0,1,0,0,1
969649850,0,1,0,0,1
969982430,0,1,0,0,1
970325858,1,0,0,0,1
970416685,0,1,0,0,1
970565064,0,1,0,0,1
970621904,0,0,1,0,1
970730582,0,1,0,0,1
970732544,0,1,0,0,1
970964203,0,1,0,0,1
971732617,0,1,0,0,1
971761188,0,1,0,0,1
972292986,1,0,0,0,1
972981415,0,1,0,0,1
973000873,0,1,0,0,1
973460881,0,1,0,0,1
973476067,0,1,0,0,1
974098518,0,1,0,0,1
974297238,1,0,0,0,1
974418080,1,0,0,0,1
974457390,0,1,0,0,1
968752536,0,1,0,0,1
968704386,1,0,0,0,1
968484974,0,1,0,0,1
965199732,0,1,0,0,1
962938632,0,1,0,0,1
962964672,0,1,0,0,1
963143256,0,0,0,1,1
963230203,1,0,0,0,1
963271549,0,1,0,0,1
963360752,1,0,0,0,1
964092416,0,1,0,0,1
964180032,0,1,0,0,1
964595772,0,1,0,0,1
965004420,0,1,0,0,1
965840365,0,1,0,0,1
968415096,0,1,0,0,1
966170156,0,1,0,0,1
966309516,0,0,0,1,1
966832574,0,1,0,0,1
967628796,0,1,0,0,1
967638506,0,1,0,0,1
967842824,0,0,0,1,1
968032866,1,0,0,0,1
968041645,1,0,0,0,1
968299117,0,1,0,0,1
968357016,1,0,0,0,1
953057574,0,1,0,0,1
952983254,1,0,0,0,1
952509391,0,1,0,0,1
943532646,0,1,0,0,1
939128154,0,1,0,0,1
939321036,0,1,0,0,1
939714547,0,1,0,0,1
939953552,0,1,0,0,1
940020500,1,0,0,0,1
940057867,0,1,0,0,1
940147904,0,1,0,0,1
940263043,1,0,0,0,1
940443780,0,1,0,0,1
941057347,0,1,0,0,1
941107394,0,1,0,0,1
941132270,0,1,0,0,1
941220098,0,1,0,0,1
941387143,1,0,0,0,1
941552454,1,0,0,0,1
941644494,0,1,0,0,1
942143191,0,1,0,0,1
942266220,0,1,0,0,1
942521154,0,1,0,0,1
942920390,1,0,0,0,1
942983628,1,0,0,0,1
943181244,1,0,0,0,1
943383540,0,1,0,0,1
939021992,0,1,0,0,1
938613151,0,1,0,0,1
938486442,0,1,0,0,1
935211918,0,1,0,0,1
932891479,0,1,0,0,1
933104496,0,1,0,0,1
933217284,0,1,0,0,1
933638226,0,1,0,0,1
934223971,0,1,0,0,1
934614732,1,0,0,0,1
934634636,0,1,0,0,1
934969051,0,1,0,0,1
935025649,1,0,0,0,1
935161442,0,1,0,0,1
935313666,1,0,0,0,1
937629348,0,1,0,0,1
936078626,0,1,0,0,1
936144594,0,1,0,0,1
936217826,0,1,0,0,1
936222686,0,1,0,0,1
936377724,0,1,0,0,1
936745638,1,0,0,0,1
936801948,0,1,0,0,1
937026026,0,1,0,0,1
937502144,0,1,0,0,1
937513950,0,1,0,0,1
943492344,0,1,0,0,1
944235901,0,1,0,0,1
952232054,0,1,0,0,1
944338070,0,1,0,0,1
948078367,0,1,0,0,1
948278208,0,1,0,0,1
948814537,0,1,0,0,1
949042028,0,1,0,0,1
949304887,0,1,0,0,1
949411712,0,1,0,0,1
949549225,0,1,0,0,1
949853414,1,0,0,0,1
950013788,1,0,0,0,1
950190182,0,0,0,1,1
950234990,1,0,0,0,1
950351400,1,0,0,0,1
950525832,0,1,0,0,1
950781841,0,0,1,0,1
950840810,0,1,0,0,1
951118621,0,1,0,0,1
951129715,0,1,0,0,1
951133711,0,1,0,0,1
951369524,0,1,0,0,1
951456541,0,1,0,0,1
951483258,1,0,0,0,1
951808831,0,1,0,0,1
952119847,0,1,0,0,1
947844402,1,0,0,0,1
947782676,0,1,0,0,1
947511434,0,1,0,0,1
945867240,0,1,0,0,1
944382516,0,1,0,0,1
944495046,0,1,0,0,1
944595115,0,1,0,0,1
944670074,1,0,0,0,1
944780454,0,1,0,0,1
944812507,0,1,0,0,1
945249313,0,0,1,0,1
945414883,0,1,0,0,1
945643489,0,1,0,0,1
945829087,0,1,0,0,1
946023379,0,1,0,0,1
947499440,0,1,0,0,1
946101668,0,1,0,0,1
946126124,1,0,0,0,1
946426770,0,1,0,0,1
946620907,0,1,0,0,1
946628023,0,1,0,0,1
946882993,0,1,0,0,1
947234815,0,1,0,0,1
947258545,0,1,0,0,1
947371568,0,1,0,0,1
947393190,0,1,0,0,1
740206525,0,0,0,1,1
739799648,0,1,0,0,1
2216178884,0,1,0,0,1
571592528,0,1,0,0,1
571702642,0,1,0,0,1
571749254,0,1,0,0,1
571768559,0,1,0,0,1
571812501,0,1,0,0,1
572089753,0,1,0,0,1
572140349,0,1,0,0,1
572180874,0,1,0,0,1
572242415,0,1,0,0,1
572264357,0,1,0,0,1
572307182,0,1,0,0,1
572321640,0,1,0,0,1
572366810,0,1,0,0,1
572391626,0,1,0,0,1
572421376,0,1,0,0,1
572480633,0,1,0,0,1
572492507,0,1,0,0,1
572747063,0,0,1,0,1
572799746,0,1,0,0,1
572841261,0,1,0,0,1
572924982,0,1,0,0,1
572988411,0,1,0,0,1
572999306,1,0,0,0,1
573389068,0,1,0,0,1
571687681,0,1,0,0,1
571469497,0,1,0,0,1
569915667,0,1,0,0,1
571268401,0,1,0,0,1
569993991,1,0,0,0,1
570033633,0,1,0,0,1
570085943,0,1,0,0,1
570086258,0,1,0,0,1
570117439,1,0,0,0,1
570202021,0,1,0,0,1
570224548,0,1,0,0,1
570264299,0,1,0,0,1
570312123,0,1,0,0,1
570358560,0,1,0,0,1
570368730,0,1,0,0,1
570453114,0,1,0,0,1
570494012,0,1,0,0,1
570510229,0,0,0,1,1
570628854,0,1,0,0,1
570641551,0,1,0,0,1
570677631,0,1,0,0,1
570712701,0,1,0,0,1
570743153,0,1,0,0,1
570805397,1,0,0,0,1
571113102,1,0,0,0,1
571127001,0,1,0,0,1
571205721,0,1,0,0,1
573517083,0,1,0,0,1
573648948,1,0,0,0,1
573681004,0,1,0,0,1
573795317,0,1,0,0,1
575699479,0,1,0,0,1
575801859,0,1,0,0,1
575882251,0,1,0,0,1
575966271,0,1,0,0,1
576033080,0,1,0,0,1
576106827,0,1,0,0,1
576120513,0,1,0,0,1
576146929,0,1,0,0,1
576169521,0,1,0,0,1
576243423,0,1,0,0,1
576251081,1,0,0,0,1
576291134,0,1,0,0,1
576304172,0,1,0,0,1
576483224,0,1,0,0,1
576511680,0,1,0,0,1
576544713,0,1,0,0,1
576563244,0,1,0,0,1
576563652,0,1,0,0,1
576600724,0,1,0,0,1
576603943,0,1,0,0,1
576699517,0,1,0,0,1
576834361,0,1,0,0,1
576871929,1,0,0,0,1
575698060,0,1,0,0,1
575670603,0,1,0,0,1
575631226,1,0,0,0,1
574410936,0,1,0,0,1
573815501,1,0,0,0,1
573930962,0,1,0,0,1
573952814,1,0,0,0,1
573994382,0,1,0,0,1
574046902,0,1,0,0,1
574234298,0,1,0,0,1
574296496,0,1,0,0,1
574341671,0,1,0,0,1
574341836,0,1,0,0,1
574403139,1,0,0,0,1
574569222,0,1,0,0,1
575482322,0,1,0,0,1
574646002,0,1,0,0,1
574687662,0,1,0,0,1
574967909,0,1,0,0,1
575011924,0,1,0,0,1
575102404,1,0,0,0,1
575166154,0,1,0,0,1
575182570,1,0,0,0,1
575227444,0,1,0,0,1
575276843,0,1,0,0,1
575478336,0,1,0,0,1
569959171,0,1,0,0,1
569915255,0,1,0,0,1
739705153,0,1,0,0,1
564962637,1,0,0,0,1
564974377,0,1,0,0,1
565003176,0,1,0,0,1
565014186,0,1,0,0,1
565147809,0,0,0,1,1
565201109,0,1,0,0,1
565213486,0,1,0,0,1
565273540,1,0,0,0,1
565279044,0,1,0,0,1
565419009,1,0,0,0,1
565433997,0,1,0,0,1
565486853,0,0,0,1,1
565547908,0,1,0,0,1
565846785,0,1,0,0,1
565902674,0,1,0,0,1
566155847,0,1,0,0,1
566326691,0,1,0,0,1
566459972,0,1,0,0,1
566503992,0,1,0,0,1
566522835,0,1,0,0,1
566586062,0,1,0,0,1
566596923,0,1,0,0,1
566603932,0,1,0,0,1
566700592,0,1,0,0,1
564973968,0,1,0,0,1
564961963,0,0,1,0,1
569756180,1,0,0,0,1
564801545,0,1,0,0,1
563598823,0,1,0,0,1
563608575,0,1,0,0,1
563684538,0,1,0,0,1
563720164,0,1,0,0,1
563882469,0,0,0,1,1
563889088,1,0,0,0,1
563922446,0,1,0,0,1
563979204,0,1,0,0,1
563996586,0,1,0,0,1
564081675,1,0,0,0,1
564293314,1,0,0,0,1
564394199,0,1,0,0,1
564414132,0,1,0,0,1
564455537,0,1,0,0,1
564463926,0,1,0,0,1
564550961,0,1,0,0,1
564578052,0,1,0,0,1
564616641,0,1,0,0,1
564628977,1,0,0,0,1
564667441,0,1,0,0,1
564695868,0,1,0,0,1
564699876,1,0,0,0,1
564775646,0,1,0,0,1
566778615,0,1,0,0,1
566921598,0,1,0,0,1
566933124,0,1,0,0,1
567019920,0,1,0,0,1
568376483,0,1,0,0,1
568418849,0,1,0,0,1
568536009,0,0,1,0,1
568609131,0,1,0,0,1
568722374,0,1,0,0,1
568728759,0,1,0,0,1
568747595,1,0,0,0,1
568853504,0,0,0,1,1
568857113,0,1,0,0,1
568956040,0,1,0,0,1
568965315,0,1,0,0,1
569009188,0,1,0,0,1
569071517,1,0,0,0,1
569077049,1,0,0,0,1
569112650,0,0,1,0,1
569168766,1,0,0,0,1
569170009,0,1,0,0,1
569190060,0,1,0,0,1
569266549,0,1,0,0,1
569272329,0,1,0,0,1
569339774,0,1,0,0,1
569393178,0,0,1,0,1
569649430,0,1,0,0,1
568283145,0,1,0,0,1
568277162,0,1,0,0,1
568251034,0,1,0,0,1
567620793,0,1,0,0,1
567029108,0,1,0,0,1
567102460,1,0,0,0,1
567153565,0,1,0,0,1
567185485,0,1,0,0,1
567207747,0,1,0,0,1
567294809,0,1,0,0,1
567364415,0,1,0,0,1
567451040,1,0,0,0,1
567487899,0,1,0,0,1
567586950,0,1,0,0,1
567844087,1,0,0,0,1
568242996,0,1,0,0,1
567893851,0,1,0,0,1
567945880,0,1,0,0,1
568029386,0,1,0,0,1
568037581,0,1,0,0,1
568068841,0,1,0,0,1
568093153,0,1,0,0,1
568096773,1,0,0,0,1
568102169,0,1,0,0,1
568117963,0,0,0,1,1
568129848,0,1,0,0,1
576902675,0,1,0,0,1
576962693,0,1,0,0,1
577055614,1,0,0,0,1
586490970,0,1,0,0,1
586560932,1,0,0,0,1
586575672,0,1,0,0,1
586608347,0,1,0,0,1
586624738,0,1,0,0,1
586670683,0,1,0,0,1
586728549,0,1,0,0,1
586730979,0,1,0,0,1
586762620,0,1,0,0,1
586786644,1,0,0,0,1
586853589,0,1,0,0,1
586919323,0,1,0,0,1
586921010,0,1,0,0,1
587250160,1,0,0,0,1
587260847,0,1,0,0,1
587276148,1,0,0,0,1
587369115,0,0,1,0,1
587402956,0,1,0,0,1
587414782,0,1,0,0,1
587434365,0,1,0,0,1
587494855,1,0,0,0,1
587539644,0,1,0,0,1
587578093,1,0,0,0,1
587764463,0,1,0,0,1
586524042,0,1,0,0,1
586415616,0,1,0,0,1
577109184,0,1,0,0,1
586372034,0,1,0,0,1
584535821,0,1,0,0,1
584612545,0,1,0,0,1
584634290,1,0,0,0,1
584836215,0,1,0,0,1
584845235,0,1,0,0,1
585140417,0,1,0,0,1
585216682,0,1,0,0,1
585342005,1,0,0,0,1
585412426,0,1,0,0,1
585436880,0,1,0,0,1
585622432,0,1,0,0,1
585664052,0,0,0,1,1
585717190,1,0,0,0,1
585740318,0,1,0,0,1
585814600,1,0,0,0,1
585815667,0,1,0,0,1
585862440,0,1,0,0,1
585968039,0,1,0,0,1
586009990,0,1,0,0,1
586249543,0,1,0,0,1
586273231,0,1,0,0,1
586293809,0,1,0,0,1
586313559,0,1,0,0,1
587778948,0,1,0,0,1
588147343,0,1,0,0,1
588168791,1,0,0,0,1
588339803,0,1,0,0,1
590317196,0,1,0,0,1
590360871,0,1,0,0,1
590388071,0,1,0,0,1
590447366,0,1,0,0,1
590578799,1,0,0,0,1
590601574,1,0,0,0,1
590610442,0,1,0,0,1
590626337,0,1,0,0,1
590737994,0,1,0,0,1
590742580,0,1,0,0,1
590831049,0,1,0,0,1
590904222,0,1,0,0,1
590911114,0,1,0,0,1
590914791,0,1,0,0,1
590932845,0,1,0,0,1
591206812,0,1,0,0,1
591214719,0,1,0,0,1
591237276,0,1,0,0,1
591296513,1,0,0,0,1
591363454,0,1,0,0,1
591403606,0,1,0,0,1
591588823,0,1,0,0,1
591600905,0,1,0,0,1
590252398,0,1,0,0,1
590201726,0,1,0,0,1
590138749,0,1,0,0,1
589090579,0,1,0,0,1
588357585,0,1,0,0,1
588395120,0,1,0,0,1
588434195,0,1,0,0,1
588538276,0,1,0,0,1
588571374,0,1,0,0,1
588747198,0,1,0,0,1
588910218,0,1,0,0,1
588935995,0,1,0,0,1
588969305,0,1,0,0,1
589012455,0,1,0,0,1
589093875,0,1,0,0,1
590116227,0,1,0,0,1
589110565,1,0,0,0,1
589143430,0,1,0,0,1
589306963,0,1,0,0,1
589383504,0,1,0,0,1
589682949,0,1,0,0,1
589691197,0,1,0,0,1
589722497,0,1,0,0,1
589730391,0,1,0,0,1
589746178,0,1,0,0,1
589814759,0,1,0,0,1
584496409,0,1,0,0,1
584463305,1,0,0,0,1
584438383,0,1,0,0,1
580793561,0,1,0,0,1
579661087,1,0,0,0,1
579747564,0,1,0,0,1
579802621,0,1,0,0,1
579831335,0,1,0,0,1
579871616,0,0,0,1,1
579871798,0,1,0,0,1
579912278,0,1,0,0,1
579968793,0,1,0,0,1
580026542,0,1,0,0,1
580047044,0,1,0,0,1
580057697,0,1,0,0,1
580079404,0,1,0,0,1
580105502,0,1,0,0,1
580129552,0,1,0,0,1
580196299,0,1,0,0,1
580257541,0,1,0,0,1
580312943,0,0,1,0,1
580398648,0,1,0,0,1
580401727,1,0,0,0,1
580453251,0,1,0,0,1
580530323,1,0,0,0,1
580584652,0,1,0,0,1
580689062,0,1,0,0,1
579516230,0,1,0,0,1
579405237,1,0,0,0,1
579130509,0,0,1,0,1
578091498,1,0,0,0,1
577158535,0,1,0,0,1
577202683,0,1,0,0,1
577309636,0,1,0,0,1
577541694,0,1,0,0,1
577583587,0,1,0,0,1
577657408,1,0,0,0,1
577685612,0,1,0,0,1
577970552,0,1,0,0,1
577991381,0,1,0,0,1
578057143,0,1,0,0,1
578124575,0,1,0,0,1
579089730,0,1,0,0,1
578174608,0,1,0,0,1
578185355,0,1,0,0,1
578299065,0,1,0,0,1
578329365,0,1,0,0,1
578370554,0,1,0,0,1
578722695,0,1,0,0,1
578941925,0,1,0,0,1
578992077,0,1,0,0,1
579064079,0,1,0,0,1
579089415,1,0,0,0,1
580739199,0,1,0,0,1
580897181,0,1,0,0,1
584406599,0,1,0,0,1
580904565,0,1,0,0,1
582648129,0,1,0,0,1
582652787,1,0,0,0,1
582726731,0,1,0,0,1
582876332,0,1,0,0,1
582896030,0,1,0,0,1
582922321,1,0,0,0,1
583117972,0,1,0,0,1
583498000,0,1,0,0,1
583543380,0,1,0,0,1
583561154,1,0,0,0,1
583584245,0,1,0,0,1
583648901,0,1,0,0,1
583711013,0,1,0,0,1
583790840,0,1,0,0,1
584019173,0,1,0,0,1
584025782,0,1,0,0,1
584066112,0,1,0,0,1
584118126,0,1,0,0,1
584145700,0,1,0,0,1
584267571,0,1,0,0,1
584314105,0,1,0,0,1
584348056,1,0,0,0,1
584382653,0,1,0,0,1
582606869,0,1,0,0,1
582432622,1,0,0,0,1
582415455,0,1,0,0,1
581594840,0,1,0,0,1
580906768,0,1,0,0,1
580916142,0,1,0,0,1
580956747,0,1,0,0,1
581013965,0,1,0,0,1
581040373,0,1,0,0,1
581206231,0,1,0,0,1
581332963,0,1,0,0,1
581340021,0,1,0,0,1
581354880,0,1,0,0,1
581532636,0,1,0,0,1
581608884,0,1,0,0,1
582414351,1,0,0,0,1
581676375,1,0,0,0,1
581783764,0,1,0,0,1
581901300,0,1,0,0,1
581912325,0,1,0,0,1
581921563,0,1,0,0,1
581993901,0,1,0,0,1
582007469,0,1,0,0,1
582048185,0,1,0,0,1
582054643,1,0,0,0,1
582235003,0,1,0,0,1
563521457,0,1,0,0,1
563494287,0,1,0,0,1
563464269,0,1,0,0,1
544137107,0,1,0,0,1
544229298,0,1,0,0,1
544412916,0,1,0,0,1
544423454,0,1,0,0,1
544529756,0,1,0,0,1
544627192,0,1,0,0,1
544633763,0,1,0,0,1
544744021,0,1,0,0,1
544822974,0,1,0,0,1
545022186,1,0,0,0,1
545054321,0,1,0,0,1
545088857,0,1,0,0,1
545089053,0,1,0,0,1
545220045,0,1,0,0,1
545238931,0,1,0,0,1
545245083,0,1,0,0,1
545275904,0,1,0,0,1
545279994,0,1,0,0,1
545996823,0,1,0,0,1
546146480,0,1,0,0,1
546148630,0,1,0,0,1
546190436,0,1,0,0,1
546470742,0,1,0,0,1
546477466,1,0,0,0,1
544210568,0,1,0,0,1
544136122,0,0,0,1,1
549479894,0,1,0,0,1
544121186,0,1,0,0,1
541594524,1,0,0,0,1
541635344,0,1,0,0,1
541679758,0,1,0,0,1
541708585,0,0,1,0,1
541780937,0,0,0,1,1
541850213,0,1,0,0,1
541956047,0,1,0,0,1
542131751,0,1,0,0,1
542257236,0,1,0,0,1
542488698,0,1,0,0,1
542727491,0,1,0,0,1
542738262,0,1,0,0,1
543094220,0,1,0,0,1
543245067,0,1,0,0,1
543268023,0,1,0,0,1
543307471,0,1,0,0,1
543424380,0,1,0,0,1
543647273,0,1,0,0,1
543729870,0,1,0,0,1
543757822,0,1,0,0,1
543807202,0,1,0,0,1
544007758,0,1,0,0,1
544014462,0,1,0,0,1
546613799,0,1,0,0,1
546746195,0,1,0,0,1
546918866,0,1,0,0,1
546946817,0,1,0,0,1
548428993,0,1,0,0,1
548456701,0,1,0,0,1
548485814,0,1,0,0,1
548566389,0,1,0,0,1
548718135,1,0,0,0,1
548723864,0,1,0,0,1
548924757,0,1,0,0,1
548950700,0,1,0,0,1
548961556,0,1,0,0,1
549017081,0,1,0,0,1
549032600,0,1,0,0,1
549059675,0,1,0,0,1
549076773,0,1,0,0,1
549212585,0,1,0,0,1
549219686,0,1,0,0,1
549245775,0,1,0,0,1
549286934,1,0,0,0,1
549330655,0,1,0,0,1
549354789,0,1,0,0,1
549381662,0,1,0,0,1
549398356,0,1,0,0,1
549398432,0,1,0,0,1
549409687,0,1,0,0,1
548397788,0,1,0,0,1
548309682,0,1,0,0,1
548231537,0,0,1,0,1
547453728,1,0,0,0,1
547015259,0,1,0,0,1
547061643,1,0,0,0,1
547064830,0,1,0,0,1
547065623,0,1,0,0,1
547106952,0,1,0,0,1
547121229,0,1,0,0,1
547141921,0,1,0,0,1
547237027,0,1,0,0,1
547377491,0,0,0,1,1
547414616,0,1,0,0,1
547466673,1,0,0,0,1
548068254,1,0,0,0,1
547529086,0,1,0,0,1
547560060,1,0,0,0,1
547614946,0,1,0,0,1
547655073,0,1,0,0,1
547755132,1,0,0,0,1
547763089,0,0,0,1,1
547878940,0,1,0,0,1
547887929,0,1,0,0,1
547924335,0,1,0,0,1
548037240,0,1,0,0,1
541593499,0,1,0,0,1
541582600,0,1,0,0,1
541502170,0,1,0,0,1
537088215,0,1,0,0,1
535388522,0,1,0,0,1
535442436,0,1,0,0,1
535443730,0,1,0,0,1
535536344,1,0,0,0,1
535553301,0,1,0,0,1
535597030,0,1,0,0,1
535835333,0,1,0,0,1
535875102,1,0,0,0,1
535904416,0,1,0,0,1
536041275,0,1,0,0,1
536055530,0,1,0,0,1
536180191,0,1,0,0,1
536194200,0,1,0,0,1
536196146,0,1,0,0,1
536283612,0,1,0,0,1
536415482,0,1,0,0,1
536415748,0,1,0,0,1
536423802,0,1,0,0,1
536463638,0,1,0,0,1
536513618,0,1,0,0,1
536567784,0,1,0,0,1
536628862,0,0,0,1,1
536735600,0,1,0,0,1
535197767,0,1,0,0,1
535148782,0,1,0,0,1
534829606,0,1,0,0,1
533576837,0,1,0,0,1
532722125,0,1,0,0,1
532745897,0,1,0,0,1
532885649,0,1,0,0,1
533027715,0,1,0,0,1
533042963,1,0,0,0,1
533091727,0,1,0,0,1
533146087,0,1,0,0,1
533315889,0,1,0,0,1
533469634,0,1,0,0,1
533565517,0,1,0,0,1
533578801,0,1,0,0,1
534658223,0,1,0,0,1
533588854,0,1,0,0,1
533680239,1,0,0,0,1
533921654,0,0,0,1,1
533921905,0,1,0,0,1
533932894,0,1,0,0,1
534120995,0,1,0,0,1
534123159,0,0,0,1,1
534365291,0,1,0,0,1
534606782,0,0,1,0,1
534649948,0,1,0,0,1
536942682,0,1,0,0,1
537150381,0,1,0,0,1
541499619,0,1,0,0,1
537296002,0,1,0,0,1
539716163,0,1,0,0,1
539723907,0,1,0,0,1
539740405,1,0,0,0,1
539815152,0,1,0,0,1
539818362,0,1,0,0,1
539826374,0,1,0,0,1
539933621,0,0,1,0,1
540001319,0,1,0,0,1
540069578,0,1,0,0,1
540128867,0,0,1,0,1
540209107,0,1,0,0,1
540239150,1,0,0,0,1
540363714,0,1,0,0,1
540475449,0,1,0,0,1
540595717,0,1,0,0,1
540631889,0,1,0,0,1
540821519,0,1,0,0,1
540824111,0,1,0,0,1
541080006,0,1,0,0,1
541102044,0,1,0,0,1
541164257,0,1,0,0,1
541171533,0,1,0,0,1
541217000,0,1,0,0,1
539660884,0,1,0,0,1
539573373,0,1,0,0,1
539074749,0,1,0,0,1
538256428,0,1,0,0,1
537449610,0,1,0,0,1
537456518,0,1,0,0,1
537592148,0,1,0,0,1
537619201,0,1,0,0,1
537898048,0,1,0,0,1
537931040,0,1,0,0,1
537979245,0,1,0,0,1
538090753,1,0,0,0,1
538201708,0,1,0,0,1
538228642,0,1,0,0,1
538269488,0,1,0,0,1
538987132,0,1,0,0,1
538334192,0,1,0,0,1
538403083,0,1,0,0,1
538453809,0,1,0,0,1
538518260,0,1,0,0,1
538531673,1,0,0,0,1
538717739,0,1,0,0,1
538800105,0,1,0,0,1
538950022,0,1,0,0,1
538969744,1,0,0,0,1
538971892,0,1,0,0,1
549464611,1,0,0,0,1
549549497,0,1,0,0,1
563393382,1,0,0,0,1
558017188,0,1,0,0,1
558386331,0,1,0,0,1
558396901,0,1,0,0,1
558409310,0,1,0,0,1
558473244,0,1,0,0,1
558490823,1,0,0,0,1
558549822,1,0,0,0,1
558643487,0,1,0,0,1
558676332,1,0,0,0,1
558776135,0,1,0,0,1
558857948,0,1,0,0,1
558872410,0,1,0,0,1
558873531,0,1,0,0,1
558879057,0,1,0,0,1
558994617,0,1,0,0,1
559052176,0,1,0,0,1
559229803,0,1,0,0,1
559325715,0,1,0,0,1
559331546,0,1,0,0,1
559331929,1,0,0,0,1
559356642,0,1,0,0,1
559377759,0,1,0,0,1
559389790,0,1,0,0,1
559515867,0,1,0,0,1
558301390,0,1,0,0,1
557938289,0,1,0,0,1
549754533,0,1,0,0,1
557916334,0,1,0,0,1
556235011,0,1,0,0,1
556288543,1,0,0,0,1
556339967,0,1,0,0,1
556792837,0,1,0,0,1
556801980,0,1,0,0,1
556828738,1,0,0,0,1
556832784,0,1,0,0,1
556836648,0,1,0,0,1
557005384,0,0,1,0,1
557101215,0,1,0,0,1
557211434,0,1,0,0,1
557266262,0,0,1,0,1
557279352,0,1,0,0,1
557358846,0,1,0,0,1
557384263,0,1,0,0,1
557385028,0,1,0,0,1
557512342,0,1,0,0,1
557547073,0,1,0,0,1
557657855,0,1,0,0,1
557764052,1,0,0,0,1
557780859,0,1,0,0,1
557835293,1,0,0,0,1
557846162,0,1,0,0,1
559519973,0,1,0,0,1
559571712,0,1,0,0,1
559696557,1,0,0,0,1
559709894,0,1,0,0,1
561840904,0,1,0,0,1
562027228,0,1,0,0,1
562043076,0,1,0,0,1
562279214,0,1,0,0,1
562350417,0,1,0,0,1
562366875,1,0,0,0,1
562423143,0,1,0,0,1
562445297,0,1,0,0,1
562623087,0,0,0,1,1
562700047,0,1,0,0,1
562716875,1,0,0,0,1
562731682,0,1,0,0,1
562760036,0,1,0,0,1
562884891,0,1,0,0,1
562888600,0,1,0,0,1
562922946,0,1,0,0,1
562926683,0,1,0,0,1
563013181,0,1,0,0,1
563025773,0,1,0,0,1
563147998,1,0,0,0,1
563200706,0,1,0,0,1
563264623,0,1,0,0,1
563271013,0,1,0,0,1
561798277,1,0,0,0,1
561675142,0,1,0,0,1
561444872,0,1,0,0,1
560547145,0,1,0,0,1
559791808,1,0,0,0,1
559859638,0,1,0,0,1
559870034,0,1,0,0,1
559879499,0,1,0,0,1
559972584,0,1,0,0,1
560259323,0,0,1,0,1
560337554,1,0,0,0,1
560384947,0,1,0,0,1
560482445,0,1,0,0,1
560496294,1,0,0,0,1
560596348,0,1,0,0,1
561298350,1,0,0,0,1
560613223,0,1,0,0,1
560654398,0,1,0,0,1
560867314,0,1,0,0,1
560874687,0,0,1,0,1
561012586,0,1,0,0,1
561025001,0,1,0,0,1
561063495,0,1,0,0,1
561064499,0,1,0,0,1
561196095,0,1,0,0,1
561205000,0,1,0,0,1
556225953,0,1,0,0,1
556155553,0,1,0,0,1
556078740,0,1,0,0,1
552956605,0,1,0,0,1
551398784,0,1,0,0,1
551468248,0,1,0,0,1
551564132,1,0,0,0,1
551565275,0,1,0,0,1
551662303,0,1,0,0,1
551705298,1,0,0,0,1
551824543,0,1,0,0,1
551901016,0,1,0,0,1
552036395,0,0,1,0,1
552093152,0,1,0,0,1
552139703,0,1,0,0,1
552229268,0,1,0,0,1
552294855,1,0,0,0,1
552420449,1,0,0,0,1
552478395,0,1,0,0,1
552489061,0,1,0,0,1
552533269,0,1,0,0,1
552580986,0,1,0,0,1
552641912,0,1,0,0,1
552666859,0,1,0,0,1
552843788,0,1,0,0,1
552868074,0,1,0,0,1
552901214,0,1,0,0,1
551369586,0,1,0,0,1
551246971,0,1,0,0,1
551227590,0,1,0,0,1
550252653,0,1,0,0,1
549787050,0,1,0,0,1
549813058,0,0,0,1,1
549855423,0,1,0,0,1
549933361,1,0,0,0,1
549977327,0,1,0,0,1
550081161,0,1,0,0,1
550084163,0,1,0,0,1
550194211,0,1,0,0,1
550199534,0,1,0,0,1
550210920,0,1,0,0,1
550347768,0,1,0,0,1
551140324,0,1,0,0,1
550386383,0,1,0,0,1
550619155,0,1,0,0,1
550652569,1,0,0,0,1
550663701,0,1,0,0,1
550846151,0,0,0,1,1
550877827,0,1,0,0,1
550940481,0,1,0,0,1
551038252,0,1,0,0,1
551045799,0,1,0,0,1
551120648,0,1,0,0,1
552942248,0,1,0,0,1
553024992,0,1,0,0,1
555990950,0,1,0,0,1
553199230,0,1,0,0,1
554876342,0,1,0,0,1
554915062,0,1,0,0,1
554988837,1,0,0,0,1
554992820,0,1,0,0,1
555020809,0,1,0,0,1
555035416,0,1,0,0,1
555086608,0,1,0,0,1
555158350,0,0,0,1,1
555179093,0,1,0,0,1
555227531,0,1,0,0,1
555298507,0,1,0,0,1
555312507,0,1,0,0,1
555337876,0,1,0,0,1
555419708,0,1,0,0,1
555525767,0,1,0,0,1
555695067,0,1,0,0,1
555815209,0,1,0,0,1
555858404,0,1,0,0,1
555905488,0,1,0,0,1
555907017,1,0,0,0,1
555910500,0,1,0,0,1
555969752,0,1,0,0,1
555981117,0,1,0,0,1
554829851,0,1,0,0,1
554769313,0,1,0,0,1
554590801,0,0,0,1,1
553950930,0,1,0,0,1
553285596,0,1,0,0,1
553380286,0,0,0,1,1
553398208,0,1,0,0,1
553419294,0,1,0,0,1
553469321,0,1,0,0,1
553508603,0,1,0,0,1
553583928,0,1,0,0,1
553598894,0,1,0,0,1
553740596,0,1,0,0,1
553940625,0,1,0,0,1
554067158,1,0,0,0,1
554557516,0,1,0,0,1
554187890,0,1,0,0,1
554191197,0,1,0,0,1
554213231,0,1,0,0,1
554285769,0,1,0,0,1
554313343,0,1,0,0,1
554324552,0,1,0,0,1
554372340,0,1,0,0,1
554414154,1,0,0,0,1
554425824,0,1,0,0,1
554551417,0,1,0,0,1
591617967,0,1,0,0,1
591841811,0,1,0,0,1
591863990,0,1,0,0,1
701937041,1,0,0,0,1
702042668,0,1,0,0,1
702169058,1,0,0,0,1
702609374,0,1,0,0,1
702628926,0,1,0,0,1
702696020,0,1,0,0,1
702952436,0,1,0,0,1
703026589,0,1,0,0,1
703037570,0,1,0,0,1
703062776,0,1,0,0,1
703094393,0,1,0,0,1
703110281,0,1,0,0,1
703223386,0,1,0,0,1
703280985,0,1,0,0,1
703309230,0,1,0,0,1
703324622,0,1,0,0,1
703795995,0,1,0,0,1
703840644,0,1,0,0,1
703843661,0,1,0,0,1
703994217,0,1,0,0,1
704195516,0,1,0,0,1
704209219,0,1,0,0,1
704339306,0,1,0,0,1
704509827,0,1,0,0,1
702027343,1,0,0,0,1
701859832,0,1,0,0,1
711027816,0,1,0,0,1
701766919,0,1,0,0,1
636442675,0,1,0,0,1
636491084,0,1,0,0,1
636531384,1,0,0,0,1
636777523,0,1,0,0,1
636901332,0,1,0,0,1
636910268,0,1,0,0,1
636997820,0,1,0,0,1
637023555,0,1,0,0,1
637032929,1,0,0,0,1
637123683,0,1,0,0,1
637191934,0,1,0,0,1
637232269,0,1,0,0,1
637282183,0,0,0,1,1
700235877,0,0,0,1,1
700394446,1,0,0,0,1
700643472,1,0,0,0,1
700690105,0,1,0,0,1
700734559,0,1,0,0,1
700748184,0,1,0,0,1
701111606,0,1,0,0,1
701134204,0,1,0,0,1
701350568,0,1,0,0,1
701417033,0,1,0,0,1
704598397,0,1,0,0,1
704680398,1,0,0,0,1
704733753,0,1,0,0,1
704759265,0,1,0,0,1
707957752,0,1,0,0,1
708003944,0,1,0,0,1
708025199,0,1,0,0,1
708105282,0,1,0,0,1
708118559,0,1,0,0,1
708323447,0,1,0,0,1
708531648,0,1,0,0,1
708533213,0,1,0,0,1
708553878,0,0,0,1,1
708878521,0,0,0,1,1
709156154,0,1,0,0,1
709209069,0,1,0,0,1
709247376,1,0,0,0,1
709974389,0,1,0,0,1
709985439,1,0,0,0,1
710088842,0,1,0,0,1
710178830,1,0,0,0,1
710321906,0,1,0,0,1
710359794,0,0,0,1,1
710490692,0,1,0,0,1
710949062,0,1,0,0,1
710971417,0,1,0,0,1
710981658,1,0,0,0,1
707906561,0,1,0,0,1
707885182,1,0,0,0,1
707841704,0,1,0,0,1
706169772,0,1,0,0,1
704860413,0,1,0,0,1
704869940,0,1,0,0,1
704882715,0,1,0,0,1
704996147,0,1,0,0,1
705021398,0,1,0,0,1
705073561,0,1,0,0,1
705383624,0,1,0,0,1
705522967,0,1,0,0,1
705566961,0,1,0,0,1
705920935,0,1,0,0,1
706480260,1,0,0,0,1
707835814,0,1,0,0,1
706630442,0,1,0,0,1
706636039,0,1,0,0,1
707148799,1,0,0,0,1
707173838,0,1,0,0,1
707182356,0,1,0,0,1
707186902,1,0,0,0,1
707479736,0,1,0,0,1
707558646,0,1,0,0,1
707694997,0,1,0,0,1
707817493,0,1,0,0,1
636428398,0,1,0,0,1
636414809,0,1,0,0,1
636386458,0,1,0,0,1
633074429,0,1,0,0,1
630468704,0,1,0,0,1
630546585,0,1,0,0,1
630571912,0,1,0,0,1
630930368,0,1,0,0,1
630976461,0,1,0,0,1
631016178,0,1,0,0,1
631016536,0,1,0,0,1
631659998,0,1,0,0,1
631836659,0,1,0,0,1
631849189,1,0,0,0,1
631850941,0,1,0,0,1
631856347,0,0,1,0,1
631857940,0,1,0,0,1
631924651,0,1,0,0,1
631958447,0,1,0,0,1
632033691,1,0,0,0,1
632049192,0,1,0,0,1
632069020,0,1,0,0,1
632169109,0,1,0,0,1
632303819,0,1,0,0,1
632355011,0,1,0,0,1
632776179,0,1,0,0,1
632797783,1,0,0,0,1
630335013,0,1,0,0,1
630264838,1,0,0,0,1
630237764,0,1,0,0,1
627826192,0,1,0,0,1
627296689,1,0,0,0,1
627338831,0,1,0,0,1
627384651,0,1,0,0,1
627411639,0,0,1,0,1
627489961,1,0,0,0,1
627544220,0,1,0,0,1
627576239,0,1,0,0,1
627659848,0,1,0,0,1
627738230,0,1,0,0,1
627810203,0,1,0,0,1
627994880,0,1,0,0,1
630027365,1,0,0,0,1
628271302,0,1,0,0,1
628401193,0,1,0,0,1
628417129,0,1,0,0,1
628718220,0,1,0,0,1
628838035,0,1,0,0,1
629039511,0,1,0,0,1
629196833,1,0,0,0,1
629338613,0,1,0,0,1
629551340,0,1,0,0,1
629891895,0,1,0,0,1
632864010,0,1,0,0,1
633086972,0,1,0,0,1
636363400,0,1,0,0,1
633094000,0,1,0,0,1
634625383,0,1,0,0,1
634634542,0,1,0,0,1
634697984,0,1,0,0,1
634727458,0,1,0,0,1
634739372,0,1,0,0,1
634750589,1,0,0,0,1
634825260,0,1,0,0,1
634909239,0,1,0,0,1
635163450,0,1,0,0,1
635207087,0,1,0,0,1
635211054,0,1,0,0,1
635256842,0,1,0,0,1
635481458,1,0,0,0,1
635516032,0,1,0,0,1
635657365,0,1,0,0,1
635698492,1,0,0,0,1
635750362,0,1,0,0,1
635947804,0,1,0,0,1
635962842,0,1,0,0,1
636009638,0,1,0,0,1
636095356,0,1,0,0,1
636187662,0,1,0,0,1
636196702,0,1,0,0,1
634591692,0,1,0,0,1
634582310,0,0,1,0,1
634510685,0,1,0,0,1
633781150,0,1,0,0,1
633222507,0,1,0,0,1
633252462,1,0,0,0,1
633272582,0,1,0,0,1
633495534,0,1,0,0,1
633533219,0,1,0,0,1
633549545,0,1,0,0,1
633561152,0,1,0,0,1
633631211,0,1,0,0,1
633693742,0,1,0,0,1
633719940,0,1,0,0,1
633859915,1,0,0,0,1
634351399,0,1,0,0,1
633866314,0,1,0,0,1
633914846,0,1,0,0,1
633945456,0,1,0,0,1
633973557,1,0,0,0,1
634017287,0,0,0,1,1
634090644,0,1,0,0,1
634091603,0,1,0,0,1
634124789,0,1,0,0,1
634255378,0,1,0,0,1
634322628,0,1,0,0,1
710985956,0,1,0,0,1
711060245,0,1,0,0,1
627049448,0,1,0,0,1
728712338,1,0,0,0,1
729246649,1,0,0,0,1
729438630,0,0,1,0,1
729463152,0,1,0,0,1
730281487,1,0,0,0,1
730443860,0,1,0,0,1
730641529,0,1,0,0,1
730811168,1,0,0,0,1
730998553,0,1,0,0,1
731028548,0,1,0,0,1
731123420,0,1,0,0,1
731141815,0,1,0,0,1
731262506,0,1,0,0,1
731265960,0,1,0,0,1
731308178,0,1,0,0,1
731316710,0,1,0,0,1
731343264,0,1,0,0,1
731592918,0,1,0,0,1
731699190,1,0,0,0,1
732455659,0,1,0,0,1
732652993,1,0,0,0,1
732801217,0,1,0,0,1
732811266,0,1,0,0,1
732929322,0,1,0,0,1
728923068,0,1,0,0,1
728679073,0,1,0,0,1
711117578,0,1,0,0,1
728407514,0,1,0,0,1
723863467,0,1,0,0,1
723889117,1,0,0,0,1
723896642,0,1,0,0,1
723988860,0,1,0,0,1
724051429,0,1,0,0,1
724104524,0,0,0,1,1
724335841,0,1,0,0,1
724555704,0,1,0,0,1
724564074,0,1,0,0,1
724663854,0,1,0,0,1
724917577,0,1,0,0,1
725726202,0,1,0,0,1
726110132,0,1,0,0,1
726112254,0,1,0,0,1
726168512,0,1,0,0,1
726208632,0,1,0,0,1
726563006,1,0,0,0,1
726673382,0,1,0,0,1
726688736,0,1,0,0,1
726757164,0,1,0,0,1
726788581,0,1,0,0,1
727388964,1,0,0,0,1
728307288,0,0,1,0,1
732965930,0,1,0,0,1
732981824,0,1,0,0,1
733008870,1,0,0,0,1
733029576,0,1,0,0,1
736537052,0,1,0,0,1
736649448,0,1,0,0,1
736912430,1,0,0,0,1
736996813,0,1,0,0,1
737286482,0,1,0,0,1
737354124,0,1,0,0,1
737844127,1,0,0,0,1
737916403,0,1,0,0,1
738042086,0,1,0,0,1
738293906,0,1,0,0,1
738304764,0,1,0,0,1
738413064,0,1,0,0,1
738439242,0,1,0,0,1
738480043,0,1,0,0,1
738523729,1,0,0,0,1
738604597,0,1,0,0,1
738697586,0,1,0,0,1
738787902,0,1,0,0,1
738791899,0,1,0,0,1
738806388,0,1,0,0,1
738975427,0,1,0,0,1
739044282,0,1,0,0,1
739447290,0,1,0,0,1
736528068,0,1,0,0,1
736501304,0,0,0,1,1
736448628,0,1,0,0,1
734359970,0,1,0,0,1
733257169,1,0,0,0,1
733278128,0,1,0,0,1
733291560,0,1,0,0,1
733670196,0,1,0,0,1
733903614,0,1,0,0,1
733992522,0,1,0,0,1
734004217,0,1,0,0,1
734100306,0,1,0,0,1
734293746,0,1,0,0,1
734322739,0,1,0,0,1
734491789,0,1,0,0,1
736399368,0,1,0,0,1
734601072,0,1,0,0,1
734601288,0,1,0,0,1
734614963,0,1,0,0,1
734741150,1,0,0,0,1
734772932,0,1,0,0,1
734988799,0,1,0,0,1
735223555,0,1,0,0,1
735251197,0,1,0,0,1
735308094,0,1,0,0,1
736138314,0,1,0,0,1
723820321,0,1,0,0,1
722890292,0,1,0,0,1
722646721,0,0,1,0,1
716684672,0,1,0,0,1
714167586,0,1,0,0,1
714267381,1,0,0,0,1
714442700,0,1,0,0,1
714600883,0,1,0,0,1
714639792,0,1,0,0,1
714740249,0,1,0,0,1
714749587,0,1,0,0,1
715053146,0,1,0,0,1
715235732,1,0,0,0,1
715375550,0,1,0,0,1
715487364,1,0,0,0,1
715564387,0,0,0,1,1
715587649,0,1,0,0,1
715657206,0,1,0,0,1
715797681,0,1,0,0,1
715876839,0,1,0,0,1
715894491,0,1,0,0,1
715900660,0,1,0,0,1
716157686,0,1,0,0,1
716162173,0,1,0,0,1
716243750,0,1,0,0,1
716254481,0,1,0,0,1
716539813,0,1,0,0,1
713826285,0,0,1,0,1
713681642,0,1,0,0,1
713382576,0,1,0,0,1
712079881,0,1,0,0,1
711199724,1,0,0,0,1
711200361,0,1,0,0,1
711242860,0,1,0,0,1
711255251,0,1,0,0,1
711292177,0,1,0,0,1
711303466,0,1,0,0,1
711630415,0,1,0,0,1
711678644,0,0,1,0,1
711850907,0,1,0,0,1
711905926,0,1,0,0,1
712232700,0,1,0,0,1
713343616,1,0,0,0,1
712264496,0,1,0,0,1
712394371,0,1,0,0,1
712427071,0,1,0,0,1
712456961,0,1,0,0,1
712492600,0,1,0,0,1
712495352,0,0,0,1,1
712512923,1,0,0,0,1
712737599,0,1,0,0,1
712786099,0,1,0,0,1
712862954,0,1,0,0,1
716613128,0,1,0,0,1
716692848,1,0,0,0,1
722331349,0,1,0,0,1
716725224,0,1,0,0,1
719702067,0,0,0,1,1
719811660,0,1,0,0,1
719815841,0,1,0,0,1
719868644,0,1,0,0,1
719945389,0,1,0,0,1
720193795,1,0,0,0,1
720314522,1,0,0,0,1
720343272,0,1,0,0,1
720704596,0,0,1,0,1
720852348,0,1,0,0,1
720857191,0,1,0,0,1
720861203,0,1,0,0,1
721014115,0,1,0,0,1
721309626,0,1,0,0,1
721387166,0,1,0,0,1
721445478,0,1,0,0,1
721496914,0,1,0,0,1
721640827,1,0,0,0,1
721746344,0,1,0,0,1
721793118,0,1,0,0,1
721831098,0,1,0,0,1
722073619,0,0,0,1,1
722094931,0,1,0,0,1
719683460,0,1,0,0,1
719665058,1,0,0,0,1
719660543,0,1,0,0,1
718084377,0,1,0,0,1
716733902,0,1,0,0,1
716807684,0,1,0,0,1
716946325,0,1,0,0,1
716980092,0,1,0,0,1
717317735,0,1,0,0,1
717431058,0,1,0,0,1
717437701,0,1,0,0,1
717877136,0,0,0,1,1
717924049,0,1,0,0,1
718068708,0,1,0,0,1
718143988,1,0,0,0,1
719651329,0,1,0,0,1
718487389,1,0,0,0,1
718650055,0,1,0,0,1
718654323,0,1,0,0,1
718661946,0,1,0,0,1
718924667,1,0,0,0,1
719057672,1,0,0,0,1
719064493,0,1,0,0,1
719142420,1,0,0,0,1
719260982,0,1,0,0,1
719636402,1,0,0,0,1
627223449,0,1,0,0,1
626965015,0,1,0,0,1
591913947,0,1,0,0,1
602031846,0,1,0,0,1
602289609,0,1,0,0,1
602317364,0,1,0,0,1
602518458,0,1,0,0,1
602558577,0,1,0,0,1
602573261,0,1,0,0,1
602580374,0,1,0,0,1
602638322,0,1,0,0,1
602690302,0,1,0,0,1
602805922,0,1,0,0,1
602815926,0,1,0,0,1
602938576,0,1,0,0,1
603116709,0,1,0,0,1
603224654,0,1,0,0,1
603512358,0,1,0,0,1
603631983,0,1,0,0,1
603664709,0,1,0,0,1
603745486,0,1,0,0,1
603858865,0,1,0,0,1
603873160,0,1,0,0,1
603877175,0,1,0,0,1
603888854,1,0,0,0,1
603893066,0,1,0,0,1
603928154,0,1,0,0,1
602116636,0,1,0,0,1
602031213,0,1,0,0,1
608800103,0,1,0,0,1
601894148,0,1,0,0,1
600065787,1,0,0,0,1
600266635,1,0,0,0,1
600289838,0,0,0,1,1
600614309,0,1,0,0,1
600657225,0,1,0,0,1
600776477,0,1,0,0,1
600781198,0,1,0,0,1
600897225,1,0,0,0,1
600959741,1,0,0,0,1
600984167,1,0,0,0,1
601060552,0,0,0,1,1
601119662,0,1,0,0,1
601130861,0,1,0,0,1
601193849,1,0,0,0,1
601216726,1,0,0,0,1
601247324,0,1,0,0,1
601248152,0,1,0,0,1
601510359,0,1,0,0,1
601590443,0,1,0,0,1
601671806,0,1,0,0,1
601714811,0,1,0,0,1
601799419,0,1,0,0,1
601804580,0,1,0,0,1
604367894,0,1,0,0,1
604407155,0,1,0,0,1
604436095,0,1,0,0,1
604463436,1,0,0,0,1
606377641,0,1,0,0,1
606469411,0,1,0,0,1
606473439,0,1,0,0,1
606484117,0,1,0,0,1
606519251,0,1,0,0,1
606647627,1,0,0,0,1
606768482,0,1,0,0,1
606955960,1,0,0,0,1
607149622,0,1,0,0,1
607301612,0,1,0,0,1
607337256,1,0,0,0,1
607414714,0,1,0,0,1
607517520,0,1,0,0,1
607668957,0,1,0,0,1
607873890,0,1,0,0,1
607973885,0,1,0,0,1
607985392,1,0,0,0,1
608098515,0,1,0,0,1
608214857,0,1,0,0,1
608373248,1,0,0,0,1
608421051,0,1,0,0,1
608494458,0,1,0,0,1
608551069,1,0,0,0,1
606361444,0,1,0,0,1
606350126,0,1,0,0,1
606335211,0,1,0,0,1
605070217,0,1,0,0,1
604623068,0,1,0,0,1
604675626,0,1,0,0,1
604686694,0,1,0,0,1
604698233,1,0,0,0,1
604766924,0,1,0,0,1
604791286,0,1,0,0,1
604867784,0,1,0,0,1
604911418,0,1,0,0,1
604922812,0,1,0,0,1
604968039,0,1,0,0,1
605295892,1,0,0,0,1
606307597,0,1,0,0,1
605323403,0,1,0,0,1
605766989,0,1,0,0,1
605842701,0,1,0,0,1
605973980,0,1,0,0,1
606104651,0,1,0,0,1
606162308,0,1,0,0,1
606167462,0,1,0,0,1
606226991,0,1,0,0,1
606276598,0,1,0,0,1
606285257,0,1,0,0,1
599932917,0,1,0,0,1
599897972,0,0,0,1,1
599896924,0,1,0,0,1
595477532,1,0,0,0,1
594016777,1,0,0,0,1
594093483,0,1,0,0,1
594101182,0,1,0,0,1
594281419,0,1,0,0,1
594461572,0,1,0,0,1
594505704,0,1,0,0,1
594513525,0,1,0,0,1
594525068,0,1,0,0,1
594546381,1,0,0,0,1
594558493,0,1,0,0,1
594775811,0,1,0,0,1
594779501,0,1,0,0,1
594860490,0,1,0,0,1
594863511,0,1,0,0,1
594892676,0,1,0,0,1
594927125,1,0,0,0,1
594954501,0,1,0,0,1
595054296,0,1,0,0,1
595136471,0,1,0,0,1
595306976,0,1,0,0,1
595367988,0,1,0,0,1
595391425,0,0,1,0,1
595443596,0,0,1,0,1
593919574,0,1,0,0,1
593775931,0,1,0,0,1
593594458,0,1,0,0,1
592553383,0,1,0,0,1
591922711,0,1,0,0,1
591924233,0,1,0,0,1
592152178,1,0,0,0,1
592205075,0,1,0,0,1
592245548,0,1,0,0,1
592329657,0,1,0,0,1
592403411,0,0,0,1,1
592434680,0,1,0,0,1
592531793,0,1,0,0,1
592549390,0,1,0,0,1
592554063,0,1,0,0,1
593584299,0,1,0,0,1
592714538,0,1,0,0,1
592935171,0,1,0,0,1
593085579,0,1,0,0,1
593239960,1,0,0,0,1
593453528,0,1,0,0,1
593482850,0,1,0,0,1
593494162,0,1,0,0,1
593519597,0,1,0,0,1
593523410,0,1,0,0,1
593558045,0,1,0,0,1
595461840,0,1,0,0,1
595519994,0,1,0,0,1
599770738,0,0,1,0,1
595613592,0,1,0,0,1
597779999,0,1,0,0,1
597804703,0,1,0,0,1
597892323,0,1,0,0,1
598125560,0,1,0,0,1
598126527,0,1,0,0,1
598201579,0,1,0,0,1
598340883,0,1,0,0,1
598430480,0,1,0,0,1
598497180,0,1,0,0,1
598497778,0,1,0,0,1
598502313,0,1,0,0,1
598521547,0,1,0,0,1
598610127,0,1,0,0,1
598663633,0,1,0,0,1
598892920,0,1,0,0,1
599017625,0,1,0,0,1
599073876,0,1,0,0,1
599139803,0,1,0,0,1
599203457,0,1,0,0,1
599299403,0,1,0,0,1
599385605,0,0,1,0,1
599501491,1,0,0,0,1
599637755,1,0,0,0,1
597779527,0,1,0,0,1
597640393,0,1,0,0,1
597566730,0,1,0,0,1
596783721,0,1,0,0,1
595639875,1,0,0,0,1
595642137,0,1,0,0,1
595659032,0,1,0,0,1
595770145,0,1,0,0,1
595923076,0,1,0,0,1
596204727,0,1,0,0,1
596296371,0,1,0,0,1
596365854,0,1,0,0,1
596450900,0,1,0,0,1
596612517,0,1,0,0,1
596804982,0,1,0,0,1
597564319,0,1,0,0,1
596845822,0,1,0,0,1
596870560,0,1,0,0,1
597065837,0,1,0,0,1
597129892,1,0,0,0,1
597296257,0,1,0,0,1
597369468,0,1,0,0,1
597415278,1,0,0,0,1
597468907,0,1,0,0,1
597508821,0,1,0,0,1
597545163,0,1,0,0,1
608553330,0,1,0,0,1
608820688,1,0,0,0,1
626944864,0,1,0,0,1
619575970,0,1,0,0,1
619754659,0,0,0,1,1
619787900,0,1,0,0,1
619837206,0,1,0,0,1
619954619,0,1,0,0,1
619959481,0,1,0,0,1
620089214,1,0,0,0,1
620224683,0,1,0,0,1
620261355,0,0,0,1,1
620272967,0,1,0,0,1
620275290,1,0,0,0,1
620539110,0,0,0,1,1
620685663,0,1,0,0,1
620697837,1,0,0,0,1
620702473,0,1,0,0,1
620980359,0,1,0,0,1
621008243,0,1,0,0,1
621113677,0,1,0,0,1
621128071,1,0,0,0,1
621142462,0,1,0,0,1
621158709,1,0,0,0,1
621270725,0,1,0,0,1
621310298,0,1,0,0,1
621431582,0,1,0,0,1
619601985,0,1,0,0,1
619555256,0,1,0,0,1
609041793,0,1,0,0,1
619400667,0,1,0,0,1
617844362,0,1,0,0,1
617873513,0,1,0,0,1
617944083,0,1,0,0,1
617986316,0,1,0,0,1
618051042,0,1,0,0,1
618057572,0,1,0,0,1
618075834,0,1,0,0,1
618097319,0,1,0,0,1
618337988,0,1,0,0,1
618352196,0,1,0,0,1
618437855,0,1,0,0,1
618492260,0,1,0,0,1
618552128,0,1,0,0,1
618560966,0,1,0,0,1
618755584,0,1,0,0,1
618871028,0,1,0,0,1
618934824,0,0,1,0,1
619010112,0,1,0,0,1
619077346,0,1,0,0,1
619148852,0,1,0,0,1
619214761,0,1,0,0,1
619240765,1,0,0,0,1
619305865,1,0,0,0,1
621648624,0,1,0,0,1
621734911,0,1,0,0,1
621788908,0,1,0,0,1
621805061,0,1,0,0,1
623982127,0,1,0,0,1
624000077,0,1,0,0,1
624470222,0,1,0,0,1
624566798,0,1,0,0,1
624596099,0,1,0,0,1
624810281,1,0,0,0,1
624847870,0,1,0,0,1
624961735,1,0,0,0,1
625320125,1,0,0,0,1
625321555,1,0,0,0,1
625367296,0,1,0,0,1
625446171,0,1,0,0,1
625499699,0,1,0,0,1
625540290,0,1,0,0,1
625584499,1,0,0,0,1
625752429,0,1,0,0,1
625821376,1,0,0,0,1
626039658,0,1,0,0,1
626288465,0,1,0,0,1
626324127,0,1,0,0,1
626421984,0,0,1,0,1
626484872,0,1,0,0,1
626813570,1,0,0,0,1
623976450,0,1,0,0,1
623828495,0,1,0,0,1
623802588,1,0,0,0,1
622831665,0,1,0,0,1
621839839,0,1,0,0,1
621879377,1,0,0,0,1
621931666,0,1,0,0,1
621934855,0,1,0,0,1
622195290,0,1,0,0,1
622244035,0,1,0,0,1
622375134,0,1,0,0,1
622603263,0,1,0,0,1
622633138,0,1,0,0,1
622775250,0,1,0,0,1
622871181,0,1,0,0,1
623794918,0,1,0,0,1
622912118,0,1,0,0,1
622916392,0,1,0,0,1
622946523,0,1,0,0,1
623207228,0,1,0,0,1
623478324,0,1,0,0,1
623491298,1,0,0,0,1
623532293,0,1,0,0,1
623557211,0,1,0,0,1
623643684,0,1,0,0,1
623707402,0,1,0,0,1
617748491,0,1,0,0,1
617730374,0,1,0,0,1
617545415,0,1,0,0,1
612779170,0,1,0,0,1
611014331,0,1,0,0,1
611067713,0,1,0,0,1
611106491,0,1,0,0,1
611195589,0,1,0,0,1
611260742,0,1,0,0,1
611282671,0,1,0,0,1
611475196,0,1,0,0,1
611504738,0,1,0,0,1
611506533,0,1,0,0,1
611571873,0,1,0,0,1
611588384,0,0,0,1,1
611652553,0,1,0,0,1
611657624,1,0,0,0,1
611761772,0,1,0,0,1
611764949,1,0,0,0,1
611786696,0,1,0,0,1
611987945,1,0,0,0,1
612274436,0,1,0,0,1
612286393,0,1,0,0,1
612378644,0,1,0,0,1
612411163,0,1,0,0,1
612517617,0,1,0,0,1
612738796,0,1,0,0,1
610951694,0,1,0,0,1
610766977,1,0,0,0,1
610637353,0,1,0,0,1
609727999,0,1,0,0,1
609044656,0,1,0,0,1
609085954,0,1,0,0,1
609108989,0,1,0,0,1
609128032,0,1,0,0,1
609331768,0,0,1,0,1
609366255,0,0,0,1,1
609494129,0,1,0,0,1
609616577,0,1,0,0,1
609617589,0,1,0,0,1
609639651,0,1,0,0,1
609740591,1,0,0,0,1
610627641,1,0,0,0,1
609878310,0,1,0,0,1
609892822,0,1,0,0,1
609951405,1,0,0,0,1
609956013,0,1,0,0,1
610004399,0,1,0,0,1
610171435,1,0,0,0,1
610199265,0,1,0,0,1
610213533,0,1,0,0,1
610380548,0,1,0,0,1
610450595,0,1,0,0,1
612745122,1,0,0,0,1
612785170,0,1,0,0,1
617369496,0,1,0,0,1
612793180,0,1,0,0,1
614965741,0,1,0,0,1
614997109,1,0,0,0,1
615025901,0,1,0,0,1
615026476,0,1,0,0,1
615050889,0,1,0,0,1
615052781,0,1,0,0,1
615155800,0,1,0,0,1
615167420,0,1,0,0,1
615182049,0,1,0,0,1
615203449,0,1,0,0,1
615207654,0,1,0,0,1
615325869,0,1,0,0,1
615582403,0,1,0,0,1
615869763,0,1,0,0,1
615940327,0,1,0,0,1
616251371,0,1,0,0,1
616545109,1,0,0,0,1
616842790,0,1,0,0,1
617041947,0,1,0,0,1
617084138,0,1,0,0,1
617196939,0,1,0,0,1
617295004,0,1,0,0,1
617341557,0,1,0,0,1
614906013,1,0,0,0,1
614606691,0,1,0,0,1
614554365,0,0,0,1,1
613485096,1,0,0,0,1
612799653,0,1,0,0,1
612872622,0,1,0,0,1
612900442,0,1,0,0,1
613049995,0,1,0,0,1
613242008,0,1,0,0,1
613283394,0,1,0,0,1
613298455,0,1,0,0,1
613364372,0,1,0,0,1
613400228,0,0,0,1,1
613447552,0,1,0,0,1
613527532,0,1,0,0,1
614513644,1,0,0,0,1
613564582,0,1,0,0,1
613599600,0,1,0,0,1
613748055,0,1,0,0,1
613759287,1,0,0,0,1
613884613,0,1,0,0,1
613923103,0,1,0,0,1
614153867,0,1,0,0,1
614295832,0,1,0,0,1
614308426,0,1,0,0,1
614360122,0,1,0,0,1
1065254220,0,1,0,0,1
1065679819,0,1,0,0,1
1065766993,0,1,0,0,1
1647083792,1,0,0,0,1
1647142285,1,0,0,0,1
1647205621,0,1,0,0,1
1647643891,0,1,0,0,1
1647972266,0,1,0,0,1
1648016160,0,1,0,0,1
1648688898,0,1,0,0,1
1648887180,0,1,0,0,1
1649358816,0,1,0,0,1
1649602663,1,0,0,0,1
1650130532,0,1,0,0,1
1650559856,1,0,0,0,1
1650717158,0,1,0,0,1
1650799334,0,1,0,0,1
1650821773,0,1,0,0,1
1650826153,0,1,0,0,1
1650953730,0,1,0,0,1
1651976640,0,1,0,0,1
1652676248,0,1,0,0,1
1652858042,0,1,0,0,1
1652939330,0,1,0,0,1
1653124981,0,1,0,0,1
1653321715,0,1,0,0,1
1653384732,1,0,0,0,1
1647136056,0,1,0,0,1
1646937924,0,1,0,0,1
1642090826,1,0,0,0,1
1646270113,0,1,0,0,1
1642242938,0,1,0,0,1
1642278781,0,1,0,0,1
1642325580,0,1,0,0,1
1642386913,0,1,0,0,1
1642573382,0,1,0,0,1
1643206386,0,1,0,0,1
1643256834,1,0,0,0,1
1643438737,1,0,0,0,1
1643580474,0,1,0,0,1
1643594708,1,0,0,0,1
1643705004,0,1,0,0,1
1644056335,0,1,0,0,1
1644099667,1,0,0,0,1
1644407810,1,0,0,0,1
1644740664,0,1,0,0,1
1644834974,0,1,0,0,1
1644938988,0,1,0,0,1
1645345628,0,1,0,0,1
1645628082,0,1,0,0,1
1645736761,0,1,0,0,1
1645923259,0,1,0,0,1
1646033893,0,1,0,0,1
1646196895,0,1,0,0,1
1653550694,0,1,0,0,1
1653932815,0,1,0,0,1
1653949766,0,1,0,0,1
1654434738,0,0,0,1,1
1661617819,0,1,0,0,1
1662309895,0,1,0,0,1
1662343740,0,1,0,0,1
1662602407,1,0,0,0,1
1662712406,0,1,0,0,1
1663608926,1,0,0,0,1
1663683674,0,0,1,0,1
1664113290,0,1,0,0,1
1664127086,0,1,0,0,1
1664160414,0,1,0,0,1
1664421678,0,1,0,0,1
1664440664,0,1,0,0,1
1664573136,1,0,0,0,1
1664769944,0,1,0,0,1
1665050185,0,1,0,0,1
1665170575,0,0,0,1,1
1665209994,0,1,0,0,1
1665506934,0,1,0,0,1
1665542239,0,1,0,0,1
1665769639,0,1,0,0,1
1665967099,0,1,0,0,1
1666005996,1,0,0,0,1
1666147634,0,1,0,0,1
1661263351,0,1,0,0,1
1660880041,0,1,0,0,1
1660616748,1,0,0,0,1
1657652712,0,1,0,0,1
1654840484,1,0,0,0,1
1654877713,0,1,0,0,1
1654985454,1,0,0,0,1
1655031944,0,1,0,0,1
1655410519,0,1,0,0,1
1655516684,0,1,0,0,1
1656185875,0,1,0,0,1
1656922482,1,0,0,0,1
1657382814,0,1,0,0,1
1657531790,0,1,0,0,1
1658319402,0,1,0,0,1
1660550330,0,0,0,1,1
1658894466,0,1,0,0,1
1659157460,0,1,0,0,1
1659237757,0,1,0,0,1
1659430501,0,1,0,0,1
1659876937,0,1,0,0,1
1660038486,0,0,1,0,1
1660132310,0,1,0,0,1
1660185817,0,1,0,0,1
1660257805,0,1,0,0,1
1660501177,1,0,0,0,1
1642213478,0,1,0,0,1
1641077174,0,1,0,0,1
1066002818,0,0,0,1,1
1621253101,0,1,0,0,1
1621531590,0,1,0,0,1
1622031390,0,1,0,0,1
1622044567,0,1,0,0,1
1622193048,0,1,0,0,1
1622361907,0,1,0,0,1
1622815536,0,1,0,0,1
1622963779,0,1,0,0,1
1622985972,0,1,0,0,1
1623563683,0,1,0,0,1
1623591414,0,1,0,0,1
1623849360,0,1,0,0,1
1623891938,0,1,0,0,1
1624164661,0,1,0,0,1
1624369236,0,1,0,0,1
1624579272,0,1,0,0,1
1624962606,0,1,0,0,1
1624973826,1,0,0,0,1
1625021587,0,0,1,0,1
1625212680,0,0,0,1,1
1625446124,0,1,0,0,1
1626132768,0,1,0,0,1
1626278808,0,1,0,0,1
1626337080,0,1,0,0,1
1621275925,1,0,0,0,1
1620808526,0,1,0,0,1
1640801712,0,1,0,0,1
1620679315,0,0,1,0,1
1615566440,0,1,0,0,1
1615588316,0,1,0,0,1
1615658203,0,1,0,0,1
1615659636,0,1,0,0,1
1616042580,0,1,0,0,1
1616170687,0,1,0,0,1
1616388398,0,1,0,0,1
1616577680,1,0,0,0,1
1617243858,0,1,0,0,1
1617261140,0,1,0,0,1
1617350850,0,1,0,0,1
1617394340,0,1,0,0,1
1617948710,1,0,0,0,1
1618008601,0,1,0,0,1
1618562851,0,1,0,0,1
1618728666,0,1,0,0,1
1619153983,0,1,0,0,1
1619271554,0,1,0,0,1
1619899680,0,1,0,0,1
1620014078,0,1,0,0,1
1620056029,0,1,0,0,1
1620086120,0,1,0,0,1
1620649946,0,1,0,0,1
1626366475,0,1,0,0,1
1626715818,0,1,0,0,1
1626913963,1,0,0,0,1
1627042213,0,0,0,1,1
1635191695,0,0,1,0,1
1635371048,0,1,0,0,1
1635493291,0,0,0,1,1
1635753799,0,1,0,0,1
1635890220,0,1,0,0,1
1635991099,0,0,0,1,1
1636024706,0,0,0,1,1
1636107444,0,1,0,0,1
1636141934,0,1,0,0,1
1636158037,0,0,1,0,1
1636303328,0,1,0,0,1
1636468213,0,1,0,0,1
1636642578,0,1,0,0,1
1636695344,0,1,0,0,1
1637599134,1,0,0,0,1
1637765786,0,1,0,0,1
1637778870,0,1,0,0,1
1638015104,1,0,0,0,1
1638534499,0,1,0,0,1
1638548106,0,1,0,0,1
1638808086,0,1,0,0,1
1638942680,0,1,0,0,1
1639723614,1,0,0,0,1
1635043586,1,0,0,0,1
1634989388,1,0,0,0,1
1634898241,0,1,0,0,1
1630938523,0,1,0,0,1
1627051926,0,0,0,1,1
1627692716,0,1,0,0,1
1627991365,0,1,0,0,1
1628248555,0,1,0,0,1
1628623087,0,1,0,0,1
1628962530,0,0,0,1,1
1630118743,1,0,0,0,1
1630361401,0,1,0,0,1
1630877768,0,0,0,1,1
1630918242,0,1,0,0,1
1631212201,0,1,0,0,1
1634708030,1,0,0,0,1
1631295846,0,1,0,0,1
1631957832,0,1,0,0,1
1632448464,0,1,0,0,1
1632725839,0,1,0,0,1
1632917286,0,1,0,0,1
1633043084,0,1,0,0,1
1633292748,0,1,0,0,1
1633866794,0,1,0,0,1
1634421834,0,1,0,0,1
1634517212,0,1,0,0,1
1666218984,0,1,0,0,1
1666246904,0,1,0,0,1
1666748827,0,1,0,0,1
1697121157,0,1,0,0,1
1697200428,0,0,0,1,1
1698210595,0,1,0,0,1
1698228182,0,1,0,0,1
1698436202,1,0,0,0,1
1698529764,0,1,0,0,1
1698557347,0,1,0,0,1
1698616862,0,1,0,0,1
1699010030,0,1,0,0,1
1699728120,0,1,0,0,1
1699749834,1,0,0,0,1
1699763556,0,1,0,0,1
1699829078,0,1,0,0,1
1700172362,0,1,0,0,1
1700438527,0,1,0,0,1
1701411344,0,1,0,0,1
1701748046,0,1,0,0,1
1701760970,0,1,0,0,1
1701922598,0,1,0,0,1
1702031540,1,0,0,0,1
1702367521,0,1,0,0,1
1702674890,0,1,0,0,1
1702714764,0,1,0,0,1
1703389129,0,1,0,0,1
1697198498,0,1,0,0,1
1697090480,0,1,0,0,1
1666975321,0,1,0,0,1
1696779518,0,1,0,0,1
1691672857,1,0,0,0,1
1691964702,0,1,0,0,1
1691969384,0,1,0,0,1
1692104532,0,1,0,0,1
1692637692,0,1,0,0,1
1692807216,0,1,0,0,1
1693091348,1,0,0,0,1
1693169448,0,1,0,0,1
1693194908,0,1,0,0,1
1693276244,0,1,0,0,1
1693451522,0,1,0,0,1
1693678692,0,1,0,0,1
1693718630,0,0,0,1,1
1693863222,0,1,0,0,1
1693965810,0,1,0,0,1
1694606706,0,1,0,0,1
1694956722,0,1,0,0,1
1695031778,0,1,0,0,1
1695147684,0,1,0,0,1
1696035906,0,1,0,0,1
1696338426,0,0,1,0,1
1696359391,0,1,0,0,1
1696513860,1,0,0,0,1
1703957953,0,1,0,0,1
1703988967,0,0,1,0,1
1704241718,0,1,0,0,1
1704245820,1,0,0,0,1
1712044640,0,1,0,0,1
1712216286,0,1,0,0,1
1712237796,0,1,0,0,1
1712291444,0,1,0,0,1
1712538486,0,1,0,0,1
1712557380,1,0,0,0,1
1712604876,0,1,0,0,1
1712838744,0,1,0,0,1
1713027091,0,1,0,0,1
1713128834,0,1,0,0,1
1713211230,0,1,0,0,1
1713370178,0,1,0,0,1
1713942932,0,1,0,0,1
1714291674,0,1,0,0,1
1714292588,0,0,0,1,1
1714417207,0,1,0,0,1
1714912333,1,0,0,0,1
1715224591,0,1,0,0,1
1715431321,0,1,0,0,1
1715535350,0,1,0,0,1
1716252817,0,1,0,0,1
1716521730,0,1,0,0,1
1717401476,0,1,0,0,1
1711664316,0,1,0,0,1
1711562005,0,1,0,0,1
1711082726,0,1,0,0,1
1707341370,0,1,0,0,1
1704477331,1,0,0,0,1
1704812924,0,1,0,0,1
1704831494,0,1,0,0,1
1704966672,0,0,0,1,1
1704978620,0,1,0,0,1
1705707926,0,1,0,0,1
1706011321,0,1,0,0,1
1706178336,0,1,0,0,1
1706391962,0,1,0,0,1
1707208465,0,1,0,0,1
1708438885,0,1,0,0,1
1711035793,0,1,0,0,1
1708779961,0,1,0,0,1
1708853100,0,1,0,0,1
1709875334,0,1,0,0,1
1710461845,0,1,0,0,1
1710585392,0,1,0,0,1
1710630307,0,1,0,0,1
1710667428,1,0,0,0,1
1710939770,0,1,0,0,1
1710949411,0,1,0,0,1
1711015693,0,1,0,0,1
1691568890,0,1,0,0,1
1691242688,1,0,0,0,1
1691154637,0,1,0,0,1
1678346678,0,1,0,0,1
1673754914,0,0,0,1,1
1673890501,0,1,0,0,1
1673905956,0,1,0,0,1
1673991457,1,0,0,0,1
1674065839,0,1,0,0,1
1674106142,1,0,0,0,1
1674130580,0,1,0,0,1
1674260150,0,1,0,0,1
1674817838,0,1,0,0,1
1674843294,0,1,0,0,1
1675103126,0,1,0,0,1
1675215032,0,1,0,0,1
1675326608,1,0,0,0,1
1675391984,0,1,0,0,1
1675494104,0,1,0,0,1
1675809302,0,1,0,0,1
1675811360,0,1,0,0,1
1676045185,0,1,0,0,1
1676221394,0,1,0,0,1
1676390862,0,1,0,0,1
1676392549,0,0,1,0,1
1676992117,0,1,0,0,1
1677055064,0,1,0,0,1
1673294036,0,1,0,0,1
1672848248,0,1,0,0,1
1672847378,0,1,0,0,1
1670498198,0,1,0,0,1
1667517908,0,1,0,0,1
1668062246,0,1,0,0,1
1668211597,0,1,0,0,1
1668320707,0,1,0,0,1
1668560696,0,1,0,0,1
1668619556,0,1,0,0,1
1668877944,0,1,0,0,1
1668897782,0,1,0,0,1
1669085016,0,1,0,0,1
1669981711,1,0,0,0,1
1670526294,0,1,0,0,1
1672815134,0,1,0,0,1
1670939658,1,0,0,0,1
1671432690,0,1,0,0,1
1671622903,0,1,0,0,1
1671833852,0,1,0,0,1
1671842348,0,1,0,0,1
1672032343,1,0,0,0,1
1672408580,0,1,0,0,1
1672507412,0,1,0,0,1
1672596146,0,1,0,0,1
1672607396,0,1,0,0,1
1677468709,0,1,0,0,1
1678373053,0,1,0,0,1
1691123227,0,0,0,1,1
1678512426,0,1,0,0,1
1685202338,0,1,0,0,1
1685223565,0,1,0,0,1
1686173796,0,1,0,0,1
1686257755,0,1,0,0,1
1686292909,0,1,0,0,1
1686433196,0,1,0,0,1
1686607044,0,1,0,0,1
1687031636,0,1,0,0,1
1687072459,0,1,0,0,1
1687242566,0,1,0,0,1
1687549568,1,0,0,0,1
1687919762,0,1,0,0,1
1688252990,0,1,0,0,1
1688313308,1,0,0,0,1
1688455518,0,1,0,0,1
1689450175,0,1,0,0,1
1690187262,0,0,1,0,1
1690242630,0,1,0,0,1
1690464440,0,1,0,0,1
1690885716,0,1,0,0,1
1690918152,0,1,0,0,1
1691010642,0,1,0,0,1
1691033425,0,1,0,0,1
1684979804,0,0,0,1,1
1684901689,0,0,1,0,1
1684223108,0,1,0,0,1
1680834001,0,1,0,0,1
1678703299,0,1,0,0,1
1678971818,1,0,0,0,1
1679299951,0,1,0,0,1
1679857555,0,1,0,0,1
1680044112,0,1,0,0,1
1680185246,1,0,0,0,1
1680252266,0,1,0,0,1
1680408978,1,0,0,0,1
1680420019,0,1,0,0,1
1680452228,1,0,0,0,1
1681145256,0,1,0,0,1
1684116638,0,1,0,0,1
1681688977,0,1,0,0,1
1681703244,0,1,0,0,1
1681834466,0,1,0,0,1
1682203544,0,1,0,0,1
1682455968,1,0,0,0,1
1682920345,0,0,1,0,1
1683347624,1,0,0,0,1
1683348644,0,1,0,0,1
1683412946,0,1,0,0,1
1683831492,1,0,0,0,1
1615109196,1,0,0,0,1
1615070864,1,0,0,0,1
1614977558,0,1,0,0,1
1537995715,0,1,0,0,1
1538164530,0,0,1,0,1
1538200279,0,1,0,0,1
1538439546,0,1,0,0,1
1538797951,0,1,0,0,1
1539047064,1,0,0,0,1
1539126187,0,0,1,0,1
1539487184,1,0,0,0,1
1539551995,0,1,0,0,1
1539784010,0,1,0,0,1
1539795146,0,1,0,0,1
1540490474,0,1,0,0,1
1540643832,1,0,0,0,1
1540887901,0,1,0,0,1
1540904623,0,1,0,0,1
1541326603,0,1,0,0,1
1541441893,0,1,0,0,1
1541520283,0,1,0,0,1
1541791662,0,1,0,0,1
1541836838,0,1,0,0,1
1542328532,0,1,0,0,1
1542528007,0,1,0,0,1
1542817993,1,0,0,0,1
1542836676,0,1,0,0,1
1538035844,0,1,0,0,1
1537950806,0,1,0,0,1
1560874903,0,1,0,0,1
1537122702,0,1,0,0,1
1529131694,0,1,0,0,1
1529914015,0,1,0,0,1
1530285092,0,1,0,0,1
1530892800,0,1,0,0,1
1531161175,0,1,0,0,1
1531269685,0,1,0,0,1
1531527319,0,1,0,0,1
1531742743,0,1,0,0,1
1532924232,0,1,0,0,1
1533029677,0,1,0,0,1
1533041618,0,1,0,0,1
1533157088,0,1,0,0,1
1533771486,0,1,0,0,1
1533815090,0,1,0,0,1
1534189340,0,1,0,0,1
1534475402,0,1,0,0,1
1534577497,0,1,0,0,1
1535362200,0,1,0,0,1
1535829438,0,1,0,0,1
1535915922,0,1,0,0,1
1535929292,1,0,0,0,1
1536201007,0,1,0,0,1
1537017108,0,1,0,0,1
1543379946,0,0,0,1,1
1543599721,0,1,0,0,1
1543698246,0,1,0,0,1
1544037146,0,1,0,0,1
1551156355,0,1,0,0,1
1552611596,0,1,0,0,1
1553312108,0,1,0,0,1
1553799757,0,1,0,0,1
1553804294,0,1,0,0,1
1554295514,0,1,0,0,1
1555338176,1,0,0,0,1
1555389396,0,1,0,0,1
1555522675,0,1,0,0,1
1555579063,0,1,0,0,1
1556032986,0,0,0,1,1
1556298348,0,1,0,0,1
1556797915,0,1,0,0,1
1557227712,0,1,0,0,1
1557336344,0,1,0,0,1
1557557558,0,1,0,0,1
1558235917,0,1,0,0,1
1558666256,0,1,0,0,1
1558763401,0,1,0,0,1
1558896360,0,1,0,0,1
1559951184,0,1,0,0,1
1560039968,0,1,0,0,1
1560112038,0,1,0,0,1
1550762371,0,0,1,0,1
1549152956,0,1,0,0,1
1548730856,0,1,0,0,1
1547217667,1,0,0,0,1
1544317465,0,1,0,0,1
1545439135,1,0,0,0,1
1545565452,0,1,0,0,1
1545834288,0,1,0,0,1
1545916213,0,1,0,0,1
1546534830,0,1,0,0,1
1546622762,0,1,0,0,1
1546850478,0,1,0,0,1
1546981068,0,1,0,0,1
1547096798,0,1,0,0,1
1547412061,0,1,0,0,1
1548723343,0,1,0,0,1
1547539825,0,1,0,0,1
1547768323,0,1,0,0,1
1547922540,0,1,0,0,1
1548009158,0,1,0,0,1
1548088088,0,1,0,0,1
1548527790,0,1,0,0,1
1548544339,0,1,0,0,1
1548634279,0,1,0,0,1
1548684578,0,0,0,1,1
1548718524,0,1,0,0,1
1528892822,0,1,0,0,1
1528791530,0,1,0,0,1
1528641853,0,1,0,0,1
1512886482,0,1,0,0,1
1505985799,0,1,0,0,1
1506096884,1,0,0,0,1
1506124340,0,1,0,0,1
1506881066,0,1,0,0,1
1507295682,0,1,0,0,1
1508062920,0,1,0,0,1
1508170772,1,0,0,0,1
1508844643,0,1,0,0,1
1509854768,0,1,0,0,1
1509905275,0,1,0,0,1
1510036664,0,1,0,0,1
1510075747,1,0,0,0,1
1510459586,0,1,0,0,1
1510775808,0,1,0,0,1
1511057528,0,1,0,0,1
1511443195,0,1,0,0,1
1511474707,0,1,0,0,1
1511624532,0,1,0,0,1
1512516954,0,1,0,0,1
1512550304,0,1,0,0,1
1512641324,0,1,0,0,1
1512658074,0,1,0,0,1
1512835278,0,1,0,0,1
1505734922,0,1,0,0,1
1503230466,0,1,0,0,1
1503208117,1,0,0,0,1
1496120659,0,0,1,0,1
1494047359,0,1,0,0,1
1494221563,0,0,0,1,1
1494250278,0,0,1,0,1
1494968155,0,1,0,0,1
1495064965,0,1,0,0,1
1495445474,0,1,0,0,1
1495856886,1,0,0,0,1
1495983876,0,1,0,0,1
1496016650,0,0,1,0,1
1496053394,0,1,0,0,1
1496447881,0,1,0,0,1
1502419753,0,1,0,0,1
1496747096,0,1,0,0,1
1497473310,0,1,0,0,1
1497768074,0,1,0,0,1
1498406088,0,1,0,0,1
1498951694,0,1,0,0,1
1498991760,0,1,0,0,1
1499105642,0,1,0,0,1
1500767911,0,1,0,0,1
1501102405,0,1,0,0,1
1502396052,0,1,0,0,1
1512859880,0,0,0,1,1
1513322040,0,1,0,0,1
1528540574,0,0,0,1,1
1513599774,0,1,0,0,1
1521785251,0,1,0,0,1
1522427492,1,0,0,0,1
1523089580,0,1,0,0,1
1523292632,0,1,0,0,1
1523954712,0,1,0,0,1
1524654978,0,1,0,0,1
1524770024,0,1,0,0,1
1524855306,0,1,0,0,1
1524916064,1,0,0,0,1
1525122290,0,1,0,0,1
1525428110,0,0,1,0,1
1525708334,0,0,0,1,1
1525958906,0,1,0,0,1
1526224136,0,1,0,0,1
1526312119,0,0,0,1,1
1526993832,0,1,0,0,1
1527038353,0,1,0,0,1
1527842222,0,1,0,0,1
1527882536,0,1,0,0,1
1527901298,0,1,0,0,1
1527936902,0,1,0,0,1
1528162344,1,0,0,0,1
1528318758,0,1,0,0,1
1521532242,0,0,0,1,1
1520902435,0,1,0,0,1
1520676883,0,1,0,0,1
1516975808,0,1,0,0,1
1513615428,0,1,0,0,1
1514067583,0,1,0,0,1
1514408533,0,1,0,0,1
1514942330,0,1,0,0,1
1515132523,0,1,0,0,1
1515183398,0,1,0,0,1
1515398773,0,1,0,0,1
1515633001,0,1,0,0,1
1515908755,0,1,0,0,1
1516230217,0,1,0,0,1
1517461098,0,1,0,0,1
1520617009,0,1,0,0,1
1517490222,0,1,0,0,1
1517564732,0,1,0,0,1
1517596368,0,1,0,0,1
1518634837,0,1,0,0,1
1518657476,0,1,0,0,1
1518699715,0,1,0,0,1
1518931086,0,1,0,0,1
1519020271,0,1,0,0,1
1519060524,0,1,0,0,1
1520481810,0,1,0,0,1
1560830034,0,1,0,0,1
1561209410,0,1,0,0,1
1614957020,0,1,0,0,1
1596277626,0,1,0,0,1
1596283225,1,0,0,0,1
1596429151,0,1,0,0,1
1596609805,0,1,0,0,1
1597614817,0,1,0,0,1
1598101296,1,0,0,0,1
1598341261,0,1,0,0,1
1598848597,0,1,0,0,1
1598953944,0,1,0,0,1
1599043621,0,1,0,0,1
1599410622,1,0,0,0,1
1599823135,0,1,0,0,1
1600496215,0,1,0,0,1
1600700850,0,1,0,0,1
1600760167,0,1,0,0,1
1600763252,0,1,0,0,1
1600836505,0,1,0,0,1
1601136266,1,0,0,0,1
1601444113,0,1,0,0,1
1601452902,0,1,0,0,1
1601612808,0,1,0,0,1
1602087792,0,1,0,0,1
1602258968,0,1,0,0,1
1602551749,0,1,0,0,1
1596281486,0,1,0,0,1
1595500411,0,1,0,0,1
1561281198,0,1,0,0,1
1595384629,0,0,0,1,1
1589438779,0,1,0,0,1
1589547961,0,1,0,0,1
1589618282,0,1,0,0,1
1590552853,1,0,0,0,1
1590576948,0,1,0,0,1
1591447844,0,1,0,0,1
1591509698,0,1,0,0,1
1591533002,0,1,0,0,1
1591806336,0,1,0,0,1
1591846393,0,1,0,0,1
1592169738,0,1,0,0,1
1592343696,0,1,0,0,1
1592473860,0,1,0,0,1
1592528576,0,1,0,0,1
1592642858,0,1,0,0,1
1592821554,1,0,0,0,1
1593247867,0,1,0,0,1
1594058460,1,0,0,0,1
1594119218,0,1,0,0,1
1594252466,0,1,0,0,1
1594573796,0,1,0,0,1
1595131856,0,1,0,0,1
1595242650,0,1,0,0,1
1603056470,0,1,0,0,1
1603336772,0,1,0,0,1
1603556299,0,0,1,0,1
1603658850,0,1,0,0,1
1610422321,1,0,0,0,1
1610514020,0,1,0,0,1
1611665695,0,1,0,0,1
1611673825,0,1,0,0,1
1612073035,0,1,0,0,1
1612186399,1,0,0,0,1
1612259870,0,1,0,0,1
1612469221,0,1,0,0,1
1612558759,0,1,0,0,1
1612749025,0,1,0,0,1
1612827620,0,1,0,0,1
1612840645,0,1,0,0,1
1613294574,0,1,0,0,1
1613461544,0,1,0,0,1
1613740213,0,1,0,0,1
1613855587,0,1,0,0,1
1613934576,0,1,0,0,1
1614383533,0,0,0,1,1
1614636866,0,1,0,0,1
1614706892,0,1,0,0,1
1614832014,0,1,0,0,1
1614832321,0,1,0,0,1
1614931915,0,1,0,0,1
1610366665,0,1,0,0,1
1610022133,1,0,0,0,1
1609849435,0,1,0,0,1
1605747636,0,1,0,0,1
1603728836,0,1,0,0,1
1603821325,0,1,0,0,1
1603830290,0,1,0,0,1
1604126118,0,0,1,0,1
1604178991,0,1,0,0,1
1605189974,1,0,0,0,1
1605367962,1,0,0,0,1
1605511141,0,1,0,0,1
1605618222,1,0,0,0,1
1605665665,0,1,0,0,1
1605936979,0,1,0,0,1
1609589437,0,1,0,0,1
1606221144,0,1,0,0,1
1606341734,0,1,0,0,1
1606432256,0,1,0,0,1
1607710620,0,1,0,0,1
1608260407,1,0,0,0,1
1608351140,1,0,0,0,1
1608410484,0,1,0,0,1
1608970898,0,1,0,0,1
1609038757,0,1,0,0,1
1609200787,0,1,0,0,1
1589428574,0,0,0,1,1
1589011651,0,1,0,0,1
1588855146,0,1,0,0,1
1575239936,0,1,0,0,1
1569965688,0,1,0,0,1
1570023050,0,0,1,0,1
1570206811,0,1,0,0,1
1570345465,0,1,0,0,1
1570391354,0,1,0,0,1
1570567837,0,1,0,0,1
1570667798,0,1,0,0,1
1571000826,0,1,0,0,1
1571121301,0,1,0,0,1
1571596278,0,1,0,0,1
1572053784,0,1,0,0,1
1572376388,0,1,0,0,1
1572506958,0,1,0,0,1
1572913556,0,1,0,0,1
1572961609,0,1,0,0,1
1573113787,0,1,0,0,1
1573242722,1,0,0,0,1
1573629426,0,1,0,0,1
1574068921,0,1,0,0,1
1574119956,0,1,0,0,1
1574524938,0,1,0,0,1
1574782884,0,1,0,0,1
1574896046,0,1,0,0,1
1569014936,0,1,0,0,1
1568954646,0,1,0,0,1
1568559170,0,1,0,0,1
1565843598,1,0,0,0,1
1561313418,0,1,0,0,1
1562432660,0,1,0,0,1
1562697175,0,1,0,0,1
1563236820,0,1,0,0,1
1563338701,0,1,0,0,1
1563438181,0,1,0,0,1
1563867440,1,0,0,0,1
1564063284,1,0,0,0,1
1564146265,0,1,0,0,1
1565745368,1,0,0,0,1
1565963358,0,1,0,0,1
1568538643,0,1,0,0,1
1566017287,0,1,0,0,1
1566599370,0,1,0,0,1
1566929143,0,1,0,0,1
1567244304,0,1,0,0,1
1567434811,0,1,0,0,1
1567688143,0,1,0,0,1
1568064242,0,1,0,0,1
1568110362,0,1,0,0,1
1568302016,0,1,0,0,1
1568422482,0,1,0,0,1
1575060438,0,1,0,0,1
1575289159,0,1,0,0,1
1588742384,0,1,0,0,1
1575520705,0,1,0,0,1
1581481542,0,1,0,0,1
1581583939,0,1,0,0,1
1581705007,0,1,0,0,1
1582433472,1,0,0,0,1
1582451172,0,1,0,0,1
1582606296,1,0,0,0,1
1582909339,0,1,0,0,1
1582991599,0,1,0,0,1
1583615892,0,1,0,0,1
1583697416,0,1,0,0,1
1584518029,0,1,0,0,1
1585680985,0,1,0,0,1
1585855873,0,1,0,0,1
1586538054,0,1,0,0,1
1586752854,0,1,0,0,1
1587331902,0,1,0,0,1
1587655616,0,0,0,1,1
1587803179,0,1,0,0,1
1587991242,1,0,0,0,1
1588216500,0,1,0,0,1
1588414164,0,1,0,0,1
1588499166,0,1,0,0,1
1588675346,0,1,0,0,1
1581214567,0,1,0,0,1
1581177440,0,0,1,0,1
1581061698,0,1,0,0,1
1578389648,0,1,0,0,1
1575637328,0,1,0,0,1
1575955087,0,1,0,0,1
1577252077,0,0,0,1,1
1577581897,0,1,0,0,1
1577732400,0,1,0,0,1
1577749994,0,1,0,0,1
1578079832,0,1,0,0,1
1578169633,0,1,0,0,1
1578201072,0,1,0,0,1
1578248900,0,1,0,0,1
1578431606,1,0,0,0,1
1580797291,0,1,0,0,1
1578747504,0,1,0,0,1
1579103036,0,1,0,0,1
1579124671,1,0,0,0,1
1579208558,0,1,0,0,1
1579325977,0,1,0,0,1
1579331797,0,1,0,0,1
1579885711,0,1,0,0,1
1580253254,0,1,0,0,1
1580467478,0,1,0,0,1
1580711167,0,1,0,0,1
1718552898,0,1,0,0,1
1719022614,0,1,0,0,1
1719525565,0,1,0,0,1
2169597705,0,1,0,0,1
2169779467,0,1,0,0,1
2170086312,0,1,0,0,1
2170411637,0,1,0,0,1
2170490653,1,0,0,0,1
2170644857,0,1,0,0,1
2170744899,0,1,0,0,1
2171072459,0,1,0,0,1
2171335002,0,1,0,0,1
2171347651,0,1,0,0,1
2171447099,0,1,0,0,1
2171490947,0,1,0,0,1
2171505731,0,1,0,0,1
2171868491,0,1,0,0,1
2171950106,1,0,0,0,1
2171968148,0,1,0,0,1
2172277186,0,1,0,0,1
2172363114,0,1,0,0,1
2172570053,0,1,0,0,1
2172808306,0,1,0,0,1
2172997649,0,1,0,0,1
2173312324,0,1,0,0,1
2173334991,0,1,0,0,1
2173774163,0,1,0,0,1
2169684785,1,0,0,0,1
2169197141,1,0,0,0,1
2181662950,0,1,0,0,1
2169177308,0,1,0,0,1
2165186692,0,1,0,0,1
2165289405,0,1,0,0,1
2165952774,0,1,0,0,1
2166040638,0,0,0,1,1
2166095985,0,1,0,0,1
2166379986,0,0,0,1,1
2166405601,0,1,0,0,1
2166439993,0,1,0,0,1
2166600261,0,1,0,0,1
2167176920,0,1,0,0,1
2167190048,0,1,0,0,1
2167244253,0,1,0,0,1
2167521143,0,1,0,0,1
2167585046,0,0,1,0,1
2168169273,0,1,0,0,1
2168199554,0,1,0,0,1
2168444202,0,1,0,0,1
2168524194,0,1,0,0,1
2168607242,0,1,0,0,1
2168903510,0,1,0,0,1
2168910246,0,1,0,0,1
2168919036,0,1,0,0,1
2169145110,0,1,0,0,1
2173850309,0,1,0,0,1
2173970660,0,1,0,0,1
2174151434,1,0,0,0,1
2174250113,0,1,0,0,1
2177999829,0,1,0,0,1
2178001880,0,1,0,0,1
2178056621,0,1,0,0,1
2178105772,1,0,0,0,1
2178385378,0,1,0,0,1
2178526050,0,1,0,0,1
2178782179,0,1,0,0,1
2179058990,0,1,0,0,1
2179059390,0,1,0,0,1
2179439143,0,1,0,0,1
2179934343,0,1,0,0,1
2180200297,0,0,0,1,1
2180275309,0,1,0,0,1
2180338811,0,1,0,0,1
2180400041,0,1,0,0,1
2180483648,0,1,0,0,1
2180599822,0,1,0,0,1
2180633697,0,1,0,0,1
2181039508,1,0,0,0,1
2181094165,0,1,0,0,1
2181169681,0,1,0,0,1
2181192920,0,1,0,0,1
2181569037,1,0,0,0,1
2177981596,0,1,0,0,1
2177544457,0,1,0,0,1
2177483813,0,1,0,0,1
2175709636,0,1,0,0,1
2174289568,0,1,0,0,1
2174344583,0,0,0,1,1
2174416737,0,1,0,0,1
2174512683,0,1,0,0,1
2174538350,0,1,0,0,1
2174736300,0,0,0,1,1
2174760241,0,1,0,0,1
2174833181,0,1,0,0,1
2174943474,0,1,0,0,1
2174972749,1,0,0,0,1
2175921826,0,1,0,0,1
2177407438,0,1,0,0,1
2176241076,0,1,0,0,1
2176623402,0,1,0,0,1
2176640979,0,1,0,0,1
2176644179,0,1,0,0,1
2176868219,0,1,0,0,1
2176927618,1,0,0,0,1
2176928782,0,1,0,0,1
2177101793,0,1,0,0,1
2177205915,0,0,1,0,1
2177207728,1,0,0,0,1
2164815946,0,1,0,0,1
2164666838,1,0,0,0,1
2164666200,0,1,0,0,1
2154602367,0,1,0,0,1
2150026569,0,1,0,0,1
2150058352,0,1,0,0,1
2150147466,0,1,0,0,1
2150219418,0,1,0,0,1
2151271740,1,0,0,0,1
2151535403,0,1,0,0,1
2151596598,1,0,0,0,1
2151671198,0,1,0,0,1
2151980225,0,1,0,0,1
2152062270,1,0,0,0,1
2152341969,1,0,0,0,1
2152468004,0,1,0,0,1
2152474375,0,1,0,0,1
2152651668,0,1,0,0,1
2152670962,1,0,0,0,1
2152756341,0,1,0,0,1
2152779457,0,1,0,0,1
2153127194,0,1,0,0,1
2153581848,0,1,0,0,1
2153720557,0,1,0,0,1
2153802168,0,1,0,0,1
2154229250,1,0,0,0,1
2154350295,0,1,0,0,1
2149761742,1,0,0,0,1
2149585889,0,1,0,0,1
2149337345,0,1,0,0,1
1979366352,0,0,1,0,1
1975155403,1,0,0,0,1
1975306968,0,1,0,0,1
1976482890,0,1,0,0,1
1977562393,0,1,0,0,1
1977828426,0,1,0,0,1
1977896269,0,1,0,0,1
1977942522,0,1,0,0,1
1978414392,0,1,0,0,1
1978527145,0,1,0,0,1
1978645428,0,1,0,0,1
1979529691,0,1,0,0,1
2149175756,0,1,0,0,1
2147646266,0,1,0,0,1
2147705279,0,1,0,0,1
2148477897,0,1,0,0,1
2148581297,0,1,0,0,1
2148654276,0,1,0,0,1
2148694824,0,1,0,0,1
2148745847,0,1,0,0,1
2148798947,0,1,0,0,1
2148913636,0,1,0,0,1
2149062614,0,1,0,0,1
2154553311,0,1,0,0,1
2154635570,0,1,0,0,1
2164413917,0,1,0,0,1
2154875153,0,1,0,0,1
2160000356,0,1,0,0,1
2160301600,0,1,0,0,1
2160317656,0,1,0,0,1
2160400060,0,1,0,0,1
2160560375,0,0,1,0,1
2160958380,0,1,0,0,1
2160993591,0,1,0,0,1
2161347598,0,1,0,0,1
2161490723,1,0,0,0,1
2161584964,0,1,0,0,1
2161633762,0,1,0,0,1
2161951982,0,1,0,0,1
2162038843,1,0,0,0,1
2162213673,0,1,0,0,1
2162274702,1,0,0,0,1
2162299479,0,1,0,0,1
2162304474,0,1,0,0,1
2162741449,0,1,0,0,1
2162753761,1,0,0,0,1
2163045853,1,0,0,0,1
2163338973,0,1,0,0,1
2163431157,0,1,0,0,1
2164051508,0,1,0,0,1
2159796912,1,0,0,0,1
2159745586,0,1,0,0,1
2159663998,0,1,0,0,1
2156234204,0,1,0,0,1
2154880749,0,1,0,0,1
2155019928,0,1,0,0,1
2155028668,0,1,0,0,1
2155262083,0,1,0,0,1
2155461589,0,1,0,0,1
2155683744,1,0,0,0,1
2155765939,1,0,0,0,1
2155767706,0,1,0,0,1
2155939270,1,0,0,0,1
2156165617,1,0,0,0,1
2156435049,0,1,0,0,1
2159412978,0,1,0,0,1
2156970474,0,1,0,0,1
2157197513,0,1,0,0,1
2157230764,0,1,0,0,1
2157354669,0,1,0,0,1
2157668885,0,1,0,0,1
2157878718,0,1,0,0,1
2158224878,0,1,0,0,1
2158947915,0,1,0,0,1
2159000273,0,1,0,0,1
2159009177,0,1,0,0,1
2181591357,0,1,0,0,1
2181930684,0,1,0,0,1
1974853908,1,0,0,0,1
2202697164,1,0,0,0,1
2203033898,0,1,0,0,1
2203136017,0,1,0,0,1
2203257664,0,1,0,0,1
2203536998,1,0,0,0,1
2204002132,0,1,0,0,1
2204062789,0,1,0,0,1
2204147013,0,1,0,0,1
2204215353,0,1,0,0,1
2204331292,1,0,0,0,1
2204464251,0,1,0,0,1
2204726429,0,1,0,0,1
2204783010,0,1,0,0,1
2204789802,0,1,0,0,1
2205000066,0,1,0,0,1
2205013280,0,1,0,0,1
2205165174,0,0,1,0,1
2205168327,0,1,0,0,1
2205300924,0,1,0,0,1
2205570140,0,1,0,0,1
2205770961,0,1,0,0,1
2206239687,0,1,0,0,1
2206774075,0,1,0,0,1
2206909855,0,1,0,0,1
2202737214,1,0,0,0,1
2202545454,0,1,0,0,1
2182158876,0,1,0,0,1
2202087820,0,0,1,0,1
2198897346,1,0,0,0,1
2199245769,0,0,0,1,1
2199253549,0,1,0,0,1
2199268081,0,1,0,0,1
2199310139,1,0,0,0,1
2199331841,0,1,0,0,1
2199834098,0,1,0,0,1
2200212133,1,0,0,0,1
2200258773,0,1,0,0,1
2200607930,0,1,0,0,1
2200679769,1,0,0,0,1
2200794233,0,1,0,0,1
2200913684,0,1,0,0,1
2201007539,0,1,0,0,1
2201138012,0,1,0,0,1
2201162720,0,0,0,1,1
2201263424,0,1,0,0,1
2201301072,0,1,0,0,1
2201502123,1,0,0,0,1
2201594632,0,1,0,0,1
2201723346,0,1,0,0,1
2201777058,0,1,0,0,1
2201948582,0,1,0,0,1
2206966117,0,1,0,0,1
2206972257,1,0,0,0,1
2206979320,0,1,0,0,1
2207004776,0,1,0,0,1
2212284217,0,1,0,0,1
2212483418,0,1,0,0,1
2212516919,0,1,0,0,1
2212609520,0,1,0,0,1
2212671696,0,1,0,0,1
2212777022,0,1,0,0,1
2212846125,1,0,0,0,1
2212978717,1,0,0,0,1
2213145525,1,0,0,0,1
2213206130,0,1,0,0,1
2213309410,1,0,0,0,1
2213561068,0,1,0,0,1
2213781664,0,1,0,0,1
2214343909,0,1,0,0,1
2214428256,1,0,0,0,1
2214513309,1,0,0,0,1
2214737825,1,0,0,0,1
2214764382,0,1,0,0,1
2215190573,0,1,0,0,1
2215276153,0,1,0,0,1
2215781018,0,1,0,0,1
2216039470,0,1,0,0,1
2216051760,0,1,0,0,1
2212137128,1,0,0,0,1
2212029322,1,0,0,0,1
2211817873,0,1,0,0,1
2209267794,0,1,0,0,1
2207006496,0,1,0,0,1
2207294029,0,1,0,0,1
2207395217,0,1,0,0,1
2207400312,0,1,0,0,1
2207504199,0,1,0,0,1
2208593532,0,1,0,0,1
2208802604,0,0,1,0,1
2208936109,0,1,0,0,1
2209123206,0,1,0,0,1
2209137750,0,1,0,0,1
2209343676,0,1,0,0,1
2211773146,0,1,0,0,1
2210037675,0,1,0,0,1
2210132309,0,1,0,0,1
2210182847,0,1,0,0,1
2210379285,0,1,0,0,1
2210702325,0,1,0,0,1
2210780379,0,1,0,0,1
2210975163,0,1,0,0,1
2210992551,0,1,0,0,1
2211182571,0,0,0,1,1
2211435493,0,1,0,0,1
2198886950,0,1,0,0,1
2198842652,0,1,0,0,1
2198350314,1,0,0,0,1
2189548012,0,1,0,0,1
2185934637,0,1,0,0,1
2186073999,1,0,0,0,1
2186345787,0,1,0,0,1
2186376209,0,1,0,0,1
2186471199,0,1,0,0,1
2186669063,0,1,0,0,1
2186793272,0,1,0,0,1
2187110888,1,0,0,0,1
2187206380,0,1,0,0,1
2187217968,0,1,0,0,1
2187323198,0,1,0,0,1
2187466552,0,1,0,0,1
2187882578,1,0,0,0,1
2188040201,0,1,0,0,1
2188464917,1,0,0,0,1
2188783998,0,1,0,0,1
2188860466,0,1,0,0,1
2188909855,1,0,0,0,1
2188976524,0,1,0,0,1
2189053710,0,1,0,0,1
2189167837,0,1,0,0,1
2189207619,0,1,0,0,1
2189341701,0,1,0,0,1
2185863084,1,0,0,0,1
2185811874,0,0,0,1,1
2185767689,0,1,0,0,1
2183822088,0,1,0,0,1
2182162012,0,1,0,0,1
2182353415,0,1,0,0,1
2182354297,0,1,0,0,1
2182418520,1,0,0,0,1
2182701955,0,1,0,0,1
2182787228,1,0,0,0,1
2182789263,0,1,0,0,1
2182805322,0,1,0,0,1
2183220790,1,0,0,0,1
2183593887,0,1,0,0,1
2183987058,1,0,0,0,1
2185548020,0,1,0,0,1
2184124453,0,1,0,0,1
2184298088,0,1,0,0,1
2184335215,0,1,0,0,1
2184515922,0,1,0,0,1
2184517442,0,1,0,0,1
2184671595,0,1,0,0,1
2184707824,0,1,0,0,1
2184825253,0,1,0,0,1
2184921575,0,0,0,1,1
2185205875,1,0,0,0,1
2189394718,0,1,0,0,1
2189640726,0,1,0,0,1
2198145709,0,1,0,0,1
2189749478,0,1,0,0,1
2194717111,0,1,0,0,1
2194755169,0,1,0,0,1
2194776990,0,1,0,0,1
2194788505,0,1,0,0,1
2195030496,0,1,0,0,1
2195139271,0,1,0,0,1
2195338211,0,1,0,0,1
2195430920,1,0,0,0,1
2195496378,0,1,0,0,1
2195861065,0,1,0,0,1
2195968707,0,1,0,0,1
2195979760,0,1,0,0,1
2196061389,0,0,0,1,1
2196532246,0,1,0,0,1
2196832910,0,1,0,0,1
2197139826,0,1,0,0,1
2197251935,0,1,0,0,1
2197470427,0,1,0,0,1
2197559980,0,1,0,0,1
2197646427,0,1,0,0,1
2197932118,0,1,0,0,1
2197981013,0,1,0,0,1
2197983677,1,0,0,0,1
2194638493,0,1,0,0,1
2194289959,1,0,0,0,1
2194181889,0,1,0,0,1
2192123146,0,1,0,0,1
2190214412,0,1,0,0,1
2190611671,0,1,0,0,1
2191075915,0,1,0,0,1
2191155109,0,1,0,0,1
2191327068,0,1,0,0,1
2191503344,0,1,0,0,1
2191739553,0,1,0,0,1
2191868953,0,0,1,0,1
2192074197,0,1,0,0,1
2192085587,0,1,0,0,1
2192224327,0,1,0,0,1
2194122992,1,0,0,0,1
2192470647,0,1,0,0,1
2192588190,0,1,0,0,1
2192830422,0,1,0,0,1
2192983876,0,1,0,0,1
2193028797,0,1,0,0,1
2193052833,0,1,0,0,1
2193372976,0,1,0,0,1
2193581831,0,1,0,0,1
2193850566,0,1,0,0,1
2194072428,0,1,0,0,1
1975098068,0,1,0,0,1
1974783534,0,1,0,0,1
1720268072,0,1,0,0,1
1868192916,0,0,0,1,1
1868901038,0,1,0,0,1
1869402840,0,1,0,0,1
1870170001,0,1,0,0,1
1870668072,0,1,0,0,1
1871213983,0,1,0,0,1
1871417911,1,0,0,0,1
1871424620,0,1,0,0,1
1871754139,0,1,0,0,1
1871761039,0,1,0,0,1
1871826607,1,0,0,0,1
1872213121,0,1,0,0,1
1873287252,0,1,0,0,1
1874137148,0,1,0,0,1
1874238692,1,0,0,0,1
1874398320,0,1,0,0,1
1874606072,0,1,0,0,1
1874712277,0,1,0,0,1
1874769739,0,1,0,0,1
1874896579,0,1,0,0,1
1875704040,0,1,0,0,1
1876032392,1,0,0,0,1
1876085340,0,1,0,0,1
1876101288,1,0,0,0,1
1868341814,1,0,0,0,1
1867618387,0,0,1,0,1
1897388072,0,1,0,0,1
1867509733,0,1,0,0,1
1859609058,0,1,0,0,1
1859904270,1,0,0,0,1
1859991763,0,1,0,0,1
1860095792,0,1,0,0,1
1860670092,0,1,0,0,1
1860716227,0,1,0,0,1
1860717252,0,1,0,0,1
1861340186,0,1,0,0,1
1861952875,0,1,0,0,1
1862113212,0,0,0,1,1
1862863506,0,1,0,0,1
1862925356,0,1,0,0,1
1863535916,0,1,0,0,1
1863555169,0,1,0,0,1
1863844626,0,1,0,0,1
1864056720,0,1,0,0,1
1864613910,0,1,0,0,1
1864683618,0,1,0,0,1
1865510774,0,1,0,0,1
1866216182,0,1,0,0,1
1866421572,0,1,0,0,1
1866441217,1,0,0,0,1
1867167938,0,1,0,0,1
1876361738,0,1,0,0,1
1876599600,0,1,0,0,1
1876813562,0,1,0,0,1
1877959034,1,0,0,0,1
1887877867,0,1,0,0,1
1888910730,1,0,0,0,1
1888939561,0,1,0,0,1
1889009996,0,1,0,0,1
1889412146,0,0,1,0,1
1889761692,0,1,0,0,1
1890205518,0,1,0,0,1
1890715548,1,0,0,0,1
1890811410,0,1,0,0,1
1891994078,1,0,0,0,1
1892342437,1,0,0,0,1
1892541564,1,0,0,0,1
1893103014,0,1,0,0,1
1893157008,0,1,0,0,1
1893266149,0,1,0,0,1
1893653424,0,1,0,0,1
1894680912,0,1,0,0,1
1894766474,0,1,0,0,1
1894918364,0,1,0,0,1
1896039722,1,0,0,0,1
1896227568,0,1,0,0,1
1896285908,0,0,0,1,1
1896466502,0,1,0,0,1
1887255067,0,1,0,0,1
1887131718,0,1,0,0,1
1887117506,0,1,0,0,1
1880202708,0,1,0,0,1
1878083160,0,1,0,0,1
1878716563,0,0,0,1,1
1879017019,0,1,0,0,1
1879079239,0,1,0,0,1
1879132544,1,0,0,0,1
1879292869,0,1,0,0,1
1879652335,0,0,0,1,1
1879719710,0,1,0,0,1
1879981333,0,1,0,0,1
1880100169,0,1,0,0,1
1880677069,1,0,0,0,1
1886333310,1,0,0,0,1
1881503892,0,1,0,0,1
1882331226,0,1,0,0,1
1882495356,0,0,1,0,1
1883023356,0,1,0,0,1
1883354581,0,1,0,0,1
1883506526,1,0,0,0,1
1883602766,0,1,0,0,1
1883901072,0,1,0,0,1
1885597777,1,0,0,0,1
1886241036,0,1,0,0,1
1858817462,0,1,0,0,1
1858081266,0,1,0,0,1
1857465978,0,1,0,0,1
1739263746,0,1,0,0,1
1725973765,0,1,0,0,1
1725997411,0,1,0,0,1
1726106192,0,1,0,0,1
1726184683,1,0,0,0,1
1726589533,0,1,0,0,1
1727359892,0,1,0,0,1
1727416106,0,1,0,0,1
1727741324,0,1,0,0,1
1728625034,0,1,0,0,1
1728785779,0,1,0,0,1
1728853940,1,0,0,0,1
1729125788,0,1,0,0,1
1729340714,0,0,0,1,1
1730099130,0,1,0,0,1
1731832922,0,1,0,0,1
1732354904,0,1,0,0,1
1732929858,1,0,0,0,1
1735266884,1,0,0,0,1
1735485464,0,1,0,0,1
1735765843,0,1,0,0,1
1736592732,0,1,0,0,1
1736633192,0,1,0,0,1
1736831011,0,1,0,0,1
1725936817,0,0,0,1,1
1725815299,1,0,0,0,1
1725451688,1,0,0,0,1
1723083439,0,1,0,0,1
1720314133,1,0,0,0,1
1720858015,0,1,0,0,1
1721235217,0,1,0,0,1
1721514224,0,1,0,0,1
1721534258,1,0,0,0,1
1722050702,0,1,0,0,1
1722156127,1,0,0,0,1
1722346033,0,1,0,0,1
1722626408,0,1,0,0,1
1722686636,0,1,0,0,1
1723162657,0,1,0,0,1
1725422821,0,1,0,0,1
1723589527,1,0,0,0,1
1723659714,1,0,0,0,1
1723802064,0,1,0,0,1
1723825142,0,1,0,0,1
1723933063,0,1,0,0,1
1724711586,0,1,0,0,1
1724838690,0,1,0,0,1
1724933180,0,1,0,0,1
1725204048,0,1,0,0,1
1725369044,1,0,0,0,1
1738992360,0,1,0,0,1
1739501029,0,1,0,0,1
1857068298,0,1,0,0,1
1742665327,0,1,0,0,1
1850716206,0,1,0,0,1
1850907984,1,0,0,0,1
1851269936,1,0,0,0,1
1851320094,0,1,0,0,1
1851491982,0,1,0,0,1
1851497191,0,1,0,0,1
1851518864,0,1,0,0,1
1851908426,0,1,0,0,1
1852237387,0,1,0,0,1
1853210574,0,1,0,0,1
1854075763,1,0,0,0,1
1854132632,0,1,0,0,1
1854801625,0,1,0,0,1
1855097407,0,1,0,0,1
1855387928,0,1,0,0,1
1855536781,1,0,0,0,1
1855687129,0,1,0,0,1
1856097864,0,1,0,0,1
1856692831,0,1,0,0,1
1856704028,0,1,0,0,1
1856886066,0,1,0,0,1
1857010404,0,1,0,0,1
1857015020,0,1,0,0,1
1849980938,0,1,0,0,1
1849791145,0,1,0,0,1
1849763880,0,1,0,0,1
1828108754,0,1,0,0,1
1743316638,0,1,0,0,1
1753604670,0,1,0,0,1
1761477415,0,1,0,0,1
1763404345,0,1,0,0,1
1765502664,0,1,0,0,1
1766665758,0,1,0,0,1
1791564637,1,0,0,0,1
1811617681,0,1,0,0,1
1824494090,0,1,0,0,1
1827978000,0,1,0,0,1
1828479919,0,1,0,0,1
1849757179,0,1,0,0,1
1828836901,0,1,0,0,1
1830481693,0,1,0,0,1
1831255122,0,1,0,0,1
1833662454,0,1,0,0,1
1835320946,0,1,0,0,1
1846132471,0,1,0,0,1
1846374378,1,0,0,0,1
1847851992,0,1,0,0,1
1849232712,0,1,0,0,1
1849535653,0,1,0,0,1
1896634082,0,1,0,0,1
1897521505,0,1,0,0,1
1974606942,0,1,0,0,1
1947052597,0,1,0,0,1
1947381944,0,1,0,0,1
1947694880,0,1,0,0,1
1947859891,0,1,0,0,1
1948345110,0,1,0,0,1
1948767133,0,1,0,0,1
1948966038,0,1,0,0,1
1949094438,0,1,0,0,1
1949505356,0,1,0,0,1
1949924371,1,0,0,0,1
1949963113,0,1,0,0,1
1950577080,0,1,0,0,1
1950848629,0,1,0,0,1
1951566037,0,1,0,0,1
1951684814,0,1,0,0,1
1951736659,0,1,0,0,1
1951766395,0,1,0,0,1
1952762606,0,1,0,0,1
1953736166,0,1,0,0,1
1954353205,0,1,0,0,1
1954578871,0,1,0,0,1
1955152422,1,0,0,0,1
1955294672,0,1,0,0,1
1955369634,0,1,0,0,1
1947378720,0,1,0,0,1
1946989075,0,1,0,0,1
1897828034,0,1,0,0,1
1946742979,0,1,0,0,1
1935202567,0,1,0,0,1
1936185427,1,0,0,0,1
1936945374,0,1,0,0,1
1936967856,1,0,0,0,1
1937062632,0,1,0,0,1
1937476562,0,1,0,0,1
1938109520,0,1,0,0,1
1938262459,0,1,0,0,1
1938755371,1,0,0,0,1
1939987273,0,1,0,0,1
1940002406,0,1,0,0,1
1941212088,0,1,0,0,1
1942168687,0,1,0,0,1
1943436146,0,1,0,0,1
1943442614,0,1,0,0,1
1943661056,0,1,0,0,1
1944092822,1,0,0,0,1
1944928508,1,0,0,0,1
1944939763,0,1,0,0,1
1944981026,0,0,1,0,1
1945109186,0,1,0,0,1
1946244720,0,1,0,0,1
1946693713,1,0,0,0,1
1955753263,0,1,0,0,1
1955848344,1,0,0,0,1
1956883080,0,1,0,0,1
1957047750,0,1,0,0,1
1967002476,0,1,0,0,1
1967188999,0,1,0,0,1
1967451332,0,1,0,0,1
1968369564,1,0,0,0,1
1968578905,0,0,0,1,1
1968694310,0,1,0,0,1
1968717583,0,1,0,0,1
1968802526,0,1,0,0,1
1968994609,0,1,0,0,1
1969142660,0,1,0,0,1
1970401465,1,0,0,0,1
1970461734,1,0,0,0,1
1970722615,0,1,0,0,1
1971078966,0,1,0,0,1
1971303882,0,1,0,0,1
1971479916,0,1,0,0,1
1971742303,0,1,0,0,1
1971895790,0,1,0,0,1
1972313190,0,1,0,0,1
1972519165,1,0,0,0,1
1973697727,1,0,0,0,1
1974064628,0,1,0,0,1
1974450931,0,1,0,0,1
1965993505,0,1,0,0,1
1965745129,0,1,0,0,1
1965504360,0,1,0,0,1
1960625647,0,1,0,0,1
1957961994,0,1,0,0,1
1958033310,0,1,0,0,1
1958097271,0,1,0,0,1
1959026394,0,1,0,0,1
1959135697,0,1,0,0,1
1959181656,0,1,0,0,1
1959437323,0,1,0,0,1
1959517471,0,1,0,0,1
1960067671,1,0,0,0,1
1960431210,0,1,0,0,1
1960775778,0,1,0,0,1
1965407852,0,1,0,0,1
1961105160,0,1,0,0,1
1961251424,0,1,0,0,1
1961853817,0,1,0,0,1
1962067686,0,1,0,0,1
1962378061,0,1,0,0,1
1963156154,0,1,0,0,1
1963315951,0,1,0,0,1
1964786461,0,1,0,0,1
1965182156,0,1,0,0,1
1965226627,1,0,0,0,1
1935017268,1,0,0,0,1
1934967511,0,1,0,0,1
1934741881,0,1,0,0,1
1916984874,0,1,0,0,1
1910979834,0,1,0,0,1
1911007165,0,1,0,0,1
1911234486,0,0,0,1,1
1911437160,0,1,0,0,1
1911480906,0,1,0,0,1
1911615685,0,1,0,0,1
1911651564,0,1,0,0,1
1911700027,0,1,0,0,1
1911846690,0,1,0,0,1
1911846990,0,1,0,0,1
1912030890,0,1,0,0,1
1912183669,0,1,0,0,1
1912250641,0,1,0,0,1
1912464894,1,0,0,0,1
1913448872,0,1,0,0,1
1914717535,0,1,0,0,1
1914883058,0,1,0,0,1
1915006932,0,1,0,0,1
1915158127,1,0,0,0,1
1915285171,0,1,0,0,1
1915987423,1,0,0,0,1
1916374812,0,1,0,0,1
1916420629,0,1,0,0,1
1910397925,0,1,0,0,1
1909483010,0,1,0,0,1
1909471904,0,1,0,0,1
1904292878,0,1,0,0,1
1898575466,0,1,0,0,1
1898918143,1,0,0,0,1
1898963868,1,0,0,0,1
1899060228,0,1,0,0,1
1899840391,1,0,0,0,1
1899850260,0,1,0,0,1
1901142776,0,1,0,0,1
1901228246,0,1,0,0,1
1901282762,1,0,0,0,1
1902508244,0,1,0,0,1
1904505295,1,0,0,0,1
1909262473,0,1,0,0,1
1904980872,0,1,0,0,1
1905001903,1,0,0,0,1
1905051872,1,0,0,0,1
1905260270,0,1,0,0,1
1906411616,0,1,0,0,1
1907022980,0,0,0,1,1
1907362754,0,1,0,0,1
1908466740,0,1,0,0,1
1908603000,0,1,0,0,1
1909081256,0,1,0,0,1
1916756642,0,1,0,0,1
1917214832,1,0,0,0,1
1934695609,0,1,0,0,1
1917243290,0,1,0,0,1
1926422924,0,1,0,0,1
1926705236,1,0,0,0,1
1926732271,1,0,0,0,1
1926789396,0,1,0,0,1
1927191362,0,1,0,0,1
1927852674,0,1,0,0,1
1927874108,0,1,0,0,1
1927926162,0,1,0,0,1
1927954874,0,0,1,0,1
1927997468,1,0,0,0,1
1928268895,0,1,0,0,1
1928920471,0,1,0,0,1
1930037180,0,1,0,0,1
1930154088,0,1,0,0,1
1930679520,0,1,0,0,1
1930699938,0,1,0,0,1
1930745299,0,0,0,1,1
1933213796,0,0,0,1,1
1933816082,0,0,1,0,1
1933847797,1,0,0,0,1
1933868611,1,0,0,0,1
1934358650,0,1,0,0,1
1934389975,0,1,0,0,1
1924359246,0,1,0,0,1
1924334840,1,0,0,0,1
1924089643,0,1,0,0,1
1921094664,0,1,0,0,1
1917711380,1,0,0,0,1
1917923654,0,1,0,0,1
1918263128,0,1,0,0,1
1918281972,0,1,0,0,1
1919507659,0,1,0,0,1
1919669832,1,0,0,0,1
1920546055,0,1,0,0,1
1920593623,0,1,0,0,1
1920639739,0,1,0,0,1
1920984054,0,1,0,0,1
1921998559,0,1,0,0,1
1923930834,1,0,0,0,1
1922297340,0,1,0,0,1
1922390317,0,1,0,0,1
1922703656,0,1,0,0,1
1922974531,0,1,0,0,1
1923034765,0,1,0,0,1
1923112652,0,0,1,0,1
1923123444,0,1,0,0,1
1923464959,0,1,0,0,1
1923562046,1,0,0,0,1
1923892496,0,1,0,0,1
1493840641,0,0,0,1,1
1493765911,0,1,0,0,1
1493603490,0,1,0,0,1
1225242642,0,1,0,0,1
1225878757,0,1,0,0,1
1226612455,0,1,0,0,1
1227610238,0,1,0,0,1
1227754856,0,1,0,0,1
1227809010,0,1,0,0,1
1227886183,0,1,0,0,1
1228050950,1,0,0,0,1
1228360903,0,1,0,0,1
1228429111,0,1,0,0,1
1228445125,0,1,0,0,1
1228648136,0,0,1,0,1
1228786784,0,1,0,0,1
1229041398,0,1,0,0,1
1229331817,0,1,0,0,1
1229409632,0,1,0,0,1
1229607626,0,0,0,1,1
1229634001,1,0,0,0,1
1229669869,0,1,0,0,1
1229759113,0,1,0,0,1
1229768226,0,1,0,0,1
1229799908,0,1,0,0,1
1229881994,0,1,0,0,1
1230161702,0,1,0,0,1
1225413390,0,1,0,0,1
1223394830,0,1,0,0,1
1247311794,0,1,0,0,1
1223300672,0,1,0,0,1
1216256545,0,1,0,0,1
1216412774,0,1,0,0,1
1216581624,0,1,0,0,1
1216691174,0,1,0,0,1
1218850454,0,1,0,0,1
1219211748,0,1,0,0,1
1219322833,0,1,0,0,1
1219437780,0,1,0,0,1
1219573280,0,1,0,0,1
1219774855,0,1,0,0,1
1219878295,1,0,0,0,1
1220052816,0,1,0,0,1
1220585593,0,1,0,0,1
1220794404,0,1,0,0,1
1221027217,0,1,0,0,1
1221787254,1,0,0,0,1
1222314684,0,1,0,0,1
1222582268,0,1,0,0,1
1222601892,1,0,0,0,1
1222719601,0,1,0,0,1
1223051215,0,1,0,0,1
1223157229,0,1,0,0,1
1223210713,0,1,0,0,1
1230364460,1,0,0,0,1
1231080398,0,1,0,0,1
1231726424,0,1,0,0,1
1231884020,0,1,0,0,1
1242377431,1,0,0,0,1
1243136930,0,1,0,0,1
1243172346,0,1,0,0,1
1243350654,0,1,0,0,1
1243610077,0,1,0,0,1
1243829432,0,1,0,0,1
1243840688,0,1,0,0,1
1244014848,0,1,0,0,1
1244268200,0,1,0,0,1
1244477449,0,1,0,0,1
1244629567,1,0,0,0,1
1244667901,1,0,0,0,1
1244731237,0,1,0,0,1
1244970163,0,1,0,0,1
1245398881,1,0,0,0,1
1245553374,0,1,0,0,1
1245583352,0,1,0,0,1
1245910836,0,1,0,0,1
1245935858,0,1,0,0,1
1246293284,1,0,0,0,1
1246430562,0,1,0,0,1
1246515931,0,1,0,0,1
1246806540,0,1,0,0,1
1242118112,0,1,0,0,1
1241859212,0,1,0,0,1
1241817914,0,1,0,0,1
1235693594,0,1,0,0,1
1232734633,0,1,0,0,1
1233072326,0,1,0,0,1
1233195152,0,1,0,0,1
1233453223,0,1,0,0,1
1233842935,0,1,0,0,1
1234019826,0,1,0,0,1
1234458775,0,1,0,0,1
1234660638,0,1,0,0,1
1235154146,0,1,0,0,1
1235551788,0,1,0,0,1
1236425180,0,1,0,0,1
1241641670,0,1,0,0,1
1238522666,0,1,0,0,1
1238976164,0,1,0,0,1
1239122714,0,1,0,0,1
1239295530,0,1,0,0,1
1239550081,0,1,0,0,1
1239567524,0,1,0,0,1
1239703302,0,0,0,1,1
1239819888,0,1,0,0,1
1239867078,1,0,0,0,1
1239923912,0,1,0,0,1
1216107589,0,1,0,0,1
1215803150,1,0,0,0,1
1215765505,0,1,0,0,1
1197539419,0,1,0,0,1
1190269940,0,1,0,0,1
1191042565,0,1,0,0,1
1191405768,0,1,0,0,1
1191881964,1,0,0,0,1
1192463994,0,1,0,0,1
1192907388,0,0,0,1,1
1193392525,0,1,0,0,1
1193960550,0,1,0,0,1
1194160183,0,0,1,0,1
1194396426,0,1,0,0,1
1194563413,0,1,0,0,1
1194826543,0,1,0,0,1
1194957349,1,0,0,0,1
1195113781,0,1,0,0,1
1195213484,0,1,0,0,1
1195272541,0,0,1,0,1
1195358496,0,1,0,0,1
1195775558,0,1,0,0,1
1196233544,0,1,0,0,1
1196282233,0,1,0,0,1
1196415980,1,0,0,0,1
1196418644,0,1,0,0,1
1196543418,0,1,0,0,1
1189985762,0,1,0,0,1
1189800812,1,0,0,0,1
1189499690,1,0,0,0,1
1185982909,0,1,0,0,1
1183193028,0,1,0,0,1
1183360542,0,1,0,0,1
1183545174,0,1,0,0,1
1184120946,0,1,0,0,1
1184211570,1,0,0,0,1
1184228094,1,0,0,0,1
1184334258,0,1,0,0,1
1184670722,0,1,0,0,1
1184976787,1,0,0,0,1
1185082543,1,0,0,0,1
1186033728,0,1,0,0,1
1189376095,0,1,0,0,1
1186470529,0,1,0,0,1
1186656577,0,1,0,0,1
1187010325,0,0,0,1,1
1187259770,0,1,0,0,1
1187361420,1,0,0,0,1
1188128599,0,1,0,0,1
1188136585,0,1,0,0,1
1188469298,0,1,0,0,1
1188777895,0,1,0,0,1
1189073701,0,1,0,0,1
1197477823,0,1,0,0,1
1197631754,0,1,0,0,1
1215439676,0,1,0,0,1
1198066808,0,1,0,0,1
1205649853,0,1,0,0,1
1206126618,0,1,0,0,1
1207331791,0,1,0,0,1
1208352859,1,0,0,0,1
1208496990,1,0,0,0,1
1208693460,1,0,0,0,1
1208932579,0,1,0,0,1
1209569977,0,1,0,0,1
1209608719,0,0,0,1,1
1209766441,0,1,0,0,1
1210626589,0,1,0,0,1
1211310212,0,1,0,0,1
1212227990,0,0,1,0,1
1212474564,1,0,0,0,1
1213107469,0,1,0,0,1
1214266789,1,0,0,0,1
1214663527,0,1,0,0,1
1214736619,1,0,0,0,1
1214763853,0,1,0,0,1
1215056714,0,1,0,0,1
1215136490,0,1,0,0,1
1215361494,0,1,0,0,1
1215417282,1,0,0,0,1
1205588725,0,0,0,1,1
1205392308,0,1,0,0,1
1205321827,0,0,1,0,1
1200856178,0,1,0,0,1
1198086252,0,1,0,0,1
1198333657,0,0,0,1,1
1198406642,1,0,0,0,1
1198423963,0,1,0,0,1
1198680336,0,1,0,0,1
1198995517,0,1,0,0,1
1199025788,0,1,0,0,1
1199672947,0,1,0,0,1
1200145069,0,1,0,0,1
1200343214,0,1,0,0,1
1201289334,1,0,0,0,1
1204552921,0,1,0,0,1
1201462382,0,1,0,0,1
1201538251,1,0,0,0,1
1202233068,0,1,0,0,1
1202784571,0,1,0,0,1
1203160154,0,1,0,0,1
1203353136,0,1,0,0,1
1203457808,0,1,0,0,1
1203846092,1,0,0,0,1
1204347494,0,1,0,0,1
1204491840,0,1,0,0,1
1247023374,1,0,0,0,1
1247479974,0,1,0,0,1
1181479838,1,0,0,0,1
1283514792,0,1,0,0,1
1283633306,0,1,0,0,1
1284418446,0,1,0,0,1
1284539749,0,1,0,0,1
1284691310,0,1,0,0,1
1285132417,1,0,0,0,1
1285236547,1,0,0,0,1
1285329578,0,1,0,0,1
1285358299,0,1,0,0,1
1285566517,1,0,0,0,1
1285581817,0,1,0,0,1
1285695234,0,1,0,0,1
1285730594,0,1,0,0,1
1285890744,0,1,0,0,1
1285909946,1,0,0,0,1
1286206086,0,1,0,0,1
1287075452,0,1,0,0,1
1287208668,0,1,0,0,1
1287540649,0,1,0,0,1
1287995004,0,1,0,0,1
1288004450,0,1,0,0,1
1288454840,0,1,0,0,1
1288482625,0,0,0,1,1
1288564147,1,0,0,0,1
1283519922,1,0,0,0,1
1282859202,0,1,0,0,1
1247676379,0,0,0,1,1
1282857320,0,1,0,0,1
1273551398,0,1,0,0,1
1274020321,1,0,0,0,1
1274043710,0,1,0,0,1
1274653008,0,1,0,0,1
1275398286,0,1,0,0,1
1276197295,0,1,0,0,1
1276790623,1,0,0,0,1
1277463552,0,1,0,0,1
1277580301,1,0,0,0,1
1277747886,0,0,1,0,1
1278440112,0,1,0,0,1
1279850856,0,1,0,0,1
1279875410,0,1,0,0,1
1280110926,0,1,0,0,1
1280215423,0,1,0,0,1
1280235517,0,1,0,0,1
1280399652,0,1,0,0,1
1280456774,0,1,0,0,1
1281140622,0,1,0,0,1
1281695424,0,1,0,0,1
1282100756,1,0,0,0,1
1282809403,0,1,0,0,1
1282834814,0,1,0,0,1
1288621742,0,1,0,0,1
1288758535,0,1,0,0,1
1289469350,0,1,0,0,1
1289547829,0,1,0,0,1
1296612271,0,1,0,0,1
1297628634,0,1,0,0,1
1297816890,1,0,0,0,1
1298011742,0,1,0,0,1
1298248224,0,1,0,0,1
1298290987,1,0,0,0,1
1298547073,0,1,0,0,1
1298724349,1,0,0,0,1
1299048480,0,1,0,0,1
1299289771,0,1,0,0,1
1299853104,0,1,0,0,1
1299970280,0,1,0,0,1
1300309884,0,1,0,0,1
1300321032,0,1,0,0,1
1300589400,0,1,0,0,1
1300609340,0,1,0,0,1
1301071730,0,1,0,0,1
1301422388,0,1,0,0,1
1302494120,0,1,0,0,1
1302904352,0,1,0,0,1
1303049894,0,1,0,0,1
1303255333,0,1,0,0,1
1303258022,0,1,0,0,1
1296338870,0,1,0,0,1
1296277184,0,1,0,0,1
1295213118,0,1,0,0,1
1291874383,0,1,0,0,1
1290220297,0,1,0,0,1
1290444588,1,0,0,0,1
1290519342,0,1,0,0,1
1290676740,0,1,0,0,1
1290698510,0,1,0,0,1
1290783908,0,1,0,0,1
1291247042,0,1,0,0,1
1291471574,1,0,0,0,1
1291680668,0,1,0,0,1
1291777987,0,1,0,0,1
1292206554,0,1,0,0,1
1295177941,0,1,0,0,1
1293410443,0,1,0,0,1
1293673530,0,1,0,0,1
1293963937,0,1,0,0,1
1294114764,0,0,1,0,1
1294420848,0,1,0,0,1
1294664179,0,1,0,0,1
1294779548,1,0,0,0,1
1294792166,0,1,0,0,1
1294920638,0,1,0,0,1
1295040698,0,1,0,0,1
1273249170,0,1,0,0,1
1273132928,0,1,0,0,1
1272989521,0,1,0,0,1
1259161105,1,0,0,0,1
1254642890,0,1,0,0,1
1254780320,0,1,0,0,1
1255034778,0,1,0,0,1
1255044630,0,1,0,0,1
1255237182,0,1,0,0,1
1255257158,1,0,0,0,1
1255420507,0,1,0,0,1
1255682371,0,1,0,0,1
1255844972,0,1,0,0,1
1256721842,0,1,0,0,1
1257105462,0,1,0,0,1
1257646728,0,1,0,0,1
1257848060,0,0,1,0,1
1257970614,1,0,0,0,1
1257978307,0,1,0,0,1
1258128312,0,1,0,0,1
1258188504,0,1,0,0,1
1258317210,0,1,0,0,1
1258598958,0,1,0,0,1
1258696710,0,1,0,0,1
1258795002,0,1,0,0,1
1259008459,0,1,0,0,1
1259041459,0,1,0,0,1
1254537290,0,1,0,0,1
1254414248,0,1,0,0,1
1254369686,0,1,0,0,1
1249848746,0,1,0,0,1
1247737758,0,1,0,0,1
1247750384,0,1,0,0,1
1247873534,0,1,0,0,1
1248162588,0,1,0,0,1
1248677281,0,1,0,0,1
1249368565,1,0,0,0,1
1249428205,0,1,0,0,1
1249437378,0,0,0,1,1
1249494546,0,1,0,0,1
1249763118,0,1,0,0,1
1249868125,0,1,0,0,1
1253850734,0,1,0,0,1
1249977932,0,1,0,0,1
1250962657,1,0,0,0,1
1252083721,1,0,0,0,1
1252121052,0,0,1,0,1
1252321520,0,1,0,0,1
1252777735,0,1,0,0,1
1252804693,0,0,1,0,1
1252874678,0,1,0,0,1
1253672034,1,0,0,0,1
1253695280,0,1,0,0,1
1259122116,1,0,0,0,1
1259293578,0,1,0,0,1
1272891380,0,1,0,0,1
1259320328,0,1,0,0,1
1266231630,0,1,0,0,1
1266522264,0,1,0,0,1
1266794870,0,1,0,0,1
1267058250,1,0,0,0,1
1267351753,0,1,0,0,1
1267385142,0,1,0,0,1
1267750777,1,0,0,0,1
1267900400,0,1,0,0,1
1267980138,1,0,0,0,1
1268855640,0,1,0,0,1
1269269946,0,1,0,0,1
1269374424,0,1,0,0,1
1269670536,0,1,0,0,1
1269840547,0,1,0,0,1
1270169882,0,1,0,0,1
1270516729,0,1,0,0,1
1270695013,0,1,0,0,1
1270821990,0,1,0,0,1
1271485117,0,1,0,0,1
1272177636,0,1,0,0,1
1272310711,0,1,0,0,1
1272583334,0,1,0,0,1
1272626076,1,0,0,0,1
1265377520,0,1,0,0,1
1265314998,0,1,0,0,1
1264243537,0,1,0,0,1
1261503378,0,1,0,0,1
1259674092,0,1,0,0,1
1259733529,0,1,0,0,1
1259792959,0,1,0,0,1
1259949734,0,1,0,0,1
1260208796,0,1,0,0,1
1260535794,0,1,0,0,1
1260676292,0,1,0,0,1
1260822548,0,1,0,0,1
1261046426,0,1,0,0,1
1261423399,0,1,0,0,1
1261564063,0,1,0,0,1
1264209744,1,0,0,0,1
1262026784,0,0,0,1,1
1262538853,0,1,0,0,1
1262548771,1,0,0,0,1
1262994674,0,1,0,0,1
1263103657,0,1,0,0,1
1263351116,0,1,0,0,1
1263576109,1,0,0,0,1
1263580375,0,1,0,0,1
1263605546,0,1,0,0,1
1263909744,0,1,0,0,1
1183085443,0,1,0,0,1
1181161158,0,1,0,0,1
1303871827,0,1,0,0,1
1101321588,1,0,0,0,1
1101509359,0,1,0,0,1
1101766141,1,0,0,0,1
1102404272,0,0,1,0,1
1102673268,1,0,0,0,1
1102877978,1,0,0,0,1
1103050032,0,1,0,0,1
1103577378,0,0,1,0,1
1103702016,1,0,0,0,1
1103850667,0,1,0,0,1
1103913949,0,1,0,0,1
1105390201,0,1,0,0,1
1105425722,0,1,0,0,1
1105720130,0,1,0,0,1
1105817226,0,1,0,0,1
1105879586,1,0,0,0,1
1106116555,0,1,0,0,1
1106439452,1,0,0,0,1
1106446058,0,1,0,0,1
1106492216,0,1,0,0,1
1106672084,0,1,0,0,1
1106737644,0,0,1,0,1
1107143474,0,1,0,0,1
1107299299,0,1,0,0,1
1101399690,0,0,1,0,1
1101132416,0,0,0,1,1
1121732005,1,0,0,0,1
1100957016,0,1,0,0,1
1096131726,0,1,0,0,1
1096273152,0,1,0,0,1
1096353031,1,0,0,0,1
1096895204,0,1,0,0,1
1097135964,0,1,0,0,1
1097206105,0,1,0,0,1
1097236051,0,0,0,1,1
1097239165,1,0,0,0,1
1097700696,0,1,0,0,1
1098444092,0,1,0,0,1
1098705314,0,1,0,0,1
1098792156,0,1,0,0,1
1098954710,1,0,0,0,1
1099056482,0,1,0,0,1
1099073388,0,1,0,0,1
1099191242,0,1,0,0,1
1099277078,0,1,0,0,1
1100294414,0,1,0,0,1
1100388877,0,1,0,0,1
1100406042,0,1,0,0,1
1100537724,0,1,0,0,1
1100625372,1,0,0,0,1
1100661078,0,1,0,0,1
1107810326,1,0,0,0,1
1107816176,0,1,0,0,1
1108469366,0,1,0,0,1
1108499101,0,1,0,0,1
1115490384,0,1,0,0,1
1116174325,0,1,0,0,1
1116421326,0,1,0,0,1
1116610542,0,1,0,0,1
1116972440,0,1,0,0,1
1117047552,0,1,0,0,1
1117064341,0,1,0,0,1
1117130971,0,1,0,0,1
1117366399,1,0,0,0,1
1118124559,0,1,0,0,1
1118175474,0,1,0,0,1
1118338345,1,0,0,0,1
1118603724,0,1,0,0,1
1119130880,0,1,0,0,1
1119902520,0,1,0,0,1
1120013352,1,0,0,0,1
1120077294,0,1,0,0,1
1120137590,0,1,0,0,1
1120456195,1,0,0,0,1
1120897933,1,0,0,0,1
1120972896,0,1,0,0,1
1121226546,0,1,0,0,1
1121384984,0,1,0,0,1
1115165754,0,1,0,0,1
1114934311,0,1,0,0,1
1114858434,0,1,0,0,1
1110865170,0,1,0,0,1
1109338896,0,1,0,0,1
1109639072,0,1,0,0,1
1109665598,1,0,0,0,1
1109672282,0,1,0,0,1
1109720568,0,1,0,0,1
1110202802,0,0,0,1,1
1110266634,0,1,0,0,1
1110728904,0,1,0,0,1
1110798074,0,1,0,0,1
1110823710,0,1,0,0,1
1110888122,0,1,0,0,1
1114704265,0,1,0,0,1
1110949081,0,1,0,0,1
1111037629,0,1,0,0,1
1111826808,0,1,0,0,1
1112020050,0,1,0,0,1
1112396677,0,0,1,0,1
1112728004,0,1,0,0,1
1112854878,0,1,0,0,1
1112999046,1,0,0,0,1
1113537259,1,0,0,0,1
1113837156,0,1,0,0,1
1096000920,0,1,0,0,1
1094763014,0,1,0,0,1
1093884793,0,1,0,0,1
1078591664,1,0,0,0,1
1071548005,0,1,0,0,1
1072199178,0,1,0,0,1
1072937300,0,1,0,0,1
1073032664,0,1,0,0,1
1073308926,0,1,0,0,1
1073468976,0,1,0,0,1
1073544775,0,1,0,0,1
1073650933,0,1,0,0,1
1073752830,0,1,0,0,1
1073927623,0,1,0,0,1
1074018698,0,1,0,0,1
1074865789,1,0,0,0,1
1074959683,0,1,0,0,1
1075133203,1,0,0,0,1
1075936694,0,1,0,0,1
1076124552,0,1,0,0,1
1076296202,1,0,0,0,1
1076363504,0,1,0,0,1
1076513084,0,1,0,0,1
1076583715,0,1,0,0,1
1077162722,0,1,0,0,1
1077674730,0,1,0,0,1
1077970982,0,1,0,0,1
1071050887,0,1,0,0,1
1070961528,0,1,0,0,1
1070848699,0,0,0,1,1
1068266791,0,1,0,0,1
1066374266,0,1,0,0,1
1066459513,1,0,0,0,1
1066774706,0,1,0,0,1
1066782306,0,1,0,0,1
1067584250,0,1,0,0,1
1067631067,0,1,0,0,1
1067714456,0,1,0,0,1
1067789414,0,1,0,0,1
1067973890,0,1,0,0,1
1068126080,0,1,0,0,1
1068328447,0,1,0,0,1
1070835650,0,1,0,0,1
1068349682,0,1,0,0,1
1068430224,0,1,0,0,1
1068963631,0,1,0,0,1
1068993691,0,1,0,0,1
1069532240,0,1,0,0,1
1069828351,0,1,0,0,1
1070088007,0,1,0,0,1
1070449364,0,1,0,0,1
1070534946,0,1,0,0,1
1070701694,0,1,0,0,1
1078448514,0,1,0,0,1
1078984734,0,1,0,0,1
1093627886,0,0,1,0,1
1079329482,0,0,1,0,1
1088171346,0,1,0,0,1
1088402510,0,1,0,0,1
1088638880,0,1,0,0,1
1088701314,0,1,0,0,1
1089705751,1,0,0,0,1
1090258981,0,1,0,0,1
1090301264,1,0,0,0,1
1090432429,0,1,0,0,1
1090794961,0,1,0,0,1
1090933584,0,1,0,0,1
1091356908,0,1,0,0,1
1091384262,0,1,0,0,1
1091557062,0,1,0,0,1
1091623711,0,1,0,0,1
1091646974,0,1,0,0,1
1091698484,1,0,0,0,1
1092089576,0,1,0,0,1
1092506072,0,1,0,0,1
1092512862,1,0,0,0,1
1092556351,0,1,0,0,1
1092653400,0,1,0,0,1
1093049142,0,1,0,0,1
1093393596,0,1,0,0,1
1087874976,0,1,0,0,1
1087724815,0,1,0,0,1
1087359182,0,1,0,0,1
1084152606,0,1,0,0,1
1079376248,0,1,0,0,1
1080699888,0,1,0,0,1
1080779509,0,1,0,0,1
1080786871,0,1,0,0,1
1080892105,0,1,0,0,1
1081800654,0,1,0,0,1
1081876256,0,1,0,0,1
1083074257,0,1,0,0,1
1083179929,1,0,0,0,1
1083900313,0,1,0,0,1
1084224319,1,0,0,0,1
1087018164,0,1,0,0,1
1084567735,0,1,0,0,1
1084584373,0,1,0,0,1
1085776615,0,1,0,0,1
1085863038,0,1,0,0,1
1086023720,0,1,0,0,1
1086219487,0,0,0,1,1
1086354577,0,1,0,0,1
1086489222,0,1,0,0,1
1086702385,0,1,0,0,1
1086942734,0,1,0,0,1
1121605766,1,0,0,0,1
1122009662,0,1,0,0,1
1180174201,0,1,0,0,1
1158086924,1,0,0,0,1
1158605406,0,1,0,0,1
1158640098,0,1,0,0,1
1159522170,0,1,0,0,1
1159890504,0,1,0,0,1
1159896955,0,1,0,0,1
1159922707,1,0,0,0,1
1159930880,0,1,0,0,1
1160347404,0,1,0,0,1
1160666808,0,1,0,0,1
1160679427,0,1,0,0,1
1162054873,0,1,0,0,1
1163086309,0,1,0,0,1
1163116478,0,1,0,0,1
1163215290,0,1,0,0,1
1163354198,0,1,0,0,1
1163403876,0,1,0,0,1
1163522719,0,1,0,0,1
1164135116,0,1,0,0,1
1164351212,1,0,0,0,1
1164498608,0,1,0,0,1
1164539232,0,1,0,0,1
1165276243,0,1,0,0,1
1165312434,0,1,0,0,1
1158310910,0,1,0,0,1
1157612431,0,1,0,0,1
1122092934,0,1,0,0,1
1157456360,0,0,0,1,1
1151091228,0,1,0,0,1
1151239129,0,1,0,0,1
1151259499,0,1,0,0,1
1151362506,0,1,0,0,1
1151508200,1,0,0,0,1
1151684730,0,1,0,0,1
1152136603,1,0,0,0,1
1152348019,0,1,0,0,1
1152402596,0,1,0,0,1
1153155805,0,1,0,0,1
1153385461,0,1,0,0,1
1153476318,1,0,0,0,1
1154009605,0,1,0,0,1
1154119363,0,1,0,0,1
1154747053,0,0,0,1,1
1154899231,0,1,0,0,1
1155112170,1,0,0,0,1
1156035265,0,1,0,0,1
1156303286,0,1,0,0,1
1157020801,0,1,0,0,1
1157205781,1,0,0,0,1
1157261209,0,1,0,0,1
1157357880,0,1,0,0,1
1165496078,0,1,0,0,1
1165775258,0,1,0,0,1
1165800906,1,0,0,0,1
1165906176,0,1,0,0,1
1173221906,0,1,0,0,1
1173434690,0,1,0,0,1
1174211341,0,1,0,0,1
1174276615,0,1,0,0,1
1174560230,0,1,0,0,1
1174884714,0,1,0,0,1
1176217346,1,0,0,0,1
1176512804,0,1,0,0,1
1176782108,0,1,0,0,1
1176959144,0,1,0,0,1
1177002258,0,1,0,0,1
1177047872,0,0,0,1,1
1177309190,0,1,0,0,1
1178058432,1,0,0,0,1
1178663684,0,1,0,0,1
1178705954,0,1,0,0,1
1179152300,0,1,0,0,1
1179156710,0,0,1,0,1
1179231290,0,1,0,0,1
1179479251,0,1,0,0,1
1179851845,0,1,0,0,1
1179937776,0,1,0,0,1
1179950107,0,1,0,0,1
1173167119,0,1,0,0,1
1173038870,0,1,0,0,1
1172570954,1,0,0,0,1
1169065068,0,1,0,0,1
1166233590,0,1,0,0,1
1166665759,1,0,0,0,1
1166759473,0,1,0,0,1
1166956524,0,1,0,0,1
1167327805,0,1,0,0,1
1167521552,0,1,0,0,1
1167762434,0,1,0,0,1
1168027430,1,0,0,0,1
1168759927,0,1,0,0,1
1169015263,0,1,0,0,1
1169616871,0,1,0,0,1
1172414664,0,0,0,1,1
1169877992,0,1,0,0,1
1169988787,0,1,0,0,1
1170144421,0,1,0,0,1
1171213596,0,1,0,0,1
1171326637,0,1,0,0,1
1171408220,0,1,0,0,1
1171620558,0,1,0,0,1
1171648580,0,0,0,1,1
1172352422,0,1,0,0,1
1172363977,0,1,0,0,1
1151076073,0,1,0,0,1
1150978536,1,0,0,0,1
1150857277,0,1,0,0,1
1134951301,0,1,0,0,1
1128658170,0,1,0,0,1
1128773102,0,1,0,0,1
1128840420,0,1,0,0,1
1129121820,1,0,0,0,1
1129421570,0,1,0,0,1
1129763143,0,1,0,0,1
1130275662,1,0,0,0,1
1130389106,1,0,0,0,1
1130420497,0,1,0,0,1
1130767506,0,1,0,0,1
1131138488,0,1,0,0,1
1131148316,0,1,0,0,1
1131275096,0,1,0,0,1
1131370838,0,1,0,0,1
1131540900,0,1,0,0,1
1131587136,0,0,0,1,1
1131893563,0,1,0,0,1
1132082413,0,1,0,0,1
1132110962,0,1,0,0,1
1132176014,0,1,0,0,1
1132436016,0,1,0,0,1
1132919388,1,0,0,0,1
1134374222,0,1,0,0,1
1128637627,0,1,0,0,1
1128255505,0,1,0,0,1
1127963797,0,1,0,0,1
1124012821,0,1,0,0,1
1122179342,0,1,0,0,1
1122320964,0,1,0,0,1
1122778188,0,1,0,0,1
1123196971,0,1,0,0,1
1123213740,0,1,0,0,1
1123217857,0,1,0,0,1
1123297597,0,1,0,0,1
1123609483,0,1,0,0,1
1123641386,0,1,0,0,1
1123968817,1,0,0,0,1
1124167796,0,1,0,0,1
1127591090,0,1,0,0,1
1124192142,0,1,0,0,1
1124858924,1,0,0,0,1
1125556956,0,1,0,0,1
1125601146,0,1,0,0,1
1125878504,0,1,0,0,1
1126043210,0,1,0,0,1
1126046486,1,0,0,0,1
1126177986,0,1,0,0,1
1126302294,0,1,0,0,1
1127428976,0,1,0,0,1
1134594974,0,1,0,0,1
1135193670,0,1,0,0,1
1150779590,1,0,0,0,1
1135443343,0,0,1,0,1
1145039036,0,1,0,0,1
1145102592,0,1,0,0,1
1145215056,0,1,0,0,1
1145349108,0,1,0,0,1
1146009283,0,1,0,0,1
1146148478,0,1,0,0,1
1146221905,0,1,0,0,1
1146437522,0,1,0,0,1
1147405782,0,1,0,0,1
1147627152,1,0,0,0,1
1148259380,0,1,0,0,1
1148279274,0,1,0,0,1
1148331060,0,1,0,0,1
1148333508,0,1,0,0,1
1148541883,0,1,0,0,1
1148612774,0,1,0,0,1
1148831978,1,0,0,0,1
1148928457,0,1,0,0,1
1149678733,0,1,0,0,1
1150046274,0,1,0,0,1
1150243694,0,0,1,0,1
1150351428,0,1,0,0,1
1150748576,0,1,0,0,1
1143922956,0,1,0,0,1
1143718418,0,1,0,0,1
1143304232,0,1,0,0,1
1140048409,0,1,0,0,1
1136467266,0,1,0,0,1
1136821460,0,1,0,0,1
1136968777,0,1,0,0,1
1137444770,0,1,0,0,1
1137568723,1,0,0,0,1
1138181767,0,1,0,0,1
1139559170,0,1,0,0,1
1139698153,0,1,0,0,1
1139932591,0,1,0,0,1
1139984808,0,1,0,0,1
1140334423,0,1,0,0,1
1143069218,0,1,0,0,1
1140620797,0,1,0,0,1
1140658686,0,1,0,0,1
1141152576,0,1,0,0,1
1141243230,0,1,0,0,1
1141562136,1,0,0,0,1
1142053880,0,1,0,0,1
1142239662,1,0,0,0,1
1142612844,0,1,0,0,1
1142736896,0,1,0,0,1
1142825899,0,1,0,0,1
1303545817,0,1,0,0,1
1303897562,0,1,0,0,1
1493440608,0,1,0,0,1
1422812995,0,1,0,0,1
1423180512,0,1,0,0,1
1423227264,1,0,0,0,1
1423247623,0,1,0,0,1
1423402950,0,1,0,0,1
1423689679,0,1,0,0,1
1423803402,0,1,0,0,1
1424008110,0,1,0,0,1
1424308736,0,1,0,0,1
1424624701,0,1,0,0,1
1424681070,0,1,0,0,1
1424976996,0,1,0,0,1
1425007519,0,1,0,0,1
1425175735,0,1,0,0,1
1425202056,1,0,0,0,1
1425216452,0,1,0,0,1
1425384752,0,0,0,1,1
1425541243,0,1,0,0,1
1425873733,1,0,0,0,1
1425994975,0,1,0,0,1
1426043731,0,1,0,0,1
1426166545,0,1,0,0,1
1426240093,0,1,0,0,1
1426474844,0,1,0,0,1
1423074720,0,1,0,0,1
1422802832,0,1,0,0,1
1441098403,0,1,0,0,1
1422369734,0,1,0,0,1
1416652610,0,1,0,0,1
1416894920,1,0,0,0,1
1416930991,0,1,0,0,1
1417084164,0,1,0,0,1
1417146067,0,1,0,0,1
1417817065,0,1,0,0,1
1417849698,0,1,0,0,1
1418245562,0,1,0,0,1
1418295180,0,1,0,0,1
1418717526,0,1,0,0,1
1418811426,0,1,0,0,1
1418868272,1,0,0,0,1
1419091327,0,1,0,0,1
1419977708,0,1,0,0,1
1419990536,0,0,0,1,1
1420170565,0,1,0,0,1
1420696321,0,1,0,0,1
1421146280,0,1,0,0,1
1421284922,0,1,0,0,1
1421534684,0,1,0,0,1
1421770333,0,1,0,0,1
1421858798,0,1,0,0,1
1422337033,1,0,0,0,1
1427212014,0,1,0,0,1
1427408310,0,1,0,0,1
1427478474,0,1,0,0,1
1427553230,0,1,0,0,1
1435503888,0,1,0,0,1
1435514058,0,1,0,0,1
1435682564,0,1,0,0,1
1436182926,0,1,0,0,1
1436428412,0,1,0,0,1
1436628139,0,1,0,0,1
1436992904,0,1,0,0,1
1437131670,0,1,0,0,1
1437645270,0,1,0,0,1
1437673062,0,1,0,0,1
1437853825,0,1,0,0,1
1438018160,1,0,0,0,1
1438036776,0,1,0,0,1
1438183039,0,1,0,0,1
1438320546,0,1,0,0,1
1439304488,1,0,0,0,1
1439391764,0,1,0,0,1
1439740506,0,1,0,0,1
1440215022,0,1,0,0,1
1440381955,1,0,0,0,1
1440725329,0,0,1,0,1
1440859812,0,1,0,0,1
1440961530,0,1,0,0,1
1435365788,1,0,0,0,1
1435101336,0,1,0,0,1
1435048747,0,1,0,0,1
1431726547,0,1,0,0,1
1427679254,0,1,0,0,1
1428761191,0,1,0,0,1
1428767360,0,1,0,0,1
1429065110,0,1,0,0,1
1429781690,0,1,0,0,1
1430006864,0,1,0,0,1
1430623598,0,1,0,0,1
1430811542,0,1,0,0,1
1431340358,0,1,0,0,1
1431693925,1,0,0,0,1
1431997220,0,1,0,0,1
1434862968,1,0,0,0,1
1432127029,0,1,0,0,1
1432216154,0,1,0,0,1
1432898994,0,1,0,0,1
1432947576,0,1,0,0,1
1433084245,0,1,0,0,1
1433111642,0,1,0,0,1
1433277374,0,1,0,0,1
1433286494,0,1,0,0,1
1434402253,1,0,0,0,1
1434411733,0,1,0,0,1
1416311154,0,1,0,0,1
1416085334,0,1,0,0,1
1415713747,0,1,0,0,1
1401523615,0,1,0,0,1
1397740903,0,1,0,0,1
1397785446,0,1,0,0,1
1397804838,1,0,0,0,1
1397873892,0,1,0,0,1
1398152420,1,0,0,0,1
1398212712,0,1,0,0,1
1398528416,0,1,0,0,1
1398602815,0,1,0,0,1
1398883878,0,1,0,0,1
1398941594,0,1,0,0,1
1398998395,0,1,0,0,1
1399078501,0,1,0,0,1
1399441650,0,1,0,0,1
1399496215,0,1,0,0,1
1399608546,0,1,0,0,1
1399672915,0,1,0,0,1
1399707510,1,0,0,0,1
1399899816,0,1,0,0,1
1400223446,0,1,0,0,1
1400314633,0,1,0,0,1
1400478445,1,0,0,0,1
1400890434,0,1,0,0,1
1401109802,0,1,0,0,1
1397630402,1,0,0,0,1
1397120538,0,1,0,0,1
1396950571,0,1,0,0,1
1394427811,0,1,0,0,1
1391322103,0,1,0,0,1
1391338477,0,1,0,0,1
1391395964,0,1,0,0,1
1392054620,0,1,0,0,1
1392590959,1,0,0,0,1
1392732236,0,1,0,0,1
1393015957,0,1,0,0,1
1393211558,1,0,0,0,1
1393756267,0,1,0,0,1
1393819074,0,1,0,0,1
1394485098,0,1,0,0,1
1396713044,0,1,0,0,1
1394818368,0,1,0,0,1
1394921426,1,0,0,0,1
1395451782,0,1,0,0,1
1395482984,1,0,0,0,1
1395494749,0,1,0,0,1
1395766692,0,1,0,0,1
1395882728,0,1,0,0,1
1396171404,0,1,0,0,1
1396476667,0,1,0,0,1
1396706586,1,0,0,0,1
1401251442,0,1,0,0,1
1401681217,0,1,0,0,1
1415628115,0,1,0,0,1
1402294814,0,1,0,0,1
1409642101,0,1,0,0,1
1409809080,0,1,0,0,1
1409849444,0,1,0,0,1
1410052176,0,1,0,0,1
1410548790,0,1,0,0,1
1410728526,0,0,0,1,1
1411172725,0,1,0,0,1
1412172222,0,1,0,0,1
1412266543,0,1,0,0,1
1412459304,1,0,0,0,1
1412507280,0,1,0,0,1
1412848068,0,1,0,0,1
1412904018,0,1,0,0,1
1413255684,0,1,0,0,1
1414496832,0,1,0,0,1
1414776295,0,1,0,0,1
1414832816,0,1,0,0,1
1414900718,0,1,0,0,1
1414902696,0,1,0,0,1
1415066923,0,0,0,1,1
1415078696,0,1,0,0,1
1415348275,0,1,0,0,1
1415595511,0,1,0,0,1
1409553422,0,1,0,0,1
1408904797,0,1,0,0,1
1407488054,0,1,0,0,1
1404279650,0,1,0,0,1
1402472324,0,1,0,0,1
1402562467,1,0,0,0,1
1402794702,0,1,0,0,1
1402948987,1,0,0,0,1
1402960014,0,1,0,0,1
1403327010,0,1,0,0,1
1403430847,0,1,0,0,1
1403599776,0,1,0,0,1
1403869501,0,1,0,0,1
1404148213,0,1,0,0,1
1404888931,0,1,0,0,1
1407392047,0,1,0,0,1
1404996883,0,1,0,0,1
1405146698,1,0,0,0,1
1405636148,0,1,0,0,1
1405778102,0,1,0,0,1
1405899534,0,1,0,0,1
1405935996,0,1,0,0,1
1406964018,0,1,0,0,1
1407028116,0,1,0,0,1
1407239432,0,1,0,0,1
1407385428,0,1,0,0,1
1440994105,0,1,0,0,1
1441247401,0,1,0,0,1
1390562676,0,1,0,0,1
1472108646,0,1,0,0,1
1472735798,0,0,1,0,1
1472890820,0,1,0,0,1
1472922344,0,0,0,1,1
1473058052,0,1,0,0,1
1473249066,0,1,0,0,1
1473329989,1,0,0,0,1
1473900272,0,1,0,0,1
1474238790,0,1,0,0,1
1474794980,0,1,0,0,1
1475143386,0,1,0,0,1
1475596838,0,1,0,0,1
1475797860,1,0,0,0,1
1475934962,0,1,0,0,1
1476010452,0,1,0,0,1
1476658802,1,0,0,0,1
1476683024,0,1,0,0,1
1477147614,0,1,0,0,1
1477226010,0,1,0,0,1
1477322257,1,0,0,0,1
1477408754,0,1,0,0,1
1477454756,0,1,0,0,1
1477825088,0,1,0,0,1
1477936494,0,1,0,0,1
1472399882,1,0,0,0,1
1472044321,0,1,0,0,1
1441406083,0,1,0,0,1
1471864544,0,1,0,0,1
1468551757,0,1,0,0,1
1468677638,0,1,0,0,1
1468993746,0,1,0,0,1
1469086844,0,1,0,0,1
1469532156,1,0,0,0,1
1469693862,0,1,0,0,1
1469767153,1,0,0,0,1
1469929346,0,1,0,0,1
1469982290,0,1,0,0,1
1469996108,0,0,1,0,1
1470296197,1,0,0,0,1
1470308395,1,0,0,0,1
1470315270,0,1,0,0,1
1470470502,0,1,0,0,1
1470586742,0,1,0,0,1
1471019448,0,1,0,0,1
1471303448,0,1,0,0,1
1471354346,1,0,0,0,1
1471447304,0,1,0,0,1
1471466226,0,1,0,0,1
1471599270,0,1,0,0,1
1471608194,0,1,0,0,1
1471856263,0,1,0,0,1
1478028571,0,0,1,0,1
1478189000,0,1,0,0,1
1478624120,0,1,0,0,1
1478804881,1,0,0,0,1
1486802281,0,1,0,0,1
1486851750,0,1,0,0,1
1487209885,1,0,0,0,1
1487391708,0,1,0,0,1
1488591823,0,1,0,0,1
1489293445,0,1,0,0,1
1489831333,0,1,0,0,1
1490096744,0,0,0,1,1
1490402382,1,0,0,0,1
1490699312,1,0,0,0,1
1490768737,0,1,0,0,1
1490782549,0,1,0,0,1
1490786448,0,0,0,1,1
1490816180,0,1,0,0,1
1490845458,0,1,0,0,1
1491151656,0,1,0,0,1
1491978823,0,1,0,0,1
1492012374,0,1,0,0,1
1492020625,0,1,0,0,1
1492128583,0,0,0,1,1
1492727438,0,1,0,0,1
1492767318,0,1,0,0,1
1493081893,0,1,0,0,1
1486725678,1,0,0,0,1
1486269601,0,1,0,0,1
1485964106,1,0,0,0,1
1481660821,0,1,0,0,1
1479269467,0,0,0,1,1
1479315714,0,1,0,0,1
1479520231,0,1,0,0,1
1479530815,0,1,0,0,1
1480058616,0,1,0,0,1
1480289149,0,1,0,0,1
1480462459,1,0,0,0,1
1480465248,0,1,0,0,1
1480478784,0,1,0,0,1
1481417456,0,1,0,0,1
1481875442,0,1,0,0,1
1485747955,0,1,0,0,1
1482348278,0,1,0,0,1
1482390786,0,1,0,0,1
1482869419,0,1,0,0,1
1482916825,0,1,0,0,1
1483847114,0,1,0,0,1
1484073606,0,0,0,1,1
1484738353,0,0,0,1,1
1485589862,1,0,0,0,1
1485601435,0,1,0,0,1
1485723204,0,1,0,0,1
1468443032,1,0,0,0,1
1468259971,0,1,0,0,1
1468099410,1,0,0,0,1
1453729956,0,1,0,0,1
1446204877,1,0,0,0,1
1446220566,0,1,0,0,1
1446291427,0,1,0,0,1
1446819578,0,1,0,0,1
1446917773,0,1,0,0,1
1446933504,0,1,0,0,1
1447058509,0,1,0,0,1
1447071440,1,0,0,0,1
1447268928,0,1,0,0,1
1447903272,0,1,0,0,1
1447921878,0,1,0,0,1
1448820798,0,1,0,0,1
1449049974,1,0,0,0,1
1449107713,0,1,0,0,1
1449261560,0,1,0,0,1
1449488359,0,1,0,0,1
1450001076,0,1,0,0,1
1450006598,0,1,0,0,1
1450086518,0,0,1,0,1
1450542336,0,1,0,0,1
1450999958,0,1,0,0,1
1451500560,0,1,0,0,1
1451686123,0,1,0,0,1
1446134971,0,1,0,0,1
1446086550,0,1,0,0,1
1446064406,0,1,0,0,1
1443296172,0,1,0,0,1
1441513748,1,0,0,0,1
1441892899,0,1,0,0,1
1442053597,1,0,0,0,1
1442124745,0,1,0,0,1
1442131008,0,1,0,0,1
1442340529,1,0,0,0,1
1442345587,0,1,0,0,1
1442452698,0,1,0,0,1
1442484638,0,1,0,0,1
1443255854,0,1,0,0,1
1443870516,0,1,0,0,1
1446060613,1,0,0,0,1
1443939966,0,1,0,0,1
1444140662,0,1,0,0,1
1444264705,0,1,0,0,1
1444636710,1,0,0,0,1
1444752530,0,1,0,0,1
1445093496,1,0,0,0,1
1445104332,0,0,0,1,1
1445372666,1,0,0,0,1
1445772180,0,1,0,0,1
1445899525,0,1,0,0,1
1453245565,0,1,0,0,1
1454062530,0,1,0,0,1
1467386509,0,1,0,0,1
1454600642,0,1,0,0,1
1461695876,0,1,0,0,1
1461890670,0,1,0,0,1
1461938256,0,1,0,0,1
1462152643,1,0,0,0,1
1462464926,0,1,0,0,1
1462878666,0,1,0,0,1
1463026794,0,1,0,0,1
1463119027,1,0,0,0,1
1463119274,0,1,0,0,1
1463712252,0,1,0,0,1
1463936023,0,1,0,0,1
1464409536,0,1,0,0,1
1464703598,1,0,0,0,1
1464788840,0,1,0,0,1
1464870229,0,1,0,0,1
1465741808,0,1,0,0,1
1465799976,0,1,0,0,1
1465874148,0,1,0,0,1
1466108634,0,1,0,0,1
1466459964,0,1,0,0,1
1466906936,0,1,0,0,1
1467303032,0,0,1,0,1
1467353827,0,1,0,0,1
1461633692,0,1,0,0,1
1461439261,0,1,0,0,1
1461400664,0,1,0,0,1
1457924203,0,1,0,0,1
1454907175,0,1,0,0,1
1454945269,0,1,0,0,1
1455311810,0,1,0,0,1
1455715195,0,1,0,0,1
1456196845,1,0,0,0,1
1456323932,0,1,0,0,1
1456336886,0,1,0,0,1
1456651610,0,1,0,0,1
1456913000,0,1,0,0,1
1457588100,0,1,0,0,1
1457927184,0,1,0,0,1
1460915450,0,1,0,0,1
1457974662,0,1,0,0,1
1458210247,0,1,0,0,1
1458558060,0,1,0,0,1
1458602269,0,1,0,0,1
1458655500,0,1,0,0,1
1459508839,0,1,0,0,1
1459577755,0,1,0,0,1
1460154884,1,0,0,0,1
1460486252,0,1,0,0,1
1460542988,0,1,0,0,1
1391299076,0,1,0,0,1
1390561968,0,1,0,0,1
1304639208,0,1,0,0,1
1330320152,0,1,0,0,1
1330901472,0,1,0,0,1
1331030630,0,1,0,0,1
1331236176,0,1,0,0,1
1331390070,1,0,0,0,1
1331941586,0,1,0,0,1
1332077382,1,0,0,0,1
1332141055,0,1,0,0,1
1332239988,0,1,0,0,1
1332327606,0,1,0,0,1
1332409644,0,1,0,0,1
1333315370,0,1,0,0,1
1333554517,0,1,0,0,1
1333616906,0,1,0,0,1
1333798669,0,0,1,0,1
1333916858,0,0,1,0,1
1334037974,0,1,0,0,1
1334181440,0,1,0,0,1
1334243653,0,1,0,0,1
1334364955,0,1,0,0,1
1334371904,0,1,0,0,1
1334914352,0,0,0,1,1
1334985288,0,1,0,0,1
1334993402,0,1,0,0,1
1330738112,0,0,0,1,1
1330207580,0,1,0,0,1
1347496124,1,0,0,0,1
1330155186,0,1,0,0,1
1326967070,0,1,0,0,1
1327042500,0,1,0,0,1
1327133868,0,1,0,0,1
1327301012,0,1,0,0,1
1327491464,0,1,0,0,1
1327581932,0,1,0,0,1
1327833974,0,0,0,1,1
1327972998,0,1,0,0,1
1328059987,0,1,0,0,1
1328456029,1,0,0,0,1
1328674080,0,1,0,0,1
1328871265,0,1,0,0,1
1329077527,0,1,0,0,1
1329143510,0,1,0,0,1
1329226152,0,1,0,0,1
1329326204,0,1,0,0,1
1329356977,0,1,0,0,1
1329361213,0,1,0,0,1
1329372456,0,1,0,0,1
1329394754,0,1,0,0,1
1329529915,0,1,0,0,1
1329591889,0,1,0,0,1
1329680580,0,1,0,0,1
1335417415,0,1,0,0,1
1335434707,0,1,0,0,1
1335531540,1,0,0,0,1
1335798212,0,1,0,0,1
1342401062,0,1,0,0,1
1342631718,0,1,0,0,1
1342713768,0,1,0,0,1
1342822272,1,0,0,0,1
1342889220,0,1,0,0,1
1344256530,0,1,0,0,1
1344318074,0,1,0,0,1
1344505094,0,1,0,0,1
1344587053,0,1,0,0,1
1344782732,0,1,0,0,1
1344805928,0,1,0,0,1
1345134451,1,0,0,0,1
1345235948,0,1,0,0,1
1345438626,0,1,0,0,1
1345496029,0,1,0,0,1
1345881127,0,1,0,0,1
1345996543,0,1,0,0,1
1346099389,0,1,0,0,1
1346197489,0,1,0,0,1
1346266394,0,1,0,0,1
1346368122,1,0,0,0,1
1346526894,0,1,0,0,1
1347172465,1,0,0,0,1
1342219501,0,1,0,0,1
1341809990,0,1,0,0,1
1340990569,0,1,0,0,1
1337226882,0,1,0,0,1
1335861955,0,1,0,0,1
1335984504,0,1,0,0,1
1336334690,0,1,0,0,1
1336375393,0,1,0,0,1
1336419704,0,1,0,0,1
1336460454,0,1,0,0,1
1336715544,1,0,0,0,1
1336767644,0,1,0,0,1
1336788278,0,1,0,0,1
1336801411,0,0,1,0,1
1337574758,0,1,0,0,1
1340288743,0,1,0,0,1
1337666808,0,1,0,0,1
1337999496,0,1,0,0,1
1338263766,0,1,0,0,1
1338406920,0,1,0,0,1
1338614814,0,1,0,0,1
1338758491,0,1,0,0,1
1338762896,0,1,0,0,1
1338892022,0,0,0,1,1
1338908707,0,1,0,0,1
1339585694,1,0,0,0,1
1326929953,0,1,0,0,1
1326780398,0,1,0,0,1
1326613848,0,1,0,0,1
1317763201,0,1,0,0,1
1313635662,1,0,0,0,1
1313716068,0,1,0,0,1
1313984042,0,1,0,0,1
1314135505,0,1,0,0,1
1314237307,0,1,0,0,1
1314487532,0,1,0,0,1
1314709250,0,1,0,0,1
1315329163,0,1,0,0,1
1315373798,0,1,0,0,1
1315448017,0,1,0,0,1
1315753123,0,1,0,0,1
1315855098,0,1,0,0,1
1316007925,0,1,0,0,1
1316156635,0,1,0,0,1
1316475642,0,0,0,1,1
1316537664,0,1,0,0,1
1316580654,0,1,0,0,1
1316585378,0,1,0,0,1
1316602694,0,1,0,0,1
1316610823,0,1,0,0,1
1316658380,0,1,0,0,1
1316843857,0,1,0,0,1
1317291414,0,1,0,0,1
1313522929,0,1,0,0,1
1313458081,0,1,0,0,1
1312927069,0,1,0,0,1
1308376885,0,1,0,0,1
1305673812,0,1,0,0,1
1305893689,0,1,0,0,1
1306009328,0,1,0,0,1
1307314884,0,1,0,0,1
1307491405,0,1,0,0,1
1307513166,0,1,0,0,1
1307589469,0,1,0,0,1
1307631529,0,1,0,0,1
1307635921,0,1,0,0,1
1308168762,0,1,0,0,1
1308673675,0,1,0,0,1
1311948732,0,1,0,0,1
1308727603,0,1,0,0,1
1310381732,1,0,0,0,1
1310385030,0,1,0,0,1
1310402162,0,1,0,0,1
1311087422,1,0,0,0,1
1311089827,1,0,0,0,1
1311369162,1,0,0,0,1
1311420488,0,1,0,0,1
1311514867,1,0,0,0,1
1311687600,0,1,0,0,1
1317721999,0,1,0,0,1
1318066669,0,1,0,0,1
1326561031,0,0,0,1,1
1318097737,0,1,0,0,1
1322587315,0,1,0,0,1
1322607757,0,1,0,0,1
1323060438,0,1,0,0,1
1323091795,0,1,0,0,1
1323189030,0,1,0,0,1
1323237762,0,1,0,0,1
1323300486,0,1,0,0,1
1323727632,0,1,0,0,1
1323757002,0,1,0,0,1
1323842544,1,0,0,0,1
1323882326,1,0,0,0,1
1323976818,0,1,0,0,1
1324019023,0,1,0,0,1
1324066586,0,1,0,0,1
1324170252,0,1,0,0,1
1324297788,1,0,0,0,1
1324736137,0,1,0,0,1
1325024886,0,1,0,0,1
1325333893,0,1,0,0,1
1325348076,0,1,0,0,1
1326219354,0,1,0,0,1
1326226345,0,1,0,0,1
1326358754,1,0,0,0,1
1322543941,0,1,0,0,1
1322463840,1,0,0,0,1
1322393514,0,1,0,0,1
1319923434,1,0,0,0,1
1318133942,0,1,0,0,1
1318217952,0,0,0,1,1
1318380067,0,1,0,0,1
1318656314,0,1,0,0,1
1318748778,0,0,1,0,1
1318946011,0,1,0,0,1
1318975081,0,1,0,0,1
1319343536,0,1,0,0,1
1319595066,0,1,0,0,1
1319816078,0,0,0,1,1
1319965194,0,1,0,0,1
1322197670,0,1,0,0,1
1320201884,0,1,0,0,1
1320224101,1,0,0,0,1
1320339271,0,1,0,0,1
1320372781,0,1,0,0,1
1320384402,1,0,0,0,1
1320386209,0,1,0,0,1
1320680588,0,1,0,0,1
1320774902,0,1,0,0,1
1321916790,0,1,0,0,1
1322129689,0,1,0,0,1
1347344792,0,1,0,0,1
1347569732,0,1,0,0,1
1389588673,0,1,0,0,1
1373047758,0,1,0,0,1
1373138118,0,1,0,0,1
1373273234,0,1,0,0,1
1373314729,0,1,0,0,1
1373681184,0,1,0,0,1
1374047570,0,1,0,0,1
1374089244,0,1,0,0,1
1374261745,0,1,0,0,1
1374646453,0,1,0,0,1
1374691927,0,1,0,0,1
1374825404,1,0,0,0,1
1374844333,1,0,0,0,1
1375098068,0,1,0,0,1
1375293577,0,1,0,0,1
1375823418,0,1,0,0,1
1375861262,0,1,0,0,1
1375985810,0,1,0,0,1
1376091272,0,1,0,0,1
1376447690,0,1,0,0,1
1376781655,0,1,0,0,1
1377003895,1,0,0,0,1
1377136308,0,1,0,0,1
1377255762,0,1,0,0,1
1377541238,0,1,0,0,1
1373132725,0,1,0,0,1
1372953144,0,1,0,0,1
1347811669,0,1,0,0,1
1372892166,0,1,0,0,1
1368302030,0,1,0,0,1
1369025263,0,1,0,0,1
1369068458,0,1,0,0,1
1369341750,1,0,0,0,1
1370040475,0,1,0,0,1
1370156850,0,1,0,0,1
1370223962,0,1,0,0,1
1370396190,0,1,0,0,1
1370476886,0,1,0,0,1
1370605363,0,1,0,0,1
1370721852,0,1,0,0,1
1370818670,1,0,0,0,1
1371142633,1,0,0,0,1
1371188174,0,1,0,0,1
1371346676,0,1,0,0,1
1371533862,0,1,0,0,1
1371593258,0,1,0,0,1
1371650910,0,0,0,1,1
1371806995,0,1,0,0,1
1371838129,0,1,0,0,1
1372154484,1,0,0,0,1
1372300784,0,1,0,0,1
1372464902,0,1,0,0,1
1377564290,0,1,0,0,1
1377583435,0,1,0,0,1
1377610592,0,1,0,0,1
1377735108,0,1,0,0,1
1383682784,0,1,0,0,1
1384028648,0,1,0,0,1
1384384424,0,1,0,0,1
1384411184,0,1,0,0,1
1384592844,0,1,0,0,1
1384681364,0,1,0,0,1
1384828974,0,1,0,0,1
1385173843,1,0,0,0,1
1386184428,0,1,0,0,1
1386196662,0,1,0,0,1
1386619502,0,1,0,0,1
1386624901,0,1,0,0,1
1387227974,0,1,0,0,1
1387388706,0,1,0,0,1
1387569313,0,1,0,0,1
1387737205,0,1,0,0,1
1388357792,0,1,0,0,1
1388360870,0,1,0,0,1
1388854795,0,1,0,0,1
1389350762,0,1,0,0,1
1389396872,0,1,0,0,1
1389438278,1,0,0,0,1
1389501931,1,0,0,0,1
1383621650,0,1,0,0,1
1383386605,0,1,0,0,1
1383210816,0,1,0,0,1
1380893342,1,0,0,0,1
1378009178,0,0,1,0,1
1378555610,1,0,0,0,1
1378568700,0,1,0,0,1
1378600585,0,1,0,0,1
1378704643,0,1,0,0,1
1378829070,1,0,0,0,1
1378844276,1,0,0,0,1
1379900528,0,1,0,0,1
1380628428,0,1,0,0,1
1380772248,0,1,0,0,1
1381025108,0,1,0,0,1
1383126888,0,1,0,0,1
1381278439,1,0,0,0,1
1381551204,0,1,0,0,1
1381610659,0,1,0,0,1
1381636404,1,0,0,0,1
1381690255,0,1,0,0,1
1382273138,0,1,0,0,1
1382630126,0,1,0,0,1
1382793386,0,1,0,0,1
1382894354,0,1,0,0,1
1383062868,0,1,0,0,1
1367655900,0,1,0,0,1
1367530219,0,1,0,0,1
1367302226,0,1,0,0,1
1356961332,0,1,0,0,1
1352973302,0,1,0,0,1
1353176904,1,0,0,0,1
1353271416,0,1,0,0,1
1353440216,0,1,0,0,1
1353463476,1,0,0,0,1
1353812106,0,1,0,0,1
1353821396,1,0,0,0,1
1353826602,0,1,0,0,1
1354140470,0,1,0,0,1
1354207861,0,1,0,0,1
1354287337,0,1,0,0,1
1354430420,0,1,0,0,1
1354940034,1,0,0,0,1
1355218452,1,0,0,0,1
1355320849,1,0,0,0,1
1355478690,0,1,0,0,1
1355715434,0,1,0,0,1
1355862728,1,0,0,0,1
1355864328,0,1,0,0,1
1356185149,1,0,0,0,1
1356190034,0,1,0,0,1
1356634735,0,1,0,0,1
1356648518,0,1,0,0,1
1352747408,0,1,0,0,1
1352630378,0,1,0,0,1
1352578878,1,0,0,0,1
1349999419,0,1,0,0,1
1347836504,0,1,0,0,1
1347875294,0,1,0,0,1
1348425925,0,1,0,0,1
1348687224,0,1,0,0,1
1349021318,0,1,0,0,1
1349349786,0,1,0,0,1
1349666131,0,1,0,0,1
1349717305,0,1,0,0,1
1349846588,0,0,1,0,1
1349915514,0,1,0,0,1
1350044414,0,1,0,0,1
1352332688,1,0,0,0,1
1350103176,0,1,0,0,1
1350490724,0,1,0,0,1
1350905654,0,1,0,0,1
1351257036,0,1,0,0,1
1351285573,0,1,0,0,1
1351424377,0,1,0,0,1
1351522272,0,1,0,0,1
1351534183,0,0,0,1,1
1351621272,1,0,0,0,1
1351667317,0,1,0,0,1
1356843019,1,0,0,0,1
1357089205,0,1,0,0,1
1367119082,0,1,0,0,1
1357597333,0,1,0,0,1
1362555728,0,1,0,0,1
1362564518,0,1,0,0,1
1362833605,0,1,0,0,1
1362861528,0,1,0,0,1
1363237574,0,1,0,0,1
1363290452,0,1,0,0,1
1363742172,0,0,0,1,1
1363817280,0,1,0,0,1
1363919330,0,1,0,0,1
1364222018,0,1,0,0,1
1364380482,0,1,0,0,1
1364558228,0,1,0,0,1
1365059208,0,1,0,0,1
1365066307,0,0,0,1,1
1365175729,0,1,0,0,1
1365236959,0,1,0,0,1
1365365545,0,1,0,0,1
1365415658,0,0,0,1,1
1365426169,1,0,0,0,1
1365564739,0,1,0,0,1
1365863611,0,1,0,0,1
1366307209,0,1,0,0,1
1366414879,0,1,0,0,1
1361985366,0,0,0,1,1
1361339766,1,0,0,0,1
1360931047,0,1,0,0,1
1358951946,0,1,0,0,1
1357702062,0,1,0,0,1
1357737690,0,1,0,0,1
1357756776,0,1,0,0,1
1357780663,1,0,0,0,1
1357952856,0,1,0,0,1
1357958744,0,1,0,0,1
1358165268,0,1,0,0,1
1358936678,1,0,0,0,1
1358944273,0,1,0,0,1
1358949950,1,0,0,0,1
1359042271,0,1,0,0,1
1360882183,0,1,0,0,1
1359078091,0,1,0,0,1
1359120289,1,0,0,0,1
1359361290,0,0,1,0,1
1359363510,0,1,0,0,1
1359385039,0,1,0,0,1
1359531462,0,1,0,0,1
1359542971,1,0,0,0,1
1359803707,0,1,0,0,1
1359924350,1,0,0,0,1
1360270746,1,0,0,0,1
1552616183714676736,0,0,1,0,1
