,norigins,nretweets,nquotes,nreplies,ntotal
0,32,575,0,7,614
1,386,2,107,48,543
2,2,416,0,3,421
3,5,0,2,374,381
4,1,346,1,0,348
5,3,303,0,0,306
6,175,85,8,7,275
7,221,0,1,34,256
8,20,0,0,230,250
9,1,236,0,0,237
10,215,7,2,0,224
11,0,199,0,0,199
12,1,179,0,2,182
13,98,6,69,5,178
14,7,135,0,31,173
15,1,151,4,3,159
16,0,153,0,0,153
17,0,145,0,5,150
18,2,145,0,0,147
19,1,134,0,0,135
20,0,120,0,2,122
21,0,0,1,118,119
22,3,109,2,3,117
23,0,116,0,0,116
24,3,0,0,105,108
25,5,87,2,6,100
26,2,97,0,0,99
27,0,98,0,0,98
28,0,95,0,0,95
29,0,92,0,0,92
30,0,89,0,0,89
31,0,88,0,0,88
32,0,85,0,0,85
33,81,0,3,0,84
34,0,83,0,0,83
35,0,79,0,0,79
36,1,78,0,0,79
37,2,69,1,6,78
38,2,73,1,0,76
39,0,72,0,2,74
40,71,0,0,0,71
41,0,71,0,0,71
42,18,1,50,1,70
43,1,67,0,2,70
44,1,63,3,3,70
45,3,66,0,0,69
46,15,53,0,0,68
47,0,67,0,0,67
48,1,63,0,0,64
49,0,62,0,0,62
50,0,60,0,0,60
51,0,60,0,0,60
52,3,29,5,22,59
53,0,58,0,0,58
54,2,54,0,0,56
55,0,56,0,0,56
56,0,56,0,0,56
57,0,54,0,0,54
58,0,52,0,0,52
59,42,2,0,6,50
60,0,50,0,0,50
61,0,49,0,0,49
62,0,47,0,0,47
63,0,0,1,46,47
64,0,47,0,0,47
65,0,46,0,0,46
66,1,43,1,0,45
67,0,44,0,0,44
68,0,44,0,0,44
69,0,43,0,0,43
70,16,13,1,13,43
71,0,43,0,0,43
72,0,43,0,0,43
73,42,0,0,0,42
74,3,39,0,0,42
75,0,42,0,0,42
76,0,42,0,0,42
77,1,40,0,0,41
78,0,41,0,0,41
79,0,41,0,0,41
80,0,41,0,0,41
81,0,40,0,0,40
82,0,40,0,0,40
83,0,40,0,0,40
84,18,16,1,5,40
85,1,0,0,39,40
86,1,39,0,0,40
87,0,40,0,0,40
88,0,40,0,0,40
89,0,39,0,0,39
90,0,39,0,0,39
91,39,0,0,0,39
92,0,39,0,0,39
93,0,38,0,0,38
94,0,38,0,0,38
95,0,37,0,0,37
96,0,37,0,0,37
97,1,35,0,0,36
98,0,0,0,36,36
99,0,36,0,0,36
100,0,36,0,0,36
101,2,0,0,34,36
102,0,36,0,0,36
103,0,36,0,0,36
104,0,36,0,0,36
105,0,36,0,0,36
106,2,34,0,0,36
107,0,35,0,0,35
108,0,35,0,0,35
109,0,35,0,0,35
110,0,34,1,0,35
111,35,0,0,0,35
112,2,32,0,0,34
113,0,34,0,0,34
114,0,34,0,0,34
115,2,31,0,1,34
116,0,34,0,0,34
117,0,0,0,34,34
118,0,34,0,0,34
119,7,26,0,0,33
120,5,28,0,0,33
121,3,30,0,0,33
122,32,1,0,0,33
123,0,33,0,0,33
124,1,32,0,0,33
125,0,32,0,0,32
126,2,30,0,0,32
127,0,32,0,0,32
128,0,32,0,0,32
129,3,26,3,0,32
130,0,32,0,0,32
131,0,31,0,0,31
132,31,0,0,0,31
133,1,30,0,0,31
134,0,31,0,0,31
135,0,31,0,0,31
136,0,31,0,0,31
137,0,30,0,0,30
138,0,30,0,0,30
139,1,25,2,2,30
140,0,29,0,0,29
141,2,27,0,0,29
142,1,26,1,1,29
143,0,29,0,0,29
144,0,29,0,0,29
145,0,8,0,21,29
146,0,29,0,0,29
147,1,0,1,27,29
148,29,0,0,0,29
149,4,19,6,0,29
150,0,28,0,0,28
151,0,28,0,0,28
152,0,28,0,0,28
153,0,26,2,0,28
154,11,17,0,0,28
155,1,27,0,0,28
156,0,22,0,6,28
157,0,28,0,0,28
158,0,28,0,0,28
159,0,28,0,0,28
160,1,26,0,0,27
161,3,22,2,0,27
162,0,27,0,0,27
163,0,27,0,0,27
164,0,27,0,0,27
165,0,27,0,0,27
166,0,27,0,0,27
167,1,26,0,0,27
168,0,27,0,0,27
169,0,27,0,0,27
170,0,22,0,4,26
171,0,26,0,0,26
172,0,26,0,0,26
173,0,26,0,0,26
174,0,26,0,0,26
175,0,26,0,0,26
176,0,26,0,0,26
177,0,26,0,0,26
178,0,26,0,0,26
179,0,26,0,0,26
180,3,21,0,2,26
181,1,4,20,0,25
182,0,25,0,0,25
183,0,25,0,0,25
184,24,1,0,0,25
185,1,22,0,2,25
186,0,25,0,0,25
187,6,19,0,0,25
188,19,0,0,6,25
189,0,24,0,0,24
190,0,24,0,0,24
191,0,24,0,0,24
192,2,22,0,0,24
193,0,24,0,0,24
194,0,24,0,0,24
195,0,24,0,0,24
196,0,24,0,0,24
197,0,23,0,0,23
198,0,23,0,0,23
199,0,23,0,0,23
200,0,23,0,0,23
201,2,21,0,0,23
202,0,23,0,0,23
203,20,2,1,0,23
204,23,0,0,0,23
205,0,23,0,0,23
206,0,23,0,0,23
207,0,22,0,1,23
208,0,23,0,0,23
209,0,23,0,0,23
210,0,23,0,0,23
211,0,23,0,0,23
212,0,23,0,0,23
213,0,22,1,0,23
214,0,22,0,1,23
215,0,23,0,0,23
216,0,23,0,0,23
217,0,23,0,0,23
218,0,22,0,0,22
219,0,22,0,0,22
220,0,22,0,0,22
221,0,22,0,0,22
222,4,10,0,8,22
223,0,22,0,0,22
224,0,22,0,0,22
225,0,22,0,0,22
226,0,22,0,0,22
227,0,19,0,3,22
228,2,0,20,0,22
229,1,5,0,16,22
230,0,22,0,0,22
231,0,21,0,0,21
232,3,16,2,0,21
233,0,21,0,0,21
234,1,20,0,0,21
235,0,21,0,0,21
236,0,21,0,0,21
237,0,21,0,0,21
238,0,21,0,0,21
239,0,21,0,0,21
240,0,21,0,0,21
241,15,5,0,1,21
242,0,21,0,0,21
243,0,21,0,0,21
244,0,20,0,0,20
245,8,12,0,0,20
246,8,8,0,4,20
247,0,20,0,0,20
248,5,9,6,0,20
249,0,20,0,0,20
250,2,9,1,8,20
251,0,20,0,0,20
252,0,20,0,0,20
253,0,20,0,0,20
254,0,20,0,0,20
255,0,20,0,0,20
256,1,17,2,0,20
257,0,20,0,0,20
258,4,16,0,0,20
259,0,20,0,0,20
260,0,20,0,0,20
261,0,20,0,0,20
262,0,20,0,0,20
263,0,20,0,0,20
264,1,19,0,0,20
265,0,20,0,0,20
266,0,0,0,20,20
267,6,1,0,13,20
268,20,0,0,0,20
269,0,19,0,0,19
270,8,6,5,0,19
271,0,19,0,0,19
272,0,1,18,0,19
273,0,19,0,0,19
274,0,18,1,0,19
275,0,19,0,0,19
276,0,19,0,0,19
277,0,19,0,0,19
278,3,15,1,0,19
279,0,0,0,19,19
280,0,19,0,0,19
281,19,0,0,0,19
282,0,19,0,0,19
283,0,19,0,0,19
284,0,18,0,0,18
285,0,18,0,0,18
286,0,18,0,0,18
287,0,18,0,0,18
288,0,18,0,0,18
289,0,18,0,0,18
290,0,18,0,0,18
291,0,18,0,0,18
292,0,18,0,0,18
293,0,18,0,0,18
294,5,13,0,0,18
295,0,18,0,0,18
296,8,10,0,0,18
297,0,18,0,0,18
298,0,15,3,0,18
299,12,0,0,6,18
300,0,18,0,0,18
301,0,18,0,0,18
302,0,18,0,0,18
303,0,18,0,0,18
304,0,18,0,0,18
305,0,18,0,0,18
306,0,18,0,0,18
307,2,16,0,0,18
308,0,18,0,0,18
309,0,18,0,0,18
310,0,17,0,0,17
311,0,17,0,0,17
312,17,0,0,0,17
313,0,17,0,0,17
314,1,16,0,0,17
315,0,17,0,0,17
316,0,17,0,0,17
317,0,14,0,3,17
318,0,17,0,0,17
319,0,17,0,0,17
320,0,17,0,0,17
321,0,17,0,0,17
322,0,17,0,0,17
323,4,1,2,10,17
324,0,17,0,0,17
325,1,16,0,0,17
326,0,17,0,0,17
327,0,17,0,0,17
328,0,17,0,0,17
329,0,17,0,0,17
330,0,17,0,0,17
331,0,17,0,0,17
332,0,16,0,0,16
333,0,16,0,0,16
334,0,16,0,0,16
335,0,16,0,0,16
336,0,16,0,0,16
337,0,16,0,0,16
338,10,6,0,0,16
339,0,16,0,0,16
340,0,16,0,0,16
341,16,0,0,0,16
342,0,16,0,0,16
343,0,16,0,0,16
344,1,7,0,8,16
345,0,16,0,0,16
346,0,16,0,0,16
347,0,16,0,0,16
348,0,16,0,0,16
349,0,16,0,0,16
350,0,16,0,0,16
351,0,0,4,12,16
352,16,0,0,0,16
353,12,1,3,0,16
354,0,16,0,0,16
355,1,15,0,0,16
356,0,16,0,0,16
357,3,10,1,2,16
358,0,0,16,0,16
359,0,16,0,0,16
360,0,16,0,0,16
361,0,16,0,0,16
362,0,16,0,0,16
363,0,16,0,0,16
364,0,16,0,0,16
365,0,16,0,0,16
366,1,13,1,1,16
367,0,16,0,0,16
368,0,15,0,0,15
369,0,15,0,0,15
370,0,15,0,0,15
371,15,0,0,0,15
372,0,15,0,0,15
373,0,15,0,0,15
374,0,15,0,0,15
375,0,15,0,0,15
376,0,15,0,0,15
377,0,15,0,0,15
378,0,15,0,0,15
379,0,15,0,0,15
380,0,15,0,0,15
381,0,15,0,0,15
382,0,15,0,0,15
383,0,15,0,0,15
384,0,15,0,0,15
385,0,15,0,0,15
386,0,15,0,0,15
387,0,15,0,0,15
388,0,15,0,0,15
389,0,15,0,0,15
390,2,0,0,13,15
391,0,15,0,0,15
392,0,15,0,0,15
393,0,15,0,0,15
394,0,15,0,0,15
395,10,5,0,0,15
396,0,15,0,0,15
397,2,1,7,5,15
398,1,14,0,0,15
399,0,15,0,0,15
400,0,15,0,0,15
401,0,15,0,0,15
402,0,14,0,0,14
403,0,14,0,0,14
404,0,14,0,0,14
405,0,14,0,0,14
406,0,13,0,1,14
407,0,14,0,0,14
408,0,14,0,0,14
409,1,13,0,0,14
410,0,0,0,14,14
411,0,14,0,0,14
412,0,14,0,0,14
413,0,14,0,0,14
414,0,14,0,0,14
415,0,14,0,0,14
416,0,14,0,0,14
417,14,0,0,0,14
418,0,14,0,0,14
419,0,14,0,0,14
420,0,14,0,0,14
421,2,12,0,0,14
422,0,14,0,0,14
423,0,12,2,0,14
424,0,14,0,0,14
425,1,8,0,5,14
426,0,14,0,0,14
427,0,14,0,0,14
428,13,0,0,1,14
429,0,14,0,0,14
430,0,14,0,0,14
431,0,13,0,1,14
432,4,10,0,0,14
433,14,0,0,0,14
434,1,13,0,0,14
435,0,10,0,4,14
436,0,13,1,0,14
437,2,12,0,0,14
438,0,14,0,0,14
439,0,14,0,0,14
440,0,14,0,0,14
441,0,13,0,0,13
442,1,11,1,0,13
443,0,13,0,0,13
444,0,13,0,0,13
445,0,13,0,0,13
446,0,13,0,0,13
447,2,7,2,2,13
448,0,13,0,0,13
449,0,13,0,0,13
450,5,8,0,0,13
451,4,9,0,0,13
452,0,13,0,0,13
453,0,13,0,0,13
454,0,13,0,0,13
455,0,13,0,0,13
456,0,13,0,0,13
457,0,13,0,0,13
458,0,8,0,5,13
459,0,13,0,0,13
460,1,12,0,0,13
461,0,13,0,0,13
462,0,13,0,0,13
463,0,13,0,0,13
464,0,13,0,0,13
465,0,13,0,0,13
466,0,13,0,0,13
467,0,13,0,0,13
468,0,13,0,0,13
469,1,11,1,0,13
470,0,13,0,0,13
471,0,13,0,0,13
472,0,13,0,0,13
473,13,0,0,0,13
474,0,13,0,0,13
475,0,13,0,0,13
476,0,13,0,0,13
477,0,13,0,0,13
478,0,13,0,0,13
479,0,13,0,0,13
480,0,13,0,0,13
481,0,13,0,0,13
482,0,13,0,0,13
483,0,13,0,0,13
484,0,13,0,0,13
485,1,0,0,12,13
486,0,13,0,0,13
487,0,12,0,0,12
488,0,12,0,0,12
489,2,3,7,0,12
490,0,12,0,0,12
491,0,12,0,0,12
492,10,0,1,1,12
493,0,12,0,0,12
494,0,12,0,0,12
495,0,12,0,0,12
496,0,12,0,0,12
497,0,12,0,0,12
498,0,12,0,0,12
499,0,12,0,0,12
500,0,12,0,0,12
501,0,12,0,0,12
502,0,12,0,0,12
503,0,12,0,0,12
504,12,0,0,0,12
505,0,12,0,0,12
506,0,12,0,0,12
507,0,12,0,0,12
508,0,12,0,0,12
509,0,12,0,0,12
510,0,12,0,0,12
511,0,12,0,0,12
512,0,12,0,0,12
513,12,0,0,0,12
514,0,12,0,0,12
515,0,12,0,0,12
516,0,12,0,0,12
517,0,12,0,0,12
518,0,12,0,0,12
519,0,12,0,0,12
520,0,12,0,0,12
521,0,12,0,0,12
522,1,11,0,0,12
523,0,12,0,0,12
524,3,8,0,1,12
525,0,12,0,0,12
526,11,0,0,1,12
527,0,12,0,0,12
528,1,11,0,0,12
529,0,12,0,0,12
530,0,12,0,0,12
531,0,12,0,0,12
532,0,12,0,0,12
533,0,12,0,0,12
534,1,11,0,0,12
535,0,12,0,0,12
536,3,9,0,0,12
537,0,12,0,0,12
538,0,12,0,0,12
539,0,12,0,0,12
540,0,12,0,0,12
541,0,12,0,0,12
542,0,12,0,0,12
543,1,11,0,0,12
544,9,3,0,0,12
545,0,12,0,0,12
546,0,12,0,0,12
547,4,4,4,0,12
548,0,12,0,0,12
549,0,11,0,0,11
550,2,9,0,0,11
551,0,11,0,0,11
552,0,11,0,0,11
553,0,11,0,0,11
554,2,7,2,0,11
555,0,11,0,0,11
556,0,11,0,0,11
557,0,11,0,0,11
558,1,10,0,0,11
559,0,11,0,0,11
560,0,11,0,0,11
561,0,11,0,0,11
562,0,11,0,0,11
563,0,11,0,0,11
564,0,11,0,0,11
565,0,11,0,0,11
566,0,11,0,0,11
567,0,11,0,0,11
568,1,10,0,0,11
569,0,11,0,0,11
570,0,11,0,0,11
571,0,11,0,0,11
572,0,11,0,0,11
573,0,11,0,0,11
574,0,11,0,0,11
575,0,11,0,0,11
576,2,9,0,0,11
577,0,0,6,5,11
578,4,0,4,3,11
579,0,11,0,0,11
580,0,11,0,0,11
581,0,11,0,0,11
582,2,8,1,0,11
583,0,11,0,0,11
584,0,11,0,0,11
585,0,11,0,0,11
586,0,11,0,0,11
587,0,11,0,0,11
588,0,11,0,0,11
589,0,11,0,0,11
590,3,4,4,0,11
591,6,5,0,0,11
592,0,11,0,0,11
593,0,11,0,0,11
594,0,11,0,0,11
595,0,11,0,0,11
596,0,11,0,0,11
597,4,0,6,1,11
598,0,11,0,0,11
599,0,11,0,0,11
600,2,8,0,1,11
601,11,0,0,0,11
602,0,10,1,0,11
603,0,11,0,0,11
604,0,11,0,0,11
605,0,11,0,0,11
606,0,11,0,0,11
607,0,11,0,0,11
608,0,11,0,0,11
609,11,0,0,0,11
610,0,11,0,0,11
611,11,0,0,0,11
612,0,11,0,0,11
613,1,10,0,0,11
614,0,11,0,0,11
615,8,1,1,1,11
616,11,0,0,0,11
617,10,0,0,0,10
618,0,10,0,0,10
619,0,10,0,0,10
620,0,10,0,0,10
621,0,10,0,0,10
622,0,0,10,0,10
623,0,10,0,0,10
624,0,10,0,0,10
625,0,10,0,0,10
626,0,10,0,0,10
627,0,10,0,0,10
628,1,9,0,0,10
629,0,10,0,0,10
630,0,10,0,0,10
631,0,0,0,10,10
632,10,0,0,0,10
633,0,10,0,0,10
634,0,10,0,0,10
635,0,10,0,0,10
636,0,10,0,0,10
637,0,10,0,0,10
638,0,10,0,0,10
639,2,5,0,3,10
640,0,10,0,0,10
641,0,10,0,0,10
642,1,9,0,0,10
643,0,10,0,0,10
644,0,10,0,0,10
645,0,10,0,0,10
646,0,10,0,0,10
647,0,9,0,1,10
648,9,0,0,1,10
649,0,10,0,0,10
650,1,2,6,1,10
651,0,10,0,0,10
652,0,10,0,0,10
653,0,10,0,0,10
654,0,10,0,0,10
655,0,10,0,0,10
656,0,10,0,0,10
657,0,10,0,0,10
658,0,10,0,0,10
659,0,10,0,0,10
660,0,10,0,0,10
661,1,9,0,0,10
662,0,10,0,0,10
663,0,10,0,0,10
664,0,10,0,0,10
665,0,10,0,0,10
666,10,0,0,0,10
667,0,10,0,0,10
668,0,10,0,0,10
669,3,7,0,0,10
670,0,5,5,0,10
671,0,10,0,0,10
672,0,10,0,0,10
673,0,10,0,0,10
674,0,10,0,0,10
675,0,10,0,0,10
676,0,10,0,0,10
677,3,7,0,0,10
678,0,10,0,0,10
679,0,10,0,0,10
680,0,10,0,0,10
681,0,10,0,0,10
682,0,10,0,0,10
683,0,10,0,0,10
684,0,10,0,0,10
685,2,8,0,0,10
686,0,10,0,0,10
687,0,10,0,0,10
688,0,10,0,0,10
689,0,10,0,0,10
690,0,10,0,0,10
691,10,0,0,0,10
692,0,7,1,1,9
693,0,9,0,0,9
694,8,0,0,1,9
695,0,9,0,0,9
696,0,9,0,0,9
697,0,9,0,0,9
698,0,9,0,0,9
699,0,9,0,0,9
700,0,9,0,0,9
701,6,2,0,1,9
702,0,9,0,0,9
703,0,9,0,0,9
704,0,9,0,0,9
705,9,0,0,0,9
706,0,9,0,0,9
707,0,9,0,0,9
708,0,9,0,0,9
709,6,3,0,0,9
710,0,9,0,0,9
711,0,9,0,0,9
712,0,9,0,0,9
713,1,7,1,0,9
714,0,9,0,0,9
715,9,0,0,0,9
716,0,9,0,0,9
717,0,9,0,0,9
718,0,9,0,0,9
719,0,9,0,0,9
720,0,9,0,0,9
721,0,9,0,0,9
722,0,9,0,0,9
723,0,9,0,0,9
724,0,9,0,0,9
725,0,1,5,3,9
726,0,9,0,0,9
727,0,9,0,0,9
728,0,9,0,0,9
729,2,7,0,0,9
730,5,4,0,0,9
731,0,9,0,0,9
732,0,9,0,0,9
733,0,9,0,0,9
734,0,9,0,0,9
735,0,9,0,0,9
736,0,9,0,0,9
737,0,9,0,0,9
738,3,4,2,0,9
739,0,9,0,0,9
740,0,9,0,0,9
741,8,0,0,1,9
742,0,9,0,0,9
743,0,9,0,0,9
744,0,9,0,0,9
745,0,9,0,0,9
746,0,9,0,0,9
747,0,9,0,0,9
748,4,5,0,0,9
749,0,9,0,0,9
750,7,1,1,0,9
751,3,2,0,4,9
752,0,9,0,0,9
753,0,9,0,0,9
754,0,9,0,0,9
755,0,9,0,0,9
756,0,9,0,0,9
757,0,9,0,0,9
758,0,9,0,0,9
759,0,9,0,0,9
760,0,9,0,0,9
761,0,9,0,0,9
762,0,9,0,0,9
763,0,9,0,0,9
764,0,9,0,0,9
765,9,0,0,0,9
766,0,9,0,0,9
767,0,9,0,0,9
768,0,9,0,0,9
769,0,9,0,0,9
770,0,9,0,0,9
771,0,9,0,0,9
772,0,9,0,0,9
773,0,0,0,9,9
774,0,9,0,0,9
775,0,4,5,0,9
776,0,9,0,0,9
777,0,9,0,0,9
778,0,9,0,0,9
779,0,9,0,0,9
780,0,9,0,0,9
781,0,9,0,0,9
782,0,9,0,0,9
783,0,9,0,0,9
784,0,9,0,0,9
785,0,9,0,0,9
786,0,9,0,0,9
787,0,8,1,0,9
788,0,9,0,0,9
789,1,6,0,2,9
790,1,0,1,7,9
791,1,8,0,0,9
792,0,9,0,0,9
793,0,9,0,0,9
794,0,9,0,0,9
795,0,0,0,8,8
796,0,8,0,0,8
797,8,0,0,0,8
798,0,8,0,0,8
799,0,8,0,0,8
800,8,0,0,0,8
801,0,8,0,0,8
802,0,8,0,0,8
803,0,7,1,0,8
804,0,8,0,0,8
805,0,8,0,0,8
806,0,8,0,0,8
807,0,8,0,0,8
808,0,5,0,3,8
809,0,8,0,0,8
810,0,8,0,0,8
811,0,8,0,0,8
812,2,6,0,0,8
813,0,8,0,0,8
814,2,1,0,5,8
815,8,0,0,0,8
816,6,2,0,0,8
817,0,8,0,0,8
818,4,4,0,0,8
819,3,4,1,0,8
820,0,8,0,0,8
821,0,8,0,0,8
822,0,8,0,0,8
823,2,6,0,0,8
824,1,7,0,0,8
825,0,8,0,0,8
826,0,8,0,0,8
827,8,0,0,0,8
828,0,8,0,0,8
829,0,8,0,0,8
830,0,8,0,0,8
831,0,8,0,0,8
832,0,8,0,0,8
833,0,8,0,0,8
834,0,8,0,0,8
835,3,0,0,5,8
836,0,8,0,0,8
837,0,8,0,0,8
838,0,8,0,0,8
839,0,8,0,0,8
840,1,7,0,0,8
841,8,0,0,0,8
842,0,8,0,0,8
843,0,8,0,0,8
844,0,8,0,0,8
845,0,8,0,0,8
846,0,8,0,0,8
847,0,8,0,0,8
848,0,8,0,0,8
849,1,7,0,0,8
850,2,0,0,6,8
851,0,8,0,0,8
852,0,8,0,0,8
853,0,8,0,0,8
854,0,8,0,0,8
855,4,4,0,0,8
856,0,8,0,0,8
857,0,8,0,0,8
858,4,4,0,0,8
859,0,8,0,0,8
860,0,8,0,0,8
861,0,8,0,0,8
862,0,8,0,0,8
863,0,8,0,0,8
864,7,1,0,0,8
865,0,6,0,2,8
866,0,8,0,0,8
867,0,8,0,0,8
868,2,6,0,0,8
869,0,0,0,8,8
870,1,7,0,0,8
871,0,8,0,0,8
872,8,0,0,0,8
873,0,8,0,0,8
874,0,8,0,0,8
875,0,8,0,0,8
876,0,8,0,0,8
877,4,4,0,0,8
878,0,8,0,0,8
879,2,4,1,1,8
880,0,8,0,0,8
881,1,6,1,0,8
882,0,0,0,8,8
883,0,8,0,0,8
884,0,7,0,1,8
885,0,8,0,0,8
886,0,8,0,0,8
887,0,8,0,0,8
888,0,8,0,0,8
889,0,8,0,0,8
890,1,7,0,0,8
891,0,8,0,0,8
892,0,8,0,0,8
893,0,8,0,0,8
894,0,8,0,0,8
895,0,8,0,0,8
896,8,0,0,0,8
897,0,8,0,0,8
898,0,8,0,0,8
899,1,7,0,0,8
900,8,0,0,0,8
901,1,6,0,1,8
902,0,8,0,0,8
903,0,8,0,0,8
904,0,4,0,4,8
905,0,8,0,0,8
906,0,8,0,0,8
907,0,8,0,0,8
908,0,8,0,0,8
909,8,0,0,0,8
910,0,8,0,0,8
911,7,0,0,1,8
912,0,8,0,0,8
913,0,8,0,0,8
914,0,8,0,0,8
915,8,0,0,0,8
916,0,8,0,0,8
917,0,8,0,0,8
918,0,8,0,0,8
919,0,8,0,0,8
920,0,0,0,8,8
921,0,8,0,0,8
922,0,8,0,0,8
923,1,7,0,0,8
924,0,8,0,0,8
925,1,7,0,0,8
926,0,8,0,0,8
927,0,8,0,0,8
928,4,3,1,0,8
929,0,0,0,8,8
930,1,0,0,7,8
931,0,8,0,0,8
932,0,8,0,0,8
933,0,8,0,0,8
934,8,0,0,0,8
935,0,8,0,0,8
936,1,0,0,7,8
937,0,8,0,0,8
938,0,7,0,0,7
939,0,7,0,0,7
940,0,7,0,0,7
941,2,5,0,0,7
942,0,7,0,0,7
943,0,7,0,0,7
944,0,7,0,0,7
945,0,7,0,0,7
946,0,7,0,0,7
947,0,7,0,0,7
948,1,5,1,0,7
949,5,2,0,0,7
950,0,7,0,0,7
951,1,5,0,1,7
952,0,7,0,0,7
953,0,7,0,0,7
954,0,7,0,0,7
955,0,7,0,0,7
956,2,5,0,0,7
957,0,7,0,0,7
958,0,7,0,0,7
959,0,7,0,0,7
960,0,7,0,0,7
961,0,7,0,0,7
962,0,7,0,0,7
963,0,7,0,0,7
964,0,7,0,0,7
965,0,7,0,0,7
966,2,0,0,5,7
967,0,7,0,0,7
968,0,3,4,0,7
969,0,7,0,0,7
970,0,7,0,0,7
971,0,7,0,0,7
972,5,2,0,0,7
973,0,7,0,0,7
974,0,7,0,0,7
975,0,7,0,0,7
976,0,6,1,0,7
977,3,4,0,0,7
978,7,0,0,0,7
979,0,7,0,0,7
980,0,7,0,0,7
981,0,7,0,0,7
982,2,5,0,0,7
983,0,7,0,0,7
984,3,2,1,1,7
985,0,7,0,0,7
986,0,7,0,0,7
987,0,7,0,0,7
988,0,7,0,0,7
989,0,7,0,0,7
990,0,4,1,2,7
991,0,7,0,0,7
992,7,0,0,0,7
993,7,0,0,0,7
994,0,7,0,0,7
995,0,7,0,0,7
996,0,0,0,7,7
997,0,7,0,0,7
998,0,7,0,0,7
999,0,7,0,0,7
1000,0,7,0,0,7
1001,0,7,0,0,7
1002,0,7,0,0,7
1003,0,7,0,0,7
1004,0,7,0,0,7
1005,0,7,0,0,7
1006,0,7,0,0,7
1007,0,7,0,0,7
1008,0,7,0,0,7
1009,0,7,0,0,7
1010,0,7,0,0,7
1011,0,7,0,0,7
1012,2,5,0,0,7
1013,0,7,0,0,7
1014,0,7,0,0,7
1015,0,7,0,0,7
1016,0,7,0,0,7
1017,0,7,0,0,7
1018,0,7,0,0,7
1019,0,7,0,0,7
1020,0,7,0,0,7
1021,0,7,0,0,7
1022,0,7,0,0,7
1023,0,7,0,0,7
1024,0,7,0,0,7
1025,7,0,0,0,7
1026,0,7,0,0,7
1027,0,1,0,6,7
1028,0,7,0,0,7
1029,7,0,0,0,7
1030,0,7,0,0,7
1031,5,2,0,0,7
1032,0,7,0,0,7
1033,4,0,0,3,7
1034,1,5,1,0,7
1035,0,7,0,0,7
1036,0,7,0,0,7
1037,0,7,0,0,7
1038,2,4,0,1,7
1039,0,7,0,0,7
1040,0,7,0,0,7
1041,0,1,1,5,7
1042,0,7,0,0,7
1043,7,0,0,0,7
1044,0,7,0,0,7
1045,3,0,4,0,7
1046,0,7,0,0,7
1047,0,1,6,0,7
1048,0,7,0,0,7
1049,0,7,0,0,7
1050,0,7,0,0,7
1051,0,7,0,0,7
1052,0,7,0,0,7
1053,0,7,0,0,7
1054,0,7,0,0,7
1055,0,7,0,0,7
1056,0,7,0,0,7
1057,0,7,0,0,7
1058,0,4,1,2,7
1059,0,7,0,0,7
1060,0,7,0,0,7
1061,0,7,0,0,7
1062,1,4,0,2,7
1063,0,7,0,0,7
1064,1,6,0,0,7
1065,0,7,0,0,7
1066,1,5,0,1,7
1067,0,7,0,0,7
1068,0,7,0,0,7
1069,0,7,0,0,7
1070,1,6,0,0,7
1071,0,7,0,0,7
1072,0,7,0,0,7
1073,5,2,0,0,7
1074,1,6,0,0,7
1075,3,0,0,4,7
1076,0,7,0,0,7
1077,0,7,0,0,7
1078,0,7,0,0,7
1079,0,6,0,1,7
1080,0,7,0,0,7
1081,0,7,0,0,7
1082,0,7,0,0,7
1083,0,7,0,0,7
1084,0,7,0,0,7
1085,0,7,0,0,7
1086,0,7,0,0,7
1087,0,7,0,0,7
1088,0,6,0,1,7
1089,0,7,0,0,7
1090,0,7,0,0,7
1091,0,7,0,0,7
1092,0,7,0,0,7
1093,0,7,0,0,7
1094,0,7,0,0,7
1095,0,7,0,0,7
1096,0,7,0,0,7
1097,0,7,0,0,7
1098,1,6,0,0,7
1099,0,7,0,0,7
1100,1,6,0,0,7
1101,0,7,0,0,7
1102,0,7,0,0,7
1103,0,7,0,0,7
1104,0,7,0,0,7
1105,0,7,0,0,7
1106,4,3,0,0,7
1107,0,7,0,0,7
1108,0,3,4,0,7
1109,0,4,3,0,7
1110,0,1,1,5,7
1111,0,7,0,0,7
1112,0,7,0,0,7
1113,1,2,4,0,7
1114,0,7,0,0,7
1115,0,7,0,0,7
1116,0,7,0,0,7
1117,0,7,0,0,7
1118,0,7,0,0,7
1119,0,7,0,0,7
1120,0,7,0,0,7
1121,0,7,0,0,7
1122,0,7,0,0,7
1123,0,7,0,0,7
1124,0,5,1,0,6
1125,0,6,0,0,6
1126,1,5,0,0,6
1127,0,6,0,0,6
1128,0,6,0,0,6
1129,0,6,0,0,6
1130,0,6,0,0,6
1131,0,6,0,0,6
1132,5,0,0,1,6
1133,0,6,0,0,6
1134,0,6,0,0,6
1135,0,6,0,0,6
1136,0,6,0,0,6
1137,0,6,0,0,6
1138,3,1,2,0,6
1139,1,5,0,0,6
1140,0,6,0,0,6
1141,0,6,0,0,6
1142,0,6,0,0,6
1143,0,6,0,0,6
1144,0,6,0,0,6
1145,0,6,0,0,6
1146,0,6,0,0,6
1147,0,6,0,0,6
1148,0,6,0,0,6
1149,0,6,0,0,6
1150,0,6,0,0,6
1151,0,6,0,0,6
1152,0,5,0,1,6
1153,0,6,0,0,6
1154,0,6,0,0,6
1155,0,6,0,0,6
1156,0,6,0,0,6
1157,0,6,0,0,6
1158,0,6,0,0,6
1159,0,6,0,0,6
1160,0,6,0,0,6
1161,1,5,0,0,6
1162,0,6,0,0,6
1163,0,6,0,0,6
1164,0,6,0,0,6
1165,1,0,0,5,6
1166,0,6,0,0,6
1167,0,6,0,0,6
1168,0,6,0,0,6
1169,0,6,0,0,6
1170,0,6,0,0,6
1171,0,6,0,0,6
1172,0,4,0,2,6
1173,0,6,0,0,6
1174,1,5,0,0,6
1175,2,4,0,0,6
1176,0,6,0,0,6
1177,1,3,2,0,6
1178,0,6,0,0,6
1179,0,6,0,0,6
1180,0,6,0,0,6
1181,0,6,0,0,6
1182,0,6,0,0,6
1183,0,6,0,0,6
1184,0,6,0,0,6
1185,0,6,0,0,6
1186,0,6,0,0,6
1187,1,5,0,0,6
1188,0,6,0,0,6
1189,0,6,0,0,6
1190,6,0,0,0,6
1191,0,1,0,5,6
1192,0,6,0,0,6
1193,0,6,0,0,6
1194,1,5,0,0,6
1195,0,6,0,0,6
1196,0,6,0,0,6
1197,0,6,0,0,6
1198,4,0,0,2,6
1199,0,6,0,0,6
1200,0,6,0,0,6
1201,0,6,0,0,6
1202,0,6,0,0,6
1203,0,6,0,0,6
1204,0,6,0,0,6
1205,0,5,1,0,6
1206,0,6,0,0,6
1207,0,6,0,0,6
1208,0,6,0,0,6
1209,5,0,1,0,6
1210,0,6,0,0,6
1211,0,6,0,0,6
1212,1,5,0,0,6
1213,0,6,0,0,6
1214,1,0,0,5,6
1215,0,6,0,0,6
1216,0,6,0,0,6
1217,0,6,0,0,6
1218,0,6,0,0,6
1219,1,5,0,0,6
1220,0,6,0,0,6
1221,0,6,0,0,6
1222,1,5,0,0,6
1223,0,6,0,0,6
1224,0,6,0,0,6
1225,0,6,0,0,6
1226,1,5,0,0,6
1227,0,6,0,0,6
1228,0,6,0,0,6
1229,0,6,0,0,6
1230,0,5,0,1,6
1231,1,0,0,5,6
1232,0,6,0,0,6
1233,3,2,0,1,6
1234,1,5,0,0,6
1235,0,6,0,0,6
1236,2,0,0,4,6
1237,0,6,0,0,6
1238,0,6,0,0,6
1239,0,6,0,0,6
1240,2,4,0,0,6
1241,0,6,0,0,6
1242,0,6,0,0,6
1243,1,5,0,0,6
1244,0,6,0,0,6
1245,0,6,0,0,6
1246,0,6,0,0,6
1247,4,0,2,0,6
1248,0,6,0,0,6
1249,6,0,0,0,6
1250,0,6,0,0,6
1251,0,6,0,0,6
1252,0,6,0,0,6
1253,0,6,0,0,6
1254,1,5,0,0,6
1255,0,6,0,0,6
1256,0,6,0,0,6
1257,0,6,0,0,6
1258,0,6,0,0,6
1259,0,5,0,1,6
1260,1,5,0,0,6
1261,0,6,0,0,6
1262,1,5,0,0,6
1263,0,6,0,0,6
1264,0,6,0,0,6
1265,0,6,0,0,6
1266,3,3,0,0,6
1267,0,6,0,0,6
1268,2,3,0,1,6
1269,0,6,0,0,6
1270,0,6,0,0,6
1271,0,6,0,0,6
1272,0,6,0,0,6
1273,4,2,0,0,6
1274,6,0,0,0,6
1275,0,6,0,0,6
1276,0,6,0,0,6
1277,1,5,0,0,6
1278,0,6,0,0,6
1279,0,6,0,0,6
1280,0,6,0,0,6
1281,0,6,0,0,6
1282,0,6,0,0,6
1283,0,6,0,0,6
1284,0,6,0,0,6
1285,0,6,0,0,6
1286,0,5,1,0,6
1287,0,6,0,0,6
1288,6,0,0,0,6
1289,0,6,0,0,6
1290,0,6,0,0,6
1291,0,6,0,0,6
1292,1,0,0,5,6
1293,1,0,0,5,6
1294,0,6,0,0,6
1295,0,6,0,0,6
1296,0,6,0,0,6
1297,0,6,0,0,6
1298,0,6,0,0,6
1299,6,0,0,0,6
1300,0,6,0,0,6
1301,0,6,0,0,6
1302,0,6,0,0,6
1303,0,6,0,0,6
1304,0,6,0,0,6
1305,0,6,0,0,6
1306,0,6,0,0,6
1307,6,0,0,0,6
1308,0,6,0,0,6
1309,1,5,0,0,6
1310,6,0,0,0,6
1311,0,6,0,0,6
1312,0,6,0,0,6
1313,3,2,0,1,6
1314,0,6,0,0,6
1315,6,0,0,0,6
1316,6,0,0,0,6
1317,0,6,0,0,6
1318,0,6,0,0,6
1319,6,0,0,0,6
1320,0,6,0,0,6
1321,0,6,0,0,6
1322,0,6,0,0,6
1323,0,6,0,0,6
1324,0,6,0,0,6
1325,1,5,0,0,6
1326,0,6,0,0,6
1327,0,6,0,0,6
1328,0,6,0,0,6
1329,0,6,0,0,6
1330,0,6,0,0,6
1331,0,6,0,0,6
1332,0,6,0,0,6
1333,0,6,0,0,6
1334,0,6,0,0,6
1335,0,6,0,0,6
1336,0,6,0,0,6
1337,0,6,0,0,6
1338,0,6,0,0,6
1339,0,6,0,0,6
1340,6,0,0,0,6
1341,6,0,0,0,6
1342,0,6,0,0,6
1343,0,6,0,0,6
1344,0,6,0,0,6
1345,1,5,0,0,6
1346,0,6,0,0,6
1347,0,6,0,0,6
1348,0,6,0,0,6
1349,0,6,0,0,6
1350,0,6,0,0,6
1351,0,6,0,0,6
1352,0,6,0,0,6
1353,0,6,0,0,6
1354,0,6,0,0,6
1355,0,6,0,0,6
1356,0,6,0,0,6
1357,0,6,0,0,6
1358,6,0,0,0,6
1359,0,6,0,0,6
1360,6,0,0,0,6
1361,0,6,0,0,6
1362,0,6,0,0,6
1363,0,6,0,0,6
1364,6,0,0,0,6
1365,1,1,3,1,6
1366,0,6,0,0,6
1367,0,6,0,0,6
1368,0,6,0,0,6
1369,6,0,0,0,6
1370,0,6,0,0,6
1371,0,6,0,0,6
1372,0,6,0,0,6
1373,0,0,0,6,6
1374,3,3,0,0,6
1375,0,6,0,0,6
1376,0,6,0,0,6
1377,5,0,0,0,5
1378,0,5,0,0,5
1379,0,5,0,0,5
1380,0,5,0,0,5
1381,0,5,0,0,5
1382,0,5,0,0,5
1383,0,5,0,0,5
1384,0,5,0,0,5
1385,5,0,0,0,5
1386,0,5,0,0,5
1387,0,5,0,0,5
1388,0,5,0,0,5
1389,0,5,0,0,5
1390,0,5,0,0,5
1391,1,4,0,0,5
1392,2,3,0,0,5
1393,0,5,0,0,5
1394,0,5,0,0,5
1395,0,5,0,0,5
1396,0,5,0,0,5
1397,2,3,0,0,5
1398,0,5,0,0,5
1399,0,5,0,0,5
1400,0,5,0,0,5
1401,0,5,0,0,5
1402,0,5,0,0,5
1403,0,5,0,0,5
1404,0,4,0,1,5
1405,3,2,0,0,5
1406,0,5,0,0,5
1407,0,5,0,0,5
1408,0,4,1,0,5
1409,5,0,0,0,5
1410,1,2,0,2,5
1411,0,5,0,0,5
1412,0,5,0,0,5
1413,0,5,0,0,5
1414,0,5,0,0,5
1415,0,5,0,0,5
1416,0,5,0,0,5
1417,2,1,2,0,5
1418,0,3,1,1,5
1419,0,5,0,0,5
1420,0,5,0,0,5
1421,0,5,0,0,5
1422,0,5,0,0,5
1423,0,5,0,0,5
1424,0,5,0,0,5
1425,0,5,0,0,5
1426,0,5,0,0,5
1427,0,5,0,0,5
1428,1,4,0,0,5
1429,5,0,0,0,5
1430,0,5,0,0,5
1431,1,4,0,0,5
1432,0,5,0,0,5
1433,0,5,0,0,5
1434,0,5,0,0,5
1435,0,5,0,0,5
1436,0,5,0,0,5
1437,0,5,0,0,5
1438,3,2,0,0,5
1439,1,4,0,0,5
1440,0,5,0,0,5
1441,0,5,0,0,5
1442,0,5,0,0,5
1443,0,0,0,5,5
1444,2,3,0,0,5
1445,0,5,0,0,5
1446,0,5,0,0,5
1447,0,5,0,0,5
1448,0,5,0,0,5
1449,0,5,0,0,5
1450,0,5,0,0,5
1451,0,4,1,0,5
1452,0,5,0,0,5
1453,0,5,0,0,5
1454,0,5,0,0,5
1455,1,4,0,0,5
1456,0,5,0,0,5
1457,0,5,0,0,5
1458,0,5,0,0,5
1459,0,5,0,0,5
1460,0,5,0,0,5
1461,0,5,0,0,5
1462,0,5,0,0,5
1463,0,5,0,0,5
1464,0,5,0,0,5
1465,0,5,0,0,5
1466,0,5,0,0,5
1467,0,5,0,0,5
1468,0,5,0,0,5
1469,5,0,0,0,5
1470,0,5,0,0,5
1471,0,5,0,0,5
1472,0,5,0,0,5
1473,0,5,0,0,5
1474,0,5,0,0,5
1475,1,4,0,0,5
1476,0,5,0,0,5
1477,0,5,0,0,5
1478,0,5,0,0,5
1479,0,5,0,0,5
1480,0,5,0,0,5
1481,0,5,0,0,5
1482,0,5,0,0,5
1483,0,5,0,0,5
1484,2,3,0,0,5
1485,0,0,0,5,5
1486,0,5,0,0,5
1487,0,5,0,0,5
1488,0,4,0,1,5
1489,0,5,0,0,5
1490,0,5,0,0,5
1491,5,0,0,0,5
1492,0,5,0,0,5
1493,0,5,0,0,5
1494,0,5,0,0,5
1495,0,5,0,0,5
1496,0,5,0,0,5
1497,2,3,0,0,5
1498,0,5,0,0,5
1499,0,5,0,0,5
1500,0,5,0,0,5
1501,0,5,0,0,5
1502,0,5,0,0,5
1503,0,5,0,0,5
1504,3,2,0,0,5
1505,5,0,0,0,5
1506,0,5,0,0,5
1507,2,1,1,1,5
1508,0,5,0,0,5
1509,3,2,0,0,5
1510,0,5,0,0,5
1511,5,0,0,0,5
1512,0,5,0,0,5
1513,0,5,0,0,5
1514,1,4,0,0,5
1515,0,5,0,0,5
1516,0,5,0,0,5
1517,0,5,0,0,5
1518,4,1,0,0,5
1519,0,5,0,0,5
1520,0,5,0,0,5
1521,0,5,0,0,5
1522,0,5,0,0,5
1523,0,5,0,0,5
1524,0,5,0,0,5
1525,0,5,0,0,5
1526,5,0,0,0,5
1527,0,5,0,0,5
1528,0,5,0,0,5
1529,0,5,0,0,5
1530,0,5,0,0,5
1531,5,0,0,0,5
1532,0,5,0,0,5
1533,0,5,0,0,5
1534,0,5,0,0,5
1535,0,5,0,0,5
1536,1,4,0,0,5
1537,0,5,0,0,5
1538,4,1,0,0,5
1539,1,4,0,0,5
1540,0,5,0,0,5
1541,0,5,0,0,5
1542,5,0,0,0,5
1543,0,5,0,0,5
1544,5,0,0,0,5
1545,0,5,0,0,5
1546,5,0,0,0,5
1547,0,4,0,1,5
1548,0,5,0,0,5
1549,0,5,0,0,5
1550,0,5,0,0,5
1551,0,5,0,0,5
1552,0,5,0,0,5
1553,0,5,0,0,5
1554,0,5,0,0,5
1555,0,5,0,0,5
1556,0,5,0,0,5
1557,0,5,0,0,5
1558,0,5,0,0,5
1559,0,5,0,0,5
1560,0,5,0,0,5
1561,0,4,1,0,5
1562,0,5,0,0,5
1563,1,4,0,0,5
1564,0,5,0,0,5
1565,3,2,0,0,5
1566,0,5,0,0,5
1567,0,5,0,0,5
1568,2,1,2,0,5
1569,1,4,0,0,5
1570,0,5,0,0,5
1571,0,5,0,0,5
1572,0,5,0,0,5
1573,0,5,0,0,5
1574,0,5,0,0,5
1575,0,5,0,0,5
1576,0,5,0,0,5
1577,5,0,0,0,5
1578,0,5,0,0,5
1579,0,5,0,0,5
1580,0,5,0,0,5
1581,5,0,0,0,5
1582,0,5,0,0,5
1583,4,1,0,0,5
1584,0,5,0,0,5
1585,0,5,0,0,5
1586,0,5,0,0,5
1587,1,0,0,4,5
1588,0,5,0,0,5
1589,0,5,0,0,5
1590,0,5,0,0,5
1591,0,5,0,0,5
1592,0,5,0,0,5
1593,0,4,0,1,5
1594,0,5,0,0,5
1595,0,5,0,0,5
1596,0,5,0,0,5
1597,0,5,0,0,5
1598,0,4,0,1,5
1599,0,5,0,0,5
1600,0,5,0,0,5
1601,1,1,3,0,5
1602,0,5,0,0,5
1603,5,0,0,0,5
1604,0,5,0,0,5
1605,0,5,0,0,5
1606,0,5,0,0,5
1607,1,0,2,2,5
1608,0,5,0,0,5
1609,0,5,0,0,5
1610,0,5,0,0,5
1611,0,5,0,0,5
1612,0,5,0,0,5
1613,0,5,0,0,5
1614,0,5,0,0,5
1615,0,5,0,0,5
1616,0,5,0,0,5
1617,0,5,0,0,5
1618,1,4,0,0,5
1619,0,5,0,0,5
1620,0,5,0,0,5
1621,0,5,0,0,5
1622,5,0,0,0,5
1623,0,5,0,0,5
1624,0,5,0,0,5
1625,0,5,0,0,5
1626,0,5,0,0,5
1627,0,5,0,0,5
1628,0,5,0,0,5
1629,0,5,0,0,5
1630,0,5,0,0,5
1631,0,5,0,0,5
1632,0,0,0,5,5
1633,0,0,2,3,5
1634,1,4,0,0,5
1635,3,0,0,2,5
1636,5,0,0,0,5
1637,0,3,2,0,5
1638,0,5,0,0,5
1639,0,5,0,0,5
1640,0,5,0,0,5
1641,0,5,0,0,5
1642,0,5,0,0,5
1643,0,5,0,0,5
1644,4,0,1,0,5
1645,5,0,0,0,5
1646,0,5,0,0,5
1647,0,5,0,0,5
1648,0,5,0,0,5
1649,0,5,0,0,5
1650,0,5,0,0,5
1651,1,3,1,0,5
1652,0,5,0,0,5
1653,0,5,0,0,5
1654,0,5,0,0,5
1655,0,5,0,0,5
1656,1,4,0,0,5
1657,0,4,0,1,5
1658,1,4,0,0,5
1659,0,5,0,0,5
1660,0,5,0,0,5
1661,0,5,0,0,5
1662,5,0,0,0,5
1663,0,5,0,0,5
1664,5,0,0,0,5
1665,1,4,0,0,5
1666,0,5,0,0,5
1667,1,3,1,0,5
1668,0,5,0,0,5
1669,0,5,0,0,5
1670,0,5,0,0,5
1671,0,5,0,0,5
1672,0,5,0,0,5
1673,0,5,0,0,5
1674,5,0,0,0,5
1675,0,5,0,0,5
1676,1,1,0,3,5
1677,0,5,0,0,5
1678,0,5,0,0,5
1679,0,5,0,0,5
1680,0,5,0,0,5
1681,0,5,0,0,5
1682,0,5,0,0,5
1683,4,0,0,1,5
1684,0,5,0,0,5
1685,0,5,0,0,5
1686,0,5,0,0,5
1687,0,5,0,0,5
1688,0,5,0,0,5
1689,5,0,0,0,5
1690,1,0,0,4,5
1691,0,5,0,0,5
1692,0,5,0,0,5
1693,0,5,0,0,5
1694,0,5,0,0,5
1695,0,5,0,0,5
1696,0,5,0,0,5
1697,0,5,0,0,5
1698,0,5,0,0,5
1699,0,5,0,0,5
1700,0,5,0,0,5
1701,0,5,0,0,5
1702,0,5,0,0,5
1703,0,5,0,0,5
1704,0,5,0,0,5
1705,0,5,0,0,5
1706,0,4,0,0,4
1707,3,1,0,0,4
1708,0,4,0,0,4
1709,0,4,0,0,4
1710,0,4,0,0,4
1711,0,4,0,0,4
1712,0,4,0,0,4
1713,0,4,0,0,4
1714,0,4,0,0,4
1715,0,4,0,0,4
1716,0,4,0,0,4
1717,0,4,0,0,4
1718,2,2,0,0,4
1719,0,4,0,0,4
1720,0,4,0,0,4
1721,0,4,0,0,4
1722,0,0,1,3,4
1723,0,4,0,0,4
1724,4,0,0,0,4
1725,0,4,0,0,4
1726,0,4,0,0,4
1727,4,0,0,0,4
1728,0,4,0,0,4
1729,0,4,0,0,4
1730,0,4,0,0,4
1731,1,3,0,0,4
1732,0,4,0,0,4
1733,0,4,0,0,4
1734,0,4,0,0,4
1735,0,4,0,0,4
1736,0,4,0,0,4
1737,0,4,0,0,4
1738,0,4,0,0,4
1739,1,3,0,0,4
1740,0,3,0,1,4
1741,0,4,0,0,4
1742,0,4,0,0,4
1743,0,4,0,0,4
1744,0,4,0,0,4
1745,0,4,0,0,4
1746,0,4,0,0,4
1747,2,2,0,0,4
1748,0,3,1,0,4
1749,0,4,0,0,4
1750,0,4,0,0,4
1751,0,4,0,0,4
1752,0,4,0,0,4
1753,0,4,0,0,4
1754,0,4,0,0,4
1755,0,4,0,0,4
1756,0,0,0,4,4
1757,4,0,0,0,4
1758,0,4,0,0,4
1759,0,4,0,0,4
1760,2,2,0,0,4
1761,0,4,0,0,4
1762,2,2,0,0,4
1763,0,4,0,0,4
1764,0,4,0,0,4
1765,0,0,0,4,4
1766,0,4,0,0,4
1767,4,0,0,0,4
1768,0,4,0,0,4
1769,0,4,0,0,4
1770,0,4,0,0,4
1771,0,4,0,0,4
1772,0,4,0,0,4
1773,0,4,0,0,4
1774,0,4,0,0,4
1775,2,2,0,0,4
1776,2,2,0,0,4
1777,0,4,0,0,4
1778,1,3,0,0,4
1779,0,4,0,0,4
1780,0,4,0,0,4
1781,0,4,0,0,4
1782,0,4,0,0,4
1783,0,3,0,1,4
1784,0,4,0,0,4
1785,0,4,0,0,4
1786,0,4,0,0,4
1787,0,4,0,0,4
1788,0,4,0,0,4
1789,0,4,0,0,4
1790,0,4,0,0,4
1791,2,0,0,2,4
1792,0,4,0,0,4
1793,0,4,0,0,4
1794,0,4,0,0,4
1795,3,1,0,0,4
1796,0,4,0,0,4
1797,0,4,0,0,4
1798,4,0,0,0,4
1799,0,4,0,0,4
1800,1,3,0,0,4
1801,0,0,0,4,4
1802,4,0,0,0,4
1803,1,3,0,0,4
1804,0,4,0,0,4
1805,1,3,0,0,4
1806,1,3,0,0,4
1807,0,4,0,0,4
1808,4,0,0,0,4
1809,0,4,0,0,4
1810,4,0,0,0,4
1811,4,0,0,0,4
1812,0,4,0,0,4
1813,0,4,0,0,4
1814,0,4,0,0,4
1815,0,4,0,0,4
1816,0,4,0,0,4
1817,0,4,0,0,4
1818,0,4,0,0,4
1819,1,0,0,3,4
1820,0,4,0,0,4
1821,0,4,0,0,4
1822,0,4,0,0,4
1823,0,4,0,0,4
1824,1,3,0,0,4
1825,0,4,0,0,4
1826,0,4,0,0,4
1827,0,0,0,4,4
1828,0,4,0,0,4
1829,2,0,0,2,4
1830,0,4,0,0,4
1831,0,4,0,0,4
1832,0,4,0,0,4
1833,0,4,0,0,4
1834,0,4,0,0,4
1835,0,4,0,0,4
1836,0,4,0,0,4
1837,0,4,0,0,4
1838,0,4,0,0,4
1839,1,2,1,0,4
1840,0,4,0,0,4
1841,0,4,0,0,4
1842,0,4,0,0,4
1843,1,3,0,0,4
1844,0,4,0,0,4
1845,0,4,0,0,4
1846,0,4,0,0,4
1847,0,4,0,0,4
1848,4,0,0,0,4
1849,0,4,0,0,4
1850,0,4,0,0,4
1851,0,4,0,0,4
1852,4,0,0,0,4
1853,4,0,0,0,4
1854,0,4,0,0,4
1855,0,4,0,0,4
1856,0,4,0,0,4
1857,0,4,0,0,4
1858,0,4,0,0,4
1859,0,4,0,0,4
1860,0,4,0,0,4
1861,4,0,0,0,4
1862,0,4,0,0,4
1863,0,4,0,0,4
1864,4,0,0,0,4
1865,0,4,0,0,4
1866,0,4,0,0,4
1867,1,3,0,0,4
1868,0,4,0,0,4
1869,0,4,0,0,4
1870,0,4,0,0,4
1871,1,0,0,3,4
1872,0,4,0,0,4
1873,1,3,0,0,4
1874,0,4,0,0,4
1875,0,4,0,0,4
1876,0,4,0,0,4
1877,0,4,0,0,4
1878,0,4,0,0,4
1879,0,4,0,0,4
1880,0,4,0,0,4
1881,0,3,1,0,4
1882,4,0,0,0,4
1883,0,4,0,0,4
1884,0,4,0,0,4
1885,0,4,0,0,4
1886,0,4,0,0,4
1887,0,4,0,0,4
1888,0,4,0,0,4
1889,0,4,0,0,4
1890,1,0,0,3,4
1891,0,4,0,0,4
1892,1,3,0,0,4
1893,0,4,0,0,4
1894,0,1,0,3,4
1895,4,0,0,0,4
1896,0,4,0,0,4
1897,1,3,0,0,4
1898,0,3,0,1,4
1899,0,4,0,0,4
1900,0,4,0,0,4
1901,0,4,0,0,4
1902,3,0,0,1,4
1903,2,2,0,0,4
1904,0,4,0,0,4
1905,0,4,0,0,4
1906,0,4,0,0,4
1907,0,4,0,0,4
1908,0,4,0,0,4
1909,0,4,0,0,4
1910,0,4,0,0,4
1911,0,4,0,0,4
1912,0,4,0,0,4
1913,0,4,0,0,4
1914,0,4,0,0,4
1915,2,0,0,2,4
1916,0,4,0,0,4
1917,1,0,3,0,4
1918,1,3,0,0,4
1919,0,4,0,0,4
1920,0,4,0,0,4
1921,0,4,0,0,4
1922,0,4,0,0,4
1923,0,4,0,0,4
1924,0,4,0,0,4
1925,0,4,0,0,4
1926,1,2,1,0,4
1927,0,4,0,0,4
1928,0,4,0,0,4
1929,0,4,0,0,4
1930,0,4,0,0,4
1931,0,4,0,0,4
1932,0,4,0,0,4
1933,2,0,0,2,4
1934,0,4,0,0,4
1935,0,4,0,0,4
1936,0,4,0,0,4
1937,0,4,0,0,4
1938,0,4,0,0,4
1939,0,4,0,0,4
1940,0,4,0,0,4
1941,0,4,0,0,4
1942,0,4,0,0,4
1943,0,4,0,0,4
1944,1,0,1,2,4
1945,0,4,0,0,4
1946,0,4,0,0,4
1947,0,4,0,0,4
1948,0,4,0,0,4
1949,0,4,0,0,4
1950,0,4,0,0,4
1951,4,0,0,0,4
1952,0,4,0,0,4
1953,0,4,0,0,4
1954,4,0,0,0,4
1955,1,3,0,0,4
1956,0,4,0,0,4
1957,4,0,0,0,4
1958,0,4,0,0,4
1959,0,4,0,0,4
1960,1,3,0,0,4
1961,0,4,0,0,4
1962,2,0,1,1,4
1963,0,4,0,0,4
1964,0,4,0,0,4
1965,0,4,0,0,4
1966,1,3,0,0,4
1967,0,4,0,0,4
1968,1,3,0,0,4
1969,4,0,0,0,4
1970,0,4,0,0,4
1971,0,4,0,0,4
1972,0,4,0,0,4
1973,0,4,0,0,4
1974,0,4,0,0,4
1975,0,4,0,0,4
1976,0,4,0,0,4
1977,0,4,0,0,4
1978,0,4,0,0,4
1979,1,3,0,0,4
1980,0,4,0,0,4
1981,4,0,0,0,4
1982,1,3,0,0,4
1983,3,1,0,0,4
1984,0,4,0,0,4
1985,0,4,0,0,4
1986,0,4,0,0,4
1987,0,4,0,0,4
1988,1,3,0,0,4
1989,1,0,0,3,4
1990,0,4,0,0,4
1991,0,4,0,0,4
1992,0,4,0,0,4
1993,0,4,0,0,4
1994,0,4,0,0,4
1995,0,4,0,0,4
1996,0,4,0,0,4
1997,0,4,0,0,4
1998,1,3,0,0,4
1999,0,4,0,0,4
2000,0,4,0,0,4
2001,0,4,0,0,4
2002,0,4,0,0,4
2003,0,4,0,0,4
2004,0,4,0,0,4
2005,0,4,0,0,4
2006,0,4,0,0,4
2007,0,4,0,0,4
2008,0,4,0,0,4
2009,0,4,0,0,4
2010,0,0,4,0,4
2011,0,4,0,0,4
2012,0,4,0,0,4
2013,0,4,0,0,4
2014,0,4,0,0,4
2015,0,4,0,0,4
2016,0,4,0,0,4
2017,0,4,0,0,4
2018,0,4,0,0,4
2019,0,4,0,0,4
2020,0,4,0,0,4
2021,0,4,0,0,4
2022,0,4,0,0,4
2023,1,3,0,0,4
2024,0,4,0,0,4
2025,0,4,0,0,4
2026,0,4,0,0,4
2027,4,0,0,0,4
2028,0,4,0,0,4
2029,1,3,0,0,4
2030,0,4,0,0,4
2031,0,4,0,0,4
2032,0,4,0,0,4
2033,0,4,0,0,4
2034,0,4,0,0,4
2035,0,4,0,0,4
2036,0,4,0,0,4
2037,0,4,0,0,4
2038,0,4,0,0,4
2039,0,4,0,0,4
2040,0,4,0,0,4
2041,0,4,0,0,4
2042,0,4,0,0,4
2043,4,0,0,0,4
2044,0,4,0,0,4
2045,0,4,0,0,4
2046,4,0,0,0,4
2047,0,4,0,0,4
2048,0,4,0,0,4
2049,2,2,0,0,4
2050,0,4,0,0,4
2051,0,4,0,0,4
2052,0,4,0,0,4
2053,0,4,0,0,4
2054,1,0,0,3,4
2055,1,2,1,0,4
2056,1,1,0,2,4
2057,0,4,0,0,4
2058,0,4,0,0,4
2059,0,4,0,0,4
2060,0,4,0,0,4
2061,0,4,0,0,4
2062,0,4,0,0,4
2063,0,4,0,0,4
2064,0,4,0,0,4
2065,0,4,0,0,4
2066,0,4,0,0,4
2067,0,4,0,0,4
2068,0,4,0,0,4
2069,0,4,0,0,4
2070,0,4,0,0,4
2071,0,4,0,0,4
2072,0,4,0,0,4
2073,0,4,0,0,4
2074,0,4,0,0,4
2075,2,2,0,0,4
2076,0,4,0,0,4
2077,0,4,0,0,4
2078,0,4,0,0,4
2079,0,4,0,0,4
2080,0,4,0,0,4
2081,0,3,0,1,4
2082,0,4,0,0,4
2083,0,4,0,0,4
2084,0,4,0,0,4
2085,0,4,0,0,4
2086,0,4,0,0,4
2087,0,4,0,0,4
2088,2,2,0,0,4
2089,0,4,0,0,4
2090,0,4,0,0,4
2091,4,0,0,0,4
2092,0,4,0,0,4
2093,3,0,0,1,4
2094,0,4,0,0,4
2095,0,4,0,0,4
2096,0,4,0,0,4
2097,0,4,0,0,4
2098,0,4,0,0,4
2099,0,4,0,0,4
2100,0,4,0,0,4
2101,0,4,0,0,4
2102,0,3,1,0,4
2103,0,4,0,0,4
2104,0,4,0,0,4
2105,0,0,0,4,4
2106,0,1,3,0,4
2107,0,4,0,0,4
2108,0,4,0,0,4
2109,2,0,0,2,4
2110,0,4,0,0,4
2111,0,0,0,4,4
2112,0,4,0,0,4
2113,0,4,0,0,4
2114,1,3,0,0,4
2115,0,0,0,4,4
2116,0,4,0,0,4
2117,0,4,0,0,4
2118,0,4,0,0,4
2119,1,3,0,0,4
2120,0,2,0,2,4
2121,2,2,0,0,4
2122,0,4,0,0,4
2123,3,0,0,1,4
2124,0,4,0,0,4
2125,0,4,0,0,4
2126,0,4,0,0,4
2127,0,4,0,0,4
2128,0,4,0,0,4
2129,0,4,0,0,4
2130,0,0,0,4,4
2131,3,0,1,0,4
2132,1,3,0,0,4
2133,0,4,0,0,4
2134,0,4,0,0,4
2135,0,4,0,0,4
2136,1,1,2,0,4
2137,2,2,0,0,4
2138,0,4,0,0,4
2139,1,3,0,0,4
2140,0,4,0,0,4
2141,0,4,0,0,4
2142,0,4,0,0,4
2143,0,4,0,0,4
2144,0,4,0,0,4
2145,0,4,0,0,4
2146,0,4,0,0,4
2147,4,0,0,0,4
2148,0,4,0,0,4
2149,0,4,0,0,4
2150,0,4,0,0,4
2151,1,3,0,0,4
2152,0,4,0,0,4
2153,0,4,0,0,4
2154,0,4,0,0,4
2155,0,0,4,0,4
2156,0,4,0,0,4
2157,0,4,0,0,4
2158,0,4,0,0,4
2159,0,4,0,0,4
2160,0,4,0,0,4
2161,0,4,0,0,4
2162,0,4,0,0,4
2163,0,4,0,0,4
2164,0,4,0,0,4
2165,0,4,0,0,4
2166,0,4,0,0,4
2167,0,4,0,0,4
2168,0,4,0,0,4
2169,0,4,0,0,4
2170,0,4,0,0,4
2171,2,2,0,0,4
2172,1,3,0,0,4
2173,0,4,0,0,4
2174,0,4,0,0,4
2175,2,2,0,0,4
2176,0,4,0,0,4
2177,4,0,0,0,4
2178,2,2,0,0,4
2179,2,2,0,0,4
2180,0,4,0,0,4
2181,0,4,0,0,4
2182,0,4,0,0,4
2183,0,4,0,0,4
2184,0,4,0,0,4
2185,0,4,0,0,4
2186,4,0,0,0,4
2187,4,0,0,0,4
2188,0,0,0,4,4
2189,0,4,0,0,4
2190,0,4,0,0,4
2191,0,4,0,0,4
2192,0,4,0,0,4
2193,0,4,0,0,4
2194,0,4,0,0,4
2195,4,0,0,0,4
2196,0,4,0,0,4
2197,0,4,0,0,4
2198,0,4,0,0,4
2199,0,4,0,0,4
2200,0,4,0,0,4
2201,0,4,0,0,4
2202,0,0,0,4,4
2203,4,0,0,0,4
2204,0,4,0,0,4
2205,0,4,0,0,4
2206,0,4,0,0,4
2207,0,4,0,0,4
2208,2,2,0,0,4
2209,0,4,0,0,4
2210,0,4,0,0,4
2211,4,0,0,0,4
2212,4,0,0,0,4
2213,0,4,0,0,4
2214,0,1,0,3,4
2215,0,4,0,0,4
2216,3,1,0,0,4
2217,0,4,0,0,4
2218,0,4,0,0,4
2219,4,0,0,0,4
2220,0,4,0,0,4
2221,0,4,0,0,4
2222,0,4,0,0,4
2223,0,4,0,0,4
2224,0,4,0,0,4
2225,0,4,0,0,4
2226,0,4,0,0,4
2227,4,0,0,0,4
2228,0,4,0,0,4
2229,0,4,0,0,4
2230,0,4,0,0,4
2231,0,4,0,0,4
2232,0,4,0,0,4
2233,0,4,0,0,4
2234,0,4,0,0,4
2235,0,4,0,0,4
2236,0,4,0,0,4
2237,0,4,0,0,4
2238,0,4,0,0,4
2239,0,4,0,0,4
2240,0,4,0,0,4
2241,0,4,0,0,4
2242,1,0,0,3,4
2243,0,4,0,0,4
2244,0,4,0,0,4
2245,0,4,0,0,4
2246,0,4,0,0,4
2247,1,0,3,0,4
2248,0,0,0,4,4
2249,0,4,0,0,4
2250,0,4,0,0,4
2251,0,4,0,0,4
2252,0,4,0,0,4
2253,2,2,0,0,4
2254,0,4,0,0,4
2255,0,4,0,0,4
2256,0,4,0,0,4
2257,0,4,0,0,4
2258,0,4,0,0,4
2259,0,4,0,0,4
2260,0,4,0,0,4
2261,0,4,0,0,4
2262,0,4,0,0,4
2263,1,0,0,3,4
2264,0,4,0,0,4
2265,0,4,0,0,4
2266,0,4,0,0,4
2267,1,3,0,0,4
2268,0,4,0,0,4
2269,0,4,0,0,4
2270,0,4,0,0,4
2271,0,4,0,0,4
2272,0,4,0,0,4
2273,0,4,0,0,4
2274,3,1,0,0,4
2275,0,4,0,0,4
2276,0,4,0,0,4
2277,0,4,0,0,4
2278,1,3,0,0,4
2279,0,4,0,0,4
2280,0,4,0,0,4
2281,0,4,0,0,4
2282,2,2,0,0,4
2283,0,4,0,0,4
2284,0,4,0,0,4
2285,0,4,0,0,4
2286,0,4,0,0,4
2287,0,4,0,0,4
2288,0,4,0,0,4
2289,0,3,0,0,3
2290,0,2,0,1,3
2291,0,3,0,0,3
2292,0,3,0,0,3
2293,0,3,0,0,3
2294,3,0,0,0,3
2295,0,3,0,0,3
2296,0,3,0,0,3
2297,3,0,0,0,3
2298,0,3,0,0,3
2299,1,2,0,0,3
2300,1,2,0,0,3
2301,0,3,0,0,3
2302,0,3,0,0,3
2303,0,3,0,0,3
2304,0,3,0,0,3
2305,0,3,0,0,3
2306,0,3,0,0,3
2307,0,3,0,0,3
2308,0,3,0,0,3
2309,0,3,0,0,3
2310,0,0,0,3,3
2311,3,0,0,0,3
2312,0,3,0,0,3
2313,0,3,0,0,3
2314,0,3,0,0,3
2315,0,3,0,0,3
2316,0,3,0,0,3
2317,0,3,0,0,3
2318,0,3,0,0,3
2319,0,3,0,0,3
2320,0,3,0,0,3
2321,0,3,0,0,3
2322,1,0,0,2,3
2323,0,3,0,0,3
2324,0,3,0,0,3
2325,0,3,0,0,3
2326,0,3,0,0,3
2327,0,3,0,0,3
2328,0,3,0,0,3
2329,0,3,0,0,3
2330,1,2,0,0,3
2331,0,3,0,0,3
2332,0,3,0,0,3
2333,0,3,0,0,3
2334,3,0,0,0,3
2335,1,2,0,0,3
2336,0,3,0,0,3
2337,3,0,0,0,3
2338,0,3,0,0,3
2339,0,3,0,0,3
2340,3,0,0,0,3
2341,1,2,0,0,3
2342,1,1,0,1,3
2343,0,3,0,0,3
2344,0,3,0,0,3
2345,0,3,0,0,3
2346,0,3,0,0,3
2347,3,0,0,0,3
2348,0,3,0,0,3
2349,0,2,0,1,3
2350,0,3,0,0,3
2351,0,3,0,0,3
2352,0,3,0,0,3
2353,0,3,0,0,3
2354,0,0,1,2,3
2355,0,3,0,0,3
2356,0,3,0,0,3
2357,0,3,0,0,3
2358,0,3,0,0,3
2359,2,0,0,1,3
2360,0,3,0,0,3
2361,0,3,0,0,3
2362,0,3,0,0,3
2363,0,3,0,0,3
2364,0,3,0,0,3
2365,0,3,0,0,3
2366,0,3,0,0,3
2367,0,3,0,0,3
2368,0,2,0,1,3
2369,0,3,0,0,3
2370,0,3,0,0,3
2371,0,3,0,0,3
2372,0,3,0,0,3
2373,0,3,0,0,3
2374,0,3,0,0,3
2375,0,3,0,0,3
2376,0,3,0,0,3
2377,0,3,0,0,3
2378,0,3,0,0,3
2379,0,3,0,0,3
2380,0,3,0,0,3
2381,0,3,0,0,3
2382,0,3,0,0,3
2383,0,3,0,0,3
2384,0,3,0,0,3
2385,3,0,0,0,3
2386,0,3,0,0,3
2387,1,1,1,0,3
2388,0,3,0,0,3
2389,0,3,0,0,3
2390,0,3,0,0,3
2391,0,3,0,0,3
2392,1,2,0,0,3
2393,0,3,0,0,3
2394,2,1,0,0,3
2395,0,3,0,0,3
2396,0,3,0,0,3
2397,0,3,0,0,3
2398,0,3,0,0,3
2399,0,3,0,0,3
2400,0,3,0,0,3
2401,0,3,0,0,3
2402,0,3,0,0,3
2403,0,3,0,0,3
2404,0,3,0,0,3
2405,0,3,0,0,3
2406,0,3,0,0,3
2407,0,3,0,0,3
2408,0,3,0,0,3
2409,0,3,0,0,3
2410,0,3,0,0,3
2411,0,3,0,0,3
2412,2,1,0,0,3
2413,0,3,0,0,3
2414,0,3,0,0,3
2415,1,2,0,0,3
2416,0,3,0,0,3
2417,1,2,0,0,3
2418,3,0,0,0,3
2419,0,3,0,0,3
2420,0,3,0,0,3
2421,0,3,0,0,3
2422,0,3,0,0,3
2423,0,3,0,0,3
2424,1,2,0,0,3
2425,0,3,0,0,3
2426,0,3,0,0,3
2427,0,3,0,0,3
2428,0,3,0,0,3
2429,1,2,0,0,3
2430,0,0,0,3,3
2431,0,3,0,0,3
2432,0,3,0,0,3
2433,3,0,0,0,3
2434,1,0,0,2,3
2435,0,3,0,0,3
2436,0,3,0,0,3
2437,0,3,0,0,3
2438,3,0,0,0,3
2439,0,3,0,0,3
2440,0,2,1,0,3
2441,2,0,0,1,3
2442,3,0,0,0,3
2443,0,3,0,0,3
2444,0,3,0,0,3
2445,0,3,0,0,3
2446,0,3,0,0,3
2447,0,3,0,0,3
2448,0,3,0,0,3
2449,0,3,0,0,3
2450,0,3,0,0,3
2451,0,3,0,0,3
2452,0,3,0,0,3
2453,0,3,0,0,3
2454,1,2,0,0,3
2455,3,0,0,0,3
2456,0,3,0,0,3
2457,0,3,0,0,3
2458,0,3,0,0,3
2459,0,3,0,0,3
2460,0,3,0,0,3
2461,0,3,0,0,3
2462,0,3,0,0,3
2463,0,3,0,0,3
2464,0,3,0,0,3
2465,2,1,0,0,3
2466,0,3,0,0,3
2467,0,3,0,0,3
2468,0,3,0,0,3
2469,0,3,0,0,3
2470,0,3,0,0,3
2471,0,3,0,0,3
2472,0,3,0,0,3
2473,2,1,0,0,3
2474,0,3,0,0,3
2475,1,2,0,0,3
2476,2,1,0,0,3
2477,0,0,0,3,3
2478,0,3,0,0,3
2479,0,3,0,0,3
2480,0,3,0,0,3
2481,0,3,0,0,3
2482,0,3,0,0,3
2483,0,3,0,0,3
2484,2,0,0,1,3
2485,3,0,0,0,3
2486,2,0,0,1,3
2487,0,3,0,0,3
2488,0,3,0,0,3
2489,1,2,0,0,3
2490,0,3,0,0,3
2491,0,3,0,0,3
2492,0,3,0,0,3
2493,0,3,0,0,3
2494,0,3,0,0,3
2495,2,0,1,0,3
2496,0,3,0,0,3
2497,0,3,0,0,3
2498,0,3,0,0,3
2499,0,3,0,0,3
2500,0,3,0,0,3
2501,2,1,0,0,3
2502,1,2,0,0,3
2503,0,3,0,0,3
2504,0,3,0,0,3
2505,0,3,0,0,3
2506,0,3,0,0,3
2507,3,0,0,0,3
2508,0,3,0,0,3
2509,0,3,0,0,3
2510,1,2,0,0,3
2511,0,3,0,0,3
2512,0,0,0,3,3
2513,0,3,0,0,3
2514,0,3,0,0,3
2515,0,3,0,0,3
2516,0,3,0,0,3
2517,0,3,0,0,3
2518,0,3,0,0,3
2519,0,3,0,0,3
2520,0,3,0,0,3
2521,1,2,0,0,3
2522,0,3,0,0,3
2523,0,3,0,0,3
2524,0,3,0,0,3
2525,3,0,0,0,3
2526,0,3,0,0,3
2527,0,1,2,0,3
2528,0,3,0,0,3
2529,0,3,0,0,3
2530,0,3,0,0,3
2531,0,3,0,0,3
2532,0,3,0,0,3
2533,0,2,1,0,3
2534,0,3,0,0,3
2535,0,3,0,0,3
2536,0,3,0,0,3
2537,0,3,0,0,3
2538,0,3,0,0,3
2539,0,3,0,0,3
2540,0,3,0,0,3
2541,3,0,0,0,3
2542,0,3,0,0,3
2543,1,0,0,2,3
2544,0,3,0,0,3
2545,0,3,0,0,3
2546,0,3,0,0,3
2547,0,3,0,0,3
2548,0,3,0,0,3
2549,0,3,0,0,3
2550,0,3,0,0,3
2551,0,3,0,0,3
2552,2,0,0,1,3
2553,0,3,0,0,3
2554,0,3,0,0,3
2555,0,3,0,0,3
2556,0,3,0,0,3
2557,0,3,0,0,3
2558,0,3,0,0,3
2559,0,3,0,0,3
2560,3,0,0,0,3
2561,0,3,0,0,3
2562,1,2,0,0,3
2563,0,3,0,0,3
2564,0,3,0,0,3
2565,0,3,0,0,3
2566,0,3,0,0,3
2567,0,3,0,0,3
2568,0,3,0,0,3
2569,0,3,0,0,3
2570,3,0,0,0,3
2571,0,3,0,0,3
2572,2,1,0,0,3
2573,0,3,0,0,3
2574,0,3,0,0,3
2575,0,3,0,0,3
2576,0,3,0,0,3
2577,0,3,0,0,3
2578,0,3,0,0,3
2579,0,3,0,0,3
2580,0,3,0,0,3
2581,1,2,0,0,3
2582,0,3,0,0,3
2583,0,3,0,0,3
2584,0,3,0,0,3
2585,3,0,0,0,3
2586,0,3,0,0,3
2587,0,2,0,1,3
2588,0,3,0,0,3
2589,0,3,0,0,3
2590,0,3,0,0,3
2591,3,0,0,0,3
2592,0,3,0,0,3
2593,0,3,0,0,3
2594,0,3,0,0,3
2595,0,3,0,0,3
2596,0,3,0,0,3
2597,0,3,0,0,3
2598,0,3,0,0,3
2599,0,3,0,0,3
2600,2,1,0,0,3
2601,0,3,0,0,3
2602,0,3,0,0,3
2603,0,3,0,0,3
2604,0,3,0,0,3
2605,3,0,0,0,3
2606,0,3,0,0,3
2607,0,3,0,0,3
2608,0,3,0,0,3
2609,1,2,0,0,3
2610,0,3,0,0,3
2611,0,3,0,0,3
2612,3,0,0,0,3
2613,0,3,0,0,3
2614,0,3,0,0,3
2615,0,3,0,0,3
2616,0,3,0,0,3
2617,0,3,0,0,3
2618,0,3,0,0,3
2619,1,2,0,0,3
2620,0,3,0,0,3
2621,0,3,0,0,3
2622,0,3,0,0,3
2623,0,3,0,0,3
2624,0,3,0,0,3
2625,0,3,0,0,3
2626,0,3,0,0,3
2627,0,3,0,0,3
2628,0,3,0,0,3
2629,0,3,0,0,3
2630,0,3,0,0,3
2631,0,3,0,0,3
2632,0,3,0,0,3
2633,0,3,0,0,3
2634,0,3,0,0,3
2635,0,3,0,0,3
2636,0,3,0,0,3
2637,0,3,0,0,3
2638,0,3,0,0,3
2639,0,3,0,0,3
2640,0,3,0,0,3
2641,0,3,0,0,3
2642,0,2,0,1,3
2643,0,3,0,0,3
2644,0,3,0,0,3
2645,0,3,0,0,3
2646,0,3,0,0,3
2647,0,3,0,0,3
2648,0,3,0,0,3
2649,0,3,0,0,3
2650,0,3,0,0,3
2651,0,3,0,0,3
2652,0,3,0,0,3
2653,0,3,0,0,3
2654,0,3,0,0,3
2655,0,3,0,0,3
2656,0,3,0,0,3
2657,0,3,0,0,3
2658,0,3,0,0,3
2659,0,3,0,0,3
2660,3,0,0,0,3
2661,2,1,0,0,3
2662,0,3,0,0,3
2663,0,3,0,0,3
2664,0,3,0,0,3
2665,0,3,0,0,3
2666,3,0,0,0,3
2667,0,3,0,0,3
2668,0,3,0,0,3
2669,0,3,0,0,3
2670,3,0,0,0,3
2671,1,2,0,0,3
2672,0,3,0,0,3
2673,0,3,0,0,3
2674,0,3,0,0,3
2675,0,3,0,0,3
2676,0,3,0,0,3
2677,0,3,0,0,3
2678,0,3,0,0,3
2679,0,3,0,0,3
2680,0,3,0,0,3
2681,0,3,0,0,3
2682,0,3,0,0,3
2683,0,3,0,0,3
2684,0,3,0,0,3
2685,0,1,2,0,3
2686,0,3,0,0,3
2687,0,3,0,0,3
2688,0,3,0,0,3
2689,0,3,0,0,3
2690,0,3,0,0,3
2691,3,0,0,0,3
2692,0,3,0,0,3
2693,0,0,3,0,3
2694,0,3,0,0,3
2695,3,0,0,0,3
2696,0,3,0,0,3
2697,0,3,0,0,3
2698,0,3,0,0,3
2699,1,1,0,1,3
2700,3,0,0,0,3
2701,0,3,0,0,3
2702,0,3,0,0,3
2703,3,0,0,0,3
2704,0,3,0,0,3
2705,0,3,0,0,3
2706,0,2,0,1,3
2707,0,3,0,0,3
2708,0,3,0,0,3
2709,0,3,0,0,3
2710,0,3,0,0,3
2711,3,0,0,0,3
2712,3,0,0,0,3
2713,0,3,0,0,3
2714,0,3,0,0,3
2715,0,3,0,0,3
2716,0,3,0,0,3
2717,0,2,0,1,3
2718,3,0,0,0,3
2719,1,2,0,0,3
2720,0,3,0,0,3
2721,0,3,0,0,3
2722,0,3,0,0,3
2723,0,1,2,0,3
2724,0,3,0,0,3
2725,0,1,0,2,3
2726,0,3,0,0,3
2727,0,3,0,0,3
2728,1,2,0,0,3
2729,0,3,0,0,3
2730,2,1,0,0,3
2731,0,3,0,0,3
2732,0,3,0,0,3
2733,0,2,0,1,3
2734,0,3,0,0,3
2735,0,3,0,0,3
2736,2,0,1,0,3
2737,0,3,0,0,3
2738,0,3,0,0,3
2739,0,3,0,0,3
2740,0,3,0,0,3
2741,3,0,0,0,3
2742,0,3,0,0,3
2743,0,3,0,0,3
2744,0,3,0,0,3
2745,0,3,0,0,3
2746,0,3,0,0,3
2747,0,3,0,0,3
2748,0,3,0,0,3
2749,0,3,0,0,3
2750,0,3,0,0,3
2751,0,3,0,0,3
2752,0,3,0,0,3
2753,0,3,0,0,3
2754,0,3,0,0,3
2755,0,3,0,0,3
2756,0,2,0,1,3
2757,0,3,0,0,3
2758,0,3,0,0,3
2759,2,1,0,0,3
2760,0,3,0,0,3
2761,0,3,0,0,3
2762,3,0,0,0,3
2763,0,3,0,0,3
2764,0,3,0,0,3
2765,0,3,0,0,3
2766,0,3,0,0,3
2767,0,3,0,0,3
2768,3,0,0,0,3
2769,0,3,0,0,3
2770,0,3,0,0,3
2771,0,3,0,0,3
2772,2,1,0,0,3
2773,0,3,0,0,3
2774,0,3,0,0,3
2775,0,3,0,0,3
2776,0,3,0,0,3
2777,0,3,0,0,3
2778,1,2,0,0,3
2779,0,3,0,0,3
2780,0,3,0,0,3
2781,2,0,1,0,3
2782,3,0,0,0,3
2783,0,3,0,0,3
2784,0,3,0,0,3
2785,0,3,0,0,3
2786,0,3,0,0,3
2787,1,1,0,1,3
2788,0,3,0,0,3
2789,0,3,0,0,3
2790,0,3,0,0,3
2791,0,3,0,0,3
2792,2,0,0,1,3
2793,0,3,0,0,3
2794,0,3,0,0,3
2795,0,3,0,0,3
2796,0,3,0,0,3
2797,0,3,0,0,3
2798,0,3,0,0,3
2799,0,3,0,0,3
2800,0,3,0,0,3
2801,0,3,0,0,3
2802,0,3,0,0,3
2803,3,0,0,0,3
2804,0,3,0,0,3
2805,0,3,0,0,3
2806,0,3,0,0,3
2807,0,3,0,0,3
2808,0,3,0,0,3
2809,0,3,0,0,3
2810,2,1,0,0,3
2811,0,0,2,1,3
2812,1,2,0,0,3
2813,0,3,0,0,3
2814,0,3,0,0,3
2815,0,3,0,0,3
2816,0,3,0,0,3
2817,0,3,0,0,3
2818,0,3,0,0,3
2819,2,0,0,1,3
2820,0,3,0,0,3
2821,0,3,0,0,3
2822,0,3,0,0,3
2823,0,3,0,0,3
2824,3,0,0,0,3
2825,0,3,0,0,3
2826,0,3,0,0,3
2827,0,3,0,0,3
2828,0,3,0,0,3
2829,0,1,1,1,3
2830,0,3,0,0,3
2831,3,0,0,0,3
2832,0,3,0,0,3
2833,0,3,0,0,3
2834,1,2,0,0,3
2835,0,3,0,0,3
2836,0,3,0,0,3
2837,0,3,0,0,3
2838,0,3,0,0,3
2839,0,3,0,0,3
2840,1,0,1,1,3
2841,0,3,0,0,3
2842,1,1,1,0,3
2843,0,3,0,0,3
2844,0,3,0,0,3
2845,3,0,0,0,3
2846,0,1,2,0,3
2847,0,3,0,0,3
2848,0,3,0,0,3
2849,0,3,0,0,3
2850,0,3,0,0,3
2851,0,3,0,0,3
2852,0,3,0,0,3
2853,0,3,0,0,3
2854,0,3,0,0,3
2855,0,3,0,0,3
2856,1,2,0,0,3
2857,0,3,0,0,3
2858,0,1,2,0,3
2859,0,3,0,0,3
2860,0,3,0,0,3
2861,0,3,0,0,3
2862,0,3,0,0,3
2863,0,3,0,0,3
2864,0,3,0,0,3
2865,0,3,0,0,3
2866,0,3,0,0,3
2867,0,3,0,0,3
2868,0,3,0,0,3
2869,0,3,0,0,3
2870,0,3,0,0,3
2871,0,3,0,0,3
2872,0,3,0,0,3
2873,0,3,0,0,3
2874,0,3,0,0,3
2875,1,0,1,1,3
2876,0,3,0,0,3
2877,1,2,0,0,3
2878,0,3,0,0,3
2879,0,3,0,0,3
2880,0,3,0,0,3
2881,0,3,0,0,3
2882,0,3,0,0,3
2883,0,3,0,0,3
2884,0,3,0,0,3
2885,0,3,0,0,3
2886,0,2,0,1,3
2887,3,0,0,0,3
2888,0,3,0,0,3
2889,3,0,0,0,3
2890,0,3,0,0,3
2891,0,3,0,0,3
2892,0,3,0,0,3
2893,0,3,0,0,3
2894,0,3,0,0,3
2895,0,3,0,0,3
2896,0,3,0,0,3
2897,0,3,0,0,3
2898,0,3,0,0,3
2899,0,3,0,0,3
2900,0,3,0,0,3
2901,0,3,0,0,3
2902,0,3,0,0,3
2903,1,2,0,0,3
2904,0,3,0,0,3
2905,0,3,0,0,3
2906,0,3,0,0,3
2907,0,3,0,0,3
2908,0,3,0,0,3
2909,0,3,0,0,3
2910,0,3,0,0,3
2911,0,3,0,0,3
2912,0,3,0,0,3
2913,0,3,0,0,3
2914,0,3,0,0,3
2915,0,3,0,0,3
2916,0,3,0,0,3
2917,0,3,0,0,3
2918,0,0,0,3,3
2919,1,2,0,0,3
2920,0,3,0,0,3
2921,0,2,1,0,3
2922,0,3,0,0,3
2923,0,3,0,0,3
2924,0,3,0,0,3
2925,0,3,0,0,3
2926,3,0,0,0,3
2927,2,0,1,0,3
2928,0,0,0,3,3
2929,0,3,0,0,3
2930,0,3,0,0,3
2931,0,3,0,0,3
2932,0,3,0,0,3
2933,0,0,0,3,3
2934,0,3,0,0,3
2935,0,3,0,0,3
2936,0,3,0,0,3
2937,0,3,0,0,3
2938,0,3,0,0,3
2939,0,3,0,0,3
2940,0,3,0,0,3
2941,0,3,0,0,3
2942,0,3,0,0,3
2943,0,3,0,0,3
2944,0,3,0,0,3
2945,0,3,0,0,3
2946,1,2,0,0,3
2947,0,3,0,0,3
2948,0,2,0,1,3
2949,0,3,0,0,3
2950,0,3,0,0,3
2951,0,3,0,0,3
2952,1,0,0,2,3
2953,0,3,0,0,3
2954,0,3,0,0,3
2955,0,3,0,0,3
2956,0,3,0,0,3
2957,0,3,0,0,3
2958,3,0,0,0,3
2959,0,3,0,0,3
2960,0,3,0,0,3
2961,0,3,0,0,3
2962,0,3,0,0,3
2963,0,3,0,0,3
2964,0,3,0,0,3
2965,0,3,0,0,3
2966,0,3,0,0,3
2967,0,3,0,0,3
2968,0,3,0,0,3
2969,0,3,0,0,3
2970,0,3,0,0,3
2971,0,3,0,0,3
2972,0,3,0,0,3
2973,0,3,0,0,3
2974,0,2,1,0,3
2975,0,3,0,0,3
2976,3,0,0,0,3
2977,3,0,0,0,3
2978,0,3,0,0,3
2979,1,1,1,0,3
2980,3,0,0,0,3
2981,0,3,0,0,3
2982,0,3,0,0,3
2983,0,3,0,0,3
2984,0,3,0,0,3
2985,0,3,0,0,3
2986,0,3,0,0,3
2987,0,3,0,0,3
2988,0,3,0,0,3
2989,0,3,0,0,3
2990,0,3,0,0,3
2991,0,3,0,0,3
2992,0,0,3,0,3
2993,0,2,0,1,3
2994,0,3,0,0,3
2995,0,3,0,0,3
2996,2,1,0,0,3
2997,0,3,0,0,3
2998,0,2,0,1,3
2999,0,3,0,0,3
3000,0,2,1,0,3
3001,0,3,0,0,3
3002,1,2,0,0,3
3003,0,3,0,0,3
3004,0,3,0,0,3
3005,0,3,0,0,3
3006,0,3,0,0,3
3007,0,3,0,0,3
3008,0,3,0,0,3
3009,0,3,0,0,3
3010,3,0,0,0,3
3011,3,0,0,0,3
3012,0,3,0,0,3
3013,0,3,0,0,3
3014,0,3,0,0,3
3015,0,3,0,0,3
3016,0,3,0,0,3
3017,0,3,0,0,3
3018,0,3,0,0,3
3019,0,3,0,0,3
3020,0,3,0,0,3
3021,0,3,0,0,3
3022,0,2,0,1,3
3023,0,3,0,0,3
3024,0,3,0,0,3
3025,0,3,0,0,3
3026,0,1,1,1,3
3027,0,3,0,0,3
3028,0,3,0,0,3
3029,0,3,0,0,3
3030,0,3,0,0,3
3031,0,3,0,0,3
3032,1,2,0,0,3
3033,0,3,0,0,3
3034,0,3,0,0,3
3035,1,2,0,0,3
3036,0,3,0,0,3
3037,0,3,0,0,3
3038,0,3,0,0,3
3039,3,0,0,0,3
3040,3,0,0,0,3
3041,0,3,0,0,3
3042,0,3,0,0,3
3043,0,3,0,0,3
3044,3,0,0,0,3
3045,3,0,0,0,3
3046,0,3,0,0,3
3047,0,3,0,0,3
3048,0,3,0,0,3
3049,0,3,0,0,3
3050,0,3,0,0,3
3051,0,3,0,0,3
3052,1,2,0,0,3
3053,0,3,0,0,3
3054,0,3,0,0,3
3055,0,3,0,0,3
3056,0,3,0,0,3
3057,3,0,0,0,3
3058,0,3,0,0,3
3059,0,2,1,0,3
3060,0,3,0,0,3
3061,0,3,0,0,3
3062,1,2,0,0,3
3063,0,0,0,3,3
3064,0,3,0,0,3
3065,0,3,0,0,3
3066,0,3,0,0,3
3067,1,2,0,0,3
3068,3,0,0,0,3
3069,0,3,0,0,3
3070,3,0,0,0,3
3071,2,1,0,0,3
3072,0,3,0,0,3
3073,0,3,0,0,3
3074,0,3,0,0,3
3075,0,3,0,0,3
3076,0,3,0,0,3
3077,1,0,0,2,3
3078,2,1,0,0,3
3079,0,3,0,0,3
3080,0,3,0,0,3
3081,0,3,0,0,3
3082,0,3,0,0,3
3083,1,2,0,0,3
3084,0,3,0,0,3
3085,2,1,0,0,3
3086,0,3,0,0,3
3087,0,3,0,0,3
3088,0,3,0,0,3
3089,0,3,0,0,3
3090,2,1,0,0,3
3091,0,2,1,0,3
3092,2,1,0,0,3
3093,2,0,0,1,3
3094,1,2,0,0,3
3095,0,3,0,0,3
3096,0,3,0,0,3
3097,0,3,0,0,3
3098,0,3,0,0,3
3099,0,3,0,0,3
3100,0,3,0,0,3
3101,0,3,0,0,3
3102,0,3,0,0,3
3103,0,3,0,0,3
3104,0,3,0,0,3
3105,0,3,0,0,3
3106,0,3,0,0,3
3107,0,3,0,0,3
3108,0,3,0,0,3
3109,0,3,0,0,3
3110,0,3,0,0,3
3111,3,0,0,0,3
3112,0,3,0,0,3
3113,0,3,0,0,3
3114,0,3,0,0,3
3115,0,3,0,0,3
3116,0,3,0,0,3
3117,0,3,0,0,3
3118,0,3,0,0,3
3119,0,3,0,0,3
3120,0,2,0,1,3
3121,0,3,0,0,3
3122,0,3,0,0,3
3123,0,3,0,0,3
3124,0,3,0,0,3
3125,0,3,0,0,3
3126,1,2,0,0,3
3127,0,3,0,0,3
3128,2,1,0,0,3
3129,0,3,0,0,3
3130,0,3,0,0,3
3131,0,3,0,0,3
3132,1,1,1,0,3
3133,0,3,0,0,3
3134,0,3,0,0,3
3135,0,3,0,0,3
3136,0,3,0,0,3
3137,0,3,0,0,3
3138,0,3,0,0,3
3139,1,0,1,1,3
3140,0,3,0,0,3
3141,0,3,0,0,3
3142,0,3,0,0,3
3143,0,3,0,0,3
3144,3,0,0,0,3
3145,0,3,0,0,3
3146,0,3,0,0,3
3147,0,3,0,0,3
3148,0,3,0,0,3
3149,0,3,0,0,3
3150,1,2,0,0,3
3151,3,0,0,0,3
3152,0,3,0,0,3
3153,1,2,0,0,3
3154,0,3,0,0,3
3155,3,0,0,0,3
3156,0,3,0,0,3
3157,0,3,0,0,3
3158,2,0,1,0,3
3159,0,3,0,0,3
3160,0,3,0,0,3
3161,0,3,0,0,3
3162,0,3,0,0,3
3163,0,3,0,0,3
3164,0,3,0,0,3
3165,0,1,0,2,3
3166,0,3,0,0,3
3167,0,2,0,1,3
3168,0,0,0,3,3
3169,0,3,0,0,3
3170,0,3,0,0,3
3171,0,3,0,0,3
3172,0,3,0,0,3
3173,0,3,0,0,3
3174,0,3,0,0,3
3175,3,0,0,0,3
3176,0,3,0,0,3
3177,1,2,0,0,3
3178,0,3,0,0,3
3179,0,3,0,0,3
3180,0,3,0,0,3
3181,0,3,0,0,3
3182,1,1,0,1,3
3183,1,2,0,0,3
3184,0,2,1,0,3
3185,0,3,0,0,3
3186,0,3,0,0,3
3187,3,0,0,0,3
3188,0,3,0,0,3
3189,3,0,0,0,3
3190,0,3,0,0,3
3191,0,3,0,0,3
3192,0,3,0,0,3
3193,0,3,0,0,3
3194,0,2,1,0,3
3195,0,3,0,0,3
3196,0,3,0,0,3
3197,2,1,0,0,3
3198,0,3,0,0,3
3199,0,3,0,0,3
3200,0,3,0,0,3
3201,0,3,0,0,3
3202,0,3,0,0,3
3203,0,3,0,0,3
3204,2,0,0,1,3
3205,3,0,0,0,3
3206,0,3,0,0,3
3207,0,3,0,0,3
3208,0,3,0,0,3
3209,0,3,0,0,3
3210,0,3,0,0,3
3211,0,3,0,0,3
3212,1,2,0,0,3
3213,1,2,0,0,3
3214,0,3,0,0,3
3215,0,3,0,0,3
3216,0,3,0,0,3
3217,0,3,0,0,3
3218,3,0,0,0,3
3219,0,3,0,0,3
3220,1,2,0,0,3
3221,0,3,0,0,3
3222,2,0,0,1,3
3223,0,3,0,0,3
3224,0,3,0,0,3
3225,3,0,0,0,3
3226,0,3,0,0,3
3227,0,3,0,0,3
3228,0,3,0,0,3
3229,0,3,0,0,3
3230,0,3,0,0,3
3231,0,3,0,0,3
3232,3,0,0,0,3
3233,0,3,0,0,3
3234,0,3,0,0,3
3235,0,3,0,0,3
3236,1,2,0,0,3
3237,1,2,0,0,3
3238,3,0,0,0,3
3239,0,3,0,0,3
3240,3,0,0,0,3
3241,3,0,0,0,3
3242,0,3,0,0,3
3243,0,3,0,0,3
3244,0,0,0,3,3
3245,3,0,0,0,3
3246,0,3,0,0,3
3247,0,3,0,0,3
3248,0,3,0,0,3
3249,0,3,0,0,3
3250,1,2,0,0,3
3251,1,2,0,0,3
3252,0,3,0,0,3
3253,0,3,0,0,3
3254,0,3,0,0,3
3255,0,3,0,0,3
3256,0,3,0,0,3
3257,0,3,0,0,3
3258,0,3,0,0,3
3259,0,3,0,0,3
3260,0,3,0,0,3
3261,3,0,0,0,3
3262,1,2,0,0,3
3263,0,3,0,0,3
3264,0,3,0,0,3
3265,0,3,0,0,3
3266,0,3,0,0,3
3267,0,3,0,0,3
3268,0,3,0,0,3
3269,0,3,0,0,3
3270,0,3,0,0,3
3271,3,0,0,0,3
3272,3,0,0,0,3
3273,0,3,0,0,3
3274,0,3,0,0,3
3275,0,3,0,0,3
3276,0,3,0,0,3
3277,0,3,0,0,3
3278,0,3,0,0,3
3279,1,2,0,0,3
3280,0,3,0,0,3
3281,0,3,0,0,3
3282,0,3,0,0,3
3283,0,3,0,0,3
3284,0,3,0,0,3
3285,0,3,0,0,3
3286,0,3,0,0,3
3287,0,3,0,0,3
3288,0,3,0,0,3
3289,0,3,0,0,3
3290,0,3,0,0,3
3291,3,0,0,0,3
3292,2,1,0,0,3
3293,0,3,0,0,3
3294,0,0,0,3,3
3295,0,3,0,0,3
3296,3,0,0,0,3
3297,1,0,2,0,3
3298,0,3,0,0,3
3299,0,3,0,0,3
3300,1,2,0,0,3
3301,0,3,0,0,3
3302,0,3,0,0,3
3303,0,3,0,0,3
3304,1,0,0,2,3
3305,3,0,0,0,3
3306,0,3,0,0,3
3307,0,3,0,0,3
3308,0,3,0,0,3
3309,0,3,0,0,3
3310,2,0,0,1,3
3311,0,3,0,0,3
3312,0,3,0,0,3
3313,0,3,0,0,3
3314,0,3,0,0,3
3315,0,3,0,0,3
3316,0,3,0,0,3
3317,0,3,0,0,3
3318,0,3,0,0,3
3319,0,3,0,0,3
3320,0,3,0,0,3
3321,0,2,0,1,3
3322,0,3,0,0,3
3323,0,3,0,0,3
3324,0,3,0,0,3
3325,0,3,0,0,3
3326,0,3,0,0,3
3327,0,3,0,0,3
3328,0,3,0,0,3
3329,2,1,0,0,3
3330,0,3,0,0,3
3331,0,3,0,0,3
3332,0,3,0,0,3
3333,3,0,0,0,3
3334,0,3,0,0,3
3335,0,3,0,0,3
3336,0,3,0,0,3
3337,0,3,0,0,3
3338,0,3,0,0,3
3339,0,3,0,0,3
3340,0,3,0,0,3
3341,0,3,0,0,3
3342,0,3,0,0,3
3343,3,0,0,0,3
3344,0,3,0,0,3
3345,0,0,3,0,3
3346,0,3,0,0,3
3347,3,0,0,0,3
3348,0,3,0,0,3
3349,0,3,0,0,3
3350,0,3,0,0,3
3351,1,2,0,0,3
3352,1,1,0,1,3
3353,0,3,0,0,3
3354,2,1,0,0,3
3355,2,0,0,1,3
3356,3,0,0,0,3
3357,1,1,1,0,3
3358,0,3,0,0,3
3359,0,3,0,0,3
3360,0,3,0,0,3
3361,2,0,0,0,2
3362,0,2,0,0,2
3363,0,2,0,0,2
3364,0,2,0,0,2
3365,0,2,0,0,2
3366,0,2,0,0,2
3367,0,2,0,0,2
3368,0,2,0,0,2
3369,0,2,0,0,2
3370,0,2,0,0,2
3371,1,1,0,0,2
3372,0,2,0,0,2
3373,0,2,0,0,2
3374,0,2,0,0,2
3375,0,2,0,0,2
3376,0,2,0,0,2
3377,0,2,0,0,2
3378,0,0,0,2,2
3379,0,2,0,0,2
3380,0,2,0,0,2
3381,0,2,0,0,2
3382,0,2,0,0,2
3383,2,0,0,0,2
3384,0,2,0,0,2
3385,0,2,0,0,2
3386,0,2,0,0,2
3387,0,2,0,0,2
3388,0,2,0,0,2
3389,0,2,0,0,2
3390,0,2,0,0,2
3391,0,2,0,0,2
3392,0,2,0,0,2
3393,0,2,0,0,2
3394,1,1,0,0,2
3395,0,2,0,0,2
3396,0,2,0,0,2
3397,2,0,0,0,2
3398,0,2,0,0,2
3399,0,2,0,0,2
3400,0,2,0,0,2
3401,0,2,0,0,2
3402,0,2,0,0,2
3403,0,2,0,0,2
3404,0,2,0,0,2
3405,0,2,0,0,2
3406,0,2,0,0,2
3407,0,2,0,0,2
3408,0,2,0,0,2
3409,0,2,0,0,2
3410,1,1,0,0,2
3411,2,0,0,0,2
3412,0,2,0,0,2
3413,0,2,0,0,2
3414,2,0,0,0,2
3415,0,2,0,0,2
3416,2,0,0,0,2
3417,0,0,0,2,2
3418,0,2,0,0,2
3419,0,2,0,0,2
3420,1,1,0,0,2
3421,1,0,0,1,2
3422,0,2,0,0,2
3423,0,2,0,0,2
3424,2,0,0,0,2
3425,0,2,0,0,2
3426,0,2,0,0,2
3427,0,2,0,0,2
3428,0,2,0,0,2
3429,1,1,0,0,2
3430,1,1,0,0,2
3431,1,1,0,0,2
3432,0,2,0,0,2
3433,0,2,0,0,2
3434,0,2,0,0,2
3435,0,2,0,0,2
3436,0,2,0,0,2
3437,0,2,0,0,2
3438,0,2,0,0,2
3439,0,2,0,0,2
3440,0,2,0,0,2
3441,0,2,0,0,2
3442,0,2,0,0,2
3443,0,2,0,0,2
3444,0,2,0,0,2
3445,0,2,0,0,2
3446,0,2,0,0,2
3447,0,2,0,0,2
3448,0,2,0,0,2
3449,0,0,2,0,2
3450,0,2,0,0,2
3451,0,2,0,0,2
3452,0,2,0,0,2
3453,0,2,0,0,2
3454,2,0,0,0,2
3455,1,0,0,1,2
3456,0,2,0,0,2
3457,0,2,0,0,2
3458,0,2,0,0,2
3459,0,2,0,0,2
3460,1,1,0,0,2
3461,0,2,0,0,2
3462,0,2,0,0,2
3463,0,2,0,0,2
3464,0,2,0,0,2
3465,0,2,0,0,2
3466,0,2,0,0,2
3467,0,2,0,0,2
3468,0,2,0,0,2
3469,2,0,0,0,2
3470,2,0,0,0,2
3471,0,2,0,0,2
3472,0,2,0,0,2
3473,0,2,0,0,2
3474,0,2,0,0,2
3475,0,2,0,0,2
3476,0,2,0,0,2
3477,0,2,0,0,2
3478,0,2,0,0,2
3479,0,2,0,0,2
3480,2,0,0,0,2
3481,0,2,0,0,2
3482,0,2,0,0,2
3483,0,2,0,0,2
3484,0,2,0,0,2
3485,0,2,0,0,2
3486,0,2,0,0,2
3487,0,2,0,0,2
3488,0,2,0,0,2
3489,0,2,0,0,2
3490,0,2,0,0,2
3491,1,1,0,0,2
3492,0,2,0,0,2
3493,2,0,0,0,2
3494,0,2,0,0,2
3495,0,2,0,0,2
3496,0,2,0,0,2
3497,0,2,0,0,2
3498,0,2,0,0,2
3499,0,2,0,0,2
3500,1,0,1,0,2
3501,0,2,0,0,2
3502,0,2,0,0,2
3503,0,2,0,0,2
3504,0,2,0,0,2
3505,0,2,0,0,2
3506,0,2,0,0,2
3507,0,2,0,0,2
3508,0,1,1,0,2
3509,0,2,0,0,2
3510,0,2,0,0,2
3511,2,0,0,0,2
3512,0,2,0,0,2
3513,0,2,0,0,2
3514,2,0,0,0,2
3515,0,2,0,0,2
3516,0,2,0,0,2
3517,0,2,0,0,2
3518,0,2,0,0,2
3519,0,2,0,0,2
3520,0,2,0,0,2
3521,0,2,0,0,2
3522,0,2,0,0,2
3523,0,2,0,0,2
3524,0,2,0,0,2
3525,2,0,0,0,2
3526,2,0,0,0,2
3527,0,1,0,1,2
3528,0,2,0,0,2
3529,0,2,0,0,2
3530,0,2,0,0,2
3531,0,2,0,0,2
3532,1,1,0,0,2
3533,2,0,0,0,2
3534,0,2,0,0,2
3535,0,2,0,0,2
3536,1,1,0,0,2
3537,0,2,0,0,2
3538,0,2,0,0,2
3539,0,0,0,2,2
3540,0,2,0,0,2
3541,0,2,0,0,2
3542,0,2,0,0,2
3543,0,2,0,0,2
3544,0,2,0,0,2
3545,2,0,0,0,2
3546,0,2,0,0,2
3547,0,2,0,0,2
3548,0,2,0,0,2
3549,0,2,0,0,2
3550,0,1,0,1,2
3551,2,0,0,0,2
3552,0,2,0,0,2
3553,0,2,0,0,2
3554,2,0,0,0,2
3555,0,2,0,0,2
3556,0,2,0,0,2
3557,0,2,0,0,2
3558,0,2,0,0,2
3559,0,2,0,0,2
3560,0,2,0,0,2
3561,1,0,0,1,2
3562,0,2,0,0,2
3563,2,0,0,0,2
3564,0,2,0,0,2
3565,0,2,0,0,2
3566,0,2,0,0,2
3567,0,2,0,0,2
3568,2,0,0,0,2
3569,0,2,0,0,2
3570,2,0,0,0,2
3571,1,1,0,0,2
3572,0,2,0,0,2
3573,1,1,0,0,2
3574,0,2,0,0,2
3575,1,1,0,0,2
3576,0,2,0,0,2
3577,0,2,0,0,2
3578,0,2,0,0,2
3579,0,2,0,0,2
3580,0,2,0,0,2
3581,1,1,0,0,2
3582,0,2,0,0,2
3583,0,2,0,0,2
3584,0,2,0,0,2
3585,0,2,0,0,2
3586,0,2,0,0,2
3587,0,2,0,0,2
3588,2,0,0,0,2
3589,0,2,0,0,2
3590,0,2,0,0,2
3591,0,2,0,0,2
3592,0,2,0,0,2
3593,0,2,0,0,2
3594,0,2,0,0,2
3595,0,2,0,0,2
3596,0,2,0,0,2
3597,0,2,0,0,2
3598,0,2,0,0,2
3599,2,0,0,0,2
3600,1,1,0,0,2
3601,0,2,0,0,2
3602,0,2,0,0,2
3603,0,2,0,0,2
3604,1,1,0,0,2
3605,0,2,0,0,2
3606,0,2,0,0,2
3607,0,2,0,0,2
3608,0,2,0,0,2
3609,2,0,0,0,2
3610,0,2,0,0,2
3611,0,2,0,0,2
3612,0,2,0,0,2
3613,0,2,0,0,2
3614,0,2,0,0,2
3615,0,2,0,0,2
3616,0,2,0,0,2
3617,0,2,0,0,2
3618,1,0,0,1,2
3619,0,2,0,0,2
3620,1,1,0,0,2
3621,0,2,0,0,2
3622,1,0,0,1,2
3623,0,2,0,0,2
3624,0,2,0,0,2
3625,0,1,1,0,2
3626,2,0,0,0,2
3627,0,2,0,0,2
3628,0,2,0,0,2
3629,0,2,0,0,2
3630,0,2,0,0,2
3631,0,2,0,0,2
3632,0,2,0,0,2
3633,0,2,0,0,2
3634,0,2,0,0,2
3635,0,2,0,0,2
3636,0,2,0,0,2
3637,2,0,0,0,2
3638,0,2,0,0,2
3639,2,0,0,0,2
3640,0,2,0,0,2
3641,0,2,0,0,2
3642,0,1,1,0,2
3643,0,1,0,1,2
3644,2,0,0,0,2
3645,0,2,0,0,2
3646,0,2,0,0,2
3647,0,2,0,0,2
3648,0,2,0,0,2
3649,2,0,0,0,2
3650,0,2,0,0,2
3651,0,2,0,0,2
3652,0,2,0,0,2
3653,1,0,1,0,2
3654,0,2,0,0,2
3655,0,2,0,0,2
3656,0,2,0,0,2
3657,0,2,0,0,2
3658,0,2,0,0,2
3659,0,2,0,0,2
3660,0,2,0,0,2
3661,2,0,0,0,2
3662,0,2,0,0,2
3663,0,2,0,0,2
3664,0,2,0,0,2
3665,0,2,0,0,2
3666,0,2,0,0,2
3667,0,2,0,0,2
3668,0,2,0,0,2
3669,0,2,0,0,2
3670,2,0,0,0,2
3671,0,2,0,0,2
3672,0,2,0,0,2
3673,0,2,0,0,2
3674,0,2,0,0,2
3675,0,2,0,0,2
3676,0,2,0,0,2
3677,0,2,0,0,2
3678,1,1,0,0,2
3679,1,1,0,0,2
3680,0,2,0,0,2
3681,0,2,0,0,2
3682,0,2,0,0,2
3683,0,2,0,0,2
3684,1,1,0,0,2
3685,0,2,0,0,2
3686,0,2,0,0,2
3687,0,2,0,0,2
3688,0,2,0,0,2
3689,0,0,0,2,2
3690,0,2,0,0,2
3691,0,2,0,0,2
3692,0,2,0,0,2
3693,0,2,0,0,2
3694,0,2,0,0,2
3695,0,2,0,0,2
3696,0,2,0,0,2
3697,0,2,0,0,2
3698,0,2,0,0,2
3699,0,2,0,0,2
3700,0,2,0,0,2
3701,0,1,0,1,2
3702,0,2,0,0,2
3703,0,2,0,0,2
3704,0,2,0,0,2
3705,0,2,0,0,2
3706,0,2,0,0,2
3707,1,1,0,0,2
3708,0,2,0,0,2
3709,0,2,0,0,2
3710,0,2,0,0,2
3711,0,2,0,0,2
3712,0,2,0,0,2
3713,0,2,0,0,2
3714,0,2,0,0,2
3715,0,2,0,0,2
3716,0,2,0,0,2
3717,2,0,0,0,2
3718,0,2,0,0,2
3719,0,2,0,0,2
3720,0,2,0,0,2
3721,1,1,0,0,2
3722,0,2,0,0,2
3723,0,2,0,0,2
3724,0,2,0,0,2
3725,0,2,0,0,2
3726,0,2,0,0,2
3727,0,2,0,0,2
3728,0,2,0,0,2
3729,0,2,0,0,2
3730,0,2,0,0,2
3731,2,0,0,0,2
3732,0,2,0,0,2
3733,2,0,0,0,2
3734,0,2,0,0,2
3735,0,2,0,0,2
3736,0,2,0,0,2
3737,1,0,0,1,2
3738,1,1,0,0,2
3739,0,2,0,0,2
3740,0,2,0,0,2
3741,0,2,0,0,2
3742,0,2,0,0,2
3743,0,2,0,0,2
3744,0,2,0,0,2
3745,0,2,0,0,2
3746,0,2,0,0,2
3747,0,2,0,0,2
3748,0,2,0,0,2
3749,0,2,0,0,2
3750,0,2,0,0,2
3751,0,2,0,0,2
3752,0,2,0,0,2
3753,0,2,0,0,2
3754,0,2,0,0,2
3755,2,0,0,0,2
3756,0,2,0,0,2
3757,0,2,0,0,2
3758,0,2,0,0,2
3759,0,2,0,0,2
3760,0,2,0,0,2
3761,0,2,0,0,2
3762,0,2,0,0,2
3763,0,2,0,0,2
3764,0,2,0,0,2
3765,2,0,0,0,2
3766,0,2,0,0,2
3767,0,2,0,0,2
3768,0,2,0,0,2
3769,0,2,0,0,2
3770,1,1,0,0,2
3771,0,2,0,0,2
3772,2,0,0,0,2
3773,0,2,0,0,2
3774,0,2,0,0,2
3775,0,2,0,0,2
3776,2,0,0,0,2
3777,0,2,0,0,2
3778,0,2,0,0,2
3779,0,2,0,0,2
3780,0,2,0,0,2
3781,0,2,0,0,2
3782,0,2,0,0,2
3783,2,0,0,0,2
3784,0,2,0,0,2
3785,0,2,0,0,2
3786,0,2,0,0,2
3787,1,0,0,1,2
3788,0,2,0,0,2
3789,1,1,0,0,2
3790,0,2,0,0,2
3791,0,2,0,0,2
3792,0,2,0,0,2
3793,0,2,0,0,2
3794,0,2,0,0,2
3795,0,2,0,0,2
3796,0,1,1,0,2
3797,0,2,0,0,2
3798,0,2,0,0,2
3799,0,2,0,0,2
3800,2,0,0,0,2
3801,0,2,0,0,2
3802,0,2,0,0,2
3803,0,2,0,0,2
3804,0,2,0,0,2
3805,1,1,0,0,2
3806,0,2,0,0,2
3807,0,2,0,0,2
3808,0,2,0,0,2
3809,0,2,0,0,2
3810,1,1,0,0,2
3811,0,2,0,0,2
3812,0,2,0,0,2
3813,0,2,0,0,2
3814,0,2,0,0,2
3815,0,2,0,0,2
3816,0,2,0,0,2
3817,2,0,0,0,2
3818,0,1,1,0,2
3819,0,2,0,0,2
3820,1,1,0,0,2
3821,0,0,2,0,2
3822,1,1,0,0,2
3823,0,2,0,0,2
3824,0,2,0,0,2
3825,0,2,0,0,2
3826,0,2,0,0,2
3827,0,2,0,0,2
3828,0,2,0,0,2
3829,0,2,0,0,2
3830,0,2,0,0,2
3831,1,0,1,0,2
3832,0,2,0,0,2
3833,1,1,0,0,2
3834,0,2,0,0,2
3835,0,2,0,0,2
3836,0,2,0,0,2
3837,0,2,0,0,2
3838,0,2,0,0,2
3839,2,0,0,0,2
3840,0,2,0,0,2
3841,0,2,0,0,2
3842,0,2,0,0,2
3843,0,2,0,0,2
3844,0,2,0,0,2
3845,0,2,0,0,2
3846,0,2,0,0,2
3847,0,2,0,0,2
3848,2,0,0,0,2
3849,0,2,0,0,2
3850,1,1,0,0,2
3851,0,2,0,0,2
3852,0,2,0,0,2
3853,0,2,0,0,2
3854,0,2,0,0,2
3855,0,2,0,0,2
3856,2,0,0,0,2
3857,0,2,0,0,2
3858,0,2,0,0,2
3859,0,2,0,0,2
3860,0,2,0,0,2
3861,0,2,0,0,2
3862,2,0,0,0,2
3863,2,0,0,0,2
3864,0,2,0,0,2
3865,0,2,0,0,2
3866,2,0,0,0,2
3867,0,2,0,0,2
3868,1,0,1,0,2
3869,1,0,0,1,2
3870,0,2,0,0,2
3871,0,2,0,0,2
3872,2,0,0,0,2
3873,0,2,0,0,2
3874,2,0,0,0,2
3875,1,0,0,1,2
3876,2,0,0,0,2
3877,2,0,0,0,2
3878,0,2,0,0,2
3879,0,2,0,0,2
3880,0,2,0,0,2
3881,0,2,0,0,2
3882,0,2,0,0,2
3883,0,2,0,0,2
3884,2,0,0,0,2
3885,0,2,0,0,2
3886,0,2,0,0,2
3887,0,2,0,0,2
3888,0,2,0,0,2
3889,0,2,0,0,2
3890,0,2,0,0,2
3891,0,2,0,0,2
3892,0,2,0,0,2
3893,0,2,0,0,2
3894,0,2,0,0,2
3895,0,2,0,0,2
3896,0,2,0,0,2
3897,2,0,0,0,2
3898,0,2,0,0,2
3899,0,2,0,0,2
3900,0,2,0,0,2
3901,0,2,0,0,2
3902,0,2,0,0,2
3903,0,2,0,0,2
3904,0,2,0,0,2
3905,0,2,0,0,2
3906,0,2,0,0,2
3907,0,2,0,0,2
3908,0,2,0,0,2
3909,0,2,0,0,2
3910,0,2,0,0,2
3911,2,0,0,0,2
3912,0,0,2,0,2
3913,0,2,0,0,2
3914,2,0,0,0,2
3915,0,2,0,0,2
3916,0,2,0,0,2
3917,0,2,0,0,2
3918,0,2,0,0,2
3919,0,2,0,0,2
3920,0,2,0,0,2
3921,2,0,0,0,2
3922,0,2,0,0,2
3923,0,2,0,0,2
3924,0,2,0,0,2
3925,0,2,0,0,2
3926,1,0,0,1,2
3927,0,2,0,0,2
3928,1,1,0,0,2
3929,0,2,0,0,2
3930,2,0,0,0,2
3931,0,2,0,0,2
3932,0,2,0,0,2
3933,0,2,0,0,2
3934,0,2,0,0,2
3935,0,2,0,0,2
3936,2,0,0,0,2
3937,1,1,0,0,2
3938,0,2,0,0,2
3939,0,2,0,0,2
3940,0,2,0,0,2
3941,2,0,0,0,2
3942,0,2,0,0,2
3943,0,2,0,0,2
3944,0,2,0,0,2
3945,0,2,0,0,2
3946,0,2,0,0,2
3947,0,2,0,0,2
3948,0,2,0,0,2
3949,1,0,0,1,2
3950,0,2,0,0,2
3951,2,0,0,0,2
3952,1,1,0,0,2
3953,0,2,0,0,2
3954,0,2,0,0,2
3955,2,0,0,0,2
3956,0,2,0,0,2
3957,0,2,0,0,2
3958,1,0,0,1,2
3959,0,2,0,0,2
3960,0,2,0,0,2
3961,0,2,0,0,2
3962,0,2,0,0,2
3963,0,2,0,0,2
3964,0,2,0,0,2
3965,0,2,0,0,2
3966,2,0,0,0,2
3967,0,2,0,0,2
3968,0,2,0,0,2
3969,0,2,0,0,2
3970,0,2,0,0,2
3971,0,2,0,0,2
3972,0,2,0,0,2
3973,0,2,0,0,2
3974,0,2,0,0,2
3975,0,2,0,0,2
3976,0,2,0,0,2
3977,0,2,0,0,2
3978,0,2,0,0,2
3979,0,2,0,0,2
3980,0,2,0,0,2
3981,0,2,0,0,2
3982,0,2,0,0,2
3983,0,2,0,0,2
3984,0,2,0,0,2
3985,0,2,0,0,2
3986,0,2,0,0,2
3987,0,2,0,0,2
3988,0,2,0,0,2
3989,2,0,0,0,2
3990,2,0,0,0,2
3991,1,0,1,0,2
3992,1,1,0,0,2
3993,0,2,0,0,2
3994,0,2,0,0,2
3995,0,2,0,0,2
3996,0,2,0,0,2
3997,0,2,0,0,2
3998,1,1,0,0,2
3999,0,2,0,0,2
4000,0,2,0,0,2
4001,0,2,0,0,2
4002,0,2,0,0,2
4003,0,0,0,2,2
4004,1,0,0,1,2
4005,0,2,0,0,2
4006,0,2,0,0,2
4007,0,2,0,0,2
4008,0,2,0,0,2
4009,0,2,0,0,2
4010,0,2,0,0,2
4011,1,1,0,0,2
4012,0,2,0,0,2
4013,1,1,0,0,2
4014,0,2,0,0,2
4015,2,0,0,0,2
4016,2,0,0,0,2
4017,0,2,0,0,2
4018,0,2,0,0,2
4019,2,0,0,0,2
4020,0,2,0,0,2
4021,0,2,0,0,2
4022,0,2,0,0,2
4023,0,2,0,0,2
4024,0,2,0,0,2
4025,0,2,0,0,2
4026,0,2,0,0,2
4027,0,2,0,0,2
4028,0,2,0,0,2
4029,2,0,0,0,2
4030,0,2,0,0,2
4031,0,2,0,0,2
4032,0,2,0,0,2
4033,0,2,0,0,2
4034,0,2,0,0,2
4035,0,2,0,0,2
4036,1,1,0,0,2
4037,0,2,0,0,2
4038,0,2,0,0,2
4039,2,0,0,0,2
4040,0,2,0,0,2
4041,0,2,0,0,2
4042,0,2,0,0,2
4043,0,2,0,0,2
4044,0,2,0,0,2
4045,0,2,0,0,2
4046,0,2,0,0,2
4047,0,2,0,0,2
4048,0,2,0,0,2
4049,0,2,0,0,2
4050,0,2,0,0,2
4051,0,2,0,0,2
4052,0,2,0,0,2
4053,0,2,0,0,2
4054,2,0,0,0,2
4055,0,2,0,0,2
4056,0,2,0,0,2
4057,0,2,0,0,2
4058,0,2,0,0,2
4059,0,2,0,0,2
4060,0,2,0,0,2
4061,0,2,0,0,2
4062,0,2,0,0,2
4063,0,2,0,0,2
4064,0,2,0,0,2
4065,0,2,0,0,2
4066,0,2,0,0,2
4067,0,1,1,0,2
4068,0,2,0,0,2
4069,0,2,0,0,2
4070,0,2,0,0,2
4071,0,2,0,0,2
4072,1,0,0,1,2
4073,2,0,0,0,2
4074,1,0,0,1,2
4075,0,2,0,0,2
4076,0,2,0,0,2
4077,1,1,0,0,2
4078,0,2,0,0,2
4079,0,2,0,0,2
4080,0,2,0,0,2
4081,1,1,0,0,2
4082,0,2,0,0,2
4083,0,2,0,0,2
4084,0,2,0,0,2
4085,0,2,0,0,2
4086,1,1,0,0,2
4087,0,2,0,0,2
4088,0,2,0,0,2
4089,0,2,0,0,2
4090,2,0,0,0,2
4091,0,2,0,0,2
4092,0,2,0,0,2
4093,0,2,0,0,2
4094,1,1,0,0,2
4095,0,2,0,0,2
4096,0,2,0,0,2
4097,0,2,0,0,2
4098,0,2,0,0,2
4099,0,2,0,0,2
4100,2,0,0,0,2
4101,2,0,0,0,2
4102,0,2,0,0,2
4103,0,2,0,0,2
4104,0,1,0,1,2
4105,0,2,0,0,2
4106,0,2,0,0,2
4107,0,2,0,0,2
4108,0,2,0,0,2
4109,0,2,0,0,2
4110,2,0,0,0,2
4111,0,2,0,0,2
4112,0,2,0,0,2
4113,1,1,0,0,2
4114,1,1,0,0,2
4115,0,2,0,0,2
4116,1,1,0,0,2
4117,0,2,0,0,2
4118,0,2,0,0,2
4119,0,2,0,0,2
4120,2,0,0,0,2
4121,0,2,0,0,2
4122,0,1,1,0,2
4123,0,2,0,0,2
4124,0,2,0,0,2
4125,0,2,0,0,2
4126,0,2,0,0,2
4127,0,2,0,0,2
4128,0,2,0,0,2
4129,0,2,0,0,2
4130,0,2,0,0,2
4131,0,2,0,0,2
4132,0,2,0,0,2
4133,0,2,0,0,2
4134,0,2,0,0,2
4135,0,2,0,0,2
4136,0,2,0,0,2
4137,2,0,0,0,2
4138,0,2,0,0,2
4139,0,2,0,0,2
4140,0,2,0,0,2
4141,0,2,0,0,2
4142,0,2,0,0,2
4143,0,2,0,0,2
4144,2,0,0,0,2
4145,0,1,1,0,2
4146,0,2,0,0,2
4147,0,2,0,0,2
4148,1,1,0,0,2
4149,0,2,0,0,2
4150,0,2,0,0,2
4151,1,1,0,0,2
4152,0,2,0,0,2
4153,0,2,0,0,2
4154,0,2,0,0,2
4155,0,2,0,0,2
4156,0,2,0,0,2
4157,0,2,0,0,2
4158,0,1,0,1,2
4159,0,2,0,0,2
4160,1,1,0,0,2
4161,1,1,0,0,2
4162,0,2,0,0,2
4163,0,2,0,0,2
4164,0,2,0,0,2
4165,0,2,0,0,2
4166,0,2,0,0,2
4167,0,2,0,0,2
4168,0,2,0,0,2
4169,0,2,0,0,2
4170,0,2,0,0,2
4171,0,2,0,0,2
4172,0,2,0,0,2
4173,0,2,0,0,2
4174,2,0,0,0,2
4175,0,2,0,0,2
4176,0,2,0,0,2
4177,0,2,0,0,2
4178,1,1,0,0,2
4179,0,2,0,0,2
4180,0,2,0,0,2
4181,2,0,0,0,2
4182,2,0,0,0,2
4183,0,2,0,0,2
4184,0,2,0,0,2
4185,0,2,0,0,2
4186,2,0,0,0,2
4187,0,2,0,0,2
4188,0,2,0,0,2
4189,1,1,0,0,2
4190,0,2,0,0,2
4191,0,2,0,0,2
4192,0,2,0,0,2
4193,2,0,0,0,2
4194,1,1,0,0,2
4195,2,0,0,0,2
4196,0,2,0,0,2
4197,0,2,0,0,2
4198,0,2,0,0,2
4199,1,1,0,0,2
4200,0,2,0,0,2
4201,0,2,0,0,2
4202,0,2,0,0,2
4203,0,0,0,2,2
4204,2,0,0,0,2
4205,0,2,0,0,2
4206,1,1,0,0,2
4207,0,2,0,0,2
4208,0,2,0,0,2
4209,0,2,0,0,2
4210,0,2,0,0,2
4211,0,2,0,0,2
4212,0,2,0,0,2
4213,0,2,0,0,2
4214,0,2,0,0,2
4215,0,2,0,0,2
4216,0,2,0,0,2
4217,0,2,0,0,2
4218,2,0,0,0,2
4219,0,2,0,0,2
4220,0,2,0,0,2
4221,0,2,0,0,2
4222,0,2,0,0,2
4223,0,2,0,0,2
4224,0,2,0,0,2
4225,0,2,0,0,2
4226,0,2,0,0,2
4227,0,2,0,0,2
4228,0,0,0,2,2
4229,1,0,0,1,2
4230,2,0,0,0,2
4231,2,0,0,0,2
4232,0,2,0,0,2
4233,2,0,0,0,2
4234,2,0,0,0,2
4235,0,2,0,0,2
4236,0,2,0,0,2
4237,0,2,0,0,2
4238,2,0,0,0,2
4239,0,2,0,0,2
4240,0,2,0,0,2
4241,0,2,0,0,2
4242,0,1,1,0,2
4243,1,1,0,0,2
4244,0,2,0,0,2
4245,0,2,0,0,2
4246,0,2,0,0,2
4247,0,2,0,0,2
4248,0,2,0,0,2
4249,0,2,0,0,2
4250,0,2,0,0,2
4251,0,2,0,0,2
4252,0,2,0,0,2
4253,0,2,0,0,2
4254,0,2,0,0,2
4255,2,0,0,0,2
4256,0,2,0,0,2
4257,0,2,0,0,2
4258,0,2,0,0,2
4259,0,2,0,0,2
4260,0,2,0,0,2
4261,0,2,0,0,2
4262,0,1,0,1,2
4263,1,0,0,1,2
4264,0,2,0,0,2
4265,0,2,0,0,2
4266,0,2,0,0,2
4267,0,2,0,0,2
4268,0,2,0,0,2
4269,1,1,0,0,2
4270,0,2,0,0,2
4271,0,2,0,0,2
4272,0,2,0,0,2
4273,0,2,0,0,2
4274,1,0,1,0,2
4275,0,2,0,0,2
4276,1,0,0,1,2
4277,2,0,0,0,2
4278,0,2,0,0,2
4279,0,2,0,0,2
4280,0,2,0,0,2
4281,0,2,0,0,2
4282,0,2,0,0,2
4283,0,2,0,0,2
4284,0,2,0,0,2
4285,0,2,0,0,2
4286,0,2,0,0,2
4287,0,2,0,0,2
4288,1,1,0,0,2
4289,0,2,0,0,2
4290,0,2,0,0,2
4291,0,2,0,0,2
4292,0,2,0,0,2
4293,0,2,0,0,2
4294,0,2,0,0,2
4295,1,1,0,0,2
4296,0,2,0,0,2
4297,0,2,0,0,2
4298,2,0,0,0,2
4299,1,1,0,0,2
4300,0,0,0,2,2
4301,0,2,0,0,2
4302,0,2,0,0,2
4303,0,2,0,0,2
4304,0,2,0,0,2
4305,0,2,0,0,2
4306,2,0,0,0,2
4307,2,0,0,0,2
4308,0,2,0,0,2
4309,2,0,0,0,2
4310,0,2,0,0,2
4311,1,0,0,1,2
4312,0,2,0,0,2
4313,0,2,0,0,2
4314,0,2,0,0,2
4315,0,2,0,0,2
4316,0,2,0,0,2
4317,1,1,0,0,2
4318,0,2,0,0,2
4319,0,2,0,0,2
4320,0,2,0,0,2
4321,0,2,0,0,2
4322,1,1,0,0,2
4323,0,2,0,0,2
4324,0,2,0,0,2
4325,0,2,0,0,2
4326,0,2,0,0,2
4327,0,2,0,0,2
4328,1,0,0,1,2
4329,0,2,0,0,2
4330,0,2,0,0,2
4331,0,2,0,0,2
4332,0,2,0,0,2
4333,1,1,0,0,2
4334,0,2,0,0,2
4335,1,0,0,1,2
4336,0,2,0,0,2
4337,0,2,0,0,2
4338,0,2,0,0,2
4339,1,0,0,1,2
4340,0,2,0,0,2
4341,1,1,0,0,2
4342,0,0,0,2,2
4343,0,2,0,0,2
4344,0,0,0,2,2
4345,0,2,0,0,2
4346,0,2,0,0,2
4347,0,2,0,0,2
4348,0,2,0,0,2
4349,0,2,0,0,2
4350,0,2,0,0,2
4351,0,2,0,0,2
4352,0,1,0,1,2
4353,1,0,1,0,2
4354,0,2,0,0,2
4355,0,2,0,0,2
4356,0,1,1,0,2
4357,0,2,0,0,2
4358,2,0,0,0,2
4359,1,1,0,0,2
4360,0,2,0,0,2
4361,0,2,0,0,2
4362,0,2,0,0,2
4363,0,2,0,0,2
4364,0,2,0,0,2
4365,0,2,0,0,2
4366,0,2,0,0,2
4367,0,2,0,0,2
4368,0,2,0,0,2
4369,0,2,0,0,2
4370,0,1,1,0,2
4371,2,0,0,0,2
4372,0,2,0,0,2
4373,0,2,0,0,2
4374,0,2,0,0,2
4375,0,2,0,0,2
4376,0,2,0,0,2
4377,0,2,0,0,2
4378,2,0,0,0,2
4379,2,0,0,0,2
4380,0,2,0,0,2
4381,0,2,0,0,2
4382,1,1,0,0,2
4383,1,1,0,0,2
4384,0,2,0,0,2
4385,1,1,0,0,2
4386,0,1,0,1,2
4387,0,2,0,0,2
4388,0,2,0,0,2
4389,2,0,0,0,2
4390,2,0,0,0,2
4391,2,0,0,0,2
4392,0,2,0,0,2
4393,0,2,0,0,2
4394,0,2,0,0,2
4395,0,2,0,0,2
4396,0,2,0,0,2
4397,0,2,0,0,2
4398,2,0,0,0,2
4399,0,2,0,0,2
4400,1,1,0,0,2
4401,0,2,0,0,2
4402,0,2,0,0,2
4403,1,1,0,0,2
4404,0,2,0,0,2
4405,0,2,0,0,2
4406,0,2,0,0,2
4407,0,2,0,0,2
4408,2,0,0,0,2
4409,0,2,0,0,2
4410,0,2,0,0,2
4411,0,2,0,0,2
4412,1,1,0,0,2
4413,1,1,0,0,2
4414,0,0,0,2,2
4415,2,0,0,0,2
4416,0,2,0,0,2
4417,0,2,0,0,2
4418,2,0,0,0,2
4419,0,2,0,0,2
4420,0,1,0,1,2
4421,0,2,0,0,2
4422,0,2,0,0,2
4423,0,2,0,0,2
4424,0,2,0,0,2
4425,0,2,0,0,2
4426,2,0,0,0,2
4427,0,2,0,0,2
4428,0,2,0,0,2
4429,0,2,0,0,2
4430,0,2,0,0,2
4431,2,0,0,0,2
4432,2,0,0,0,2
4433,0,2,0,0,2
4434,0,2,0,0,2
4435,0,2,0,0,2
4436,0,2,0,0,2
4437,0,2,0,0,2
4438,2,0,0,0,2
4439,2,0,0,0,2
4440,0,2,0,0,2
4441,0,2,0,0,2
4442,1,1,0,0,2
4443,0,2,0,0,2
4444,0,0,0,2,2
4445,0,2,0,0,2
4446,0,2,0,0,2
4447,0,2,0,0,2
4448,0,2,0,0,2
4449,1,1,0,0,2
4450,2,0,0,0,2
4451,0,2,0,0,2
4452,2,0,0,0,2
4453,0,2,0,0,2
4454,0,2,0,0,2
4455,1,1,0,0,2
4456,2,0,0,0,2
4457,0,2,0,0,2
4458,1,0,0,1,2
4459,2,0,0,0,2
4460,2,0,0,0,2
4461,0,2,0,0,2
4462,2,0,0,0,2
4463,2,0,0,0,2
4464,0,2,0,0,2
4465,1,1,0,0,2
4466,0,2,0,0,2
4467,0,2,0,0,2
4468,0,2,0,0,2
4469,0,2,0,0,2
4470,0,2,0,0,2
4471,0,2,0,0,2
4472,0,2,0,0,2
4473,0,2,0,0,2
4474,0,2,0,0,2
4475,0,2,0,0,2
4476,0,2,0,0,2
4477,0,2,0,0,2
4478,0,2,0,0,2
4479,2,0,0,0,2
4480,0,2,0,0,2
4481,0,2,0,0,2
4482,0,2,0,0,2
4483,2,0,0,0,2
4484,1,1,0,0,2
4485,2,0,0,0,2
4486,1,1,0,0,2
4487,0,2,0,0,2
4488,0,2,0,0,2
4489,2,0,0,0,2
4490,0,2,0,0,2
4491,0,2,0,0,2
4492,0,2,0,0,2
4493,2,0,0,0,2
4494,2,0,0,0,2
4495,0,2,0,0,2
4496,2,0,0,0,2
4497,0,2,0,0,2
4498,0,0,0,2,2
4499,0,2,0,0,2
4500,0,2,0,0,2
4501,0,2,0,0,2
4502,0,2,0,0,2
4503,0,2,0,0,2
4504,0,2,0,0,2
4505,1,1,0,0,2
4506,0,0,2,0,2
4507,0,2,0,0,2
4508,0,2,0,0,2
4509,1,1,0,0,2
4510,0,2,0,0,2
4511,0,2,0,0,2
4512,0,2,0,0,2
4513,0,2,0,0,2
4514,0,2,0,0,2
4515,0,2,0,0,2
4516,0,2,0,0,2
4517,0,2,0,0,2
4518,0,2,0,0,2
4519,0,2,0,0,2
4520,2,0,0,0,2
4521,0,2,0,0,2
4522,0,2,0,0,2
4523,0,2,0,0,2
4524,2,0,0,0,2
4525,0,2,0,0,2
4526,0,2,0,0,2
4527,2,0,0,0,2
4528,0,2,0,0,2
4529,0,2,0,0,2
4530,2,0,0,0,2
4531,2,0,0,0,2
4532,2,0,0,0,2
4533,0,2,0,0,2
4534,0,2,0,0,2
4535,0,2,0,0,2
4536,0,2,0,0,2
4537,0,2,0,0,2
4538,2,0,0,0,2
4539,2,0,0,0,2
4540,1,0,0,1,2
4541,0,2,0,0,2
4542,0,2,0,0,2
4543,2,0,0,0,2
4544,0,2,0,0,2
4545,0,2,0,0,2
4546,0,2,0,0,2
4547,2,0,0,0,2
4548,0,2,0,0,2
4549,0,2,0,0,2
4550,0,2,0,0,2
4551,0,2,0,0,2
4552,0,2,0,0,2
4553,1,1,0,0,2
4554,0,2,0,0,2
4555,0,2,0,0,2
4556,0,2,0,0,2
4557,0,2,0,0,2
4558,1,1,0,0,2
4559,1,1,0,0,2
4560,0,2,0,0,2
4561,0,2,0,0,2
4562,0,2,0,0,2
4563,1,0,0,1,2
4564,0,2,0,0,2
4565,0,2,0,0,2
4566,0,2,0,0,2
4567,0,2,0,0,2
4568,0,2,0,0,2
4569,2,0,0,0,2
4570,0,2,0,0,2
4571,0,2,0,0,2
4572,0,2,0,0,2
4573,0,2,0,0,2
4574,0,2,0,0,2
4575,0,2,0,0,2
4576,2,0,0,0,2
4577,0,2,0,0,2
4578,0,2,0,0,2
4579,1,1,0,0,2
4580,0,2,0,0,2
4581,0,2,0,0,2
4582,0,2,0,0,2
4583,0,2,0,0,2
4584,0,2,0,0,2
4585,0,2,0,0,2
4586,1,1,0,0,2
4587,0,2,0,0,2
4588,0,2,0,0,2
4589,0,2,0,0,2
4590,0,0,0,2,2
4591,0,2,0,0,2
4592,0,2,0,0,2
4593,1,0,1,0,2
4594,0,2,0,0,2
4595,2,0,0,0,2
4596,0,2,0,0,2
4597,0,2,0,0,2
4598,0,2,0,0,2
4599,1,1,0,0,2
4600,0,1,1,0,2
4601,0,2,0,0,2
4602,0,2,0,0,2
4603,0,2,0,0,2
4604,0,2,0,0,2
4605,0,2,0,0,2
4606,0,2,0,0,2
4607,0,2,0,0,2
4608,0,2,0,0,2
4609,1,0,1,0,2
4610,0,2,0,0,2
4611,2,0,0,0,2
4612,0,2,0,0,2
4613,0,2,0,0,2
4614,0,2,0,0,2
4615,0,2,0,0,2
4616,2,0,0,0,2
4617,0,2,0,0,2
4618,0,2,0,0,2
4619,2,0,0,0,2
4620,0,2,0,0,2
4621,0,2,0,0,2
4622,0,2,0,0,2
4623,0,2,0,0,2
4624,0,2,0,0,2
4625,0,2,0,0,2
4626,0,2,0,0,2
4627,0,2,0,0,2
4628,0,2,0,0,2
4629,2,0,0,0,2
4630,0,2,0,0,2
4631,0,2,0,0,2
4632,0,2,0,0,2
4633,0,2,0,0,2
4634,0,2,0,0,2
4635,0,2,0,0,2
4636,0,2,0,0,2
4637,0,2,0,0,2
4638,0,2,0,0,2
4639,0,2,0,0,2
4640,0,2,0,0,2
4641,2,0,0,0,2
4642,0,2,0,0,2
4643,2,0,0,0,2
4644,2,0,0,0,2
4645,0,2,0,0,2
4646,0,2,0,0,2
4647,0,2,0,0,2
4648,0,2,0,0,2
4649,0,2,0,0,2
4650,0,2,0,0,2
4651,0,2,0,0,2
4652,0,2,0,0,2
4653,0,2,0,0,2
4654,0,2,0,0,2
4655,2,0,0,0,2
4656,0,0,1,1,2
4657,2,0,0,0,2
4658,2,0,0,0,2
4659,0,2,0,0,2
4660,2,0,0,0,2
4661,1,1,0,0,2
4662,1,0,1,0,2
4663,2,0,0,0,2
4664,2,0,0,0,2
4665,0,2,0,0,2
4666,0,1,0,1,2
4667,0,2,0,0,2
4668,0,2,0,0,2
4669,1,1,0,0,2
4670,0,2,0,0,2
4671,0,2,0,0,2
4672,0,2,0,0,2
4673,0,1,1,0,2
4674,2,0,0,0,2
4675,0,2,0,0,2
4676,2,0,0,0,2
4677,0,2,0,0,2
4678,0,2,0,0,2
4679,0,2,0,0,2
4680,0,2,0,0,2
4681,0,2,0,0,2
4682,2,0,0,0,2
4683,0,2,0,0,2
4684,1,1,0,0,2
4685,0,2,0,0,2
4686,0,2,0,0,2
4687,0,2,0,0,2
4688,0,2,0,0,2
4689,1,1,0,0,2
4690,0,2,0,0,2
4691,0,2,0,0,2
4692,0,2,0,0,2
4693,0,2,0,0,2
4694,0,2,0,0,2
4695,2,0,0,0,2
4696,0,2,0,0,2
4697,0,2,0,0,2
4698,0,2,0,0,2
4699,0,2,0,0,2
4700,0,2,0,0,2
4701,0,2,0,0,2
4702,0,2,0,0,2
4703,0,2,0,0,2
4704,0,2,0,0,2
4705,0,2,0,0,2
4706,0,2,0,0,2
4707,0,2,0,0,2
4708,0,2,0,0,2
4709,0,2,0,0,2
4710,0,2,0,0,2
4711,0,2,0,0,2
4712,0,2,0,0,2
4713,1,1,0,0,2
4714,2,0,0,0,2
4715,0,2,0,0,2
4716,0,2,0,0,2
4717,2,0,0,0,2
4718,0,2,0,0,2
4719,0,2,0,0,2
4720,0,2,0,0,2
4721,0,2,0,0,2
4722,0,2,0,0,2
4723,2,0,0,0,2
4724,0,2,0,0,2
4725,0,2,0,0,2
4726,0,2,0,0,2
4727,0,2,0,0,2
4728,2,0,0,0,2
4729,0,2,0,0,2
4730,0,2,0,0,2
4731,0,2,0,0,2
4732,0,2,0,0,2
4733,1,1,0,0,2
4734,0,2,0,0,2
4735,0,2,0,0,2
4736,0,2,0,0,2
4737,0,2,0,0,2
4738,0,0,2,0,2
4739,0,2,0,0,2
4740,0,2,0,0,2
4741,0,2,0,0,2
4742,0,2,0,0,2
4743,1,1,0,0,2
4744,0,2,0,0,2
4745,0,2,0,0,2
4746,2,0,0,0,2
4747,0,2,0,0,2
4748,0,2,0,0,2
4749,1,0,0,1,2
4750,0,2,0,0,2
4751,1,1,0,0,2
4752,2,0,0,0,2
4753,0,2,0,0,2
4754,0,2,0,0,2
4755,0,2,0,0,2
4756,2,0,0,0,2
4757,0,2,0,0,2
4758,2,0,0,0,2
4759,0,2,0,0,2
4760,0,2,0,0,2
4761,0,2,0,0,2
4762,0,2,0,0,2
4763,0,2,0,0,2
4764,0,2,0,0,2
4765,0,2,0,0,2
4766,2,0,0,0,2
4767,0,2,0,0,2
4768,0,2,0,0,2
4769,0,2,0,0,2
4770,0,2,0,0,2
4771,0,2,0,0,2
4772,0,2,0,0,2
4773,0,2,0,0,2
4774,0,2,0,0,2
4775,0,2,0,0,2
4776,0,2,0,0,2
4777,0,2,0,0,2
4778,2,0,0,0,2
4779,0,2,0,0,2
4780,0,2,0,0,2
4781,0,2,0,0,2
4782,1,1,0,0,2
4783,0,2,0,0,2
4784,0,2,0,0,2
4785,0,2,0,0,2
4786,0,2,0,0,2
4787,0,2,0,0,2
4788,0,0,0,2,2
4789,0,2,0,0,2
4790,0,2,0,0,2
4791,0,2,0,0,2
4792,2,0,0,0,2
4793,0,2,0,0,2
4794,0,2,0,0,2
4795,0,2,0,0,2
4796,0,2,0,0,2
4797,0,2,0,0,2
4798,0,2,0,0,2
4799,0,2,0,0,2
4800,0,2,0,0,2
4801,0,2,0,0,2
4802,0,2,0,0,2
4803,0,2,0,0,2
4804,0,2,0,0,2
4805,0,2,0,0,2
4806,0,2,0,0,2
4807,0,2,0,0,2
4808,0,2,0,0,2
4809,0,2,0,0,2
4810,0,2,0,0,2
4811,0,2,0,0,2
4812,0,2,0,0,2
4813,0,2,0,0,2
4814,0,2,0,0,2
4815,1,1,0,0,2
4816,1,1,0,0,2
4817,0,2,0,0,2
4818,0,0,0,2,2
4819,0,2,0,0,2
4820,0,2,0,0,2
4821,2,0,0,0,2
4822,0,2,0,0,2
4823,0,2,0,0,2
4824,2,0,0,0,2
4825,0,2,0,0,2
4826,0,2,0,0,2
4827,0,2,0,0,2
4828,0,2,0,0,2
4829,0,2,0,0,2
4830,0,2,0,0,2
4831,0,2,0,0,2
4832,0,2,0,0,2
4833,0,2,0,0,2
4834,0,2,0,0,2
4835,0,2,0,0,2
4836,2,0,0,0,2
4837,0,2,0,0,2
4838,1,0,0,1,2
4839,0,2,0,0,2
4840,1,1,0,0,2
4841,0,2,0,0,2
4842,0,2,0,0,2
4843,0,2,0,0,2
4844,0,2,0,0,2
4845,2,0,0,0,2
4846,0,2,0,0,2
4847,0,2,0,0,2
4848,0,2,0,0,2
4849,0,2,0,0,2
4850,0,2,0,0,2
4851,0,2,0,0,2
4852,0,2,0,0,2
4853,0,2,0,0,2
4854,0,2,0,0,2
4855,0,2,0,0,2
4856,0,2,0,0,2
4857,0,1,0,1,2
4858,2,0,0,0,2
4859,2,0,0,0,2
4860,2,0,0,0,2
4861,0,2,0,0,2
4862,0,2,0,0,2
4863,0,2,0,0,2
4864,2,0,0,0,2
4865,0,2,0,0,2
4866,0,2,0,0,2
4867,0,2,0,0,2
4868,0,2,0,0,2
4869,0,2,0,0,2
4870,0,2,0,0,2
4871,0,2,0,0,2
4872,0,2,0,0,2
4873,0,2,0,0,2
4874,0,2,0,0,2
4875,0,2,0,0,2
4876,0,2,0,0,2
4877,0,2,0,0,2
4878,0,2,0,0,2
4879,0,2,0,0,2
4880,0,2,0,0,2
4881,2,0,0,0,2
4882,2,0,0,0,2
4883,0,2,0,0,2
4884,0,2,0,0,2
4885,1,1,0,0,2
4886,0,2,0,0,2
4887,1,0,1,0,2
4888,0,2,0,0,2
4889,0,2,0,0,2
4890,0,2,0,0,2
4891,0,2,0,0,2
4892,0,2,0,0,2
4893,0,2,0,0,2
4894,0,2,0,0,2
4895,0,2,0,0,2
4896,0,2,0,0,2
4897,0,2,0,0,2
4898,0,2,0,0,2
4899,2,0,0,0,2
4900,0,2,0,0,2
4901,0,2,0,0,2
4902,2,0,0,0,2
4903,0,2,0,0,2
4904,0,2,0,0,2
4905,0,2,0,0,2
4906,0,2,0,0,2
4907,1,1,0,0,2
4908,0,1,1,0,2
4909,0,2,0,0,2
4910,1,1,0,0,2
4911,0,2,0,0,2
4912,1,1,0,0,2
4913,0,2,0,0,2
4914,1,1,0,0,2
4915,0,2,0,0,2
4916,0,2,0,0,2
4917,0,1,1,0,2
4918,0,2,0,0,2
4919,2,0,0,0,2
4920,0,2,0,0,2
4921,0,2,0,0,2
4922,0,2,0,0,2
4923,0,2,0,0,2
4924,0,2,0,0,2
4925,0,2,0,0,2
4926,0,2,0,0,2
4927,0,2,0,0,2
4928,0,1,1,0,2
4929,0,2,0,0,2
4930,0,2,0,0,2
4931,0,2,0,0,2
4932,0,2,0,0,2
4933,0,2,0,0,2
4934,0,2,0,0,2
4935,0,2,0,0,2
4936,0,2,0,0,2
4937,0,2,0,0,2
4938,0,2,0,0,2
4939,0,2,0,0,2
4940,2,0,0,0,2
4941,0,2,0,0,2
4942,0,2,0,0,2
4943,2,0,0,0,2
4944,0,2,0,0,2
4945,0,2,0,0,2
4946,0,2,0,0,2
4947,0,2,0,0,2
4948,0,2,0,0,2
4949,0,2,0,0,2
4950,0,0,0,2,2
4951,0,2,0,0,2
4952,0,2,0,0,2
4953,1,0,0,1,2
4954,0,2,0,0,2
4955,0,2,0,0,2
4956,0,2,0,0,2
4957,0,2,0,0,2
4958,0,2,0,0,2
4959,1,1,0,0,2
4960,2,0,0,0,2
4961,0,2,0,0,2
4962,0,2,0,0,2
4963,0,2,0,0,2
4964,2,0,0,0,2
4965,0,2,0,0,2
4966,1,0,0,1,2
4967,2,0,0,0,2
4968,0,2,0,0,2
4969,0,2,0,0,2
4970,0,2,0,0,2
4971,0,2,0,0,2
4972,0,2,0,0,2
4973,1,1,0,0,2
4974,0,2,0,0,2
4975,0,2,0,0,2
4976,0,2,0,0,2
4977,2,0,0,0,2
4978,1,1,0,0,2
4979,0,0,0,2,2
4980,0,1,0,1,2
4981,2,0,0,0,2
4982,2,0,0,0,2
4983,0,2,0,0,2
4984,1,1,0,0,2
4985,0,2,0,0,2
4986,0,2,0,0,2
4987,2,0,0,0,2
4988,2,0,0,0,2
4989,0,2,0,0,2
4990,0,2,0,0,2
4991,0,2,0,0,2
4992,2,0,0,0,2
4993,0,2,0,0,2
4994,0,2,0,0,2
4995,0,2,0,0,2
4996,2,0,0,0,2
4997,0,2,0,0,2
4998,0,2,0,0,2
4999,0,2,0,0,2
5000,2,0,0,0,2
5001,2,0,0,0,2
5002,0,2,0,0,2
5003,0,2,0,0,2
5004,0,2,0,0,2
5005,0,2,0,0,2
5006,0,2,0,0,2
5007,0,2,0,0,2
5008,0,2,0,0,2
5009,0,2,0,0,2
5010,0,1,1,0,2
5011,0,2,0,0,2
5012,0,2,0,0,2
5013,0,2,0,0,2
5014,2,0,0,0,2
5015,0,2,0,0,2
5016,0,2,0,0,2
5017,0,2,0,0,2
5018,2,0,0,0,2
5019,0,2,0,0,2
5020,1,0,0,1,2
5021,0,2,0,0,2
5022,0,2,0,0,2
5023,0,2,0,0,2
5024,0,2,0,0,2
5025,0,2,0,0,2
5026,0,2,0,0,2
5027,1,1,0,0,2
5028,0,2,0,0,2
5029,0,2,0,0,2
5030,0,2,0,0,2
5031,0,0,0,2,2
5032,0,2,0,0,2
5033,0,2,0,0,2
5034,1,0,0,1,2
5035,0,2,0,0,2
5036,0,2,0,0,2
5037,0,2,0,0,2
5038,0,2,0,0,2
5039,0,2,0,0,2
5040,0,2,0,0,2
5041,0,2,0,0,2
5042,2,0,0,0,2
5043,0,2,0,0,2
5044,0,2,0,0,2
5045,2,0,0,0,2
5046,2,0,0,0,2
5047,0,2,0,0,2
5048,0,2,0,0,2
5049,1,0,1,0,2
5050,0,2,0,0,2
5051,0,2,0,0,2
5052,0,2,0,0,2
5053,1,0,0,1,2
5054,0,2,0,0,2
5055,0,2,0,0,2
5056,2,0,0,0,2
5057,0,2,0,0,2
5058,0,2,0,0,2
5059,0,2,0,0,2
5060,0,2,0,0,2
5061,0,2,0,0,2
5062,0,2,0,0,2
5063,1,0,1,0,2
5064,0,1,0,1,2
5065,1,1,0,0,2
5066,0,1,0,1,2
5067,0,2,0,0,2
5068,0,2,0,0,2
5069,0,2,0,0,2
5070,1,1,0,0,2
5071,0,2,0,0,2
5072,0,2,0,0,2
5073,1,1,0,0,2
5074,0,2,0,0,2
5075,0,2,0,0,2
5076,0,2,0,0,2
5077,0,2,0,0,2
5078,0,2,0,0,2
5079,0,2,0,0,2
5080,0,2,0,0,2
5081,0,2,0,0,2
5082,0,2,0,0,2
5083,0,2,0,0,2
5084,0,2,0,0,2
5085,0,2,0,0,2
5086,0,2,0,0,2
5087,2,0,0,0,2
5088,0,2,0,0,2
5089,0,2,0,0,2
5090,0,2,0,0,2
5091,0,2,0,0,2
5092,1,1,0,0,2
5093,0,2,0,0,2
5094,0,2,0,0,2
5095,0,2,0,0,2
5096,2,0,0,0,2
5097,0,2,0,0,2
5098,0,2,0,0,2
5099,0,2,0,0,2
5100,0,1,0,1,2
5101,1,0,0,1,2
5102,2,0,0,0,2
5103,0,2,0,0,2
5104,2,0,0,0,2
5105,0,2,0,0,2
5106,0,2,0,0,2
5107,0,2,0,0,2
5108,0,1,0,1,2
5109,2,0,0,0,2
5110,0,2,0,0,2
5111,2,0,0,0,2
5112,0,2,0,0,2
5113,2,0,0,0,2
5114,0,2,0,0,2
5115,0,2,0,0,2
5116,0,2,0,0,2
5117,2,0,0,0,2
5118,0,2,0,0,2
5119,0,2,0,0,2
5120,0,2,0,0,2
5121,0,2,0,0,2
5122,0,2,0,0,2
5123,0,2,0,0,2
5124,0,1,0,1,2
5125,2,0,0,0,2
5126,0,2,0,0,2
5127,2,0,0,0,2
5128,0,2,0,0,2
5129,0,2,0,0,2
5130,0,2,0,0,2
5131,1,0,0,1,2
5132,0,2,0,0,2
5133,0,0,0,2,2
5134,1,1,0,0,2
5135,0,1,1,0,2
5136,0,2,0,0,2
5137,0,2,0,0,2
5138,0,2,0,0,2
5139,0,2,0,0,2
5140,0,2,0,0,2
5141,0,2,0,0,2
5142,0,2,0,0,2
5143,0,2,0,0,2
5144,0,2,0,0,2
5145,0,2,0,0,2
5146,0,2,0,0,2
5147,0,2,0,0,2
5148,2,0,0,0,2
5149,0,2,0,0,2
5150,0,2,0,0,2
5151,0,2,0,0,2
5152,0,2,0,0,2
5153,2,0,0,0,2
5154,0,2,0,0,2
5155,0,2,0,0,2
5156,0,2,0,0,2
5157,0,2,0,0,2
5158,2,0,0,0,2
5159,0,2,0,0,2
5160,0,2,0,0,2
5161,0,2,0,0,2
5162,0,2,0,0,2
5163,0,2,0,0,2
5164,0,2,0,0,2
5165,2,0,0,0,2
5166,0,1,0,1,2
5167,0,1,0,1,2
5168,0,2,0,0,2
5169,2,0,0,0,2
5170,0,2,0,0,2
5171,0,2,0,0,2
5172,2,0,0,0,2
5173,2,0,0,0,2
5174,0,2,0,0,2
5175,0,2,0,0,2
5176,0,2,0,0,2
5177,0,2,0,0,2
5178,0,2,0,0,2
5179,0,2,0,0,2
5180,0,2,0,0,2
5181,0,2,0,0,2
5182,0,2,0,0,2
5183,0,2,0,0,2
5184,0,2,0,0,2
5185,2,0,0,0,2
5186,2,0,0,0,2
5187,0,2,0,0,2
5188,0,2,0,0,2
5189,1,1,0,0,2
5190,0,2,0,0,2
5191,0,2,0,0,2
5192,0,2,0,0,2
5193,0,2,0,0,2
5194,0,2,0,0,2
5195,0,2,0,0,2
5196,0,2,0,0,2
5197,0,2,0,0,2
5198,2,0,0,0,2
5199,0,2,0,0,2
5200,0,2,0,0,2
5201,0,2,0,0,2
5202,0,2,0,0,2
5203,0,2,0,0,2
5204,0,2,0,0,2
5205,0,2,0,0,2
5206,0,2,0,0,2
5207,1,1,0,0,2
5208,0,2,0,0,2
5209,0,2,0,0,2
5210,0,2,0,0,2
5211,0,2,0,0,2
5212,0,1,0,1,2
5213,2,0,0,0,2
5214,2,0,0,0,2
5215,0,2,0,0,2
5216,0,2,0,0,2
5217,0,2,0,0,2
5218,0,2,0,0,2
5219,0,2,0,0,2
5220,0,2,0,0,2
5221,0,2,0,0,2
5222,0,2,0,0,2
5223,0,2,0,0,2
5224,0,2,0,0,2
5225,0,2,0,0,2
5226,0,2,0,0,2
5227,0,2,0,0,2
5228,1,1,0,0,2
5229,0,2,0,0,2
5230,0,2,0,0,2
5231,0,2,0,0,2
5232,0,2,0,0,2
5233,1,1,0,0,2
5234,0,2,0,0,2
5235,0,2,0,0,2
5236,0,2,0,0,2
5237,0,2,0,0,2
5238,0,2,0,0,2
5239,0,2,0,0,2
5240,1,0,0,1,2
5241,0,2,0,0,2
5242,0,2,0,0,2
5243,0,2,0,0,2
5244,0,2,0,0,2
5245,0,2,0,0,2
5246,0,2,0,0,2
5247,0,2,0,0,2
5248,0,2,0,0,2
5249,0,2,0,0,2
5250,0,2,0,0,2
5251,0,2,0,0,2
5252,0,1,0,1,2
5253,0,1,1,0,2
5254,0,2,0,0,2
5255,0,2,0,0,2
5256,0,2,0,0,2
5257,0,2,0,0,2
5258,0,2,0,0,2
5259,0,2,0,0,2
5260,2,0,0,0,2
5261,0,2,0,0,2
5262,0,2,0,0,2
5263,0,2,0,0,2
5264,0,2,0,0,2
5265,0,2,0,0,2
5266,0,2,0,0,2
5267,0,2,0,0,2
5268,0,2,0,0,2
5269,2,0,0,0,2
5270,0,2,0,0,2
5271,0,2,0,0,2
5272,0,2,0,0,2
5273,0,2,0,0,2
5274,0,2,0,0,2
5275,0,2,0,0,2
5276,0,2,0,0,2
5277,2,0,0,0,2
5278,0,2,0,0,2
5279,0,2,0,0,2
5280,0,2,0,0,2
5281,0,2,0,0,2
5282,0,2,0,0,2
5283,0,2,0,0,2
5284,0,2,0,0,2
5285,0,1,1,0,2
5286,0,2,0,0,2
5287,0,2,0,0,2
5288,0,2,0,0,2
5289,0,2,0,0,2
5290,0,2,0,0,2
5291,1,1,0,0,2
5292,0,2,0,0,2
5293,0,2,0,0,2
5294,2,0,0,0,2
5295,0,2,0,0,2
5296,0,2,0,0,2
5297,0,2,0,0,2
5298,0,2,0,0,2
5299,0,2,0,0,2
5300,0,2,0,0,2
5301,0,2,0,0,2
5302,0,2,0,0,2
5303,0,2,0,0,2
5304,0,2,0,0,2
5305,0,2,0,0,2
5306,2,0,0,0,2
5307,1,1,0,0,2
5308,0,2,0,0,2
5309,0,2,0,0,2
5310,0,2,0,0,2
5311,0,2,0,0,2
5312,0,2,0,0,2
5313,0,2,0,0,2
5314,0,2,0,0,2
5315,0,2,0,0,2
5316,0,2,0,0,2
5317,0,2,0,0,2
5318,2,0,0,0,2
5319,0,2,0,0,2
5320,2,0,0,0,2
5321,0,2,0,0,2
5322,0,2,0,0,2
5323,2,0,0,0,2
5324,0,2,0,0,2
5325,0,2,0,0,2
5326,0,2,0,0,2
5327,0,2,0,0,2
5328,0,2,0,0,2
5329,0,2,0,0,2
5330,2,0,0,0,2
5331,0,2,0,0,2
5332,0,2,0,0,2
5333,0,2,0,0,2
5334,0,2,0,0,2
5335,0,2,0,0,2
5336,0,2,0,0,2
5337,0,2,0,0,2
5338,1,1,0,0,2
5339,1,1,0,0,2
5340,0,2,0,0,2
5341,0,2,0,0,2
5342,0,2,0,0,2
5343,0,2,0,0,2
5344,1,0,0,1,2
5345,0,2,0,0,2
5346,0,2,0,0,2
5347,0,2,0,0,2
5348,0,2,0,0,2
5349,0,2,0,0,2
5350,0,2,0,0,2
5351,0,2,0,0,2
5352,0,2,0,0,2
5353,2,0,0,0,2
5354,0,0,0,2,2
5355,1,1,0,0,2
5356,0,2,0,0,2
5357,0,2,0,0,2
5358,2,0,0,0,2
5359,0,2,0,0,2
5360,0,2,0,0,2
5361,0,2,0,0,2
5362,0,2,0,0,2
5363,0,2,0,0,2
5364,0,2,0,0,2
5365,0,2,0,0,2
5366,0,2,0,0,2
5367,0,2,0,0,2
5368,0,2,0,0,2
5369,0,2,0,0,2
5370,0,2,0,0,2
5371,0,2,0,0,2
5372,0,2,0,0,2
5373,0,2,0,0,2
5374,0,2,0,0,2
5375,0,2,0,0,2
5376,0,2,0,0,2
5377,0,2,0,0,2
5378,0,2,0,0,2
5379,0,2,0,0,2
5380,0,2,0,0,2
5381,0,2,0,0,2
5382,1,0,0,1,2
5383,0,2,0,0,2
5384,0,2,0,0,2
5385,0,2,0,0,2
5386,0,0,2,0,2
5387,0,2,0,0,2
5388,0,2,0,0,2
5389,0,2,0,0,2
5390,2,0,0,0,2
5391,0,2,0,0,2
5392,0,2,0,0,2
5393,0,2,0,0,2
5394,0,2,0,0,2
5395,0,0,0,2,2
5396,0,2,0,0,2
5397,0,2,0,0,2
5398,2,0,0,0,2
5399,0,2,0,0,2
5400,0,2,0,0,2
5401,1,1,0,0,2
5402,0,2,0,0,2
5403,2,0,0,0,2
5404,0,2,0,0,2
5405,0,2,0,0,2
5406,2,0,0,0,2
5407,0,2,0,0,2
5408,0,2,0,0,2
5409,2,0,0,0,2
5410,0,2,0,0,2
5411,0,2,0,0,2
5412,0,2,0,0,2
5413,0,2,0,0,2
5414,0,2,0,0,2
5415,0,2,0,0,2
5416,1,0,1,0,2
5417,1,1,0,0,2
5418,0,2,0,0,2
5419,0,2,0,0,2
5420,0,2,0,0,2
5421,0,2,0,0,2
5422,0,2,0,0,2
5423,0,2,0,0,2
5424,0,2,0,0,2
5425,0,2,0,0,2
5426,0,2,0,0,2
5427,0,2,0,0,2
5428,0,2,0,0,2
5429,1,1,0,0,2
5430,0,2,0,0,2
5431,0,2,0,0,2
5432,1,0,0,1,2
5433,0,2,0,0,2
5434,0,2,0,0,2
5435,0,2,0,0,2
5436,2,0,0,0,2
5437,1,1,0,0,2
5438,0,2,0,0,2
5439,0,2,0,0,2
5440,0,2,0,0,2
5441,2,0,0,0,2
5442,0,2,0,0,2
5443,0,2,0,0,2
5444,0,2,0,0,2
5445,0,2,0,0,2
5446,0,2,0,0,2
5447,2,0,0,0,2
5448,1,1,0,0,2
5449,0,2,0,0,2
5450,0,2,0,0,2
5451,0,2,0,0,2
5452,0,2,0,0,2
5453,0,2,0,0,2
5454,0,2,0,0,2
5455,0,2,0,0,2
5456,2,0,0,0,2
5457,0,2,0,0,2
5458,0,0,2,0,2
5459,0,1,0,1,2
5460,0,2,0,0,2
5461,0,2,0,0,2
5462,0,2,0,0,2
5463,0,2,0,0,2
5464,0,2,0,0,2
5465,0,0,2,0,2
5466,2,0,0,0,2
5467,2,0,0,0,2
5468,0,2,0,0,2
5469,0,2,0,0,2
5470,1,1,0,0,2
5471,0,2,0,0,2
5472,0,2,0,0,2
5473,0,2,0,0,2
5474,0,2,0,0,2
5475,0,2,0,0,2
5476,0,2,0,0,2
5477,0,2,0,0,2
5478,1,1,0,0,2
5479,0,2,0,0,2
5480,0,2,0,0,2
5481,0,2,0,0,2
5482,0,2,0,0,2
5483,0,2,0,0,2
5484,0,2,0,0,2
5485,0,2,0,0,2
5486,0,2,0,0,2
5487,0,2,0,0,2
5488,2,0,0,0,2
5489,0,2,0,0,2
5490,0,2,0,0,2
5491,0,2,0,0,2
5492,0,2,0,0,2
5493,0,2,0,0,2
5494,1,1,0,0,2
5495,0,2,0,0,2
5496,0,2,0,0,2
5497,0,2,0,0,2
5498,2,0,0,0,2
5499,1,1,0,0,2
5500,0,2,0,0,2
5501,1,1,0,0,2
5502,0,2,0,0,2
5503,0,2,0,0,2
5504,0,2,0,0,2
5505,0,2,0,0,2
5506,1,1,0,0,2
5507,1,1,0,0,2
5508,0,2,0,0,2
5509,0,0,1,1,2
5510,0,2,0,0,2
5511,0,2,0,0,2
5512,0,2,0,0,2
5513,0,2,0,0,2
5514,0,2,0,0,2
5515,0,2,0,0,2
5516,0,2,0,0,2
5517,0,2,0,0,2
5518,0,2,0,0,2
5519,0,2,0,0,2
5520,0,2,0,0,2
5521,2,0,0,0,2
5522,0,2,0,0,2
5523,0,2,0,0,2
5524,0,2,0,0,2
5525,0,2,0,0,2
5526,0,2,0,0,2
5527,0,2,0,0,2
5528,2,0,0,0,2
5529,2,0,0,0,2
5530,0,2,0,0,2
5531,0,2,0,0,2
5532,0,2,0,0,2
5533,2,0,0,0,2
5534,0,2,0,0,2
5535,0,2,0,0,2
5536,1,1,0,0,2
5537,0,2,0,0,2
5538,0,2,0,0,2
5539,1,1,0,0,2
5540,2,0,0,0,2
5541,0,2,0,0,2
5542,0,2,0,0,2
5543,0,2,0,0,2
5544,0,2,0,0,2
5545,0,2,0,0,2
5546,2,0,0,0,2
5547,0,2,0,0,2
5548,0,1,0,1,2
5549,2,0,0,0,2
5550,1,1,0,0,2
5551,0,2,0,0,2
5552,0,2,0,0,2
5553,0,2,0,0,2
5554,0,2,0,0,2
5555,0,2,0,0,2
5556,0,2,0,0,2
5557,0,2,0,0,2
5558,0,2,0,0,2
5559,0,2,0,0,2
5560,0,2,0,0,2
5561,0,2,0,0,2
5562,0,2,0,0,2
5563,0,2,0,0,2
5564,0,2,0,0,2
5565,0,2,0,0,2
5566,0,1,0,1,2
5567,0,2,0,0,2
5568,2,0,0,0,2
5569,0,2,0,0,2
5570,0,2,0,0,2
5571,0,2,0,0,2
5572,0,2,0,0,2
5573,0,2,0,0,2
5574,0,2,0,0,2
5575,0,2,0,0,2
5576,0,2,0,0,2
5577,2,0,0,0,2
5578,0,2,0,0,2
5579,2,0,0,0,2
5580,0,2,0,0,2
5581,0,2,0,0,2
5582,0,2,0,0,2
5583,2,0,0,0,2
5584,0,2,0,0,2
5585,0,2,0,0,2
5586,0,2,0,0,2
5587,0,2,0,0,2
5588,0,2,0,0,2
5589,0,2,0,0,2
5590,0,2,0,0,2
5591,0,2,0,0,2
5592,2,0,0,0,2
5593,0,2,0,0,2
5594,0,2,0,0,2
5595,0,2,0,0,2
5596,0,2,0,0,2
5597,0,2,0,0,2
5598,0,1,0,1,2
5599,0,2,0,0,2
5600,0,2,0,0,2
5601,0,2,0,0,2
5602,0,2,0,0,2
5603,0,2,0,0,2
5604,0,2,0,0,2
5605,0,2,0,0,2
5606,0,2,0,0,2
5607,0,2,0,0,2
5608,0,2,0,0,2
5609,0,2,0,0,2
5610,0,2,0,0,2
5611,0,2,0,0,2
5612,0,2,0,0,2
5613,0,2,0,0,2
5614,1,1,0,0,2
5615,0,2,0,0,2
5616,0,2,0,0,2
5617,1,0,0,1,2
5618,2,0,0,0,2
5619,0,2,0,0,2
5620,0,2,0,0,2
5621,0,2,0,0,2
5622,0,0,0,2,2
5623,0,2,0,0,2
5624,0,2,0,0,2
5625,0,2,0,0,2
5626,0,2,0,0,2
5627,0,2,0,0,2
5628,0,2,0,0,2
5629,0,2,0,0,2
5630,0,2,0,0,2
5631,0,2,0,0,2
5632,0,0,0,2,2
5633,0,2,0,0,2
5634,0,2,0,0,2
5635,0,2,0,0,2
5636,0,2,0,0,2
5637,2,0,0,0,2
5638,0,2,0,0,2
5639,1,1,0,0,2
5640,0,2,0,0,2
5641,0,2,0,0,2
5642,0,2,0,0,2
5643,0,2,0,0,2
5644,0,2,0,0,2
5645,0,2,0,0,2
5646,0,2,0,0,2
5647,0,2,0,0,2
5648,2,0,0,0,2
5649,1,0,0,1,2
5650,0,2,0,0,2
5651,0,2,0,0,2
5652,0,2,0,0,2
5653,0,2,0,0,2
5654,0,2,0,0,2
5655,0,2,0,0,2
5656,1,1,0,0,2
5657,0,2,0,0,2
5658,0,2,0,0,2
5659,0,2,0,0,2
5660,0,2,0,0,2
5661,0,2,0,0,2
5662,0,2,0,0,2
5663,0,2,0,0,2
5664,0,2,0,0,2
5665,0,2,0,0,2
5666,0,2,0,0,2
5667,0,2,0,0,2
5668,0,2,0,0,2
5669,0,2,0,0,2
5670,0,2,0,0,2
5671,1,1,0,0,2
5672,0,2,0,0,2
5673,0,2,0,0,2
5674,2,0,0,0,2
5675,0,2,0,0,2
5676,0,2,0,0,2
5677,0,2,0,0,2
5678,0,2,0,0,2
5679,0,2,0,0,2
5680,0,2,0,0,2
5681,0,2,0,0,2
5682,0,2,0,0,2
5683,0,2,0,0,2
5684,0,2,0,0,2
5685,0,2,0,0,2
5686,0,2,0,0,2
5687,0,2,0,0,2
5688,0,2,0,0,2
5689,0,2,0,0,2
5690,0,2,0,0,2
5691,0,2,0,0,2
5692,0,2,0,0,2
5693,2,0,0,0,2
5694,0,2,0,0,2
5695,0,2,0,0,2
5696,0,1,1,0,2
5697,0,2,0,0,2
5698,0,2,0,0,2
5699,0,2,0,0,2
5700,1,1,0,0,2
5701,2,0,0,0,2
5702,2,0,0,0,2
5703,0,0,0,2,2
5704,0,2,0,0,2
5705,0,2,0,0,2
5706,0,2,0,0,2
5707,0,2,0,0,2
5708,1,1,0,0,2
5709,0,2,0,0,2
5710,0,2,0,0,2
5711,0,2,0,0,2
5712,1,1,0,0,2
5713,0,2,0,0,2
5714,0,2,0,0,2
5715,2,0,0,0,2
5716,0,2,0,0,2
5717,0,2,0,0,2
5718,0,2,0,0,2
5719,0,2,0,0,2
5720,0,2,0,0,2
5721,0,2,0,0,2
5722,0,2,0,0,2
5723,1,1,0,0,2
5724,2,0,0,0,2
5725,0,2,0,0,2
5726,2,0,0,0,2
5727,0,2,0,0,2
5728,0,2,0,0,2
5729,0,2,0,0,2
5730,0,2,0,0,2
5731,0,2,0,0,2
5732,1,1,0,0,2
5733,0,2,0,0,2
5734,0,2,0,0,2
5735,0,2,0,0,2
5736,0,2,0,0,2
5737,0,2,0,0,2
5738,0,2,0,0,2
5739,2,0,0,0,2
5740,0,2,0,0,2
5741,0,2,0,0,2
5742,0,1,0,1,2
5743,0,2,0,0,2
5744,0,2,0,0,2
5745,0,2,0,0,2
5746,0,2,0,0,2
5747,0,2,0,0,2
5748,0,2,0,0,2
5749,0,2,0,0,2
5750,0,2,0,0,2
5751,0,2,0,0,2
5752,0,2,0,0,2
5753,0,2,0,0,2
5754,0,2,0,0,2
5755,0,2,0,0,2
5756,0,2,0,0,2
5757,0,2,0,0,2
5758,2,0,0,0,2
5759,0,2,0,0,2
5760,0,2,0,0,2
5761,2,0,0,0,2
5762,0,2,0,0,2
5763,0,2,0,0,2
5764,0,2,0,0,2
5765,0,2,0,0,2
5766,0,2,0,0,2
5767,0,2,0,0,2
5768,2,0,0,0,2
5769,0,1,1,0,2
5770,1,1,0,0,2
5771,0,2,0,0,2
5772,0,2,0,0,2
5773,0,2,0,0,2
5774,0,2,0,0,2
5775,0,2,0,0,2
5776,0,2,0,0,2
5777,1,1,0,0,2
5778,0,2,0,0,2
5779,2,0,0,0,2
5780,0,2,0,0,2
5781,0,2,0,0,2
5782,0,2,0,0,2
5783,0,2,0,0,2
5784,2,0,0,0,2
5785,0,2,0,0,2
5786,0,2,0,0,2
5787,0,2,0,0,2
5788,0,1,0,1,2
5789,0,2,0,0,2
5790,0,2,0,0,2
5791,0,2,0,0,2
5792,0,2,0,0,2
5793,0,2,0,0,2
5794,0,2,0,0,2
5795,0,2,0,0,2
5796,0,2,0,0,2
5797,0,2,0,0,2
5798,0,2,0,0,2
5799,2,0,0,0,2
5800,1,1,0,0,2
5801,0,2,0,0,2
5802,0,2,0,0,2
5803,0,2,0,0,2
5804,0,2,0,0,2
5805,0,2,0,0,2
5806,0,2,0,0,2
5807,1,1,0,0,2
5808,0,2,0,0,2
5809,0,0,1,1,2
5810,0,2,0,0,2
5811,2,0,0,0,2
5812,0,2,0,0,2
5813,0,2,0,0,2
5814,0,2,0,0,2
5815,1,1,0,0,2
5816,0,2,0,0,2
5817,0,2,0,0,2
5818,0,2,0,0,2
5819,0,2,0,0,2
5820,0,2,0,0,2
5821,0,2,0,0,2
5822,0,2,0,0,2
5823,0,2,0,0,2
5824,0,2,0,0,2
5825,0,2,0,0,2
5826,0,2,0,0,2
5827,0,2,0,0,2
5828,0,2,0,0,2
5829,0,2,0,0,2
5830,2,0,0,0,2
5831,0,2,0,0,2
5832,0,2,0,0,2
5833,0,2,0,0,2
5834,0,2,0,0,2
5835,0,2,0,0,2
5836,0,2,0,0,2
5837,1,1,0,0,2
5838,0,2,0,0,2
5839,1,1,0,0,2
5840,0,2,0,0,2
5841,0,2,0,0,2
5842,0,2,0,0,2
5843,0,2,0,0,2
5844,2,0,0,0,2
5845,0,2,0,0,2
5846,0,2,0,0,2
5847,0,2,0,0,2
5848,0,2,0,0,2
5849,0,2,0,0,2
5850,0,2,0,0,2
5851,0,2,0,0,2
5852,0,2,0,0,2
5853,0,2,0,0,2
5854,0,2,0,0,2
5855,0,2,0,0,2
5856,0,2,0,0,2
5857,1,1,0,0,2
5858,0,2,0,0,2
5859,0,2,0,0,2
5860,0,2,0,0,2
5861,0,0,0,2,2
5862,0,2,0,0,2
5863,0,2,0,0,2
5864,0,2,0,0,2
5865,2,0,0,0,2
5866,1,1,0,0,2
5867,0,2,0,0,2
5868,0,2,0,0,2
5869,0,2,0,0,2
5870,2,0,0,0,2
5871,0,2,0,0,2
5872,2,0,0,0,2
5873,0,2,0,0,2
5874,0,2,0,0,2
5875,1,1,0,0,2
5876,0,2,0,0,2
5877,0,2,0,0,2
5878,0,2,0,0,2
5879,2,0,0,0,2
5880,0,2,0,0,2
5881,0,2,0,0,2
5882,0,2,0,0,2
5883,1,1,0,0,2
5884,0,2,0,0,2
5885,0,2,0,0,2
5886,0,2,0,0,2
5887,0,2,0,0,2
5888,0,2,0,0,2
5889,0,2,0,0,2
5890,0,2,0,0,2
5891,0,2,0,0,2
5892,0,2,0,0,2
5893,0,2,0,0,2
5894,2,0,0,0,2
5895,2,0,0,0,2
5896,0,2,0,0,2
5897,0,2,0,0,2
5898,0,2,0,0,2
5899,0,0,0,2,2
5900,0,2,0,0,2
5901,0,2,0,0,2
5902,1,1,0,0,2
5903,0,2,0,0,2
5904,0,2,0,0,2
5905,2,0,0,0,2
5906,0,2,0,0,2
5907,0,2,0,0,2
5908,0,2,0,0,2
5909,0,2,0,0,2
5910,0,2,0,0,2
5911,0,2,0,0,2
5912,0,2,0,0,2
5913,1,1,0,0,2
5914,0,2,0,0,2
5915,0,2,0,0,2
5916,0,2,0,0,2
5917,0,2,0,0,2
5918,2,0,0,0,2
5919,0,2,0,0,2
5920,0,2,0,0,2
5921,0,2,0,0,2
5922,0,2,0,0,2
5923,0,2,0,0,2
5924,0,2,0,0,2
5925,0,2,0,0,2
5926,0,2,0,0,2
5927,0,2,0,0,2
5928,0,0,0,2,2
5929,0,2,0,0,2
5930,0,2,0,0,2
5931,2,0,0,0,2
5932,0,2,0,0,2
5933,2,0,0,0,2
5934,0,2,0,0,2
5935,0,2,0,0,2
5936,0,2,0,0,2
5937,0,2,0,0,2
5938,0,2,0,0,2
5939,0,2,0,0,2
5940,0,2,0,0,2
5941,0,2,0,0,2
5942,0,2,0,0,2
5943,0,2,0,0,2
5944,0,2,0,0,2
5945,0,2,0,0,2
5946,0,2,0,0,2
5947,0,2,0,0,2
5948,0,2,0,0,2
5949,0,1,0,1,2
5950,0,2,0,0,2
5951,0,2,0,0,2
5952,0,2,0,0,2
5953,0,2,0,0,2
5954,0,2,0,0,2
5955,0,1,0,0,1
5956,0,1,0,0,1
5957,0,1,0,0,1
5958,0,1,0,0,1
5959,0,1,0,0,1
5960,0,1,0,0,1
5961,1,0,0,0,1
5962,0,1,0,0,1
5963,0,1,0,0,1
5964,0,1,0,0,1
5965,0,1,0,0,1
5966,0,1,0,0,1
5967,0,1,0,0,1
5968,0,1,0,0,1
5969,1,0,0,0,1
5970,1,0,0,0,1
5971,0,1,0,0,1
5972,0,1,0,0,1
5973,0,1,0,0,1
5974,0,1,0,0,1
5975,0,1,0,0,1
5976,0,1,0,0,1
5977,0,1,0,0,1
5978,0,1,0,0,1
5979,0,1,0,0,1
5980,0,1,0,0,1
5981,1,0,0,0,1
5982,0,0,0,1,1
5983,1,0,0,0,1
5984,1,0,0,0,1
5985,0,1,0,0,1
5986,0,1,0,0,1
5987,0,1,0,0,1
5988,0,1,0,0,1
5989,1,0,0,0,1
5990,0,1,0,0,1
5991,0,1,0,0,1
5992,0,1,0,0,1
5993,0,1,0,0,1
5994,0,1,0,0,1
5995,0,1,0,0,1
5996,0,1,0,0,1
5997,0,1,0,0,1
5998,0,1,0,0,1
5999,0,1,0,0,1
6000,0,1,0,0,1
6001,0,1,0,0,1
6002,1,0,0,0,1
6003,0,1,0,0,1
6004,0,1,0,0,1
6005,0,1,0,0,1
6006,0,1,0,0,1
6007,0,1,0,0,1
6008,0,1,0,0,1
6009,0,1,0,0,1
6010,0,1,0,0,1
6011,0,1,0,0,1
6012,1,0,0,0,1
6013,0,1,0,0,1
6014,0,1,0,0,1
6015,0,1,0,0,1
6016,0,1,0,0,1
6017,0,1,0,0,1
6018,1,0,0,0,1
6019,0,1,0,0,1
6020,0,1,0,0,1
6021,0,1,0,0,1
6022,0,1,0,0,1
6023,0,1,0,0,1
6024,1,0,0,0,1
6025,0,1,0,0,1
6026,0,1,0,0,1
6027,0,1,0,0,1
6028,0,1,0,0,1
6029,0,1,0,0,1
6030,0,1,0,0,1
6031,0,1,0,0,1
6032,1,0,0,0,1
6033,0,1,0,0,1
6034,1,0,0,0,1
6035,0,1,0,0,1
6036,1,0,0,0,1
6037,0,1,0,0,1
6038,0,1,0,0,1
6039,0,1,0,0,1
6040,1,0,0,0,1
6041,0,1,0,0,1
6042,0,1,0,0,1
6043,0,0,1,0,1
6044,1,0,0,0,1
6045,0,1,0,0,1
6046,0,1,0,0,1
6047,0,1,0,0,1
6048,0,1,0,0,1
6049,0,1,0,0,1
6050,0,1,0,0,1
6051,0,1,0,0,1
6052,0,1,0,0,1
6053,0,1,0,0,1
6054,0,1,0,0,1
6055,1,0,0,0,1
6056,1,0,0,0,1
6057,0,1,0,0,1
6058,0,1,0,0,1
6059,1,0,0,0,1
6060,0,1,0,0,1
6061,0,1,0,0,1
6062,0,1,0,0,1
6063,0,1,0,0,1
6064,1,0,0,0,1
6065,0,1,0,0,1
6066,0,1,0,0,1
6067,0,1,0,0,1
6068,0,1,0,0,1
6069,0,1,0,0,1
6070,0,1,0,0,1
6071,1,0,0,0,1
6072,1,0,0,0,1
6073,0,1,0,0,1
6074,0,1,0,0,1
6075,1,0,0,0,1
6076,0,1,0,0,1
6077,0,1,0,0,1
6078,0,1,0,0,1
6079,0,1,0,0,1
6080,1,0,0,0,1
6081,0,1,0,0,1
6082,0,1,0,0,1
6083,0,1,0,0,1
6084,0,1,0,0,1
6085,0,1,0,0,1
6086,0,1,0,0,1
6087,1,0,0,0,1
6088,1,0,0,0,1
6089,1,0,0,0,1
6090,1,0,0,0,1
6091,0,1,0,0,1
6092,1,0,0,0,1
6093,1,0,0,0,1
6094,0,1,0,0,1
6095,0,0,0,1,1
6096,0,0,1,0,1
6097,0,1,0,0,1
6098,0,1,0,0,1
6099,0,1,0,0,1
6100,0,1,0,0,1
6101,0,1,0,0,1
6102,0,1,0,0,1
6103,0,1,0,0,1
6104,0,1,0,0,1
6105,0,1,0,0,1
6106,1,0,0,0,1
6107,0,0,0,1,1
6108,0,1,0,0,1
6109,0,1,0,0,1
6110,0,1,0,0,1
6111,1,0,0,0,1
6112,1,0,0,0,1
6113,0,1,0,0,1
6114,0,1,0,0,1
6115,0,1,0,0,1
6116,0,1,0,0,1
6117,0,1,0,0,1
6118,0,1,0,0,1
6119,0,1,0,0,1
6120,0,1,0,0,1
6121,0,1,0,0,1
6122,1,0,0,0,1
6123,0,1,0,0,1
6124,0,1,0,0,1
6125,0,1,0,0,1
6126,0,1,0,0,1
6127,1,0,0,0,1
6128,0,1,0,0,1
6129,0,1,0,0,1
6130,0,1,0,0,1
6131,0,1,0,0,1
6132,1,0,0,0,1
6133,0,1,0,0,1
6134,0,1,0,0,1
6135,0,1,0,0,1
6136,0,1,0,0,1
6137,0,1,0,0,1
6138,0,1,0,0,1
6139,1,0,0,0,1
6140,0,1,0,0,1
6141,0,1,0,0,1
6142,0,1,0,0,1
6143,1,0,0,0,1
6144,1,0,0,0,1
6145,0,1,0,0,1
6146,1,0,0,0,1
6147,1,0,0,0,1
6148,0,0,1,0,1
6149,0,1,0,0,1
6150,0,1,0,0,1
6151,0,1,0,0,1
6152,0,1,0,0,1
6153,0,1,0,0,1
6154,0,1,0,0,1
6155,0,1,0,0,1
6156,0,1,0,0,1
6157,1,0,0,0,1
6158,0,1,0,0,1
6159,0,1,0,0,1
6160,0,1,0,0,1
6161,0,0,0,1,1
6162,0,0,0,1,1
6163,0,1,0,0,1
6164,0,1,0,0,1
6165,0,1,0,0,1
6166,0,1,0,0,1
6167,0,1,0,0,1
6168,1,0,0,0,1
6169,0,1,0,0,1
6170,0,1,0,0,1
6171,0,1,0,0,1
6172,1,0,0,0,1
6173,1,0,0,0,1
6174,0,1,0,0,1
6175,0,1,0,0,1
6176,0,1,0,0,1
6177,0,1,0,0,1
6178,0,1,0,0,1
6179,0,1,0,0,1
6180,0,1,0,0,1
6181,0,1,0,0,1
6182,0,1,0,0,1
6183,1,0,0,0,1
6184,0,1,0,0,1
6185,0,1,0,0,1
6186,0,1,0,0,1
6187,1,0,0,0,1
6188,0,1,0,0,1
6189,0,1,0,0,1
6190,0,1,0,0,1
6191,0,1,0,0,1
6192,0,1,0,0,1
6193,1,0,0,0,1
6194,0,1,0,0,1
6195,0,1,0,0,1
6196,0,1,0,0,1
6197,0,1,0,0,1
6198,1,0,0,0,1
6199,1,0,0,0,1
6200,0,1,0,0,1
6201,1,0,0,0,1
6202,0,1,0,0,1
6203,0,1,0,0,1
6204,1,0,0,0,1
6205,0,1,0,0,1
6206,0,1,0,0,1
6207,0,1,0,0,1
6208,0,1,0,0,1
6209,0,1,0,0,1
6210,1,0,0,0,1
6211,0,1,0,0,1
6212,1,0,0,0,1
6213,0,0,0,1,1
6214,1,0,0,0,1
6215,1,0,0,0,1
6216,0,1,0,0,1
6217,0,1,0,0,1
6218,0,1,0,0,1
6219,0,1,0,0,1
6220,0,1,0,0,1
6221,0,1,0,0,1
6222,0,1,0,0,1
6223,1,0,0,0,1
6224,0,1,0,0,1
6225,1,0,0,0,1
6226,0,1,0,0,1
6227,1,0,0,0,1
6228,1,0,0,0,1
6229,0,1,0,0,1
6230,0,1,0,0,1
6231,0,1,0,0,1
6232,1,0,0,0,1
6233,0,1,0,0,1
6234,0,1,0,0,1
6235,0,1,0,0,1
6236,0,1,0,0,1
6237,0,1,0,0,1
6238,0,1,0,0,1
6239,1,0,0,0,1
6240,1,0,0,0,1
6241,0,1,0,0,1
6242,0,1,0,0,1
6243,0,0,0,1,1
6244,0,1,0,0,1
6245,1,0,0,0,1
6246,0,1,0,0,1
6247,0,1,0,0,1
6248,1,0,0,0,1
6249,0,1,0,0,1
6250,0,1,0,0,1
6251,1,0,0,0,1
6252,0,1,0,0,1
6253,0,1,0,0,1
6254,1,0,0,0,1
6255,0,1,0,0,1
6256,0,1,0,0,1
6257,0,1,0,0,1
6258,0,1,0,0,1
6259,0,1,0,0,1
6260,0,1,0,0,1
6261,0,1,0,0,1
6262,0,1,0,0,1
6263,0,1,0,0,1
6264,0,1,0,0,1
6265,0,1,0,0,1
6266,1,0,0,0,1
6267,1,0,0,0,1
6268,1,0,0,0,1
6269,0,1,0,0,1
6270,0,1,0,0,1
6271,0,1,0,0,1
6272,0,1,0,0,1
6273,1,0,0,0,1
6274,0,1,0,0,1
6275,0,1,0,0,1
6276,0,1,0,0,1
6277,0,1,0,0,1
6278,0,1,0,0,1
6279,1,0,0,0,1
6280,1,0,0,0,1
6281,1,0,0,0,1
6282,0,1,0,0,1
6283,0,1,0,0,1
6284,0,1,0,0,1
6285,0,1,0,0,1
6286,0,1,0,0,1
6287,0,1,0,0,1
6288,0,1,0,0,1
6289,0,0,0,1,1
6290,0,1,0,0,1
6291,0,1,0,0,1
6292,0,1,0,0,1
6293,1,0,0,0,1
6294,0,1,0,0,1
6295,1,0,0,0,1
6296,0,1,0,0,1
6297,0,1,0,0,1
6298,0,1,0,0,1
6299,0,1,0,0,1
6300,0,1,0,0,1
6301,1,0,0,0,1
6302,0,0,0,1,1
6303,0,1,0,0,1
6304,0,1,0,0,1
6305,0,1,0,0,1
6306,0,1,0,0,1
6307,1,0,0,0,1
6308,0,1,0,0,1
6309,0,1,0,0,1
6310,0,1,0,0,1
6311,1,0,0,0,1
6312,1,0,0,0,1
6313,0,1,0,0,1
6314,0,1,0,0,1
6315,0,1,0,0,1
6316,1,0,0,0,1
6317,0,1,0,0,1
6318,0,1,0,0,1
6319,0,1,0,0,1
6320,1,0,0,0,1
6321,0,1,0,0,1
6322,0,1,0,0,1
6323,0,1,0,0,1
6324,0,1,0,0,1
6325,1,0,0,0,1
6326,0,1,0,0,1
6327,0,1,0,0,1
6328,1,0,0,0,1
6329,0,1,0,0,1
6330,0,1,0,0,1
6331,0,1,0,0,1
6332,0,1,0,0,1
6333,1,0,0,0,1
6334,0,1,0,0,1
6335,0,0,0,1,1
6336,0,1,0,0,1
6337,0,1,0,0,1
6338,0,1,0,0,1
6339,0,1,0,0,1
6340,0,1,0,0,1
6341,0,1,0,0,1
6342,0,1,0,0,1
6343,0,1,0,0,1
6344,0,1,0,0,1
6345,0,1,0,0,1
6346,0,1,0,0,1
6347,1,0,0,0,1
6348,1,0,0,0,1
6349,1,0,0,0,1
6350,0,1,0,0,1
6351,0,1,0,0,1
6352,0,1,0,0,1
6353,0,1,0,0,1
6354,1,0,0,0,1
6355,0,1,0,0,1
6356,0,1,0,0,1
6357,1,0,0,0,1
6358,0,1,0,0,1
6359,0,1,0,0,1
6360,1,0,0,0,1
6361,0,1,0,0,1
6362,0,1,0,0,1
6363,0,1,0,0,1
6364,0,1,0,0,1
6365,0,1,0,0,1
6366,0,1,0,0,1
6367,0,0,0,1,1
6368,0,1,0,0,1
6369,0,0,0,1,1
6370,0,0,1,0,1
6371,0,1,0,0,1
6372,1,0,0,0,1
6373,0,0,1,0,1
6374,0,1,0,0,1
6375,0,1,0,0,1
6376,1,0,0,0,1
6377,0,1,0,0,1
6378,0,1,0,0,1
6379,0,1,0,0,1
6380,0,1,0,0,1
6381,0,1,0,0,1
6382,0,1,0,0,1
6383,0,1,0,0,1
6384,1,0,0,0,1
6385,0,1,0,0,1
6386,0,1,0,0,1
6387,1,0,0,0,1
6388,0,1,0,0,1
6389,1,0,0,0,1
6390,0,1,0,0,1
6391,1,0,0,0,1
6392,0,1,0,0,1
6393,0,1,0,0,1
6394,0,1,0,0,1
6395,0,1,0,0,1
6396,1,0,0,0,1
6397,0,1,0,0,1
6398,0,1,0,0,1
6399,0,1,0,0,1
6400,0,1,0,0,1
6401,0,1,0,0,1
6402,0,1,0,0,1
6403,1,0,0,0,1
6404,0,1,0,0,1
6405,0,1,0,0,1
6406,0,1,0,0,1
6407,0,1,0,0,1
6408,0,1,0,0,1
6409,0,1,0,0,1
6410,0,1,0,0,1
6411,0,1,0,0,1
6412,1,0,0,0,1
6413,0,1,0,0,1
6414,0,1,0,0,1
6415,0,1,0,0,1
6416,0,1,0,0,1
6417,0,0,0,1,1
6418,0,1,0,0,1
6419,0,1,0,0,1
6420,0,1,0,0,1
6421,0,1,0,0,1
6422,0,1,0,0,1
6423,1,0,0,0,1
6424,0,1,0,0,1
6425,1,0,0,0,1
6426,0,1,0,0,1
6427,0,1,0,0,1
6428,1,0,0,0,1
6429,0,1,0,0,1
6430,0,1,0,0,1
6431,0,1,0,0,1
6432,0,1,0,0,1
6433,1,0,0,0,1
6434,0,1,0,0,1
6435,1,0,0,0,1
6436,0,1,0,0,1
6437,0,1,0,0,1
6438,1,0,0,0,1
6439,0,1,0,0,1
6440,0,0,0,1,1
6441,1,0,0,0,1
6442,0,1,0,0,1
6443,0,1,0,0,1
6444,0,1,0,0,1
6445,0,1,0,0,1
6446,1,0,0,0,1
6447,0,1,0,0,1
6448,1,0,0,0,1
6449,1,0,0,0,1
6450,0,1,0,0,1
6451,1,0,0,0,1
6452,0,1,0,0,1
6453,0,1,0,0,1
6454,0,1,0,0,1
6455,0,1,0,0,1
6456,0,1,0,0,1
6457,0,1,0,0,1
6458,0,1,0,0,1
6459,0,1,0,0,1
6460,0,1,0,0,1
6461,0,1,0,0,1
6462,0,1,0,0,1
6463,0,1,0,0,1
6464,1,0,0,0,1
6465,1,0,0,0,1
6466,0,1,0,0,1
6467,1,0,0,0,1
6468,0,1,0,0,1
6469,0,0,0,1,1
6470,0,1,0,0,1
6471,0,1,0,0,1
6472,0,1,0,0,1
6473,1,0,0,0,1
6474,1,0,0,0,1
6475,0,1,0,0,1
6476,0,1,0,0,1
6477,1,0,0,0,1
6478,0,1,0,0,1
6479,0,1,0,0,1
6480,0,1,0,0,1
6481,0,1,0,0,1
6482,0,1,0,0,1
6483,0,1,0,0,1
6484,0,1,0,0,1
6485,1,0,0,0,1
6486,0,1,0,0,1
6487,0,1,0,0,1
6488,0,1,0,0,1
6489,0,1,0,0,1
6490,0,0,0,1,1
6491,1,0,0,0,1
6492,0,1,0,0,1
6493,0,1,0,0,1
6494,0,1,0,0,1
6495,1,0,0,0,1
6496,0,1,0,0,1
6497,0,1,0,0,1
6498,0,1,0,0,1
6499,1,0,0,0,1
6500,0,1,0,0,1
6501,0,1,0,0,1
6502,0,1,0,0,1
6503,0,1,0,0,1
6504,1,0,0,0,1
6505,1,0,0,0,1
6506,1,0,0,0,1
6507,0,1,0,0,1
6508,0,1,0,0,1
6509,0,1,0,0,1
6510,0,1,0,0,1
6511,0,1,0,0,1
6512,0,1,0,0,1
6513,0,1,0,0,1
6514,0,1,0,0,1
6515,0,1,0,0,1
6516,0,1,0,0,1
6517,0,1,0,0,1
6518,0,1,0,0,1
6519,1,0,0,0,1
6520,1,0,0,0,1
6521,0,1,0,0,1
6522,0,1,0,0,1
6523,1,0,0,0,1
6524,0,1,0,0,1
6525,0,1,0,0,1
6526,0,1,0,0,1
6527,0,0,0,1,1
6528,1,0,0,0,1
6529,0,1,0,0,1
6530,0,1,0,0,1
6531,1,0,0,0,1
6532,0,1,0,0,1
6533,0,1,0,0,1
6534,0,1,0,0,1
6535,0,1,0,0,1
6536,0,1,0,0,1
6537,0,1,0,0,1
6538,0,1,0,0,1
6539,0,1,0,0,1
6540,0,1,0,0,1
6541,0,1,0,0,1
6542,1,0,0,0,1
6543,0,1,0,0,1
6544,1,0,0,0,1
6545,0,1,0,0,1
6546,0,1,0,0,1
6547,0,1,0,0,1
6548,0,1,0,0,1
6549,0,1,0,0,1
6550,0,1,0,0,1
6551,0,1,0,0,1
6552,0,1,0,0,1
6553,1,0,0,0,1
6554,0,0,0,1,1
6555,0,1,0,0,1
6556,0,1,0,0,1
6557,0,1,0,0,1
6558,0,1,0,0,1
6559,0,1,0,0,1
6560,0,1,0,0,1
6561,0,1,0,0,1
6562,1,0,0,0,1
6563,1,0,0,0,1
6564,0,1,0,0,1
6565,0,1,0,0,1
6566,1,0,0,0,1
6567,0,1,0,0,1
6568,1,0,0,0,1
6569,0,1,0,0,1
6570,0,1,0,0,1
6571,0,1,0,0,1
6572,0,1,0,0,1
6573,1,0,0,0,1
6574,0,1,0,0,1
6575,0,1,0,0,1
6576,0,1,0,0,1
6577,0,1,0,0,1
6578,0,1,0,0,1
6579,0,1,0,0,1
6580,1,0,0,0,1
6581,0,1,0,0,1
6582,0,1,0,0,1
6583,0,1,0,0,1
6584,0,1,0,0,1
6585,0,1,0,0,1
6586,1,0,0,0,1
6587,0,1,0,0,1
6588,0,1,0,0,1
6589,0,1,0,0,1
6590,0,1,0,0,1
6591,0,1,0,0,1
6592,1,0,0,0,1
6593,0,1,0,0,1
6594,0,1,0,0,1
6595,0,1,0,0,1
6596,0,1,0,0,1
6597,1,0,0,0,1
6598,1,0,0,0,1
6599,0,1,0,0,1
6600,0,1,0,0,1
6601,0,1,0,0,1
6602,0,1,0,0,1
6603,1,0,0,0,1
6604,0,1,0,0,1
6605,0,1,0,0,1
6606,0,1,0,0,1
6607,1,0,0,0,1
6608,0,1,0,0,1
6609,1,0,0,0,1
6610,1,0,0,0,1
6611,1,0,0,0,1
6612,1,0,0,0,1
6613,0,1,0,0,1
6614,0,0,0,1,1
6615,0,1,0,0,1
6616,0,1,0,0,1
6617,0,1,0,0,1
6618,0,1,0,0,1
6619,1,0,0,0,1
6620,0,1,0,0,1
6621,0,1,0,0,1
6622,1,0,0,0,1
6623,0,1,0,0,1
6624,0,1,0,0,1
6625,0,1,0,0,1
6626,0,1,0,0,1
6627,1,0,0,0,1
6628,0,1,0,0,1
6629,0,1,0,0,1
6630,0,1,0,0,1
6631,0,1,0,0,1
6632,0,1,0,0,1
6633,0,1,0,0,1
6634,0,1,0,0,1
6635,0,1,0,0,1
6636,0,1,0,0,1
6637,0,1,0,0,1
6638,0,1,0,0,1
6639,1,0,0,0,1
6640,0,1,0,0,1
6641,0,1,0,0,1
6642,0,1,0,0,1
6643,0,1,0,0,1
6644,0,1,0,0,1
6645,0,1,0,0,1
6646,0,1,0,0,1
6647,0,1,0,0,1
6648,1,0,0,0,1
6649,1,0,0,0,1
6650,0,1,0,0,1
6651,0,1,0,0,1
6652,0,1,0,0,1
6653,1,0,0,0,1
6654,0,1,0,0,1
6655,0,1,0,0,1
6656,0,1,0,0,1
6657,0,1,0,0,1
6658,0,1,0,0,1
6659,1,0,0,0,1
6660,0,1,0,0,1
6661,1,0,0,0,1
6662,0,1,0,0,1
6663,0,1,0,0,1
6664,0,0,0,1,1
6665,0,1,0,0,1
6666,0,1,0,0,1
6667,0,1,0,0,1
6668,0,1,0,0,1
6669,1,0,0,0,1
6670,0,1,0,0,1
6671,0,1,0,0,1
6672,1,0,0,0,1
6673,1,0,0,0,1
6674,0,1,0,0,1
6675,0,1,0,0,1
6676,0,1,0,0,1
6677,0,1,0,0,1
6678,1,0,0,0,1
6679,0,1,0,0,1
6680,0,1,0,0,1
6681,0,1,0,0,1
6682,0,1,0,0,1
6683,1,0,0,0,1
6684,0,1,0,0,1
6685,0,1,0,0,1
6686,0,1,0,0,1
6687,0,1,0,0,1
6688,0,1,0,0,1
6689,1,0,0,0,1
6690,0,1,0,0,1
6691,0,1,0,0,1
6692,0,1,0,0,1
6693,0,1,0,0,1
6694,1,0,0,0,1
6695,0,1,0,0,1
6696,0,1,0,0,1
6697,0,1,0,0,1
6698,0,1,0,0,1
6699,0,1,0,0,1
6700,0,1,0,0,1
6701,0,1,0,0,1
6702,0,1,0,0,1
6703,1,0,0,0,1
6704,0,1,0,0,1
6705,0,1,0,0,1
6706,1,0,0,0,1
6707,1,0,0,0,1
6708,0,1,0,0,1
6709,0,1,0,0,1
6710,0,1,0,0,1
6711,0,1,0,0,1
6712,0,1,0,0,1
6713,0,1,0,0,1
6714,0,1,0,0,1
6715,0,1,0,0,1
6716,0,1,0,0,1
6717,0,1,0,0,1
6718,0,1,0,0,1
6719,0,1,0,0,1
6720,0,1,0,0,1
6721,0,1,0,0,1
6722,0,1,0,0,1
6723,0,1,0,0,1
6724,0,1,0,0,1
6725,0,1,0,0,1
6726,1,0,0,0,1
6727,0,1,0,0,1
6728,0,1,0,0,1
6729,0,1,0,0,1
6730,1,0,0,0,1
6731,0,1,0,0,1
6732,0,1,0,0,1
6733,0,1,0,0,1
6734,0,1,0,0,1
6735,1,0,0,0,1
6736,0,1,0,0,1
6737,0,1,0,0,1
6738,0,1,0,0,1
6739,1,0,0,0,1
6740,1,0,0,0,1
6741,0,1,0,0,1
6742,0,1,0,0,1
6743,0,1,0,0,1
6744,0,1,0,0,1
6745,0,1,0,0,1
6746,0,1,0,0,1
6747,0,1,0,0,1
6748,1,0,0,0,1
6749,0,1,0,0,1
6750,0,1,0,0,1
6751,0,0,0,1,1
6752,0,1,0,0,1
6753,0,1,0,0,1
6754,1,0,0,0,1
6755,1,0,0,0,1
6756,0,1,0,0,1
6757,1,0,0,0,1
6758,0,0,0,1,1
6759,0,1,0,0,1
6760,0,1,0,0,1
6761,0,1,0,0,1
6762,0,1,0,0,1
6763,0,1,0,0,1
6764,0,1,0,0,1
6765,0,1,0,0,1
6766,0,0,0,1,1
6767,0,1,0,0,1
6768,0,1,0,0,1
6769,0,1,0,0,1
6770,0,1,0,0,1
6771,0,1,0,0,1
6772,1,0,0,0,1
6773,1,0,0,0,1
6774,1,0,0,0,1
6775,0,0,0,1,1
6776,1,0,0,0,1
6777,0,1,0,0,1
6778,0,1,0,0,1
6779,0,1,0,0,1
6780,0,1,0,0,1
6781,0,1,0,0,1
6782,0,1,0,0,1
6783,1,0,0,0,1
6784,0,1,0,0,1
6785,0,1,0,0,1
6786,0,1,0,0,1
6787,0,1,0,0,1
6788,0,1,0,0,1
6789,0,1,0,0,1
6790,0,1,0,0,1
6791,0,1,0,0,1
6792,0,0,0,1,1
6793,1,0,0,0,1
6794,0,1,0,0,1
6795,0,1,0,0,1
6796,0,1,0,0,1
6797,0,1,0,0,1
6798,0,1,0,0,1
6799,0,1,0,0,1
6800,0,1,0,0,1
6801,0,1,0,0,1
6802,0,1,0,0,1
6803,0,1,0,0,1
6804,0,1,0,0,1
6805,0,1,0,0,1
6806,0,1,0,0,1
6807,0,1,0,0,1
6808,1,0,0,0,1
6809,0,1,0,0,1
6810,0,1,0,0,1
6811,0,0,0,1,1
6812,0,1,0,0,1
6813,1,0,0,0,1
6814,0,1,0,0,1
6815,0,1,0,0,1
6816,0,1,0,0,1
6817,0,1,0,0,1
6818,1,0,0,0,1
6819,1,0,0,0,1
6820,0,1,0,0,1
6821,1,0,0,0,1
6822,0,1,0,0,1
6823,1,0,0,0,1
6824,1,0,0,0,1
6825,0,1,0,0,1
6826,0,1,0,0,1
6827,0,1,0,0,1
6828,0,1,0,0,1
6829,0,1,0,0,1
6830,0,1,0,0,1
6831,0,1,0,0,1
6832,0,1,0,0,1
6833,0,1,0,0,1
6834,0,1,0,0,1
6835,0,1,0,0,1
6836,1,0,0,0,1
6837,0,1,0,0,1
6838,0,1,0,0,1
6839,0,1,0,0,1
6840,0,1,0,0,1
6841,0,1,0,0,1
6842,0,1,0,0,1
6843,0,1,0,0,1
6844,1,0,0,0,1
6845,0,1,0,0,1
6846,1,0,0,0,1
6847,0,1,0,0,1
6848,0,1,0,0,1
6849,0,1,0,0,1
6850,0,1,0,0,1
6851,0,1,0,0,1
6852,1,0,0,0,1
6853,0,1,0,0,1
6854,0,0,0,1,1
6855,0,1,0,0,1
6856,0,1,0,0,1
6857,0,1,0,0,1
6858,0,1,0,0,1
6859,0,0,0,1,1
6860,1,0,0,0,1
6861,0,1,0,0,1
6862,0,1,0,0,1
6863,1,0,0,0,1
6864,0,1,0,0,1
6865,0,1,0,0,1
6866,1,0,0,0,1
6867,0,1,0,0,1
6868,0,1,0,0,1
6869,1,0,0,0,1
6870,0,1,0,0,1
6871,1,0,0,0,1
6872,0,1,0,0,1
6873,1,0,0,0,1
6874,1,0,0,0,1
6875,1,0,0,0,1
6876,0,1,0,0,1
6877,0,1,0,0,1
6878,1,0,0,0,1
6879,0,1,0,0,1
6880,1,0,0,0,1
6881,1,0,0,0,1
6882,0,1,0,0,1
6883,0,1,0,0,1
6884,0,1,0,0,1
6885,1,0,0,0,1
6886,1,0,0,0,1
6887,0,1,0,0,1
6888,0,1,0,0,1
6889,0,0,0,1,1
6890,0,1,0,0,1
6891,1,0,0,0,1
6892,1,0,0,0,1
6893,0,1,0,0,1
6894,0,1,0,0,1
6895,0,1,0,0,1
6896,1,0,0,0,1
6897,0,1,0,0,1
6898,1,0,0,0,1
6899,1,0,0,0,1
6900,0,1,0,0,1
6901,1,0,0,0,1
6902,0,0,0,1,1
6903,0,1,0,0,1
6904,0,0,0,1,1
6905,0,0,0,1,1
6906,0,1,0,0,1
6907,0,1,0,0,1
6908,0,1,0,0,1
6909,0,1,0,0,1
6910,0,1,0,0,1
6911,0,1,0,0,1
6912,0,1,0,0,1
6913,0,1,0,0,1
6914,0,1,0,0,1
6915,0,1,0,0,1
6916,0,1,0,0,1
6917,0,1,0,0,1
6918,0,1,0,0,1
6919,0,1,0,0,1
6920,0,1,0,0,1
6921,0,1,0,0,1
6922,0,0,0,1,1
6923,0,1,0,0,1
6924,0,1,0,0,1
6925,0,1,0,0,1
6926,0,1,0,0,1
6927,0,1,0,0,1
6928,0,1,0,0,1
6929,1,0,0,0,1
6930,0,1,0,0,1
6931,0,1,0,0,1
6932,0,1,0,0,1
6933,0,1,0,0,1
6934,0,1,0,0,1
6935,0,1,0,0,1
6936,1,0,0,0,1
6937,1,0,0,0,1
6938,0,1,0,0,1
6939,1,0,0,0,1
6940,0,1,0,0,1
6941,1,0,0,0,1
6942,0,1,0,0,1
6943,1,0,0,0,1
6944,1,0,0,0,1
6945,0,1,0,0,1
6946,1,0,0,0,1
6947,0,1,0,0,1
6948,0,1,0,0,1
6949,0,1,0,0,1
6950,0,1,0,0,1
6951,0,1,0,0,1
6952,1,0,0,0,1
6953,0,1,0,0,1
6954,0,1,0,0,1
6955,0,1,0,0,1
6956,0,0,1,0,1
6957,0,1,0,0,1
6958,0,0,0,1,1
6959,0,1,0,0,1
6960,1,0,0,0,1
6961,0,1,0,0,1
6962,0,0,0,1,1
6963,0,1,0,0,1
6964,0,1,0,0,1
6965,0,1,0,0,1
6966,0,1,0,0,1
6967,0,1,0,0,1
6968,0,1,0,0,1
6969,0,1,0,0,1
6970,0,1,0,0,1
6971,1,0,0,0,1
6972,1,0,0,0,1
6973,0,1,0,0,1
6974,0,1,0,0,1
6975,0,1,0,0,1
6976,0,1,0,0,1
6977,0,1,0,0,1
6978,0,1,0,0,1
6979,0,1,0,0,1
6980,0,0,0,1,1
6981,0,1,0,0,1
6982,0,1,0,0,1
6983,0,1,0,0,1
6984,0,1,0,0,1
6985,0,1,0,0,1
6986,0,1,0,0,1
6987,0,1,0,0,1
6988,0,1,0,0,1
6989,0,1,0,0,1
6990,0,1,0,0,1
6991,0,1,0,0,1
6992,0,1,0,0,1
6993,0,1,0,0,1
6994,1,0,0,0,1
6995,0,1,0,0,1
6996,0,1,0,0,1
6997,0,1,0,0,1
6998,1,0,0,0,1
6999,0,1,0,0,1
7000,1,0,0,0,1
7001,0,1,0,0,1
7002,0,1,0,0,1
7003,0,1,0,0,1
7004,0,1,0,0,1
7005,0,1,0,0,1
7006,0,1,0,0,1
7007,0,1,0,0,1
7008,0,1,0,0,1
7009,0,1,0,0,1
7010,0,1,0,0,1
7011,0,1,0,0,1
7012,0,1,0,0,1
7013,1,0,0,0,1
7014,0,1,0,0,1
7015,0,1,0,0,1
7016,0,1,0,0,1
7017,0,1,0,0,1
7018,1,0,0,0,1
7019,0,1,0,0,1
7020,0,1,0,0,1
7021,0,1,0,0,1
7022,0,1,0,0,1
7023,0,1,0,0,1
7024,0,1,0,0,1
7025,0,1,0,0,1
7026,0,1,0,0,1
7027,0,1,0,0,1
7028,0,1,0,0,1
7029,1,0,0,0,1
7030,1,0,0,0,1
7031,0,1,0,0,1
7032,0,1,0,0,1
7033,1,0,0,0,1
7034,0,1,0,0,1
7035,0,1,0,0,1
7036,0,1,0,0,1
7037,0,1,0,0,1
7038,0,1,0,0,1
7039,0,1,0,0,1
7040,0,1,0,0,1
7041,0,1,0,0,1
7042,0,1,0,0,1
7043,0,1,0,0,1
7044,0,1,0,0,1
7045,0,1,0,0,1
7046,0,1,0,0,1
7047,0,1,0,0,1
7048,0,1,0,0,1
7049,0,1,0,0,1
7050,0,1,0,0,1
7051,0,1,0,0,1
7052,0,1,0,0,1
7053,0,1,0,0,1
7054,0,1,0,0,1
7055,1,0,0,0,1
7056,0,1,0,0,1
7057,0,1,0,0,1
7058,0,1,0,0,1
7059,0,1,0,0,1
7060,1,0,0,0,1
7061,0,1,0,0,1
7062,0,1,0,0,1
7063,0,1,0,0,1
7064,1,0,0,0,1
7065,0,1,0,0,1
7066,1,0,0,0,1
7067,0,1,0,0,1
7068,0,1,0,0,1
7069,0,1,0,0,1
7070,0,1,0,0,1
7071,1,0,0,0,1
7072,0,1,0,0,1
7073,0,1,0,0,1
7074,0,1,0,0,1
7075,0,1,0,0,1
7076,1,0,0,0,1
7077,0,1,0,0,1
7078,0,1,0,0,1
7079,0,0,1,0,1
7080,0,1,0,0,1
7081,0,1,0,0,1
7082,0,1,0,0,1
7083,1,0,0,0,1
7084,0,0,0,1,1
7085,0,1,0,0,1
7086,0,1,0,0,1
7087,0,1,0,0,1
7088,0,1,0,0,1
7089,0,1,0,0,1
7090,1,0,0,0,1
7091,0,1,0,0,1
7092,0,1,0,0,1
7093,0,1,0,0,1
7094,0,0,0,1,1
7095,1,0,0,0,1
7096,0,1,0,0,1
7097,0,1,0,0,1
7098,0,1,0,0,1
7099,0,1,0,0,1
7100,0,1,0,0,1
7101,0,1,0,0,1
7102,1,0,0,0,1
7103,1,0,0,0,1
7104,1,0,0,0,1
7105,0,1,0,0,1
7106,0,1,0,0,1
7107,0,1,0,0,1
7108,0,0,0,1,1
7109,1,0,0,0,1
7110,0,1,0,0,1
7111,0,1,0,0,1
7112,0,1,0,0,1
7113,0,1,0,0,1
7114,0,1,0,0,1
7115,0,1,0,0,1
7116,0,1,0,0,1
7117,1,0,0,0,1
7118,0,1,0,0,1
7119,0,1,0,0,1
7120,1,0,0,0,1
7121,0,1,0,0,1
7122,0,0,0,1,1
7123,0,0,0,1,1
7124,0,1,0,0,1
7125,0,0,0,1,1
7126,0,1,0,0,1
7127,0,1,0,0,1
7128,0,0,0,1,1
7129,0,1,0,0,1
7130,0,1,0,0,1
7131,0,1,0,0,1
7132,0,1,0,0,1
7133,0,1,0,0,1
7134,1,0,0,0,1
7135,0,1,0,0,1
7136,0,1,0,0,1
7137,0,1,0,0,1
7138,0,1,0,0,1
7139,0,1,0,0,1
7140,1,0,0,0,1
7141,0,0,0,1,1
7142,0,1,0,0,1
7143,0,1,0,0,1
7144,1,0,0,0,1
7145,0,1,0,0,1
7146,1,0,0,0,1
7147,0,1,0,0,1
7148,0,1,0,0,1
7149,0,1,0,0,1
7150,0,1,0,0,1
7151,0,1,0,0,1
7152,1,0,0,0,1
7153,1,0,0,0,1
7154,1,0,0,0,1
7155,0,1,0,0,1
7156,1,0,0,0,1
7157,1,0,0,0,1
7158,0,1,0,0,1
7159,0,1,0,0,1
7160,1,0,0,0,1
7161,0,1,0,0,1
7162,1,0,0,0,1
7163,0,0,0,1,1
7164,1,0,0,0,1
7165,1,0,0,0,1
7166,0,1,0,0,1
7167,0,1,0,0,1
7168,0,1,0,0,1
7169,0,1,0,0,1
7170,0,1,0,0,1
7171,1,0,0,0,1
7172,1,0,0,0,1
7173,0,1,0,0,1
7174,1,0,0,0,1
7175,0,1,0,0,1
7176,0,1,0,0,1
7177,0,1,0,0,1
7178,0,1,0,0,1
7179,0,0,0,1,1
7180,0,1,0,0,1
7181,0,0,0,1,1
7182,1,0,0,0,1
7183,0,1,0,0,1
7184,0,0,0,1,1
7185,0,1,0,0,1
7186,0,1,0,0,1
7187,0,1,0,0,1
7188,0,1,0,0,1
7189,0,1,0,0,1
7190,0,1,0,0,1
7191,0,1,0,0,1
7192,0,1,0,0,1
7193,0,1,0,0,1
7194,1,0,0,0,1
7195,0,1,0,0,1
7196,0,1,0,0,1
7197,0,1,0,0,1
7198,0,1,0,0,1
7199,0,1,0,0,1
7200,0,1,0,0,1
7201,1,0,0,0,1
7202,1,0,0,0,1
7203,0,1,0,0,1
7204,1,0,0,0,1
7205,0,1,0,0,1
7206,0,1,0,0,1
7207,0,1,0,0,1
7208,0,1,0,0,1
7209,0,1,0,0,1
7210,0,1,0,0,1
7211,1,0,0,0,1
7212,0,1,0,0,1
7213,0,1,0,0,1
7214,0,1,0,0,1
7215,1,0,0,0,1
7216,0,1,0,0,1
7217,0,1,0,0,1
7218,0,1,0,0,1
7219,0,0,0,1,1
7220,0,1,0,0,1
7221,0,1,0,0,1
7222,0,0,0,1,1
7223,1,0,0,0,1
7224,0,1,0,0,1
7225,1,0,0,0,1
7226,0,1,0,0,1
7227,0,1,0,0,1
7228,0,1,0,0,1
7229,0,1,0,0,1
7230,0,1,0,0,1
7231,0,1,0,0,1
7232,0,1,0,0,1
7233,0,1,0,0,1
7234,0,1,0,0,1
7235,0,1,0,0,1
7236,0,1,0,0,1
7237,0,1,0,0,1
7238,1,0,0,0,1
7239,0,1,0,0,1
7240,0,1,0,0,1
7241,1,0,0,0,1
7242,0,1,0,0,1
7243,0,1,0,0,1
7244,1,0,0,0,1
7245,1,0,0,0,1
7246,1,0,0,0,1
7247,0,1,0,0,1
7248,0,1,0,0,1
7249,0,1,0,0,1
7250,1,0,0,0,1
7251,0,1,0,0,1
7252,0,1,0,0,1
7253,0,1,0,0,1
7254,0,0,0,1,1
7255,1,0,0,0,1
7256,0,1,0,0,1
7257,0,0,0,1,1
7258,0,1,0,0,1
7259,1,0,0,0,1
7260,1,0,0,0,1
7261,0,0,0,1,1
7262,0,1,0,0,1
7263,0,1,0,0,1
7264,0,1,0,0,1
7265,0,1,0,0,1
7266,0,1,0,0,1
7267,1,0,0,0,1
7268,0,1,0,0,1
7269,0,1,0,0,1
7270,1,0,0,0,1
7271,0,1,0,0,1
7272,0,1,0,0,1
7273,0,1,0,0,1
7274,0,1,0,0,1
7275,0,1,0,0,1
7276,1,0,0,0,1
7277,0,1,0,0,1
7278,0,0,0,1,1
7279,0,1,0,0,1
7280,1,0,0,0,1
7281,0,1,0,0,1
7282,0,1,0,0,1
7283,0,1,0,0,1
7284,1,0,0,0,1
7285,0,1,0,0,1
7286,1,0,0,0,1
7287,0,1,0,0,1
7288,1,0,0,0,1
7289,0,1,0,0,1
7290,0,1,0,0,1
7291,1,0,0,0,1
7292,0,1,0,0,1
7293,0,1,0,0,1
7294,1,0,0,0,1
7295,0,1,0,0,1
7296,0,1,0,0,1
7297,0,1,0,0,1
7298,0,1,0,0,1
7299,0,1,0,0,1
7300,1,0,0,0,1
7301,0,1,0,0,1
7302,0,1,0,0,1
7303,0,1,0,0,1
7304,0,1,0,0,1
7305,0,1,0,0,1
7306,0,1,0,0,1
7307,0,1,0,0,1
7308,1,0,0,0,1
7309,1,0,0,0,1
7310,0,1,0,0,1
7311,0,1,0,0,1
7312,0,1,0,0,1
7313,0,1,0,0,1
7314,0,1,0,0,1
7315,0,0,0,1,1
7316,0,1,0,0,1
7317,0,0,0,1,1
7318,0,0,1,0,1
7319,0,1,0,0,1
7320,0,1,0,0,1
7321,0,1,0,0,1
7322,0,1,0,0,1
7323,0,1,0,0,1
7324,0,1,0,0,1
7325,0,1,0,0,1
7326,0,0,0,1,1
7327,0,0,1,0,1
7328,1,0,0,0,1
7329,0,1,0,0,1
7330,0,1,0,0,1
7331,0,1,0,0,1
7332,1,0,0,0,1
7333,0,1,0,0,1
7334,1,0,0,0,1
7335,0,1,0,0,1
7336,1,0,0,0,1
7337,1,0,0,0,1
7338,0,1,0,0,1
7339,1,0,0,0,1
7340,1,0,0,0,1
7341,0,1,0,0,1
7342,0,1,0,0,1
7343,0,1,0,0,1
7344,0,1,0,0,1
7345,1,0,0,0,1
7346,0,1,0,0,1
7347,0,1,0,0,1
7348,0,1,0,0,1
7349,0,1,0,0,1
7350,0,1,0,0,1
7351,0,0,1,0,1
7352,0,1,0,0,1
7353,0,1,0,0,1
7354,0,1,0,0,1
7355,0,1,0,0,1
7356,0,1,0,0,1
7357,0,1,0,0,1
7358,1,0,0,0,1
7359,0,1,0,0,1
7360,0,1,0,0,1
7361,0,1,0,0,1
7362,0,1,0,0,1
7363,1,0,0,0,1
7364,0,0,0,1,1
7365,0,1,0,0,1
7366,0,1,0,0,1
7367,1,0,0,0,1
7368,1,0,0,0,1
7369,0,1,0,0,1
7370,1,0,0,0,1
7371,0,1,0,0,1
7372,0,1,0,0,1
7373,0,1,0,0,1
7374,1,0,0,0,1
7375,0,1,0,0,1
7376,1,0,0,0,1
7377,0,1,0,0,1
7378,0,1,0,0,1
7379,0,1,0,0,1
7380,0,1,0,0,1
7381,0,1,0,0,1
7382,0,1,0,0,1
7383,0,1,0,0,1
7384,0,1,0,0,1
7385,0,1,0,0,1
7386,1,0,0,0,1
7387,0,1,0,0,1
7388,0,1,0,0,1
7389,0,1,0,0,1
7390,0,1,0,0,1
7391,0,1,0,0,1
7392,1,0,0,0,1
7393,0,1,0,0,1
7394,1,0,0,0,1
7395,0,1,0,0,1
7396,0,1,0,0,1
7397,0,1,0,0,1
7398,0,1,0,0,1
7399,0,1,0,0,1
7400,0,1,0,0,1
7401,0,1,0,0,1
7402,0,1,0,0,1
7403,0,1,0,0,1
7404,0,1,0,0,1
7405,0,1,0,0,1
7406,0,1,0,0,1
7407,1,0,0,0,1
7408,1,0,0,0,1
7409,0,1,0,0,1
7410,0,1,0,0,1
7411,0,1,0,0,1
7412,0,1,0,0,1
7413,0,1,0,0,1
7414,1,0,0,0,1
7415,0,1,0,0,1
7416,1,0,0,0,1
7417,0,1,0,0,1
7418,0,1,0,0,1
7419,0,1,0,0,1
7420,0,1,0,0,1
7421,0,1,0,0,1
7422,0,1,0,0,1
7423,0,1,0,0,1
7424,1,0,0,0,1
7425,0,1,0,0,1
7426,0,1,0,0,1
7427,0,1,0,0,1
7428,0,1,0,0,1
7429,0,1,0,0,1
7430,0,1,0,0,1
7431,0,1,0,0,1
7432,0,1,0,0,1
7433,0,1,0,0,1
7434,0,1,0,0,1
7435,0,1,0,0,1
7436,0,1,0,0,1
7437,0,1,0,0,1
7438,1,0,0,0,1
7439,0,1,0,0,1
7440,0,1,0,0,1
7441,0,1,0,0,1
7442,0,1,0,0,1
7443,0,1,0,0,1
7444,0,1,0,0,1
7445,0,1,0,0,1
7446,0,1,0,0,1
7447,0,1,0,0,1
7448,0,1,0,0,1
7449,0,1,0,0,1
7450,0,1,0,0,1
7451,0,1,0,0,1
7452,0,1,0,0,1
7453,0,1,0,0,1
7454,0,1,0,0,1
7455,0,1,0,0,1
7456,0,1,0,0,1
7457,0,1,0,0,1
7458,1,0,0,0,1
7459,0,1,0,0,1
7460,0,1,0,0,1
7461,0,1,0,0,1
7462,0,1,0,0,1
7463,0,1,0,0,1
7464,1,0,0,0,1
7465,0,1,0,0,1
7466,0,0,0,1,1
7467,1,0,0,0,1
7468,0,1,0,0,1
7469,0,1,0,0,1
7470,1,0,0,0,1
7471,0,1,0,0,1
7472,1,0,0,0,1
7473,0,1,0,0,1
7474,0,1,0,0,1
7475,0,1,0,0,1
7476,0,1,0,0,1
7477,1,0,0,0,1
7478,0,1,0,0,1
7479,1,0,0,0,1
7480,0,1,0,0,1
7481,0,1,0,0,1
7482,1,0,0,0,1
7483,0,1,0,0,1
7484,0,1,0,0,1
7485,1,0,0,0,1
7486,0,1,0,0,1
7487,0,1,0,0,1
7488,1,0,0,0,1
7489,0,1,0,0,1
7490,0,1,0,0,1
7491,0,1,0,0,1
7492,0,1,0,0,1
7493,0,1,0,0,1
7494,0,1,0,0,1
7495,0,1,0,0,1
7496,0,1,0,0,1
7497,0,1,0,0,1
7498,1,0,0,0,1
7499,1,0,0,0,1
7500,0,1,0,0,1
7501,0,1,0,0,1
7502,0,1,0,0,1
7503,0,1,0,0,1
7504,0,1,0,0,1
7505,0,1,0,0,1
7506,0,1,0,0,1
7507,1,0,0,0,1
7508,0,1,0,0,1
7509,0,1,0,0,1
7510,1,0,0,0,1
7511,0,0,0,1,1
7512,0,1,0,0,1
7513,0,1,0,0,1
7514,0,1,0,0,1
7515,0,1,0,0,1
7516,1,0,0,0,1
7517,0,1,0,0,1
7518,0,1,0,0,1
7519,0,1,0,0,1
7520,0,1,0,0,1
7521,0,1,0,0,1
7522,0,1,0,0,1
7523,0,1,0,0,1
7524,1,0,0,0,1
7525,0,1,0,0,1
7526,0,1,0,0,1
7527,0,1,0,0,1
7528,1,0,0,0,1
7529,0,1,0,0,1
7530,0,1,0,0,1
7531,1,0,0,0,1
7532,0,1,0,0,1
7533,0,0,0,1,1
7534,0,1,0,0,1
7535,0,1,0,0,1
7536,0,1,0,0,1
7537,0,1,0,0,1
7538,1,0,0,0,1
7539,0,1,0,0,1
7540,0,1,0,0,1
7541,0,1,0,0,1
7542,0,1,0,0,1
7543,0,1,0,0,1
7544,1,0,0,0,1
7545,0,1,0,0,1
7546,0,1,0,0,1
7547,0,1,0,0,1
7548,1,0,0,0,1
7549,0,1,0,0,1
7550,0,1,0,0,1
7551,0,1,0,0,1
7552,1,0,0,0,1
7553,1,0,0,0,1
7554,1,0,0,0,1
7555,0,1,0,0,1
7556,1,0,0,0,1
7557,0,1,0,0,1
7558,0,1,0,0,1
7559,0,1,0,0,1
7560,0,1,0,0,1
7561,0,1,0,0,1
7562,0,1,0,0,1
7563,0,1,0,0,1
7564,0,1,0,0,1
7565,1,0,0,0,1
7566,0,1,0,0,1
7567,0,1,0,0,1
7568,1,0,0,0,1
7569,0,1,0,0,1
7570,1,0,0,0,1
7571,1,0,0,0,1
7572,0,1,0,0,1
7573,0,1,0,0,1
7574,0,1,0,0,1
7575,0,1,0,0,1
7576,0,1,0,0,1
7577,0,1,0,0,1
7578,1,0,0,0,1
7579,0,1,0,0,1
7580,1,0,0,0,1
7581,1,0,0,0,1
7582,0,1,0,0,1
7583,0,1,0,0,1
7584,1,0,0,0,1
7585,0,1,0,0,1
7586,1,0,0,0,1
7587,1,0,0,0,1
7588,0,1,0,0,1
7589,0,1,0,0,1
7590,0,1,0,0,1
7591,1,0,0,0,1
7592,0,1,0,0,1
7593,0,1,0,0,1
7594,0,1,0,0,1
7595,0,1,0,0,1
7596,0,1,0,0,1
7597,0,1,0,0,1
7598,0,1,0,0,1
7599,0,1,0,0,1
7600,1,0,0,0,1
7601,0,1,0,0,1
7602,0,1,0,0,1
7603,0,1,0,0,1
7604,0,1,0,0,1
7605,0,1,0,0,1
7606,1,0,0,0,1
7607,1,0,0,0,1
7608,0,1,0,0,1
7609,0,1,0,0,1
7610,1,0,0,0,1
7611,0,1,0,0,1
7612,0,1,0,0,1
7613,0,1,0,0,1
7614,0,1,0,0,1
7615,0,1,0,0,1
7616,0,1,0,0,1
7617,0,1,0,0,1
7618,0,0,1,0,1
7619,0,1,0,0,1
7620,0,1,0,0,1
7621,1,0,0,0,1
7622,0,1,0,0,1
7623,0,1,0,0,1
7624,0,1,0,0,1
7625,0,1,0,0,1
7626,0,1,0,0,1
7627,0,1,0,0,1
7628,1,0,0,0,1
7629,0,1,0,0,1
7630,0,1,0,0,1
7631,0,1,0,0,1
7632,0,1,0,0,1
7633,0,1,0,0,1
7634,0,1,0,0,1
7635,1,0,0,0,1
7636,0,0,1,0,1
7637,0,1,0,0,1
7638,0,1,0,0,1
7639,0,1,0,0,1
7640,1,0,0,0,1
7641,0,1,0,0,1
7642,1,0,0,0,1
7643,0,1,0,0,1
7644,0,1,0,0,1
7645,1,0,0,0,1
7646,0,1,0,0,1
7647,0,1,0,0,1
7648,1,0,0,0,1
7649,0,1,0,0,1
7650,0,1,0,0,1
7651,0,1,0,0,1
7652,0,1,0,0,1
7653,1,0,0,0,1
7654,1,0,0,0,1
7655,0,1,0,0,1
7656,0,1,0,0,1
7657,0,1,0,0,1
7658,1,0,0,0,1
7659,1,0,0,0,1
7660,0,1,0,0,1
7661,0,1,0,0,1
7662,0,1,0,0,1
7663,0,1,0,0,1
7664,1,0,0,0,1
7665,1,0,0,0,1
7666,0,1,0,0,1
7667,0,1,0,0,1
7668,0,1,0,0,1
7669,1,0,0,0,1
7670,0,1,0,0,1
7671,0,1,0,0,1
7672,0,1,0,0,1
7673,0,1,0,0,1
7674,0,1,0,0,1
7675,0,1,0,0,1
7676,0,1,0,0,1
7677,1,0,0,0,1
7678,0,1,0,0,1
7679,0,1,0,0,1
7680,0,1,0,0,1
7681,0,1,0,0,1
7682,0,1,0,0,1
7683,0,1,0,0,1
7684,0,1,0,0,1
7685,0,1,0,0,1
7686,1,0,0,0,1
7687,0,1,0,0,1
7688,0,1,0,0,1
7689,1,0,0,0,1
7690,0,1,0,0,1
7691,0,1,0,0,1
7692,1,0,0,0,1
7693,0,1,0,0,1
7694,0,1,0,0,1
7695,1,0,0,0,1
7696,0,1,0,0,1
7697,0,1,0,0,1
7698,0,1,0,0,1
7699,0,1,0,0,1
7700,0,0,1,0,1
7701,0,1,0,0,1
7702,0,1,0,0,1
7703,0,0,0,1,1
7704,1,0,0,0,1
7705,0,1,0,0,1
7706,0,1,0,0,1
7707,1,0,0,0,1
7708,0,1,0,0,1
7709,0,0,0,1,1
7710,0,1,0,0,1
7711,0,1,0,0,1
7712,0,1,0,0,1
7713,0,1,0,0,1
7714,0,1,0,0,1
7715,0,1,0,0,1
7716,0,1,0,0,1
7717,0,0,0,1,1
7718,0,1,0,0,1
7719,0,1,0,0,1
7720,1,0,0,0,1
7721,0,1,0,0,1
7722,0,1,0,0,1
7723,0,1,0,0,1
7724,0,1,0,0,1
7725,1,0,0,0,1
7726,0,1,0,0,1
7727,0,1,0,0,1
7728,0,1,0,0,1
7729,0,1,0,0,1
7730,0,1,0,0,1
7731,0,0,0,1,1
7732,0,1,0,0,1
7733,1,0,0,0,1
7734,0,1,0,0,1
7735,0,1,0,0,1
7736,1,0,0,0,1
7737,0,1,0,0,1
7738,0,1,0,0,1
7739,0,1,0,0,1
7740,0,1,0,0,1
7741,0,1,0,0,1
7742,1,0,0,0,1
7743,0,1,0,0,1
7744,0,1,0,0,1
7745,0,1,0,0,1
7746,0,1,0,0,1
7747,0,1,0,0,1
7748,0,1,0,0,1
7749,0,1,0,0,1
7750,1,0,0,0,1
7751,0,1,0,0,1
7752,0,1,0,0,1
7753,0,1,0,0,1
7754,0,1,0,0,1
7755,0,1,0,0,1
7756,0,1,0,0,1
7757,0,1,0,0,1
7758,1,0,0,0,1
7759,0,1,0,0,1
7760,0,1,0,0,1
7761,0,1,0,0,1
7762,0,0,0,1,1
7763,0,0,1,0,1
7764,0,1,0,0,1
7765,0,1,0,0,1
7766,0,1,0,0,1
7767,0,1,0,0,1
7768,0,1,0,0,1
7769,1,0,0,0,1
7770,0,1,0,0,1
7771,0,1,0,0,1
7772,0,1,0,0,1
7773,0,1,0,0,1
7774,0,1,0,0,1
7775,1,0,0,0,1
7776,1,0,0,0,1
7777,0,1,0,0,1
7778,0,1,0,0,1
7779,0,1,0,0,1
7780,0,1,0,0,1
7781,1,0,0,0,1
7782,0,1,0,0,1
7783,0,1,0,0,1
7784,0,1,0,0,1
7785,1,0,0,0,1
7786,0,1,0,0,1
7787,0,1,0,0,1
7788,0,1,0,0,1
7789,0,1,0,0,1
7790,0,1,0,0,1
7791,0,1,0,0,1
7792,0,1,0,0,1
7793,0,1,0,0,1
7794,1,0,0,0,1
7795,0,1,0,0,1
7796,1,0,0,0,1
7797,0,0,0,1,1
7798,0,1,0,0,1
7799,0,1,0,0,1
7800,0,1,0,0,1
7801,0,0,0,1,1
7802,0,1,0,0,1
7803,0,1,0,0,1
7804,0,1,0,0,1
7805,1,0,0,0,1
7806,0,1,0,0,1
7807,1,0,0,0,1
7808,0,1,0,0,1
7809,0,1,0,0,1
7810,0,1,0,0,1
7811,0,1,0,0,1
7812,1,0,0,0,1
7813,0,1,0,0,1
7814,0,1,0,0,1
7815,0,1,0,0,1
7816,0,1,0,0,1
7817,0,1,0,0,1
7818,0,1,0,0,1
7819,0,1,0,0,1
7820,1,0,0,0,1
7821,1,0,0,0,1
7822,0,1,0,0,1
7823,0,1,0,0,1
7824,0,0,0,1,1
7825,0,1,0,0,1
7826,0,0,1,0,1
7827,0,1,0,0,1
7828,0,1,0,0,1
7829,1,0,0,0,1
7830,0,1,0,0,1
7831,0,1,0,0,1
7832,0,1,0,0,1
7833,0,1,0,0,1
7834,0,1,0,0,1
7835,0,1,0,0,1
7836,0,0,0,1,1
7837,0,1,0,0,1
7838,0,1,0,0,1
7839,0,1,0,0,1
7840,0,1,0,0,1
7841,0,1,0,0,1
7842,0,1,0,0,1
7843,0,1,0,0,1
7844,0,1,0,0,1
7845,0,1,0,0,1
7846,1,0,0,0,1
7847,0,1,0,0,1
7848,0,1,0,0,1
7849,0,1,0,0,1
7850,0,1,0,0,1
7851,1,0,0,0,1
7852,0,1,0,0,1
7853,0,1,0,0,1
7854,0,1,0,0,1
7855,0,1,0,0,1
7856,0,1,0,0,1
7857,0,1,0,0,1
7858,0,1,0,0,1
7859,0,1,0,0,1
7860,0,1,0,0,1
7861,0,1,0,0,1
7862,0,1,0,0,1
7863,0,1,0,0,1
7864,1,0,0,0,1
7865,0,1,0,0,1
7866,0,1,0,0,1
7867,0,1,0,0,1
7868,1,0,0,0,1
7869,0,1,0,0,1
7870,0,1,0,0,1
7871,1,0,0,0,1
7872,0,1,0,0,1
7873,1,0,0,0,1
7874,0,1,0,0,1
7875,1,0,0,0,1
7876,0,1,0,0,1
7877,0,1,0,0,1
7878,0,1,0,0,1
7879,1,0,0,0,1
7880,0,1,0,0,1
7881,0,1,0,0,1
7882,0,1,0,0,1
7883,0,1,0,0,1
7884,0,1,0,0,1
7885,0,1,0,0,1
7886,0,1,0,0,1
7887,0,1,0,0,1
7888,0,1,0,0,1
7889,0,1,0,0,1
7890,0,1,0,0,1
7891,0,1,0,0,1
7892,1,0,0,0,1
7893,0,1,0,0,1
7894,1,0,0,0,1
7895,0,1,0,0,1
7896,0,1,0,0,1
7897,1,0,0,0,1
7898,0,1,0,0,1
7899,0,1,0,0,1
7900,0,1,0,0,1
7901,1,0,0,0,1
7902,1,0,0,0,1
7903,1,0,0,0,1
7904,0,1,0,0,1
7905,0,1,0,0,1
7906,0,1,0,0,1
7907,0,1,0,0,1
7908,1,0,0,0,1
7909,0,1,0,0,1
7910,0,1,0,0,1
7911,0,1,0,0,1
7912,0,1,0,0,1
7913,0,1,0,0,1
7914,0,1,0,0,1
7915,0,1,0,0,1
7916,0,1,0,0,1
7917,0,1,0,0,1
7918,0,1,0,0,1
7919,0,1,0,0,1
7920,0,1,0,0,1
7921,0,1,0,0,1
7922,0,1,0,0,1
7923,0,1,0,0,1
7924,1,0,0,0,1
7925,0,1,0,0,1
7926,0,1,0,0,1
7927,0,1,0,0,1
7928,0,1,0,0,1
7929,0,1,0,0,1
7930,1,0,0,0,1
7931,0,1,0,0,1
7932,0,1,0,0,1
7933,0,1,0,0,1
7934,0,1,0,0,1
7935,0,1,0,0,1
7936,0,1,0,0,1
7937,0,1,0,0,1
7938,1,0,0,0,1
7939,1,0,0,0,1
7940,0,1,0,0,1
7941,0,1,0,0,1
7942,0,1,0,0,1
7943,0,1,0,0,1
7944,1,0,0,0,1
7945,0,1,0,0,1
7946,0,1,0,0,1
7947,0,1,0,0,1
7948,0,1,0,0,1
7949,0,1,0,0,1
7950,0,1,0,0,1
7951,0,1,0,0,1
7952,0,1,0,0,1
7953,0,1,0,0,1
7954,0,1,0,0,1
7955,0,0,0,1,1
7956,0,1,0,0,1
7957,0,1,0,0,1
7958,0,1,0,0,1
7959,1,0,0,0,1
7960,0,1,0,0,1
7961,0,1,0,0,1
7962,0,1,0,0,1
7963,1,0,0,0,1
7964,0,1,0,0,1
7965,0,1,0,0,1
7966,0,1,0,0,1
7967,0,1,0,0,1
7968,1,0,0,0,1
7969,0,1,0,0,1
7970,0,1,0,0,1
7971,0,1,0,0,1
7972,0,1,0,0,1
7973,1,0,0,0,1
7974,0,0,0,1,1
7975,1,0,0,0,1
7976,1,0,0,0,1
7977,0,0,0,1,1
7978,0,1,0,0,1
7979,0,1,0,0,1
7980,0,1,0,0,1
7981,0,1,0,0,1
7982,0,1,0,0,1
7983,0,1,0,0,1
7984,0,1,0,0,1
7985,1,0,0,0,1
7986,0,0,1,0,1
7987,0,1,0,0,1
7988,1,0,0,0,1
7989,1,0,0,0,1
7990,0,1,0,0,1
7991,0,1,0,0,1
7992,0,1,0,0,1
7993,0,1,0,0,1
7994,0,1,0,0,1
7995,0,1,0,0,1
7996,0,1,0,0,1
7997,0,1,0,0,1
7998,0,1,0,0,1
7999,0,1,0,0,1
8000,0,1,0,0,1
8001,1,0,0,0,1
8002,0,1,0,0,1
8003,1,0,0,0,1
8004,0,1,0,0,1
8005,1,0,0,0,1
8006,0,1,0,0,1
8007,0,1,0,0,1
8008,1,0,0,0,1
8009,0,1,0,0,1
8010,0,1,0,0,1
8011,0,1,0,0,1
8012,0,1,0,0,1
8013,0,1,0,0,1
8014,0,1,0,0,1
8015,0,1,0,0,1
8016,1,0,0,0,1
8017,1,0,0,0,1
8018,1,0,0,0,1
8019,0,1,0,0,1
8020,0,1,0,0,1
8021,0,1,0,0,1
8022,0,1,0,0,1
8023,0,1,0,0,1
8024,0,1,0,0,1
8025,0,1,0,0,1
8026,0,1,0,0,1
8027,0,1,0,0,1
8028,0,1,0,0,1
8029,0,1,0,0,1
8030,0,1,0,0,1
8031,0,1,0,0,1
8032,0,1,0,0,1
8033,1,0,0,0,1
8034,0,1,0,0,1
8035,0,1,0,0,1
8036,0,1,0,0,1
8037,0,0,0,1,1
8038,1,0,0,0,1
8039,1,0,0,0,1
8040,0,1,0,0,1
8041,0,1,0,0,1
8042,0,1,0,0,1
8043,0,1,0,0,1
8044,0,1,0,0,1
8045,1,0,0,0,1
8046,0,1,0,0,1
8047,0,1,0,0,1
8048,0,1,0,0,1
8049,0,1,0,0,1
8050,1,0,0,0,1
8051,0,1,0,0,1
8052,0,1,0,0,1
8053,0,1,0,0,1
8054,0,1,0,0,1
8055,0,1,0,0,1
8056,0,1,0,0,1
8057,0,1,0,0,1
8058,0,1,0,0,1
8059,0,1,0,0,1
8060,0,1,0,0,1
8061,0,1,0,0,1
8062,0,1,0,0,1
8063,1,0,0,0,1
8064,0,1,0,0,1
8065,0,0,0,1,1
8066,0,1,0,0,1
8067,0,1,0,0,1
8068,1,0,0,0,1
8069,0,1,0,0,1
8070,0,1,0,0,1
8071,1,0,0,0,1
8072,0,0,0,1,1
8073,1,0,0,0,1
8074,0,1,0,0,1
8075,0,1,0,0,1
8076,0,1,0,0,1
8077,0,1,0,0,1
8078,1,0,0,0,1
8079,1,0,0,0,1
8080,0,1,0,0,1
8081,0,1,0,0,1
8082,0,1,0,0,1
8083,1,0,0,0,1
8084,0,1,0,0,1
8085,0,1,0,0,1
8086,0,1,0,0,1
8087,0,1,0,0,1
8088,0,1,0,0,1
8089,0,1,0,0,1
8090,1,0,0,0,1
8091,0,1,0,0,1
8092,0,0,0,1,1
8093,0,1,0,0,1
8094,1,0,0,0,1
8095,0,1,0,0,1
8096,1,0,0,0,1
8097,0,1,0,0,1
8098,0,1,0,0,1
8099,0,1,0,0,1
8100,0,1,0,0,1
8101,0,1,0,0,1
8102,0,1,0,0,1
8103,0,1,0,0,1
8104,0,0,0,1,1
8105,1,0,0,0,1
8106,0,1,0,0,1
8107,0,1,0,0,1
8108,0,1,0,0,1
8109,1,0,0,0,1
8110,0,1,0,0,1
8111,0,1,0,0,1
8112,0,1,0,0,1
8113,0,1,0,0,1
8114,1,0,0,0,1
8115,0,1,0,0,1
8116,0,1,0,0,1
8117,0,1,0,0,1
8118,0,1,0,0,1
8119,0,1,0,0,1
8120,0,1,0,0,1
8121,0,1,0,0,1
8122,0,1,0,0,1
8123,0,1,0,0,1
8124,1,0,0,0,1
8125,1,0,0,0,1
8126,0,1,0,0,1
8127,0,1,0,0,1
8128,0,1,0,0,1
8129,1,0,0,0,1
8130,0,1,0,0,1
8131,0,1,0,0,1
8132,0,1,0,0,1
8133,1,0,0,0,1
8134,0,1,0,0,1
8135,0,1,0,0,1
8136,0,1,0,0,1
8137,0,1,0,0,1
8138,0,1,0,0,1
8139,0,1,0,0,1
8140,0,1,0,0,1
8141,1,0,0,0,1
8142,0,1,0,0,1
8143,0,1,0,0,1
8144,1,0,0,0,1
8145,0,1,0,0,1
8146,0,1,0,0,1
8147,0,1,0,0,1
8148,0,1,0,0,1
8149,1,0,0,0,1
8150,1,0,0,0,1
8151,0,1,0,0,1
8152,0,1,0,0,1
8153,0,1,0,0,1
8154,1,0,0,0,1
8155,0,1,0,0,1
8156,0,1,0,0,1
8157,0,1,0,0,1
8158,0,1,0,0,1
8159,1,0,0,0,1
8160,0,1,0,0,1
8161,0,1,0,0,1
8162,0,1,0,0,1
8163,1,0,0,0,1
8164,0,1,0,0,1
8165,1,0,0,0,1
8166,0,1,0,0,1
8167,0,1,0,0,1
8168,0,0,0,1,1
8169,0,1,0,0,1
8170,0,1,0,0,1
8171,0,1,0,0,1
8172,0,1,0,0,1
8173,0,1,0,0,1
8174,0,1,0,0,1
8175,0,1,0,0,1
8176,1,0,0,0,1
8177,0,1,0,0,1
8178,0,1,0,0,1
8179,0,1,0,0,1
8180,1,0,0,0,1
8181,0,0,0,1,1
8182,0,1,0,0,1
8183,0,1,0,0,1
8184,0,1,0,0,1
8185,0,1,0,0,1
8186,0,1,0,0,1
8187,0,1,0,0,1
8188,0,1,0,0,1
8189,0,1,0,0,1
8190,1,0,0,0,1
8191,0,1,0,0,1
8192,0,1,0,0,1
8193,0,1,0,0,1
8194,0,1,0,0,1
8195,0,1,0,0,1
8196,1,0,0,0,1
8197,0,1,0,0,1
8198,0,1,0,0,1
8199,0,1,0,0,1
8200,0,1,0,0,1
8201,0,1,0,0,1
8202,0,1,0,0,1
8203,0,1,0,0,1
8204,0,1,0,0,1
8205,0,1,0,0,1
8206,0,1,0,0,1
8207,0,1,0,0,1
8208,0,1,0,0,1
8209,0,1,0,0,1
8210,0,1,0,0,1
8211,1,0,0,0,1
8212,0,1,0,0,1
8213,0,1,0,0,1
8214,0,1,0,0,1
8215,1,0,0,0,1
8216,0,1,0,0,1
8217,1,0,0,0,1
8218,0,0,0,1,1
8219,0,1,0,0,1
8220,0,1,0,0,1
8221,0,1,0,0,1
8222,0,0,0,1,1
8223,0,1,0,0,1
8224,0,1,0,0,1
8225,0,1,0,0,1
8226,0,1,0,0,1
8227,0,1,0,0,1
8228,0,1,0,0,1
8229,0,1,0,0,1
8230,1,0,0,0,1
8231,0,1,0,0,1
8232,0,1,0,0,1
8233,0,1,0,0,1
8234,0,1,0,0,1
8235,0,0,0,1,1
8236,0,1,0,0,1
8237,0,1,0,0,1
8238,0,1,0,0,1
8239,0,1,0,0,1
8240,0,1,0,0,1
8241,0,1,0,0,1
8242,0,1,0,0,1
8243,0,0,0,1,1
8244,1,0,0,0,1
8245,0,1,0,0,1
8246,0,1,0,0,1
8247,0,1,0,0,1
8248,1,0,0,0,1
8249,0,1,0,0,1
8250,0,1,0,0,1
8251,0,1,0,0,1
8252,0,1,0,0,1
8253,1,0,0,0,1
8254,0,1,0,0,1
8255,0,1,0,0,1
8256,0,1,0,0,1
8257,0,1,0,0,1
8258,1,0,0,0,1
8259,0,1,0,0,1
8260,0,1,0,0,1
8261,1,0,0,0,1
8262,1,0,0,0,1
8263,1,0,0,0,1
8264,0,1,0,0,1
8265,1,0,0,0,1
8266,0,1,0,0,1
8267,0,1,0,0,1
8268,0,1,0,0,1
8269,1,0,0,0,1
8270,1,0,0,0,1
8271,1,0,0,0,1
8272,1,0,0,0,1
8273,0,1,0,0,1
8274,0,1,0,0,1
8275,0,1,0,0,1
8276,0,1,0,0,1
8277,1,0,0,0,1
8278,0,1,0,0,1
8279,0,1,0,0,1
8280,0,1,0,0,1
8281,0,1,0,0,1
8282,0,1,0,0,1
8283,1,0,0,0,1
8284,0,1,0,0,1
8285,0,1,0,0,1
8286,1,0,0,0,1
8287,1,0,0,0,1
8288,0,1,0,0,1
8289,0,1,0,0,1
8290,0,1,0,0,1
8291,0,1,0,0,1
8292,1,0,0,0,1
8293,0,0,1,0,1
8294,1,0,0,0,1
8295,0,0,1,0,1
8296,0,1,0,0,1
8297,0,1,0,0,1
8298,0,1,0,0,1
8299,1,0,0,0,1
8300,0,1,0,0,1
8301,0,1,0,0,1
8302,1,0,0,0,1
8303,0,1,0,0,1
8304,1,0,0,0,1
8305,0,1,0,0,1
8306,1,0,0,0,1
8307,0,1,0,0,1
8308,0,1,0,0,1
8309,0,1,0,0,1
8310,0,1,0,0,1
8311,0,1,0,0,1
8312,0,1,0,0,1
8313,0,1,0,0,1
8314,0,1,0,0,1
8315,0,1,0,0,1
8316,1,0,0,0,1
8317,1,0,0,0,1
8318,0,1,0,0,1
8319,0,1,0,0,1
8320,0,1,0,0,1
8321,0,1,0,0,1
8322,0,1,0,0,1
8323,1,0,0,0,1
8324,1,0,0,0,1
8325,0,1,0,0,1
8326,0,1,0,0,1
8327,0,1,0,0,1
8328,0,1,0,0,1
8329,0,1,0,0,1
8330,1,0,0,0,1
8331,0,1,0,0,1
8332,0,1,0,0,1
8333,0,1,0,0,1
8334,0,1,0,0,1
8335,0,1,0,0,1
8336,0,1,0,0,1
8337,0,1,0,0,1
8338,0,1,0,0,1
8339,0,1,0,0,1
8340,0,1,0,0,1
8341,0,1,0,0,1
8342,0,1,0,0,1
8343,0,1,0,0,1
8344,0,1,0,0,1
8345,1,0,0,0,1
8346,0,1,0,0,1
8347,0,1,0,0,1
8348,1,0,0,0,1
8349,0,1,0,0,1
8350,1,0,0,0,1
8351,0,1,0,0,1
8352,0,1,0,0,1
8353,0,1,0,0,1
8354,0,1,0,0,1
8355,0,1,0,0,1
8356,0,1,0,0,1
8357,0,1,0,0,1
8358,1,0,0,0,1
8359,0,1,0,0,1
8360,0,1,0,0,1
8361,0,1,0,0,1
8362,0,1,0,0,1
8363,0,1,0,0,1
8364,0,1,0,0,1
8365,0,1,0,0,1
8366,1,0,0,0,1
8367,0,1,0,0,1
8368,0,1,0,0,1
8369,0,1,0,0,1
8370,0,1,0,0,1
8371,0,1,0,0,1
8372,0,1,0,0,1
8373,0,1,0,0,1
8374,1,0,0,0,1
8375,0,1,0,0,1
8376,0,1,0,0,1
8377,0,1,0,0,1
8378,0,1,0,0,1
8379,0,1,0,0,1
8380,0,1,0,0,1
8381,0,1,0,0,1
8382,0,1,0,0,1
8383,0,1,0,0,1
8384,1,0,0,0,1
8385,0,1,0,0,1
8386,0,1,0,0,1
8387,0,1,0,0,1
8388,1,0,0,0,1
8389,1,0,0,0,1
8390,0,1,0,0,1
8391,0,1,0,0,1
8392,0,1,0,0,1
8393,0,1,0,0,1
8394,0,1,0,0,1
8395,0,1,0,0,1
8396,0,1,0,0,1
8397,0,1,0,0,1
8398,0,1,0,0,1
8399,0,1,0,0,1
8400,0,1,0,0,1
8401,1,0,0,0,1
8402,0,1,0,0,1
8403,0,1,0,0,1
8404,0,1,0,0,1
8405,0,1,0,0,1
8406,0,1,0,0,1
8407,0,1,0,0,1
8408,1,0,0,0,1
8409,1,0,0,0,1
8410,0,1,0,0,1
8411,0,1,0,0,1
8412,1,0,0,0,1
8413,0,1,0,0,1
8414,1,0,0,0,1
8415,0,1,0,0,1
8416,0,1,0,0,1
8417,0,1,0,0,1
8418,1,0,0,0,1
8419,0,1,0,0,1
8420,0,1,0,0,1
8421,0,0,0,1,1
8422,0,1,0,0,1
8423,0,1,0,0,1
8424,0,1,0,0,1
8425,0,1,0,0,1
8426,0,1,0,0,1
8427,0,1,0,0,1
8428,0,1,0,0,1
8429,0,0,0,1,1
8430,0,1,0,0,1
8431,0,1,0,0,1
8432,0,1,0,0,1
8433,1,0,0,0,1
8434,1,0,0,0,1
8435,0,1,0,0,1
8436,0,1,0,0,1
8437,1,0,0,0,1
8438,0,1,0,0,1
8439,0,1,0,0,1
8440,0,0,0,1,1
8441,1,0,0,0,1
8442,0,1,0,0,1
8443,1,0,0,0,1
8444,0,1,0,0,1
8445,0,1,0,0,1
8446,0,1,0,0,1
8447,0,1,0,0,1
8448,1,0,0,0,1
8449,1,0,0,0,1
8450,0,1,0,0,1
8451,0,1,0,0,1
8452,0,1,0,0,1
8453,0,1,0,0,1
8454,1,0,0,0,1
8455,0,1,0,0,1
8456,0,1,0,0,1
8457,0,1,0,0,1
8458,0,1,0,0,1
8459,0,1,0,0,1
8460,0,1,0,0,1
8461,1,0,0,0,1
8462,0,1,0,0,1
8463,0,1,0,0,1
8464,0,0,1,0,1
8465,0,1,0,0,1
8466,0,1,0,0,1
8467,0,1,0,0,1
8468,0,1,0,0,1
8469,0,1,0,0,1
8470,0,1,0,0,1
8471,0,0,0,1,1
8472,0,1,0,0,1
8473,0,1,0,0,1
8474,0,1,0,0,1
8475,1,0,0,0,1
8476,1,0,0,0,1
8477,1,0,0,0,1
8478,0,1,0,0,1
8479,0,1,0,0,1
8480,1,0,0,0,1
8481,0,1,0,0,1
8482,0,1,0,0,1
8483,0,1,0,0,1
8484,0,1,0,0,1
8485,0,1,0,0,1
8486,0,1,0,0,1
8487,0,1,0,0,1
8488,0,1,0,0,1
8489,1,0,0,0,1
8490,0,1,0,0,1
8491,0,1,0,0,1
8492,0,1,0,0,1
8493,0,1,0,0,1
8494,0,1,0,0,1
8495,1,0,0,0,1
8496,1,0,0,0,1
8497,1,0,0,0,1
8498,0,1,0,0,1
8499,0,1,0,0,1
8500,0,1,0,0,1
8501,0,1,0,0,1
8502,0,1,0,0,1
8503,0,1,0,0,1
8504,0,1,0,0,1
8505,0,1,0,0,1
8506,0,1,0,0,1
8507,0,1,0,0,1
8508,1,0,0,0,1
8509,0,1,0,0,1
8510,0,1,0,0,1
8511,0,1,0,0,1
8512,1,0,0,0,1
8513,0,1,0,0,1
8514,0,1,0,0,1
8515,0,1,0,0,1
8516,1,0,0,0,1
8517,0,1,0,0,1
8518,0,1,0,0,1
8519,0,1,0,0,1
8520,0,1,0,0,1
8521,1,0,0,0,1
8522,0,1,0,0,1
8523,1,0,0,0,1
8524,0,1,0,0,1
8525,0,1,0,0,1
8526,1,0,0,0,1
8527,1,0,0,0,1
8528,0,1,0,0,1
8529,0,1,0,0,1
8530,0,1,0,0,1
8531,0,1,0,0,1
8532,0,1,0,0,1
8533,0,1,0,0,1
8534,0,1,0,0,1
8535,0,1,0,0,1
8536,0,1,0,0,1
8537,0,1,0,0,1
8538,0,1,0,0,1
8539,0,1,0,0,1
8540,0,1,0,0,1
8541,0,1,0,0,1
8542,0,1,0,0,1
8543,0,0,0,1,1
8544,0,1,0,0,1
8545,0,1,0,0,1
8546,1,0,0,0,1
8547,0,0,0,1,1
8548,0,1,0,0,1
8549,1,0,0,0,1
8550,0,1,0,0,1
8551,0,1,0,0,1
8552,0,1,0,0,1
8553,0,1,0,0,1
8554,0,1,0,0,1
8555,1,0,0,0,1
8556,0,1,0,0,1
8557,1,0,0,0,1
8558,1,0,0,0,1
8559,0,1,0,0,1
8560,0,1,0,0,1
8561,0,1,0,0,1
8562,0,1,0,0,1
8563,1,0,0,0,1
8564,0,1,0,0,1
8565,1,0,0,0,1
8566,1,0,0,0,1
8567,0,0,0,1,1
8568,0,1,0,0,1
8569,0,1,0,0,1
8570,0,1,0,0,1
8571,0,1,0,0,1
8572,0,1,0,0,1
8573,0,1,0,0,1
8574,0,1,0,0,1
8575,0,1,0,0,1
8576,0,1,0,0,1
8577,0,1,0,0,1
8578,0,1,0,0,1
8579,0,1,0,0,1
8580,0,1,0,0,1
8581,0,1,0,0,1
8582,0,1,0,0,1
8583,1,0,0,0,1
8584,0,1,0,0,1
8585,0,1,0,0,1
8586,1,0,0,0,1
8587,0,1,0,0,1
8588,0,1,0,0,1
8589,1,0,0,0,1
8590,1,0,0,0,1
8591,0,1,0,0,1
8592,0,1,0,0,1
8593,0,1,0,0,1
8594,0,1,0,0,1
8595,0,1,0,0,1
8596,0,1,0,0,1
8597,0,1,0,0,1
8598,0,1,0,0,1
8599,0,1,0,0,1
8600,0,1,0,0,1
8601,0,1,0,0,1
8602,0,1,0,0,1
8603,0,1,0,0,1
8604,0,1,0,0,1
8605,0,1,0,0,1
8606,1,0,0,0,1
8607,1,0,0,0,1
8608,1,0,0,0,1
8609,0,1,0,0,1
8610,1,0,0,0,1
8611,0,1,0,0,1
8612,0,1,0,0,1
8613,0,1,0,0,1
8614,0,1,0,0,1
8615,0,1,0,0,1
8616,0,1,0,0,1
8617,0,1,0,0,1
8618,0,1,0,0,1
8619,0,1,0,0,1
8620,0,1,0,0,1
8621,0,1,0,0,1
8622,0,1,0,0,1
8623,0,1,0,0,1
8624,0,1,0,0,1
8625,0,1,0,0,1
8626,0,1,0,0,1
8627,0,1,0,0,1
8628,1,0,0,0,1
8629,0,1,0,0,1
8630,0,1,0,0,1
8631,0,1,0,0,1
8632,0,1,0,0,1
8633,0,1,0,0,1
8634,0,1,0,0,1
8635,0,1,0,0,1
8636,0,1,0,0,1
8637,0,1,0,0,1
8638,1,0,0,0,1
8639,0,1,0,0,1
8640,0,1,0,0,1
8641,1,0,0,0,1
8642,0,1,0,0,1
8643,0,1,0,0,1
8644,0,0,0,1,1
8645,0,1,0,0,1
8646,0,1,0,0,1
8647,1,0,0,0,1
8648,0,1,0,0,1
8649,0,1,0,0,1
8650,0,1,0,0,1
8651,1,0,0,0,1
8652,0,1,0,0,1
8653,0,1,0,0,1
8654,0,1,0,0,1
8655,0,1,0,0,1
8656,0,1,0,0,1
8657,0,1,0,0,1
8658,0,1,0,0,1
8659,0,1,0,0,1
8660,0,1,0,0,1
8661,0,1,0,0,1
8662,0,1,0,0,1
8663,0,1,0,0,1
8664,0,1,0,0,1
8665,0,1,0,0,1
8666,0,1,0,0,1
8667,0,1,0,0,1
8668,0,1,0,0,1
8669,0,1,0,0,1
8670,1,0,0,0,1
8671,0,1,0,0,1
8672,0,1,0,0,1
8673,0,1,0,0,1
8674,0,1,0,0,1
8675,0,1,0,0,1
8676,0,0,0,1,1
8677,0,1,0,0,1
8678,0,1,0,0,1
8679,0,1,0,0,1
8680,0,1,0,0,1
8681,1,0,0,0,1
8682,0,1,0,0,1
8683,0,1,0,0,1
8684,0,1,0,0,1
8685,0,1,0,0,1
8686,0,1,0,0,1
8687,0,1,0,0,1
8688,0,1,0,0,1
8689,0,1,0,0,1
8690,0,1,0,0,1
8691,0,1,0,0,1
8692,0,1,0,0,1
8693,0,1,0,0,1
8694,0,1,0,0,1
8695,0,1,0,0,1
8696,0,1,0,0,1
8697,0,1,0,0,1
8698,0,1,0,0,1
8699,0,1,0,0,1
8700,0,1,0,0,1
8701,0,1,0,0,1
8702,0,1,0,0,1
8703,0,1,0,0,1
8704,1,0,0,0,1
8705,1,0,0,0,1
8706,0,1,0,0,1
8707,0,1,0,0,1
8708,1,0,0,0,1
8709,0,1,0,0,1
8710,0,1,0,0,1
8711,0,1,0,0,1
8712,0,0,1,0,1
8713,0,1,0,0,1
8714,0,0,0,1,1
8715,0,1,0,0,1
8716,0,1,0,0,1
8717,1,0,0,0,1
8718,0,1,0,0,1
8719,0,1,0,0,1
8720,1,0,0,0,1
8721,0,1,0,0,1
8722,0,1,0,0,1
8723,0,1,0,0,1
8724,0,1,0,0,1
8725,1,0,0,0,1
8726,1,0,0,0,1
8727,0,1,0,0,1
8728,0,1,0,0,1
8729,0,1,0,0,1
8730,1,0,0,0,1
8731,0,1,0,0,1
8732,0,1,0,0,1
8733,0,1,0,0,1
8734,0,1,0,0,1
8735,0,1,0,0,1
8736,0,0,0,1,1
8737,0,1,0,0,1
8738,0,1,0,0,1
8739,0,1,0,0,1
8740,0,1,0,0,1
8741,0,1,0,0,1
8742,0,1,0,0,1
8743,0,1,0,0,1
8744,0,1,0,0,1
8745,0,1,0,0,1
8746,0,1,0,0,1
8747,0,1,0,0,1
8748,0,1,0,0,1
8749,0,1,0,0,1
8750,0,1,0,0,1
8751,0,1,0,0,1
8752,0,1,0,0,1
8753,0,1,0,0,1
8754,0,0,0,1,1
8755,0,1,0,0,1
8756,0,1,0,0,1
8757,0,1,0,0,1
8758,0,1,0,0,1
8759,0,1,0,0,1
8760,0,1,0,0,1
8761,0,1,0,0,1
8762,0,1,0,0,1
8763,0,1,0,0,1
8764,0,1,0,0,1
8765,0,1,0,0,1
8766,0,1,0,0,1
8767,1,0,0,0,1
8768,0,1,0,0,1
8769,0,1,0,0,1
8770,0,1,0,0,1
8771,0,1,0,0,1
8772,0,1,0,0,1
8773,0,1,0,0,1
8774,0,1,0,0,1
8775,0,1,0,0,1
8776,0,1,0,0,1
8777,0,1,0,0,1
8778,0,1,0,0,1
8779,0,1,0,0,1
8780,0,1,0,0,1
8781,0,1,0,0,1
8782,0,0,0,1,1
8783,0,1,0,0,1
8784,0,1,0,0,1
8785,1,0,0,0,1
8786,0,1,0,0,1
8787,0,1,0,0,1
8788,0,1,0,0,1
8789,0,1,0,0,1
8790,0,1,0,0,1
8791,0,1,0,0,1
8792,0,1,0,0,1
8793,0,0,0,1,1
8794,0,1,0,0,1
8795,0,1,0,0,1
8796,0,1,0,0,1
8797,1,0,0,0,1
8798,0,1,0,0,1
8799,0,1,0,0,1
8800,1,0,0,0,1
8801,0,1,0,0,1
8802,0,1,0,0,1
8803,1,0,0,0,1
8804,1,0,0,0,1
8805,0,1,0,0,1
8806,0,1,0,0,1
8807,0,0,1,0,1
8808,0,1,0,0,1
8809,0,1,0,0,1
8810,1,0,0,0,1
8811,0,1,0,0,1
8812,0,1,0,0,1
8813,0,1,0,0,1
8814,0,1,0,0,1
8815,0,1,0,0,1
8816,1,0,0,0,1
8817,0,1,0,0,1
8818,0,1,0,0,1
8819,0,1,0,0,1
8820,0,1,0,0,1
8821,0,1,0,0,1
8822,0,1,0,0,1
8823,0,1,0,0,1
8824,0,1,0,0,1
8825,0,1,0,0,1
8826,0,1,0,0,1
8827,0,1,0,0,1
8828,0,1,0,0,1
8829,0,1,0,0,1
8830,0,1,0,0,1
8831,1,0,0,0,1
8832,1,0,0,0,1
8833,0,1,0,0,1
8834,1,0,0,0,1
8835,1,0,0,0,1
8836,1,0,0,0,1
8837,1,0,0,0,1
8838,0,1,0,0,1
8839,0,1,0,0,1
8840,1,0,0,0,1
8841,0,1,0,0,1
8842,0,1,0,0,1
8843,0,1,0,0,1
8844,0,1,0,0,1
8845,0,1,0,0,1
8846,0,1,0,0,1
8847,1,0,0,0,1
8848,0,1,0,0,1
8849,0,1,0,0,1
8850,0,1,0,0,1
8851,0,1,0,0,1
8852,0,1,0,0,1
8853,0,1,0,0,1
8854,0,1,0,0,1
8855,0,1,0,0,1
8856,0,0,1,0,1
8857,0,1,0,0,1
8858,1,0,0,0,1
8859,0,1,0,0,1
8860,0,1,0,0,1
8861,0,1,0,0,1
8862,1,0,0,0,1
8863,0,1,0,0,1
8864,0,1,0,0,1
8865,0,1,0,0,1
8866,0,1,0,0,1
8867,0,1,0,0,1
8868,0,1,0,0,1
8869,0,1,0,0,1
8870,1,0,0,0,1
8871,0,1,0,0,1
8872,0,1,0,0,1
8873,0,1,0,0,1
8874,0,1,0,0,1
8875,0,1,0,0,1
8876,0,1,0,0,1
8877,0,1,0,0,1
8878,0,1,0,0,1
8879,0,1,0,0,1
8880,0,1,0,0,1
8881,0,1,0,0,1
8882,0,1,0,0,1
8883,0,1,0,0,1
8884,1,0,0,0,1
8885,0,1,0,0,1
8886,0,1,0,0,1
8887,0,1,0,0,1
8888,0,1,0,0,1
8889,0,1,0,0,1
8890,0,1,0,0,1
8891,0,1,0,0,1
8892,0,1,0,0,1
8893,0,1,0,0,1
8894,0,1,0,0,1
8895,0,1,0,0,1
8896,1,0,0,0,1
8897,0,1,0,0,1
8898,0,1,0,0,1
8899,0,0,0,1,1
8900,0,1,0,0,1
8901,1,0,0,0,1
8902,0,0,1,0,1
8903,0,1,0,0,1
8904,1,0,0,0,1
8905,0,1,0,0,1
8906,0,1,0,0,1
8907,0,1,0,0,1
8908,0,1,0,0,1
8909,0,1,0,0,1
8910,0,1,0,0,1
8911,0,1,0,0,1
8912,0,1,0,0,1
8913,0,1,0,0,1
8914,1,0,0,0,1
8915,0,1,0,0,1
8916,0,1,0,0,1
8917,0,1,0,0,1
8918,0,1,0,0,1
8919,0,1,0,0,1
8920,0,0,0,1,1
8921,0,1,0,0,1
8922,0,1,0,0,1
8923,0,1,0,0,1
8924,0,1,0,0,1
8925,1,0,0,0,1
8926,0,1,0,0,1
8927,0,1,0,0,1
8928,0,1,0,0,1
8929,1,0,0,0,1
8930,0,1,0,0,1
8931,0,0,0,1,1
8932,0,1,0,0,1
8933,0,0,0,1,1
8934,0,1,0,0,1
8935,0,1,0,0,1
8936,0,1,0,0,1
8937,0,1,0,0,1
8938,0,1,0,0,1
8939,0,1,0,0,1
8940,0,1,0,0,1
8941,0,1,0,0,1
8942,1,0,0,0,1
8943,0,1,0,0,1
8944,1,0,0,0,1
8945,0,1,0,0,1
8946,0,1,0,0,1
8947,0,0,0,1,1
8948,0,1,0,0,1
8949,0,1,0,0,1
8950,0,1,0,0,1
8951,0,1,0,0,1
8952,0,1,0,0,1
8953,0,1,0,0,1
8954,0,1,0,0,1
8955,0,1,0,0,1
8956,0,1,0,0,1
8957,0,1,0,0,1
8958,0,1,0,0,1
8959,0,1,0,0,1
8960,1,0,0,0,1
8961,1,0,0,0,1
8962,0,1,0,0,1
8963,0,1,0,0,1
8964,0,1,0,0,1
8965,0,1,0,0,1
8966,0,1,0,0,1
8967,0,1,0,0,1
8968,0,1,0,0,1
8969,0,1,0,0,1
8970,0,1,0,0,1
8971,1,0,0,0,1
8972,0,1,0,0,1
8973,1,0,0,0,1
8974,0,1,0,0,1
8975,0,1,0,0,1
8976,0,1,0,0,1
8977,1,0,0,0,1
8978,0,1,0,0,1
8979,1,0,0,0,1
8980,0,1,0,0,1
8981,0,1,0,0,1
8982,0,1,0,0,1
8983,0,1,0,0,1
8984,0,1,0,0,1
8985,0,1,0,0,1
8986,0,1,0,0,1
8987,0,1,0,0,1
8988,0,1,0,0,1
8989,0,1,0,0,1
8990,0,1,0,0,1
8991,0,1,0,0,1
8992,0,1,0,0,1
8993,1,0,0,0,1
8994,0,1,0,0,1
8995,0,1,0,0,1
8996,0,1,0,0,1
8997,0,1,0,0,1
8998,1,0,0,0,1
8999,0,1,0,0,1
9000,0,1,0,0,1
9001,0,1,0,0,1
9002,0,1,0,0,1
9003,1,0,0,0,1
9004,1,0,0,0,1
9005,0,1,0,0,1
9006,0,1,0,0,1
9007,0,1,0,0,1
9008,0,1,0,0,1
9009,0,1,0,0,1
9010,0,1,0,0,1
9011,1,0,0,0,1
9012,0,1,0,0,1
9013,0,1,0,0,1
9014,1,0,0,0,1
9015,0,1,0,0,1
9016,0,1,0,0,1
9017,0,1,0,0,1
9018,0,1,0,0,1
9019,0,1,0,0,1
9020,0,1,0,0,1
9021,0,1,0,0,1
9022,0,1,0,0,1
9023,0,1,0,0,1
9024,1,0,0,0,1
9025,0,1,0,0,1
9026,0,1,0,0,1
9027,1,0,0,0,1
9028,0,1,0,0,1
9029,0,1,0,0,1
9030,0,1,0,0,1
9031,0,1,0,0,1
9032,0,1,0,0,1
9033,0,1,0,0,1
9034,0,1,0,0,1
9035,0,1,0,0,1
9036,0,1,0,0,1
9037,0,1,0,0,1
9038,0,1,0,0,1
9039,0,1,0,0,1
9040,0,1,0,0,1
9041,1,0,0,0,1
9042,0,1,0,0,1
9043,0,1,0,0,1
9044,0,1,0,0,1
9045,0,1,0,0,1
9046,0,1,0,0,1
9047,0,1,0,0,1
9048,0,1,0,0,1
9049,0,1,0,0,1
9050,0,1,0,0,1
9051,0,1,0,0,1
9052,0,1,0,0,1
9053,1,0,0,0,1
9054,0,1,0,0,1
9055,0,1,0,0,1
9056,0,1,0,0,1
9057,0,1,0,0,1
9058,0,1,0,0,1
9059,0,1,0,0,1
9060,0,1,0,0,1
9061,0,1,0,0,1
9062,1,0,0,0,1
9063,1,0,0,0,1
9064,0,1,0,0,1
9065,1,0,0,0,1
9066,0,0,0,1,1
9067,0,1,0,0,1
9068,0,1,0,0,1
9069,1,0,0,0,1
9070,0,1,0,0,1
9071,0,1,0,0,1
9072,1,0,0,0,1
9073,0,1,0,0,1
9074,0,1,0,0,1
9075,0,1,0,0,1
9076,0,1,0,0,1
9077,1,0,0,0,1
9078,0,1,0,0,1
9079,0,1,0,0,1
9080,0,1,0,0,1
9081,0,1,0,0,1
9082,0,1,0,0,1
9083,0,0,1,0,1
9084,0,1,0,0,1
9085,0,1,0,0,1
9086,0,1,0,0,1
9087,0,1,0,0,1
9088,0,1,0,0,1
9089,0,1,0,0,1
9090,0,1,0,0,1
9091,0,1,0,0,1
9092,0,1,0,0,1
9093,0,1,0,0,1
9094,0,0,1,0,1
9095,0,1,0,0,1
9096,0,1,0,0,1
9097,0,1,0,0,1
9098,0,1,0,0,1
9099,0,1,0,0,1
9100,0,1,0,0,1
9101,0,1,0,0,1
9102,0,1,0,0,1
9103,0,1,0,0,1
9104,0,1,0,0,1
9105,1,0,0,0,1
9106,1,0,0,0,1
9107,1,0,0,0,1
9108,0,1,0,0,1
9109,0,1,0,0,1
9110,0,1,0,0,1
9111,1,0,0,0,1
9112,0,1,0,0,1
9113,1,0,0,0,1
9114,0,1,0,0,1
9115,1,0,0,0,1
9116,1,0,0,0,1
9117,0,1,0,0,1
9118,1,0,0,0,1
9119,0,1,0,0,1
9120,0,1,0,0,1
9121,0,1,0,0,1
9122,0,1,0,0,1
9123,0,1,0,0,1
9124,0,1,0,0,1
9125,0,1,0,0,1
9126,1,0,0,0,1
9127,0,1,0,0,1
9128,0,1,0,0,1
9129,0,1,0,0,1
9130,0,1,0,0,1
9131,0,1,0,0,1
9132,0,1,0,0,1
9133,0,1,0,0,1
9134,0,1,0,0,1
9135,0,1,0,0,1
9136,0,1,0,0,1
9137,0,1,0,0,1
9138,0,1,0,0,1
9139,0,1,0,0,1
9140,0,1,0,0,1
9141,0,1,0,0,1
9142,0,1,0,0,1
9143,0,1,0,0,1
9144,0,1,0,0,1
9145,0,1,0,0,1
9146,0,1,0,0,1
9147,1,0,0,0,1
9148,0,1,0,0,1
9149,0,1,0,0,1
9150,0,1,0,0,1
9151,0,1,0,0,1
9152,0,1,0,0,1
9153,0,1,0,0,1
9154,0,1,0,0,1
9155,1,0,0,0,1
9156,1,0,0,0,1
9157,1,0,0,0,1
9158,0,1,0,0,1
9159,0,1,0,0,1
9160,0,1,0,0,1
9161,1,0,0,0,1
9162,0,1,0,0,1
9163,0,1,0,0,1
9164,0,1,0,0,1
9165,0,1,0,0,1
9166,0,0,0,1,1
9167,0,1,0,0,1
9168,1,0,0,0,1
9169,0,0,0,1,1
9170,1,0,0,0,1
9171,0,1,0,0,1
9172,1,0,0,0,1
9173,0,0,1,0,1
9174,0,1,0,0,1
9175,1,0,0,0,1
9176,0,1,0,0,1
9177,0,1,0,0,1
9178,0,1,0,0,1
9179,0,1,0,0,1
9180,0,1,0,0,1
9181,0,1,0,0,1
9182,0,1,0,0,1
9183,1,0,0,0,1
9184,0,0,0,1,1
9185,0,1,0,0,1
9186,0,1,0,0,1
9187,0,1,0,0,1
9188,0,1,0,0,1
9189,0,1,0,0,1
9190,0,1,0,0,1
9191,0,1,0,0,1
9192,0,1,0,0,1
9193,1,0,0,0,1
9194,0,1,0,0,1
9195,0,1,0,0,1
9196,0,1,0,0,1
9197,1,0,0,0,1
9198,0,1,0,0,1
9199,0,1,0,0,1
9200,0,1,0,0,1
9201,1,0,0,0,1
9202,0,1,0,0,1
9203,0,1,0,0,1
9204,1,0,0,0,1
9205,0,1,0,0,1
9206,0,1,0,0,1
9207,0,1,0,0,1
9208,0,1,0,0,1
9209,1,0,0,0,1
9210,0,1,0,0,1
9211,0,1,0,0,1
9212,0,1,0,0,1
9213,0,1,0,0,1
9214,0,1,0,0,1
9215,0,0,1,0,1
9216,0,1,0,0,1
9217,0,1,0,0,1
9218,0,1,0,0,1
9219,0,1,0,0,1
9220,0,1,0,0,1
9221,0,1,0,0,1
9222,0,1,0,0,1
9223,1,0,0,0,1
9224,0,1,0,0,1
9225,0,1,0,0,1
9226,0,1,0,0,1
9227,0,1,0,0,1
9228,0,1,0,0,1
9229,0,1,0,0,1
9230,0,1,0,0,1
9231,0,1,0,0,1
9232,0,1,0,0,1
9233,0,1,0,0,1
9234,0,1,0,0,1
9235,0,1,0,0,1
9236,0,1,0,0,1
9237,0,1,0,0,1
9238,0,1,0,0,1
9239,0,1,0,0,1
9240,0,1,0,0,1
9241,0,1,0,0,1
9242,1,0,0,0,1
9243,0,1,0,0,1
9244,0,1,0,0,1
9245,0,1,0,0,1
9246,0,0,1,0,1
9247,0,1,0,0,1
9248,0,1,0,0,1
9249,1,0,0,0,1
9250,0,1,0,0,1
9251,1,0,0,0,1
9252,0,1,0,0,1
9253,1,0,0,0,1
9254,0,1,0,0,1
9255,1,0,0,0,1
9256,0,1,0,0,1
9257,0,1,0,0,1
9258,0,1,0,0,1
9259,0,1,0,0,1
9260,0,1,0,0,1
9261,1,0,0,0,1
9262,0,1,0,0,1
9263,0,1,0,0,1
9264,0,1,0,0,1
9265,1,0,0,0,1
9266,0,1,0,0,1
9267,0,1,0,0,1
9268,0,1,0,0,1
9269,0,1,0,0,1
9270,0,1,0,0,1
9271,0,0,1,0,1
9272,0,1,0,0,1
9273,0,1,0,0,1
9274,0,1,0,0,1
9275,1,0,0,0,1
9276,0,1,0,0,1
9277,0,1,0,0,1
9278,0,1,0,0,1
9279,0,1,0,0,1
9280,0,1,0,0,1
9281,0,1,0,0,1
9282,0,1,0,0,1
9283,0,0,0,1,1
9284,0,1,0,0,1
9285,0,1,0,0,1
9286,0,1,0,0,1
9287,0,1,0,0,1
9288,0,1,0,0,1
9289,0,1,0,0,1
9290,0,1,0,0,1
9291,1,0,0,0,1
9292,0,1,0,0,1
9293,1,0,0,0,1
9294,0,1,0,0,1
9295,0,1,0,0,1
9296,0,1,0,0,1
9297,0,1,0,0,1
9298,0,1,0,0,1
9299,1,0,0,0,1
9300,0,1,0,0,1
9301,0,1,0,0,1
9302,0,1,0,0,1
9303,0,1,0,0,1
9304,1,0,0,0,1
9305,0,1,0,0,1
9306,0,1,0,0,1
9307,0,1,0,0,1
9308,0,1,0,0,1
9309,0,1,0,0,1
9310,0,1,0,0,1
9311,0,1,0,0,1
9312,0,1,0,0,1
9313,0,1,0,0,1
9314,1,0,0,0,1
9315,0,1,0,0,1
9316,0,1,0,0,1
9317,0,0,1,0,1
9318,0,1,0,0,1
9319,1,0,0,0,1
9320,0,1,0,0,1
9321,0,1,0,0,1
9322,0,1,0,0,1
9323,0,1,0,0,1
9324,0,0,0,1,1
9325,0,1,0,0,1
9326,0,1,0,0,1
9327,0,1,0,0,1
9328,0,1,0,0,1
9329,0,1,0,0,1
9330,0,1,0,0,1
9331,0,1,0,0,1
9332,0,1,0,0,1
9333,0,1,0,0,1
9334,0,1,0,0,1
9335,0,1,0,0,1
9336,0,1,0,0,1
9337,0,1,0,0,1
9338,0,1,0,0,1
9339,0,0,0,1,1
9340,1,0,0,0,1
9341,0,1,0,0,1
9342,1,0,0,0,1
9343,0,1,0,0,1
9344,1,0,0,0,1
9345,0,1,0,0,1
9346,1,0,0,0,1
9347,1,0,0,0,1
9348,0,1,0,0,1
9349,0,1,0,0,1
9350,0,1,0,0,1
9351,0,1,0,0,1
9352,0,1,0,0,1
9353,0,1,0,0,1
9354,0,0,0,1,1
9355,1,0,0,0,1
9356,0,1,0,0,1
9357,0,1,0,0,1
9358,0,1,0,0,1
9359,0,1,0,0,1
9360,0,1,0,0,1
9361,0,1,0,0,1
9362,0,1,0,0,1
9363,0,1,0,0,1
9364,0,1,0,0,1
9365,0,1,0,0,1
9366,0,1,0,0,1
9367,0,1,0,0,1
9368,0,1,0,0,1
9369,0,1,0,0,1
9370,0,1,0,0,1
9371,1,0,0,0,1
9372,1,0,0,0,1
9373,0,1,0,0,1
9374,0,1,0,0,1
9375,0,1,0,0,1
9376,0,1,0,0,1
9377,0,1,0,0,1
9378,1,0,0,0,1
9379,0,1,0,0,1
9380,0,1,0,0,1
9381,0,1,0,0,1
9382,1,0,0,0,1
9383,0,1,0,0,1
9384,1,0,0,0,1
9385,1,0,0,0,1
9386,0,1,0,0,1
9387,0,1,0,0,1
9388,0,1,0,0,1
9389,0,1,0,0,1
9390,0,1,0,0,1
9391,0,1,0,0,1
9392,0,1,0,0,1
9393,0,1,0,0,1
9394,0,1,0,0,1
9395,0,1,0,0,1
9396,1,0,0,0,1
9397,0,1,0,0,1
9398,0,1,0,0,1
9399,0,1,0,0,1
9400,0,1,0,0,1
9401,0,1,0,0,1
9402,0,1,0,0,1
9403,0,1,0,0,1
9404,0,1,0,0,1
9405,0,1,0,0,1
9406,0,1,0,0,1
9407,0,1,0,0,1
9408,0,1,0,0,1
9409,0,1,0,0,1
9410,0,1,0,0,1
9411,0,1,0,0,1
9412,0,1,0,0,1
9413,1,0,0,0,1
9414,0,1,0,0,1
9415,0,1,0,0,1
9416,0,1,0,0,1
9417,0,1,0,0,1
9418,0,1,0,0,1
9419,0,1,0,0,1
9420,0,1,0,0,1
9421,0,1,0,0,1
9422,0,1,0,0,1
9423,0,1,0,0,1
9424,0,1,0,0,1
9425,0,1,0,0,1
9426,1,0,0,0,1
9427,0,1,0,0,1
9428,1,0,0,0,1
9429,1,0,0,0,1
9430,0,1,0,0,1
9431,0,1,0,0,1
9432,0,1,0,0,1
9433,0,1,0,0,1
9434,1,0,0,0,1
9435,1,0,0,0,1
9436,1,0,0,0,1
9437,0,1,0,0,1
9438,0,1,0,0,1
9439,0,1,0,0,1
9440,0,1,0,0,1
9441,0,1,0,0,1
9442,1,0,0,0,1
9443,0,1,0,0,1
9444,0,1,0,0,1
9445,1,0,0,0,1
9446,0,1,0,0,1
9447,0,1,0,0,1
9448,0,1,0,0,1
9449,0,1,0,0,1
9450,1,0,0,0,1
9451,0,1,0,0,1
9452,1,0,0,0,1
9453,0,0,1,0,1
9454,0,1,0,0,1
9455,0,1,0,0,1
9456,0,1,0,0,1
9457,0,1,0,0,1
9458,1,0,0,0,1
9459,1,0,0,0,1
9460,0,1,0,0,1
9461,0,1,0,0,1
9462,0,1,0,0,1
9463,1,0,0,0,1
9464,0,1,0,0,1
9465,1,0,0,0,1
9466,0,1,0,0,1
9467,1,0,0,0,1
9468,0,1,0,0,1
9469,1,0,0,0,1
9470,0,1,0,0,1
9471,1,0,0,0,1
9472,0,0,0,1,1
9473,0,1,0,0,1
9474,0,1,0,0,1
9475,0,1,0,0,1
9476,0,1,0,0,1
9477,0,1,0,0,1
9478,1,0,0,0,1
9479,0,1,0,0,1
9480,0,1,0,0,1
9481,1,0,0,0,1
9482,0,1,0,0,1
9483,0,1,0,0,1
9484,0,1,0,0,1
9485,0,1,0,0,1
9486,0,1,0,0,1
9487,0,1,0,0,1
9488,0,1,0,0,1
9489,0,1,0,0,1
9490,0,1,0,0,1
9491,0,1,0,0,1
9492,0,0,0,1,1
9493,0,1,0,0,1
9494,0,1,0,0,1
9495,0,1,0,0,1
9496,0,1,0,0,1
9497,0,1,0,0,1
9498,0,1,0,0,1
9499,0,1,0,0,1
9500,0,1,0,0,1
9501,0,1,0,0,1
9502,0,1,0,0,1
9503,1,0,0,0,1
9504,0,1,0,0,1
9505,1,0,0,0,1
9506,0,1,0,0,1
9507,0,1,0,0,1
9508,0,1,0,0,1
9509,0,1,0,0,1
9510,0,1,0,0,1
9511,1,0,0,0,1
9512,0,1,0,0,1
9513,0,1,0,0,1
9514,1,0,0,0,1
9515,1,0,0,0,1
9516,0,1,0,0,1
9517,1,0,0,0,1
9518,0,1,0,0,1
9519,0,1,0,0,1
9520,0,1,0,0,1
9521,0,1,0,0,1
9522,0,1,0,0,1
9523,0,1,0,0,1
9524,1,0,0,0,1
9525,0,1,0,0,1
9526,0,1,0,0,1
9527,0,1,0,0,1
9528,0,1,0,0,1
9529,0,1,0,0,1
9530,1,0,0,0,1
9531,0,1,0,0,1
9532,0,1,0,0,1
9533,0,1,0,0,1
9534,1,0,0,0,1
9535,0,1,0,0,1
9536,0,0,0,1,1
9537,0,0,1,0,1
9538,0,1,0,0,1
9539,0,1,0,0,1
9540,0,1,0,0,1
9541,0,1,0,0,1
9542,0,1,0,0,1
9543,0,1,0,0,1
9544,0,1,0,0,1
9545,0,1,0,0,1
9546,0,1,0,0,1
9547,0,1,0,0,1
9548,0,1,0,0,1
9549,0,1,0,0,1
9550,0,1,0,0,1
9551,0,1,0,0,1
9552,0,1,0,0,1
9553,0,1,0,0,1
9554,0,1,0,0,1
9555,0,1,0,0,1
9556,0,1,0,0,1
9557,0,1,0,0,1
9558,0,1,0,0,1
9559,0,1,0,0,1
9560,0,0,0,1,1
9561,0,1,0,0,1
9562,0,1,0,0,1
9563,0,1,0,0,1
9564,0,1,0,0,1
9565,0,0,0,1,1
9566,0,1,0,0,1
9567,0,1,0,0,1
9568,0,1,0,0,1
9569,1,0,0,0,1
9570,0,1,0,0,1
9571,0,1,0,0,1
9572,1,0,0,0,1
9573,0,1,0,0,1
9574,0,1,0,0,1
9575,1,0,0,0,1
9576,0,1,0,0,1
9577,0,1,0,0,1
9578,0,1,0,0,1
9579,0,1,0,0,1
9580,0,1,0,0,1
9581,0,1,0,0,1
9582,0,1,0,0,1
9583,0,1,0,0,1
9584,0,1,0,0,1
9585,0,1,0,0,1
9586,0,1,0,0,1
9587,0,1,0,0,1
9588,0,1,0,0,1
9589,0,1,0,0,1
9590,0,1,0,0,1
9591,1,0,0,0,1
9592,0,1,0,0,1
9593,1,0,0,0,1
9594,1,0,0,0,1
9595,1,0,0,0,1
9596,0,1,0,0,1
9597,0,1,0,0,1
9598,1,0,0,0,1
9599,1,0,0,0,1
9600,0,1,0,0,1
9601,0,1,0,0,1
9602,1,0,0,0,1
9603,0,1,0,0,1
9604,0,1,0,0,1
9605,0,1,0,0,1
9606,0,1,0,0,1
9607,0,1,0,0,1
9608,0,1,0,0,1
9609,0,1,0,0,1
9610,0,1,0,0,1
9611,1,0,0,0,1
9612,0,1,0,0,1
9613,0,1,0,0,1
9614,0,1,0,0,1
9615,1,0,0,0,1
9616,0,1,0,0,1
9617,0,1,0,0,1
9618,0,1,0,0,1
9619,0,1,0,0,1
9620,1,0,0,0,1
9621,0,1,0,0,1
9622,0,1,0,0,1
9623,0,0,0,1,1
9624,0,1,0,0,1
9625,0,1,0,0,1
9626,1,0,0,0,1
9627,0,1,0,0,1
9628,0,1,0,0,1
9629,0,1,0,0,1
9630,1,0,0,0,1
9631,0,1,0,0,1
9632,1,0,0,0,1
9633,1,0,0,0,1
9634,0,1,0,0,1
9635,0,1,0,0,1
9636,0,1,0,0,1
9637,0,1,0,0,1
9638,1,0,0,0,1
9639,0,1,0,0,1
9640,0,1,0,0,1
9641,0,1,0,0,1
9642,0,1,0,0,1
9643,0,1,0,0,1
9644,1,0,0,0,1
9645,1,0,0,0,1
9646,0,1,0,0,1
9647,0,1,0,0,1
9648,0,1,0,0,1
9649,0,1,0,0,1
9650,1,0,0,0,1
9651,0,1,0,0,1
9652,0,1,0,0,1
9653,0,1,0,0,1
9654,0,1,0,0,1
9655,0,1,0,0,1
9656,0,1,0,0,1
9657,0,1,0,0,1
9658,1,0,0,0,1
9659,0,1,0,0,1
9660,0,1,0,0,1
9661,0,1,0,0,1
9662,0,1,0,0,1
9663,0,0,0,1,1
9664,0,1,0,0,1
9665,0,1,0,0,1
9666,1,0,0,0,1
9667,0,1,0,0,1
9668,0,1,0,0,1
9669,0,1,0,0,1
9670,0,1,0,0,1
9671,0,1,0,0,1
9672,0,1,0,0,1
9673,0,1,0,0,1
9674,0,1,0,0,1
9675,0,1,0,0,1
9676,0,1,0,0,1
9677,0,1,0,0,1
9678,0,1,0,0,1
9679,0,1,0,0,1
9680,0,1,0,0,1
9681,1,0,0,0,1
9682,0,1,0,0,1
9683,0,1,0,0,1
9684,0,1,0,0,1
9685,1,0,0,0,1
9686,0,1,0,0,1
9687,1,0,0,0,1
9688,0,1,0,0,1
9689,0,1,0,0,1
9690,1,0,0,0,1
9691,0,1,0,0,1
9692,0,1,0,0,1
9693,0,1,0,0,1
9694,0,1,0,0,1
9695,0,1,0,0,1
9696,0,1,0,0,1
9697,0,1,0,0,1
9698,1,0,0,0,1
9699,0,1,0,0,1
9700,0,1,0,0,1
9701,1,0,0,0,1
9702,1,0,0,0,1
9703,0,1,0,0,1
9704,0,1,0,0,1
9705,1,0,0,0,1
9706,0,0,0,1,1
9707,0,1,0,0,1
9708,0,1,0,0,1
9709,0,1,0,0,1
9710,0,1,0,0,1
9711,1,0,0,0,1
9712,1,0,0,0,1
9713,0,1,0,0,1
9714,0,1,0,0,1
9715,0,1,0,0,1
9716,0,1,0,0,1
9717,0,1,0,0,1
9718,1,0,0,0,1
9719,0,1,0,0,1
9720,1,0,0,0,1
9721,0,1,0,0,1
9722,0,1,0,0,1
9723,0,1,0,0,1
9724,1,0,0,0,1
9725,0,1,0,0,1
9726,0,1,0,0,1
9727,0,1,0,0,1
9728,0,1,0,0,1
9729,0,1,0,0,1
9730,1,0,0,0,1
9731,0,1,0,0,1
9732,0,1,0,0,1
9733,0,1,0,0,1
9734,0,1,0,0,1
9735,0,1,0,0,1
9736,1,0,0,0,1
9737,1,0,0,0,1
9738,0,1,0,0,1
9739,1,0,0,0,1
9740,0,1,0,0,1
9741,0,1,0,0,1
9742,0,1,0,0,1
9743,1,0,0,0,1
9744,0,0,0,1,1
9745,0,1,0,0,1
9746,0,1,0,0,1
9747,0,1,0,0,1
9748,1,0,0,0,1
9749,0,0,1,0,1
9750,0,1,0,0,1
9751,0,1,0,0,1
9752,0,1,0,0,1
9753,0,1,0,0,1
9754,0,1,0,0,1
9755,0,1,0,0,1
9756,0,1,0,0,1
9757,0,1,0,0,1
9758,1,0,0,0,1
9759,0,1,0,0,1
9760,1,0,0,0,1
9761,0,0,0,1,1
9762,0,1,0,0,1
9763,1,0,0,0,1
9764,1,0,0,0,1
9765,1,0,0,0,1
9766,0,1,0,0,1
9767,1,0,0,0,1
9768,0,1,0,0,1
9769,0,1,0,0,1
9770,0,1,0,0,1
9771,0,1,0,0,1
9772,0,1,0,0,1
9773,0,1,0,0,1
9774,0,1,0,0,1
9775,1,0,0,0,1
9776,0,1,0,0,1
9777,1,0,0,0,1
9778,0,1,0,0,1
9779,0,1,0,0,1
9780,0,1,0,0,1
9781,0,1,0,0,1
9782,0,1,0,0,1
9783,0,1,0,0,1
9784,1,0,0,0,1
9785,0,1,0,0,1
9786,1,0,0,0,1
9787,0,1,0,0,1
9788,0,1,0,0,1
9789,1,0,0,0,1
9790,0,1,0,0,1
9791,0,1,0,0,1
9792,0,1,0,0,1
9793,1,0,0,0,1
9794,0,1,0,0,1
9795,1,0,0,0,1
9796,0,1,0,0,1
9797,0,1,0,0,1
9798,0,1,0,0,1
9799,1,0,0,0,1
9800,1,0,0,0,1
9801,0,1,0,0,1
9802,0,1,0,0,1
9803,1,0,0,0,1
9804,1,0,0,0,1
9805,0,1,0,0,1
9806,0,1,0,0,1
9807,0,1,0,0,1
9808,1,0,0,0,1
9809,0,1,0,0,1
9810,0,1,0,0,1
9811,1,0,0,0,1
9812,1,0,0,0,1
9813,0,1,0,0,1
9814,0,1,0,0,1
9815,0,1,0,0,1
9816,0,1,0,0,1
9817,0,1,0,0,1
9818,0,1,0,0,1
9819,0,1,0,0,1
9820,0,1,0,0,1
9821,1,0,0,0,1
9822,0,1,0,0,1
9823,0,1,0,0,1
9824,0,1,0,0,1
9825,1,0,0,0,1
9826,0,1,0,0,1
9827,0,1,0,0,1
9828,1,0,0,0,1
9829,0,1,0,0,1
9830,0,1,0,0,1
9831,0,1,0,0,1
9832,1,0,0,0,1
9833,0,1,0,0,1
9834,0,1,0,0,1
9835,0,1,0,0,1
9836,0,1,0,0,1
9837,0,1,0,0,1
9838,0,1,0,0,1
9839,1,0,0,0,1
9840,1,0,0,0,1
9841,1,0,0,0,1
9842,0,1,0,0,1
9843,0,1,0,0,1
9844,0,1,0,0,1
9845,1,0,0,0,1
9846,0,1,0,0,1
9847,0,0,1,0,1
9848,1,0,0,0,1
9849,0,1,0,0,1
9850,0,1,0,0,1
9851,0,1,0,0,1
9852,0,1,0,0,1
9853,0,1,0,0,1
9854,0,1,0,0,1
9855,0,1,0,0,1
9856,0,1,0,0,1
9857,0,1,0,0,1
9858,0,1,0,0,1
9859,0,1,0,0,1
9860,1,0,0,0,1
9861,0,0,0,1,1
9862,1,0,0,0,1
9863,0,1,0,0,1
9864,1,0,0,0,1
9865,0,1,0,0,1
9866,0,1,0,0,1
9867,0,1,0,0,1
9868,0,1,0,0,1
9869,1,0,0,0,1
9870,0,1,0,0,1
9871,0,0,1,0,1
9872,0,1,0,0,1
9873,0,1,0,0,1
9874,0,1,0,0,1
9875,1,0,0,0,1
9876,0,1,0,0,1
9877,0,1,0,0,1
9878,0,1,0,0,1
9879,0,1,0,0,1
9880,1,0,0,0,1
9881,0,1,0,0,1
9882,0,1,0,0,1
9883,0,1,0,0,1
9884,0,1,0,0,1
9885,1,0,0,0,1
9886,1,0,0,0,1
9887,0,1,0,0,1
9888,0,1,0,0,1
9889,0,1,0,0,1
9890,1,0,0,0,1
9891,0,1,0,0,1
9892,1,0,0,0,1
9893,0,1,0,0,1
9894,0,1,0,0,1
9895,1,0,0,0,1
9896,0,1,0,0,1
9897,0,1,0,0,1
9898,0,1,0,0,1
9899,0,1,0,0,1
9900,0,1,0,0,1
9901,0,1,0,0,1
9902,0,1,0,0,1
9903,0,1,0,0,1
9904,0,1,0,0,1
9905,1,0,0,0,1
9906,1,0,0,0,1
9907,0,1,0,0,1
9908,1,0,0,0,1
9909,0,1,0,0,1
9910,0,1,0,0,1
9911,0,1,0,0,1
9912,1,0,0,0,1
9913,1,0,0,0,1
9914,1,0,0,0,1
9915,0,1,0,0,1
9916,0,1,0,0,1
9917,0,1,0,0,1
9918,0,1,0,0,1
9919,0,1,0,0,1
9920,0,1,0,0,1
9921,0,0,0,1,1
9922,0,1,0,0,1
9923,0,1,0,0,1
9924,0,1,0,0,1
9925,0,1,0,0,1
9926,0,1,0,0,1
9927,0,1,0,0,1
9928,1,0,0,0,1
9929,0,1,0,0,1
9930,0,1,0,0,1
9931,0,1,0,0,1
9932,0,1,0,0,1
9933,0,1,0,0,1
9934,0,1,0,0,1
9935,0,1,0,0,1
9936,0,1,0,0,1
9937,0,0,1,0,1
9938,0,1,0,0,1
9939,0,1,0,0,1
9940,0,1,0,0,1
9941,0,1,0,0,1
9942,0,0,1,0,1
9943,0,1,0,0,1
9944,0,1,0,0,1
9945,0,1,0,0,1
9946,0,1,0,0,1
9947,0,0,0,1,1
9948,0,1,0,0,1
9949,1,0,0,0,1
9950,1,0,0,0,1
9951,1,0,0,0,1
9952,0,1,0,0,1
9953,0,1,0,0,1
9954,1,0,0,0,1
9955,1,0,0,0,1
9956,0,1,0,0,1
9957,0,1,0,0,1
9958,1,0,0,0,1
9959,0,1,0,0,1
9960,0,1,0,0,1
9961,0,1,0,0,1
9962,0,1,0,0,1
9963,0,1,0,0,1
9964,0,1,0,0,1
9965,0,1,0,0,1
9966,1,0,0,0,1
9967,0,1,0,0,1
9968,0,1,0,0,1
9969,0,1,0,0,1
9970,0,0,1,0,1
9971,0,1,0,0,1
9972,0,1,0,0,1
9973,0,1,0,0,1
9974,0,1,0,0,1
9975,0,0,0,1,1
9976,0,1,0,0,1
9977,0,1,0,0,1
9978,0,1,0,0,1
9979,0,1,0,0,1
9980,0,1,0,0,1
9981,0,1,0,0,1
9982,0,1,0,0,1
9983,0,0,0,1,1
9984,0,1,0,0,1
9985,0,1,0,0,1
9986,0,1,0,0,1
9987,1,0,0,0,1
9988,0,1,0,0,1
9989,0,1,0,0,1
9990,0,1,0,0,1
9991,0,1,0,0,1
9992,1,0,0,0,1
9993,0,1,0,0,1
9994,0,1,0,0,1
9995,1,0,0,0,1
9996,0,1,0,0,1
9997,0,1,0,0,1
9998,0,1,0,0,1
9999,0,1,0,0,1
10000,0,1,0,0,1
10001,0,1,0,0,1
10002,1,0,0,0,1
10003,1,0,0,0,1
10004,0,1,0,0,1
10005,0,1,0,0,1
10006,0,1,0,0,1
10007,0,1,0,0,1
10008,0,1,0,0,1
10009,1,0,0,0,1
10010,0,1,0,0,1
10011,0,1,0,0,1
10012,0,1,0,0,1
10013,0,1,0,0,1
10014,1,0,0,0,1
10015,1,0,0,0,1
10016,0,1,0,0,1
10017,1,0,0,0,1
10018,0,1,0,0,1
10019,0,1,0,0,1
10020,0,1,0,0,1
10021,0,1,0,0,1
10022,0,1,0,0,1
10023,0,1,0,0,1
10024,0,1,0,0,1
10025,0,1,0,0,1
10026,0,1,0,0,1
10027,0,1,0,0,1
10028,0,0,0,1,1
10029,0,1,0,0,1
10030,0,1,0,0,1
10031,1,0,0,0,1
10032,0,1,0,0,1
10033,0,1,0,0,1
10034,0,1,0,0,1
10035,0,1,0,0,1
10036,1,0,0,0,1
10037,0,1,0,0,1
10038,0,1,0,0,1
10039,0,0,1,0,1
10040,0,1,0,0,1
10041,0,1,0,0,1
10042,0,1,0,0,1
10043,0,0,0,1,1
10044,1,0,0,0,1
10045,0,1,0,0,1
10046,0,1,0,0,1
10047,0,1,0,0,1
10048,0,1,0,0,1
10049,0,1,0,0,1
10050,0,0,0,1,1
10051,0,1,0,0,1
10052,0,0,0,1,1
10053,1,0,0,0,1
10054,1,0,0,0,1
10055,1,0,0,0,1
10056,0,1,0,0,1
10057,0,1,0,0,1
10058,1,0,0,0,1
10059,1,0,0,0,1
10060,0,1,0,0,1
10061,0,1,0,0,1
10062,0,1,0,0,1
10063,0,1,0,0,1
10064,0,1,0,0,1
10065,0,1,0,0,1
10066,0,1,0,0,1
10067,0,1,0,0,1
10068,0,1,0,0,1
10069,0,1,0,0,1
10070,0,1,0,0,1
10071,0,1,0,0,1
10072,0,1,0,0,1
10073,0,1,0,0,1
10074,0,1,0,0,1
10075,0,1,0,0,1
10076,0,1,0,0,1
10077,0,1,0,0,1
10078,0,1,0,0,1
10079,0,1,0,0,1
10080,1,0,0,0,1
10081,0,1,0,0,1
10082,0,1,0,0,1
10083,0,1,0,0,1
10084,0,1,0,0,1
10085,1,0,0,0,1
10086,0,1,0,0,1
10087,1,0,0,0,1
10088,0,1,0,0,1
10089,0,1,0,0,1
10090,0,1,0,0,1
10091,0,1,0,0,1
10092,0,1,0,0,1
10093,0,1,0,0,1
10094,0,1,0,0,1
10095,0,1,0,0,1
10096,1,0,0,0,1
10097,0,1,0,0,1
10098,0,1,0,0,1
10099,0,1,0,0,1
10100,0,1,0,0,1
10101,0,1,0,0,1
10102,0,1,0,0,1
10103,0,1,0,0,1
10104,0,1,0,0,1
10105,0,1,0,0,1
10106,0,1,0,0,1
10107,0,1,0,0,1
10108,0,1,0,0,1
10109,1,0,0,0,1
10110,0,1,0,0,1
10111,0,1,0,0,1
10112,0,1,0,0,1
10113,0,1,0,0,1
10114,0,1,0,0,1
10115,0,1,0,0,1
10116,1,0,0,0,1
10117,0,1,0,0,1
10118,0,1,0,0,1
10119,0,1,0,0,1
10120,0,1,0,0,1
10121,0,1,0,0,1
10122,1,0,0,0,1
10123,0,1,0,0,1
10124,0,1,0,0,1
10125,1,0,0,0,1
10126,1,0,0,0,1
10127,0,1,0,0,1
10128,1,0,0,0,1
10129,0,1,0,0,1
10130,1,0,0,0,1
10131,0,1,0,0,1
10132,0,1,0,0,1
10133,0,1,0,0,1
10134,0,1,0,0,1
10135,0,1,0,0,1
10136,1,0,0,0,1
10137,0,1,0,0,1
10138,0,1,0,0,1
10139,0,1,0,0,1
10140,0,1,0,0,1
10141,0,1,0,0,1
10142,0,0,1,0,1
10143,0,1,0,0,1
10144,0,1,0,0,1
10145,0,1,0,0,1
10146,0,1,0,0,1
10147,0,0,0,1,1
10148,1,0,0,0,1
10149,0,1,0,0,1
10150,0,1,0,0,1
10151,0,1,0,0,1
10152,0,1,0,0,1
10153,0,1,0,0,1
10154,0,1,0,0,1
10155,0,1,0,0,1
10156,0,1,0,0,1
10157,0,1,0,0,1
10158,0,1,0,0,1
10159,0,1,0,0,1
10160,0,1,0,0,1
10161,0,1,0,0,1
10162,0,1,0,0,1
10163,0,1,0,0,1
10164,0,1,0,0,1
10165,0,1,0,0,1
10166,0,1,0,0,1
10167,0,1,0,0,1
10168,0,1,0,0,1
10169,0,1,0,0,1
10170,0,1,0,0,1
10171,0,1,0,0,1
10172,0,1,0,0,1
10173,1,0,0,0,1
10174,1,0,0,0,1
10175,0,1,0,0,1
10176,1,0,0,0,1
10177,0,1,0,0,1
10178,1,0,0,0,1
10179,0,1,0,0,1
10180,0,1,0,0,1
10181,0,1,0,0,1
10182,0,1,0,0,1
10183,0,1,0,0,1
10184,0,1,0,0,1
10185,0,1,0,0,1
10186,0,1,0,0,1
10187,0,1,0,0,1
10188,0,1,0,0,1
10189,0,1,0,0,1
10190,1,0,0,0,1
10191,0,1,0,0,1
10192,0,1,0,0,1
10193,0,1,0,0,1
10194,0,1,0,0,1
10195,0,1,0,0,1
10196,0,1,0,0,1
10197,0,1,0,0,1
10198,0,1,0,0,1
10199,0,1,0,0,1
10200,0,1,0,0,1
10201,0,1,0,0,1
10202,0,1,0,0,1
10203,0,1,0,0,1
10204,0,1,0,0,1
10205,0,1,0,0,1
10206,0,1,0,0,1
10207,1,0,0,0,1
10208,0,1,0,0,1
10209,0,1,0,0,1
10210,1,0,0,0,1
10211,0,1,0,0,1
10212,0,1,0,0,1
10213,0,1,0,0,1
10214,0,0,1,0,1
10215,0,0,0,1,1
10216,0,1,0,0,1
10217,0,1,0,0,1
10218,0,1,0,0,1
10219,1,0,0,0,1
10220,0,1,0,0,1
10221,0,1,0,0,1
10222,0,1,0,0,1
10223,0,1,0,0,1
10224,0,1,0,0,1
10225,0,0,0,1,1
10226,0,1,0,0,1
10227,0,1,0,0,1
10228,0,1,0,0,1
10229,0,1,0,0,1
10230,0,1,0,0,1
10231,0,1,0,0,1
10232,0,1,0,0,1
10233,0,1,0,0,1
10234,0,1,0,0,1
10235,0,1,0,0,1
10236,1,0,0,0,1
10237,0,1,0,0,1
10238,0,1,0,0,1
10239,0,1,0,0,1
10240,0,1,0,0,1
10241,0,1,0,0,1
10242,0,1,0,0,1
10243,1,0,0,0,1
10244,0,1,0,0,1
10245,1,0,0,0,1
10246,0,1,0,0,1
10247,0,1,0,0,1
10248,0,1,0,0,1
10249,0,1,0,0,1
10250,0,1,0,0,1
10251,0,1,0,0,1
10252,0,1,0,0,1
10253,1,0,0,0,1
10254,0,1,0,0,1
10255,0,1,0,0,1
10256,0,1,0,0,1
10257,0,1,0,0,1
10258,1,0,0,0,1
10259,0,1,0,0,1
10260,0,1,0,0,1
10261,1,0,0,0,1
10262,0,1,0,0,1
10263,0,1,0,0,1
10264,0,1,0,0,1
10265,0,1,0,0,1
10266,1,0,0,0,1
10267,0,1,0,0,1
10268,0,1,0,0,1
10269,0,1,0,0,1
10270,0,1,0,0,1
10271,0,1,0,0,1
10272,0,1,0,0,1
10273,0,1,0,0,1
10274,1,0,0,0,1
10275,0,1,0,0,1
10276,0,1,0,0,1
10277,1,0,0,0,1
10278,0,1,0,0,1
10279,0,1,0,0,1
10280,0,1,0,0,1
10281,0,0,0,1,1
10282,0,1,0,0,1
10283,0,1,0,0,1
10284,0,0,0,1,1
10285,0,1,0,0,1
10286,0,1,0,0,1
10287,0,1,0,0,1
10288,0,1,0,0,1
10289,1,0,0,0,1
10290,1,0,0,0,1
10291,0,1,0,0,1
10292,0,1,0,0,1
10293,0,1,0,0,1
10294,0,1,0,0,1
10295,0,1,0,0,1
10296,0,1,0,0,1
10297,0,1,0,0,1
10298,1,0,0,0,1
10299,0,1,0,0,1
10300,0,1,0,0,1
10301,1,0,0,0,1
10302,0,1,0,0,1
10303,0,1,0,0,1
10304,0,1,0,0,1
10305,0,1,0,0,1
10306,0,1,0,0,1
10307,0,1,0,0,1
10308,0,1,0,0,1
10309,0,1,0,0,1
10310,0,1,0,0,1
10311,0,1,0,0,1
10312,0,1,0,0,1
10313,0,1,0,0,1
10314,0,1,0,0,1
10315,1,0,0,0,1
10316,0,1,0,0,1
10317,0,1,0,0,1
10318,0,1,0,0,1
10319,0,1,0,0,1
10320,0,1,0,0,1
10321,0,1,0,0,1
10322,0,1,0,0,1
10323,1,0,0,0,1
10324,1,0,0,0,1
10325,0,1,0,0,1
10326,0,1,0,0,1
10327,0,1,0,0,1
10328,0,1,0,0,1
10329,0,1,0,0,1
10330,1,0,0,0,1
10331,0,1,0,0,1
10332,0,1,0,0,1
10333,0,1,0,0,1
10334,0,1,0,0,1
10335,0,1,0,0,1
10336,0,1,0,0,1
10337,0,1,0,0,1
10338,0,1,0,0,1
10339,1,0,0,0,1
10340,1,0,0,0,1
10341,0,1,0,0,1
10342,0,1,0,0,1
10343,1,0,0,0,1
10344,0,1,0,0,1
10345,0,1,0,0,1
10346,0,1,0,0,1
10347,0,1,0,0,1
10348,0,1,0,0,1
10349,0,1,0,0,1
10350,0,1,0,0,1
10351,0,1,0,0,1
10352,0,1,0,0,1
10353,0,1,0,0,1
10354,0,1,0,0,1
10355,0,1,0,0,1
10356,0,1,0,0,1
10357,0,1,0,0,1
10358,0,1,0,0,1
10359,0,1,0,0,1
10360,0,1,0,0,1
10361,0,1,0,0,1
10362,0,1,0,0,1
10363,0,1,0,0,1
10364,0,1,0,0,1
10365,0,1,0,0,1
10366,0,1,0,0,1
10367,0,1,0,0,1
10368,0,1,0,0,1
10369,0,1,0,0,1
10370,0,1,0,0,1
10371,0,1,0,0,1
10372,0,1,0,0,1
10373,0,1,0,0,1
10374,1,0,0,0,1
10375,0,1,0,0,1
10376,0,1,0,0,1
10377,0,1,0,0,1
10378,0,1,0,0,1
10379,0,1,0,0,1
10380,0,1,0,0,1
10381,0,1,0,0,1
10382,0,1,0,0,1
10383,0,1,0,0,1
10384,0,1,0,0,1
10385,0,1,0,0,1
10386,0,1,0,0,1
10387,0,0,1,0,1
10388,0,1,0,0,1
10389,0,1,0,0,1
10390,0,1,0,0,1
10391,0,1,0,0,1
10392,0,1,0,0,1
10393,0,1,0,0,1
10394,1,0,0,0,1
10395,0,1,0,0,1
10396,0,1,0,0,1
10397,0,1,0,0,1
10398,0,1,0,0,1
10399,0,1,0,0,1
10400,0,1,0,0,1
10401,0,1,0,0,1
10402,0,1,0,0,1
10403,0,1,0,0,1
10404,0,1,0,0,1
10405,0,1,0,0,1
10406,0,1,0,0,1
10407,0,1,0,0,1
10408,0,1,0,0,1
10409,1,0,0,0,1
10410,1,0,0,0,1
10411,1,0,0,0,1
10412,0,1,0,0,1
10413,0,1,0,0,1
10414,0,1,0,0,1
10415,0,1,0,0,1
10416,0,1,0,0,1
10417,0,1,0,0,1
10418,0,0,0,1,1
10419,0,1,0,0,1
10420,0,1,0,0,1
10421,0,1,0,0,1
10422,0,1,0,0,1
10423,0,1,0,0,1
10424,0,1,0,0,1
10425,0,1,0,0,1
10426,0,1,0,0,1
10427,0,1,0,0,1
10428,1,0,0,0,1
10429,0,1,0,0,1
10430,0,1,0,0,1
10431,0,1,0,0,1
10432,0,1,0,0,1
10433,0,1,0,0,1
10434,0,1,0,0,1
10435,0,1,0,0,1
10436,0,1,0,0,1
10437,0,1,0,0,1
10438,0,1,0,0,1
10439,0,0,0,1,1
10440,0,1,0,0,1
10441,0,1,0,0,1
10442,0,1,0,0,1
10443,0,1,0,0,1
10444,0,1,0,0,1
10445,0,1,0,0,1
10446,0,1,0,0,1
10447,0,1,0,0,1
10448,0,1,0,0,1
10449,1,0,0,0,1
10450,0,1,0,0,1
10451,0,1,0,0,1
10452,1,0,0,0,1
10453,0,1,0,0,1
10454,0,1,0,0,1
10455,0,1,0,0,1
10456,0,1,0,0,1
10457,0,1,0,0,1
10458,0,1,0,0,1
10459,0,1,0,0,1
10460,0,1,0,0,1
10461,0,1,0,0,1
10462,0,1,0,0,1
10463,0,1,0,0,1
10464,0,1,0,0,1
10465,0,1,0,0,1
10466,1,0,0,0,1
10467,0,1,0,0,1
10468,0,1,0,0,1
10469,0,1,0,0,1
10470,0,1,0,0,1
10471,0,1,0,0,1
10472,0,1,0,0,1
10473,1,0,0,0,1
10474,1,0,0,0,1
10475,0,1,0,0,1
10476,0,1,0,0,1
10477,0,1,0,0,1
10478,1,0,0,0,1
10479,0,1,0,0,1
10480,0,1,0,0,1
10481,0,0,0,1,1
10482,0,1,0,0,1
10483,0,1,0,0,1
10484,0,1,0,0,1
10485,0,1,0,0,1
10486,0,1,0,0,1
10487,0,1,0,0,1
10488,0,1,0,0,1
10489,0,1,0,0,1
10490,0,1,0,0,1
10491,0,1,0,0,1
10492,0,1,0,0,1
10493,0,1,0,0,1
10494,0,1,0,0,1
10495,0,1,0,0,1
10496,0,1,0,0,1
10497,0,1,0,0,1
10498,0,1,0,0,1
10499,0,1,0,0,1
10500,0,1,0,0,1
10501,0,1,0,0,1
10502,0,1,0,0,1
10503,0,1,0,0,1
10504,0,1,0,0,1
10505,0,1,0,0,1
10506,0,1,0,0,1
10507,1,0,0,0,1
10508,0,1,0,0,1
10509,0,1,0,0,1
10510,1,0,0,0,1
10511,0,1,0,0,1
10512,0,1,0,0,1
10513,0,1,0,0,1
10514,0,1,0,0,1
10515,0,1,0,0,1
10516,0,1,0,0,1
10517,0,1,0,0,1
10518,1,0,0,0,1
10519,0,1,0,0,1
10520,0,1,0,0,1
10521,1,0,0,0,1
10522,0,1,0,0,1
10523,0,1,0,0,1
10524,0,1,0,0,1
10525,1,0,0,0,1
10526,0,1,0,0,1
10527,0,1,0,0,1
10528,0,1,0,0,1
10529,0,1,0,0,1
10530,0,1,0,0,1
10531,0,0,0,1,1
10532,0,1,0,0,1
10533,0,1,0,0,1
10534,0,1,0,0,1
10535,0,1,0,0,1
10536,0,1,0,0,1
10537,0,1,0,0,1
10538,1,0,0,0,1
10539,0,1,0,0,1
10540,0,1,0,0,1
10541,0,1,0,0,1
10542,0,1,0,0,1
10543,0,1,0,0,1
10544,0,1,0,0,1
10545,0,1,0,0,1
10546,0,1,0,0,1
10547,0,1,0,0,1
10548,0,1,0,0,1
10549,0,1,0,0,1
10550,0,1,0,0,1
10551,0,1,0,0,1
10552,0,1,0,0,1
10553,0,1,0,0,1
10554,0,1,0,0,1
10555,0,1,0,0,1
10556,0,1,0,0,1
10557,0,1,0,0,1
10558,0,1,0,0,1
10559,0,1,0,0,1
10560,0,1,0,0,1
10561,0,1,0,0,1
10562,0,1,0,0,1
10563,0,1,0,0,1
10564,0,1,0,0,1
10565,0,1,0,0,1
10566,0,1,0,0,1
10567,0,1,0,0,1
10568,0,1,0,0,1
10569,0,1,0,0,1
10570,0,1,0,0,1
10571,0,1,0,0,1
10572,0,1,0,0,1
10573,0,1,0,0,1
10574,0,1,0,0,1
10575,0,1,0,0,1
10576,0,1,0,0,1
10577,0,0,1,0,1
10578,0,1,0,0,1
10579,0,1,0,0,1
10580,0,1,0,0,1
10581,0,1,0,0,1
10582,0,1,0,0,1
10583,0,1,0,0,1
10584,0,1,0,0,1
10585,1,0,0,0,1
10586,0,1,0,0,1
10587,0,1,0,0,1
10588,0,1,0,0,1
10589,0,1,0,0,1
10590,0,1,0,0,1
10591,0,1,0,0,1
10592,0,1,0,0,1
10593,0,1,0,0,1
10594,0,1,0,0,1
10595,0,1,0,0,1
10596,0,1,0,0,1
10597,0,0,0,1,1
10598,0,1,0,0,1
10599,0,1,0,0,1
10600,0,1,0,0,1
10601,1,0,0,0,1
10602,0,1,0,0,1
10603,0,1,0,0,1
10604,0,1,0,0,1
10605,0,1,0,0,1
10606,0,1,0,0,1
10607,0,1,0,0,1
10608,0,1,0,0,1
10609,0,1,0,0,1
10610,0,1,0,0,1
10611,0,1,0,0,1
10612,0,1,0,0,1
10613,0,1,0,0,1
10614,0,1,0,0,1
10615,0,1,0,0,1
10616,0,1,0,0,1
10617,0,1,0,0,1
10618,0,1,0,0,1
10619,0,1,0,0,1
10620,0,1,0,0,1
10621,0,1,0,0,1
10622,0,1,0,0,1
10623,0,1,0,0,1
10624,0,1,0,0,1
10625,1,0,0,0,1
10626,0,1,0,0,1
10627,0,0,1,0,1
10628,0,1,0,0,1
10629,0,1,0,0,1
10630,0,1,0,0,1
10631,0,1,0,0,1
10632,0,1,0,0,1
10633,1,0,0,0,1
10634,0,1,0,0,1
10635,0,1,0,0,1
10636,0,1,0,0,1
10637,0,1,0,0,1
10638,1,0,0,0,1
10639,0,1,0,0,1
10640,0,0,1,0,1
10641,0,1,0,0,1
10642,0,1,0,0,1
10643,0,0,0,1,1
10644,0,1,0,0,1
10645,0,1,0,0,1
10646,0,1,0,0,1
10647,0,1,0,0,1
10648,0,1,0,0,1
10649,0,1,0,0,1
10650,0,1,0,0,1
10651,1,0,0,0,1
10652,0,1,0,0,1
10653,0,1,0,0,1
10654,0,1,0,0,1
10655,0,1,0,0,1
10656,1,0,0,0,1
10657,0,1,0,0,1
10658,0,1,0,0,1
10659,0,1,0,0,1
10660,0,1,0,0,1
10661,0,1,0,0,1
10662,0,1,0,0,1
10663,0,1,0,0,1
10664,0,0,1,0,1
10665,0,1,0,0,1
10666,0,1,0,0,1
10667,0,1,0,0,1
10668,0,1,0,0,1
10669,0,1,0,0,1
10670,0,1,0,0,1
10671,0,1,0,0,1
10672,0,1,0,0,1
10673,0,1,0,0,1
10674,0,1,0,0,1
10675,0,1,0,0,1
10676,1,0,0,0,1
10677,0,1,0,0,1
10678,0,1,0,0,1
10679,1,0,0,0,1
10680,0,1,0,0,1
10681,0,1,0,0,1
10682,0,1,0,0,1
10683,1,0,0,0,1
10684,0,1,0,0,1
10685,0,1,0,0,1
10686,1,0,0,0,1
10687,0,1,0,0,1
10688,0,1,0,0,1
10689,0,1,0,0,1
10690,0,1,0,0,1
10691,0,1,0,0,1
10692,0,0,1,0,1
10693,0,1,0,0,1
10694,0,1,0,0,1
10695,0,1,0,0,1
10696,1,0,0,0,1
10697,0,1,0,0,1
10698,0,1,0,0,1
10699,0,1,0,0,1
10700,0,1,0,0,1
10701,1,0,0,0,1
10702,0,1,0,0,1
10703,0,1,0,0,1
10704,1,0,0,0,1
10705,0,1,0,0,1
10706,0,1,0,0,1
10707,0,1,0,0,1
10708,0,1,0,0,1
10709,0,1,0,0,1
10710,0,1,0,0,1
10711,0,0,0,1,1
10712,0,1,0,0,1
10713,0,1,0,0,1
10714,0,1,0,0,1
10715,0,1,0,0,1
10716,0,1,0,0,1
10717,0,1,0,0,1
10718,0,1,0,0,1
10719,0,1,0,0,1
10720,0,1,0,0,1
10721,0,1,0,0,1
10722,0,1,0,0,1
10723,0,1,0,0,1
10724,0,1,0,0,1
10725,0,1,0,0,1
10726,0,1,0,0,1
10727,0,1,0,0,1
10728,0,1,0,0,1
10729,0,1,0,0,1
10730,0,1,0,0,1
10731,0,1,0,0,1
10732,0,1,0,0,1
10733,0,1,0,0,1
10734,0,1,0,0,1
10735,1,0,0,0,1
10736,0,1,0,0,1
10737,0,1,0,0,1
10738,0,1,0,0,1
10739,0,1,0,0,1
10740,0,1,0,0,1
10741,0,1,0,0,1
10742,0,1,0,0,1
10743,0,1,0,0,1
10744,0,1,0,0,1
10745,0,1,0,0,1
10746,0,1,0,0,1
10747,0,1,0,0,1
10748,0,1,0,0,1
10749,0,1,0,0,1
10750,0,1,0,0,1
10751,1,0,0,0,1
10752,0,1,0,0,1
10753,0,1,0,0,1
10754,0,1,0,0,1
10755,0,1,0,0,1
10756,0,1,0,0,1
10757,1,0,0,0,1
10758,0,1,0,0,1
10759,0,1,0,0,1
10760,1,0,0,0,1
10761,0,1,0,0,1
10762,0,1,0,0,1
10763,0,1,0,0,1
10764,0,1,0,0,1
10765,0,0,0,1,1
10766,0,1,0,0,1
10767,1,0,0,0,1
10768,0,1,0,0,1
10769,0,1,0,0,1
10770,0,1,0,0,1
10771,0,1,0,0,1
10772,0,1,0,0,1
10773,0,1,0,0,1
10774,0,1,0,0,1
10775,0,1,0,0,1
10776,0,1,0,0,1
10777,0,1,0,0,1
10778,0,1,0,0,1
10779,0,1,0,0,1
10780,0,1,0,0,1
10781,0,1,0,0,1
10782,0,1,0,0,1
10783,0,1,0,0,1
10784,0,1,0,0,1
10785,0,1,0,0,1
10786,0,1,0,0,1
10787,0,1,0,0,1
10788,0,1,0,0,1
10789,1,0,0,0,1
10790,0,1,0,0,1
10791,0,1,0,0,1
10792,1,0,0,0,1
10793,0,1,0,0,1
10794,0,1,0,0,1
10795,0,1,0,0,1
10796,0,1,0,0,1
10797,0,1,0,0,1
10798,0,1,0,0,1
10799,0,1,0,0,1
10800,0,1,0,0,1
10801,0,1,0,0,1
10802,0,1,0,0,1
10803,0,1,0,0,1
10804,0,1,0,0,1
10805,0,1,0,0,1
10806,0,1,0,0,1
10807,1,0,0,0,1
10808,0,1,0,0,1
10809,0,0,0,1,1
10810,0,1,0,0,1
10811,0,1,0,0,1
10812,0,1,0,0,1
10813,0,1,0,0,1
10814,0,1,0,0,1
10815,0,1,0,0,1
10816,1,0,0,0,1
10817,0,1,0,0,1
10818,0,1,0,0,1
10819,0,1,0,0,1
10820,0,1,0,0,1
10821,0,1,0,0,1
10822,0,1,0,0,1
10823,0,1,0,0,1
10824,1,0,0,0,1
10825,1,0,0,0,1
10826,0,1,0,0,1
10827,0,1,0,0,1
10828,0,1,0,0,1
10829,0,1,0,0,1
10830,1,0,0,0,1
10831,0,1,0,0,1
10832,0,1,0,0,1
10833,1,0,0,0,1
10834,0,1,0,0,1
10835,0,1,0,0,1
10836,0,1,0,0,1
10837,1,0,0,0,1
10838,0,1,0,0,1
10839,0,1,0,0,1
10840,0,1,0,0,1
10841,0,1,0,0,1
10842,0,1,0,0,1
10843,0,0,0,1,1
10844,0,1,0,0,1
10845,0,1,0,0,1
10846,0,1,0,0,1
10847,0,1,0,0,1
10848,0,1,0,0,1
10849,0,1,0,0,1
10850,0,1,0,0,1
10851,0,1,0,0,1
10852,0,1,0,0,1
10853,0,1,0,0,1
10854,0,1,0,0,1
10855,0,1,0,0,1
10856,1,0,0,0,1
10857,0,1,0,0,1
10858,0,1,0,0,1
10859,0,1,0,0,1
10860,0,1,0,0,1
10861,0,1,0,0,1
10862,0,1,0,0,1
10863,0,1,0,0,1
10864,1,0,0,0,1
10865,0,1,0,0,1
10866,0,1,0,0,1
10867,0,1,0,0,1
10868,1,0,0,0,1
10869,0,1,0,0,1
10870,0,1,0,0,1
10871,0,1,0,0,1
10872,0,1,0,0,1
10873,0,1,0,0,1
10874,0,1,0,0,1
10875,0,1,0,0,1
10876,0,1,0,0,1
10877,0,1,0,0,1
10878,0,1,0,0,1
10879,0,1,0,0,1
10880,0,1,0,0,1
10881,0,1,0,0,1
10882,0,1,0,0,1
10883,0,1,0,0,1
10884,0,1,0,0,1
10885,0,1,0,0,1
10886,0,1,0,0,1
10887,0,1,0,0,1
10888,0,1,0,0,1
10889,0,1,0,0,1
10890,0,1,0,0,1
10891,0,1,0,0,1
10892,0,1,0,0,1
10893,1,0,0,0,1
10894,0,1,0,0,1
10895,0,1,0,0,1
10896,0,1,0,0,1
10897,1,0,0,0,1
10898,0,1,0,0,1
10899,0,1,0,0,1
10900,0,1,0,0,1
10901,0,1,0,0,1
10902,0,1,0,0,1
10903,0,1,0,0,1
10904,0,1,0,0,1
10905,0,1,0,0,1
10906,0,1,0,0,1
10907,0,1,0,0,1
10908,1,0,0,0,1
10909,0,1,0,0,1
10910,0,1,0,0,1
10911,0,1,0,0,1
10912,1,0,0,0,1
10913,0,1,0,0,1
10914,0,1,0,0,1
10915,1,0,0,0,1
10916,0,1,0,0,1
10917,0,1,0,0,1
10918,0,1,0,0,1
10919,0,1,0,0,1
10920,0,1,0,0,1
10921,0,1,0,0,1
10922,0,1,0,0,1
10923,0,1,0,0,1
10924,0,1,0,0,1
10925,1,0,0,0,1
10926,0,1,0,0,1
10927,0,1,0,0,1
10928,0,1,0,0,1
10929,0,1,0,0,1
10930,0,1,0,0,1
10931,0,1,0,0,1
10932,1,0,0,0,1
10933,0,1,0,0,1
10934,0,1,0,0,1
10935,0,1,0,0,1
10936,0,1,0,0,1
10937,0,1,0,0,1
10938,0,1,0,0,1
10939,0,1,0,0,1
10940,1,0,0,0,1
10941,0,1,0,0,1
10942,0,1,0,0,1
10943,0,1,0,0,1
10944,0,1,0,0,1
10945,1,0,0,0,1
10946,0,1,0,0,1
10947,0,1,0,0,1
10948,0,1,0,0,1
10949,0,1,0,0,1
10950,0,1,0,0,1
10951,0,1,0,0,1
10952,0,1,0,0,1
10953,0,1,0,0,1
10954,1,0,0,0,1
10955,0,1,0,0,1
10956,0,1,0,0,1
10957,0,1,0,0,1
10958,0,1,0,0,1
10959,0,1,0,0,1
10960,0,1,0,0,1
10961,0,1,0,0,1
10962,0,1,0,0,1
10963,0,1,0,0,1
10964,0,1,0,0,1
10965,0,1,0,0,1
10966,0,1,0,0,1
10967,0,1,0,0,1
10968,1,0,0,0,1
10969,1,0,0,0,1
10970,0,1,0,0,1
10971,0,1,0,0,1
10972,0,1,0,0,1
10973,0,1,0,0,1
10974,0,1,0,0,1
10975,0,1,0,0,1
10976,0,1,0,0,1
10977,0,1,0,0,1
10978,0,1,0,0,1
10979,0,1,0,0,1
10980,0,1,0,0,1
10981,0,1,0,0,1
10982,0,1,0,0,1
10983,0,1,0,0,1
10984,0,1,0,0,1
10985,0,1,0,0,1
10986,0,1,0,0,1
10987,0,1,0,0,1
10988,0,1,0,0,1
10989,0,0,0,1,1
10990,0,1,0,0,1
10991,0,1,0,0,1
10992,0,1,0,0,1
10993,0,1,0,0,1
10994,0,1,0,0,1
10995,0,1,0,0,1
10996,0,1,0,0,1
10997,0,1,0,0,1
10998,0,1,0,0,1
10999,0,1,0,0,1
11000,0,1,0,0,1
11001,0,1,0,0,1
11002,1,0,0,0,1
11003,0,1,0,0,1
11004,1,0,0,0,1
11005,0,1,0,0,1
11006,0,1,0,0,1
11007,0,1,0,0,1
11008,0,1,0,0,1
11009,0,1,0,0,1
11010,0,1,0,0,1
11011,0,1,0,0,1
11012,0,1,0,0,1
11013,0,1,0,0,1
11014,0,1,0,0,1
11015,0,1,0,0,1
11016,0,1,0,0,1
11017,0,1,0,0,1
11018,0,1,0,0,1
11019,0,1,0,0,1
11020,1,0,0,0,1
11021,0,1,0,0,1
11022,0,1,0,0,1
11023,0,1,0,0,1
11024,0,1,0,0,1
11025,1,0,0,0,1
11026,0,1,0,0,1
11027,0,1,0,0,1
11028,0,1,0,0,1
11029,0,1,0,0,1
11030,1,0,0,0,1
11031,0,1,0,0,1
11032,0,1,0,0,1
11033,0,1,0,0,1
11034,0,1,0,0,1
11035,0,1,0,0,1
11036,1,0,0,0,1
11037,0,0,0,1,1
11038,0,1,0,0,1
11039,0,1,0,0,1
11040,1,0,0,0,1
11041,0,1,0,0,1
11042,0,1,0,0,1
11043,0,1,0,0,1
11044,0,1,0,0,1
11045,0,1,0,0,1
11046,1,0,0,0,1
11047,0,1,0,0,1
11048,0,1,0,0,1
11049,0,1,0,0,1
11050,1,0,0,0,1
11051,0,1,0,0,1
11052,0,1,0,0,1
11053,1,0,0,0,1
11054,1,0,0,0,1
11055,0,0,0,1,1
11056,1,0,0,0,1
11057,0,1,0,0,1
11058,0,1,0,0,1
11059,0,1,0,0,1
11060,0,1,0,0,1
11061,0,1,0,0,1
11062,0,0,0,1,1
11063,0,1,0,0,1
11064,0,1,0,0,1
11065,0,1,0,0,1
11066,0,1,0,0,1
11067,0,1,0,0,1
11068,1,0,0,0,1
11069,0,1,0,0,1
11070,0,1,0,0,1
11071,0,1,0,0,1
11072,0,1,0,0,1
11073,0,1,0,0,1
11074,0,1,0,0,1
11075,0,1,0,0,1
11076,0,1,0,0,1
11077,0,1,0,0,1
11078,0,1,0,0,1
11079,0,1,0,0,1
11080,0,1,0,0,1
11081,0,1,0,0,1
11082,0,1,0,0,1
11083,0,1,0,0,1
11084,0,1,0,0,1
11085,0,1,0,0,1
11086,0,1,0,0,1
11087,0,1,0,0,1
11088,0,1,0,0,1
11089,1,0,0,0,1
11090,1,0,0,0,1
11091,0,1,0,0,1
11092,0,1,0,0,1
11093,0,1,0,0,1
11094,0,1,0,0,1
11095,0,1,0,0,1
11096,1,0,0,0,1
11097,0,1,0,0,1
11098,1,0,0,0,1
11099,0,1,0,0,1
11100,0,1,0,0,1
11101,0,1,0,0,1
11102,0,1,0,0,1
11103,0,1,0,0,1
11104,0,1,0,0,1
11105,0,1,0,0,1
11106,0,1,0,0,1
11107,0,1,0,0,1
11108,0,1,0,0,1
11109,0,1,0,0,1
11110,0,1,0,0,1
11111,1,0,0,0,1
11112,0,1,0,0,1
11113,0,0,0,1,1
11114,0,1,0,0,1
11115,0,1,0,0,1
11116,0,1,0,0,1
11117,0,1,0,0,1
11118,1,0,0,0,1
11119,0,1,0,0,1
11120,0,1,0,0,1
11121,0,1,0,0,1
11122,0,1,0,0,1
11123,0,1,0,0,1
11124,0,1,0,0,1
11125,0,1,0,0,1
11126,0,1,0,0,1
11127,0,1,0,0,1
11128,0,1,0,0,1
11129,0,1,0,0,1
11130,0,0,0,1,1
11131,0,0,0,1,1
11132,1,0,0,0,1
11133,0,1,0,0,1
11134,0,1,0,0,1
11135,0,1,0,0,1
11136,0,1,0,0,1
11137,0,1,0,0,1
11138,1,0,0,0,1
11139,0,1,0,0,1
11140,0,1,0,0,1
11141,0,1,0,0,1
11142,0,1,0,0,1
11143,0,1,0,0,1
11144,0,1,0,0,1
11145,0,1,0,0,1
11146,0,1,0,0,1
11147,0,1,0,0,1
11148,0,1,0,0,1
11149,0,1,0,0,1
11150,0,1,0,0,1
11151,1,0,0,0,1
11152,0,1,0,0,1
11153,0,1,0,0,1
11154,0,1,0,0,1
11155,0,1,0,0,1
11156,0,1,0,0,1
11157,0,1,0,0,1
11158,0,1,0,0,1
11159,0,1,0,0,1
11160,0,1,0,0,1
11161,0,1,0,0,1
11162,0,1,0,0,1
11163,0,1,0,0,1
11164,0,1,0,0,1
11165,1,0,0,0,1
11166,1,0,0,0,1
11167,0,1,0,0,1
11168,0,0,1,0,1
11169,0,1,0,0,1
11170,1,0,0,0,1
11171,1,0,0,0,1
11172,0,1,0,0,1
11173,0,1,0,0,1
11174,0,1,0,0,1
11175,0,1,0,0,1
11176,0,1,0,0,1
11177,0,1,0,0,1
11178,0,1,0,0,1
11179,0,1,0,0,1
11180,0,1,0,0,1
11181,0,1,0,0,1
11182,0,1,0,0,1
11183,0,1,0,0,1
11184,0,1,0,0,1
11185,0,1,0,0,1
11186,0,1,0,0,1
11187,0,1,0,0,1
11188,0,1,0,0,1
11189,0,1,0,0,1
11190,0,1,0,0,1
11191,0,1,0,0,1
11192,0,1,0,0,1
11193,1,0,0,0,1
11194,0,1,0,0,1
11195,0,1,0,0,1
11196,0,1,0,0,1
11197,0,1,0,0,1
11198,0,1,0,0,1
11199,0,1,0,0,1
11200,0,1,0,0,1
11201,0,1,0,0,1
11202,0,1,0,0,1
11203,0,1,0,0,1
11204,0,1,0,0,1
11205,1,0,0,0,1
11206,0,1,0,0,1
11207,0,1,0,0,1
11208,0,1,0,0,1
11209,0,1,0,0,1
11210,0,1,0,0,1
11211,0,1,0,0,1
11212,0,1,0,0,1
11213,0,1,0,0,1
11214,1,0,0,0,1
11215,1,0,0,0,1
11216,0,1,0,0,1
11217,0,0,0,1,1
11218,1,0,0,0,1
11219,0,1,0,0,1
11220,0,1,0,0,1
11221,0,1,0,0,1
11222,0,1,0,0,1
11223,1,0,0,0,1
11224,0,1,0,0,1
11225,0,1,0,0,1
11226,0,1,0,0,1
11227,0,1,0,0,1
11228,0,1,0,0,1
11229,0,1,0,0,1
11230,0,1,0,0,1
11231,0,1,0,0,1
11232,1,0,0,0,1
11233,0,1,0,0,1
11234,0,1,0,0,1
11235,0,1,0,0,1
11236,0,1,0,0,1
11237,0,1,0,0,1
11238,0,0,0,1,1
11239,0,1,0,0,1
11240,0,1,0,0,1
11241,0,1,0,0,1
11242,0,1,0,0,1
11243,0,1,0,0,1
11244,1,0,0,0,1
11245,0,1,0,0,1
11246,1,0,0,0,1
11247,0,1,0,0,1
11248,0,1,0,0,1
11249,0,1,0,0,1
11250,0,1,0,0,1
11251,0,1,0,0,1
11252,0,1,0,0,1
11253,1,0,0,0,1
11254,0,1,0,0,1
11255,0,1,0,0,1
11256,0,1,0,0,1
11257,0,1,0,0,1
11258,0,1,0,0,1
11259,0,1,0,0,1
11260,0,1,0,0,1
11261,0,1,0,0,1
11262,0,1,0,0,1
11263,0,1,0,0,1
11264,0,1,0,0,1
11265,0,1,0,0,1
11266,0,1,0,0,1
11267,0,1,0,0,1
11268,0,1,0,0,1
11269,0,1,0,0,1
11270,0,1,0,0,1
11271,0,1,0,0,1
11272,0,1,0,0,1
11273,0,1,0,0,1
11274,0,1,0,0,1
11275,0,1,0,0,1
11276,0,1,0,0,1
11277,0,1,0,0,1
11278,0,0,0,1,1
11279,0,1,0,0,1
11280,0,1,0,0,1
11281,0,1,0,0,1
11282,0,0,0,1,1
11283,1,0,0,0,1
11284,0,1,0,0,1
11285,0,1,0,0,1
11286,0,1,0,0,1
11287,0,1,0,0,1
11288,0,1,0,0,1
11289,0,1,0,0,1
11290,0,1,0,0,1
11291,0,0,0,1,1
11292,1,0,0,0,1
11293,0,1,0,0,1
11294,0,1,0,0,1
11295,0,1,0,0,1
11296,0,1,0,0,1
11297,0,1,0,0,1
11298,0,1,0,0,1
11299,0,1,0,0,1
11300,0,1,0,0,1
11301,0,1,0,0,1
11302,0,1,0,0,1
11303,1,0,0,0,1
11304,0,1,0,0,1
11305,0,1,0,0,1
11306,1,0,0,0,1
11307,0,1,0,0,1
11308,0,1,0,0,1
11309,0,1,0,0,1
11310,0,1,0,0,1
11311,0,0,0,1,1
11312,0,1,0,0,1
11313,1,0,0,0,1
11314,0,1,0,0,1
11315,0,1,0,0,1
11316,0,1,0,0,1
11317,0,1,0,0,1
11318,0,1,0,0,1
11319,0,1,0,0,1
11320,0,1,0,0,1
11321,0,1,0,0,1
11322,1,0,0,0,1
11323,0,1,0,0,1
11324,0,1,0,0,1
11325,0,1,0,0,1
11326,0,1,0,0,1
11327,0,1,0,0,1
11328,0,1,0,0,1
11329,0,1,0,0,1
11330,0,1,0,0,1
11331,0,1,0,0,1
11332,0,1,0,0,1
11333,0,1,0,0,1
11334,0,1,0,0,1
11335,0,1,0,0,1
11336,0,1,0,0,1
11337,0,1,0,0,1
11338,0,1,0,0,1
11339,1,0,0,0,1
11340,0,1,0,0,1
11341,0,1,0,0,1
11342,1,0,0,0,1
11343,0,1,0,0,1
11344,0,1,0,0,1
11345,1,0,0,0,1
11346,0,1,0,0,1
11347,0,1,0,0,1
11348,0,1,0,0,1
11349,0,1,0,0,1
11350,0,1,0,0,1
11351,0,1,0,0,1
11352,0,1,0,0,1
11353,0,1,0,0,1
11354,0,1,0,0,1
11355,0,1,0,0,1
11356,0,1,0,0,1
11357,0,1,0,0,1
11358,0,1,0,0,1
11359,0,1,0,0,1
11360,0,1,0,0,1
11361,0,1,0,0,1
11362,0,1,0,0,1
11363,0,1,0,0,1
11364,0,1,0,0,1
11365,0,1,0,0,1
11366,0,1,0,0,1
11367,0,1,0,0,1
11368,0,0,0,1,1
11369,0,1,0,0,1
11370,0,1,0,0,1
11371,0,1,0,0,1
11372,0,1,0,0,1
11373,0,1,0,0,1
11374,0,1,0,0,1
11375,0,1,0,0,1
11376,0,1,0,0,1
11377,0,1,0,0,1
11378,0,1,0,0,1
11379,0,1,0,0,1
11380,0,1,0,0,1
11381,0,1,0,0,1
11382,0,1,0,0,1
11383,0,1,0,0,1
11384,0,1,0,0,1
11385,1,0,0,0,1
11386,0,1,0,0,1
11387,0,1,0,0,1
11388,0,1,0,0,1
11389,0,1,0,0,1
11390,0,1,0,0,1
11391,0,1,0,0,1
11392,0,1,0,0,1
11393,0,1,0,0,1
11394,0,1,0,0,1
11395,0,1,0,0,1
11396,0,1,0,0,1
11397,0,1,0,0,1
11398,0,1,0,0,1
11399,0,1,0,0,1
11400,0,1,0,0,1
11401,0,1,0,0,1
11402,0,1,0,0,1
11403,0,1,0,0,1
11404,0,1,0,0,1
11405,0,1,0,0,1
11406,0,1,0,0,1
11407,0,1,0,0,1
11408,0,1,0,0,1
11409,0,1,0,0,1
11410,0,1,0,0,1
11411,0,1,0,0,1
11412,0,1,0,0,1
11413,0,1,0,0,1
11414,0,1,0,0,1
11415,0,1,0,0,1
11416,0,1,0,0,1
11417,1,0,0,0,1
11418,0,1,0,0,1
11419,0,1,0,0,1
11420,0,1,0,0,1
11421,0,1,0,0,1
11422,0,1,0,0,1
11423,0,1,0,0,1
11424,0,1,0,0,1
11425,0,1,0,0,1
11426,0,1,0,0,1
11427,0,1,0,0,1
11428,0,1,0,0,1
11429,0,1,0,0,1
11430,0,1,0,0,1
11431,0,1,0,0,1
11432,0,1,0,0,1
11433,0,1,0,0,1
11434,0,1,0,0,1
11435,0,1,0,0,1
11436,0,1,0,0,1
11437,0,1,0,0,1
11438,0,1,0,0,1
11439,0,1,0,0,1
11440,0,1,0,0,1
11441,0,1,0,0,1
11442,0,1,0,0,1
11443,0,1,0,0,1
11444,1,0,0,0,1
11445,0,1,0,0,1
11446,1,0,0,0,1
11447,0,1,0,0,1
11448,0,1,0,0,1
11449,0,1,0,0,1
11450,0,1,0,0,1
11451,0,1,0,0,1
11452,0,0,0,1,1
11453,0,1,0,0,1
11454,0,1,0,0,1
11455,0,1,0,0,1
11456,0,1,0,0,1
11457,0,1,0,0,1
11458,0,1,0,0,1
11459,1,0,0,0,1
11460,0,1,0,0,1
11461,0,1,0,0,1
11462,0,1,0,0,1
11463,0,1,0,0,1
11464,0,1,0,0,1
11465,0,1,0,0,1
11466,0,1,0,0,1
11467,0,1,0,0,1
11468,0,1,0,0,1
11469,0,1,0,0,1
11470,0,1,0,0,1
11471,1,0,0,0,1
11472,0,1,0,0,1
11473,0,1,0,0,1
11474,0,1,0,0,1
11475,0,1,0,0,1
11476,0,1,0,0,1
11477,0,1,0,0,1
11478,0,1,0,0,1
11479,0,1,0,0,1
11480,0,1,0,0,1
11481,1,0,0,0,1
11482,0,1,0,0,1
11483,0,1,0,0,1
11484,0,1,0,0,1
11485,0,1,0,0,1
11486,0,1,0,0,1
11487,0,1,0,0,1
11488,0,1,0,0,1
11489,0,1,0,0,1
11490,0,1,0,0,1
11491,0,1,0,0,1
11492,0,1,0,0,1
11493,0,1,0,0,1
11494,0,1,0,0,1
11495,0,1,0,0,1
11496,0,1,0,0,1
11497,0,1,0,0,1
11498,0,1,0,0,1
11499,0,1,0,0,1
11500,0,1,0,0,1
11501,0,1,0,0,1
11502,0,1,0,0,1
11503,0,1,0,0,1
11504,0,1,0,0,1
11505,0,1,0,0,1
11506,0,1,0,0,1
11507,0,1,0,0,1
11508,0,1,0,0,1
11509,0,1,0,0,1
11510,0,1,0,0,1
11511,0,1,0,0,1
11512,0,1,0,0,1
11513,0,1,0,0,1
11514,0,1,0,0,1
11515,0,1,0,0,1
11516,0,1,0,0,1
11517,1,0,0,0,1
11518,0,1,0,0,1
11519,0,1,0,0,1
11520,0,1,0,0,1
11521,0,1,0,0,1
11522,0,1,0,0,1
11523,0,1,0,0,1
11524,0,1,0,0,1
11525,0,1,0,0,1
11526,0,1,0,0,1
11527,0,0,0,1,1
11528,0,1,0,0,1
11529,0,0,0,1,1
11530,0,0,1,0,1
11531,0,1,0,0,1
11532,0,1,0,0,1
11533,0,1,0,0,1
11534,0,1,0,0,1
11535,0,1,0,0,1
11536,0,1,0,0,1
11537,0,1,0,0,1
11538,0,1,0,0,1
11539,0,1,0,0,1
11540,0,1,0,0,1
11541,0,1,0,0,1
11542,0,1,0,0,1
11543,0,1,0,0,1
11544,0,1,0,0,1
11545,0,1,0,0,1
11546,0,1,0,0,1
11547,0,1,0,0,1
11548,0,1,0,0,1
11549,1,0,0,0,1
11550,0,1,0,0,1
11551,0,1,0,0,1
11552,0,1,0,0,1
11553,0,1,0,0,1
11554,0,1,0,0,1
11555,0,1,0,0,1
11556,0,1,0,0,1
11557,1,0,0,0,1
11558,0,1,0,0,1
11559,0,1,0,0,1
11560,0,1,0,0,1
11561,0,1,0,0,1
11562,0,1,0,0,1
11563,0,1,0,0,1
11564,0,1,0,0,1
11565,0,1,0,0,1
11566,0,1,0,0,1
11567,0,1,0,0,1
11568,1,0,0,0,1
11569,1,0,0,0,1
11570,1,0,0,0,1
11571,0,1,0,0,1
11572,0,1,0,0,1
11573,1,0,0,0,1
11574,0,1,0,0,1
11575,0,1,0,0,1
11576,0,1,0,0,1
11577,0,1,0,0,1
11578,0,1,0,0,1
11579,0,1,0,0,1
11580,0,1,0,0,1
11581,0,1,0,0,1
11582,0,1,0,0,1
11583,0,1,0,0,1
11584,0,1,0,0,1
11585,0,1,0,0,1
11586,0,1,0,0,1
11587,0,1,0,0,1
11588,0,1,0,0,1
11589,0,1,0,0,1
11590,0,1,0,0,1
11591,0,1,0,0,1
11592,0,1,0,0,1
11593,0,1,0,0,1
11594,0,1,0,0,1
11595,0,1,0,0,1
11596,0,1,0,0,1
11597,0,1,0,0,1
11598,0,1,0,0,1
11599,0,1,0,0,1
11600,0,1,0,0,1
11601,0,1,0,0,1
11602,0,1,0,0,1
11603,0,1,0,0,1
11604,0,1,0,0,1
11605,0,1,0,0,1
11606,0,1,0,0,1
11607,0,1,0,0,1
11608,0,1,0,0,1
11609,0,1,0,0,1
11610,1,0,0,0,1
11611,0,1,0,0,1
11612,0,1,0,0,1
11613,0,1,0,0,1
11614,0,1,0,0,1
11615,0,1,0,0,1
11616,0,1,0,0,1
11617,0,1,0,0,1
11618,0,1,0,0,1
11619,0,1,0,0,1
11620,0,1,0,0,1
11621,0,1,0,0,1
11622,0,1,0,0,1
11623,0,1,0,0,1
11624,0,1,0,0,1
11625,0,1,0,0,1
11626,0,1,0,0,1
11627,0,1,0,0,1
11628,0,1,0,0,1
11629,0,1,0,0,1
11630,0,1,0,0,1
11631,0,1,0,0,1
11632,0,1,0,0,1
11633,0,1,0,0,1
11634,0,1,0,0,1
11635,0,1,0,0,1
11636,0,1,0,0,1
11637,0,1,0,0,1
11638,0,1,0,0,1
11639,0,1,0,0,1
11640,0,1,0,0,1
11641,1,0,0,0,1
11642,0,1,0,0,1
11643,0,1,0,0,1
11644,0,1,0,0,1
11645,0,1,0,0,1
11646,0,1,0,0,1
11647,0,1,0,0,1
11648,1,0,0,0,1
11649,0,0,0,1,1
11650,0,1,0,0,1
11651,0,1,0,0,1
11652,0,1,0,0,1
11653,0,1,0,0,1
11654,0,1,0,0,1
11655,0,1,0,0,1
11656,1,0,0,0,1
11657,0,1,0,0,1
11658,0,1,0,0,1
11659,0,1,0,0,1
11660,0,1,0,0,1
11661,0,1,0,0,1
11662,0,1,0,0,1
11663,0,1,0,0,1
11664,0,1,0,0,1
11665,0,1,0,0,1
11666,0,1,0,0,1
11667,0,1,0,0,1
11668,0,1,0,0,1
11669,0,1,0,0,1
11670,0,1,0,0,1
11671,0,1,0,0,1
11672,0,1,0,0,1
11673,0,1,0,0,1
11674,1,0,0,0,1
11675,0,1,0,0,1
11676,1,0,0,0,1
11677,0,1,0,0,1
11678,1,0,0,0,1
11679,0,1,0,0,1
11680,0,1,0,0,1
11681,0,1,0,0,1
11682,0,1,0,0,1
11683,0,1,0,0,1
11684,0,1,0,0,1
11685,0,1,0,0,1
11686,0,1,0,0,1
11687,0,0,1,0,1
11688,0,1,0,0,1
11689,0,1,0,0,1
11690,0,1,0,0,1
11691,0,1,0,0,1
11692,1,0,0,0,1
11693,0,1,0,0,1
11694,0,1,0,0,1
11695,0,1,0,0,1
11696,0,1,0,0,1
11697,0,1,0,0,1
11698,0,1,0,0,1
11699,0,1,0,0,1
11700,0,1,0,0,1
11701,1,0,0,0,1
11702,0,1,0,0,1
11703,0,1,0,0,1
11704,0,1,0,0,1
11705,1,0,0,0,1
11706,1,0,0,0,1
11707,1,0,0,0,1
11708,0,1,0,0,1
11709,0,1,0,0,1
11710,0,1,0,0,1
11711,0,0,0,1,1
11712,0,1,0,0,1
11713,0,1,0,0,1
11714,0,1,0,0,1
11715,0,1,0,0,1
11716,1,0,0,0,1
11717,0,1,0,0,1
11718,0,1,0,0,1
11719,0,1,0,0,1
11720,0,1,0,0,1
11721,0,1,0,0,1
11722,0,1,0,0,1
11723,0,1,0,0,1
11724,0,1,0,0,1
11725,0,1,0,0,1
11726,0,0,0,1,1
11727,0,1,0,0,1
11728,0,1,0,0,1
11729,0,1,0,0,1
11730,0,1,0,0,1
11731,0,1,0,0,1
11732,0,1,0,0,1
11733,0,1,0,0,1
11734,0,1,0,0,1
11735,0,1,0,0,1
11736,0,1,0,0,1
11737,0,1,0,0,1
11738,0,1,0,0,1
11739,0,1,0,0,1
11740,0,1,0,0,1
11741,0,1,0,0,1
11742,0,1,0,0,1
11743,1,0,0,0,1
11744,0,1,0,0,1
11745,0,1,0,0,1
11746,0,1,0,0,1
11747,0,1,0,0,1
11748,0,1,0,0,1
11749,0,1,0,0,1
11750,0,1,0,0,1
11751,0,1,0,0,1
11752,0,1,0,0,1
11753,0,1,0,0,1
11754,0,1,0,0,1
11755,0,1,0,0,1
11756,0,1,0,0,1
11757,0,1,0,0,1
11758,0,1,0,0,1
11759,0,1,0,0,1
11760,0,1,0,0,1
11761,0,1,0,0,1
11762,0,1,0,0,1
11763,1,0,0,0,1
11764,0,1,0,0,1
11765,1,0,0,0,1
11766,0,1,0,0,1
11767,0,1,0,0,1
11768,0,0,1,0,1
11769,0,1,0,0,1
11770,0,1,0,0,1
11771,0,1,0,0,1
11772,0,1,0,0,1
11773,0,1,0,0,1
11774,0,1,0,0,1
11775,0,1,0,0,1
11776,0,0,0,1,1
11777,0,1,0,0,1
11778,1,0,0,0,1
11779,0,1,0,0,1
11780,0,1,0,0,1
11781,0,1,0,0,1
11782,0,1,0,0,1
11783,0,1,0,0,1
11784,0,1,0,0,1
11785,0,1,0,0,1
11786,0,1,0,0,1
11787,0,1,0,0,1
11788,0,1,0,0,1
11789,0,1,0,0,1
11790,0,1,0,0,1
11791,0,1,0,0,1
11792,0,1,0,0,1
11793,0,1,0,0,1
11794,0,1,0,0,1
11795,0,1,0,0,1
11796,0,1,0,0,1
11797,0,1,0,0,1
11798,0,1,0,0,1
11799,1,0,0,0,1
11800,0,1,0,0,1
11801,0,1,0,0,1
11802,0,1,0,0,1
11803,0,1,0,0,1
11804,0,1,0,0,1
11805,0,1,0,0,1
11806,0,1,0,0,1
11807,0,1,0,0,1
11808,0,1,0,0,1
11809,0,1,0,0,1
11810,0,1,0,0,1
11811,0,1,0,0,1
11812,0,1,0,0,1
11813,0,1,0,0,1
11814,0,1,0,0,1
11815,0,1,0,0,1
11816,1,0,0,0,1
11817,0,1,0,0,1
11818,0,1,0,0,1
11819,0,1,0,0,1
11820,0,1,0,0,1
11821,0,1,0,0,1
11822,0,1,0,0,1
11823,0,1,0,0,1
11824,0,1,0,0,1
11825,1,0,0,0,1
11826,1,0,0,0,1
11827,0,1,0,0,1
11828,0,1,0,0,1
11829,1,0,0,0,1
11830,0,1,0,0,1
11831,0,1,0,0,1
11832,1,0,0,0,1
11833,0,1,0,0,1
11834,0,1,0,0,1
11835,0,1,0,0,1
11836,0,1,0,0,1
11837,1,0,0,0,1
11838,0,1,0,0,1
11839,1,0,0,0,1
11840,1,0,0,0,1
11841,0,1,0,0,1
11842,1,0,0,0,1
11843,0,1,0,0,1
11844,0,1,0,0,1
11845,0,1,0,0,1
11846,0,1,0,0,1
11847,0,1,0,0,1
11848,0,1,0,0,1
11849,0,1,0,0,1
11850,0,1,0,0,1
11851,0,1,0,0,1
11852,0,1,0,0,1
11853,0,1,0,0,1
11854,0,1,0,0,1
11855,0,1,0,0,1
11856,0,1,0,0,1
11857,0,1,0,0,1
11858,0,1,0,0,1
11859,0,1,0,0,1
11860,0,1,0,0,1
11861,0,1,0,0,1
11862,1,0,0,0,1
11863,0,1,0,0,1
11864,0,1,0,0,1
11865,0,1,0,0,1
11866,0,1,0,0,1
11867,0,1,0,0,1
11868,0,0,0,1,1
11869,0,1,0,0,1
11870,0,1,0,0,1
11871,1,0,0,0,1
11872,0,1,0,0,1
11873,0,1,0,0,1
11874,0,1,0,0,1
11875,1,0,0,0,1
11876,0,1,0,0,1
11877,0,1,0,0,1
11878,0,1,0,0,1
11879,0,1,0,0,1
11880,0,1,0,0,1
11881,0,1,0,0,1
11882,0,1,0,0,1
11883,0,1,0,0,1
11884,0,1,0,0,1
11885,0,1,0,0,1
11886,0,0,0,1,1
11887,0,1,0,0,1
11888,0,1,0,0,1
11889,0,1,0,0,1
11890,0,1,0,0,1
11891,0,1,0,0,1
11892,1,0,0,0,1
11893,0,1,0,0,1
11894,0,1,0,0,1
11895,0,1,0,0,1
11896,0,1,0,0,1
11897,0,1,0,0,1
11898,0,1,0,0,1
11899,0,1,0,0,1
11900,0,1,0,0,1
11901,0,0,0,1,1
11902,0,1,0,0,1
11903,0,1,0,0,1
11904,0,1,0,0,1
11905,0,1,0,0,1
11906,0,1,0,0,1
11907,0,1,0,0,1
11908,1,0,0,0,1
11909,0,1,0,0,1
11910,0,1,0,0,1
11911,0,1,0,0,1
11912,0,1,0,0,1
11913,0,1,0,0,1
11914,0,1,0,0,1
11915,0,1,0,0,1
11916,0,1,0,0,1
11917,0,1,0,0,1
11918,0,1,0,0,1
11919,0,1,0,0,1
11920,0,1,0,0,1
11921,0,1,0,0,1
11922,0,1,0,0,1
11923,0,0,0,1,1
11924,0,1,0,0,1
11925,0,1,0,0,1
11926,0,1,0,0,1
11927,0,1,0,0,1
11928,0,1,0,0,1
11929,0,1,0,0,1
11930,0,1,0,0,1
11931,0,1,0,0,1
11932,0,1,0,0,1
11933,0,1,0,0,1
11934,0,1,0,0,1
11935,0,1,0,0,1
11936,0,1,0,0,1
11937,0,1,0,0,1
11938,0,1,0,0,1
11939,0,1,0,0,1
11940,1,0,0,0,1
11941,0,1,0,0,1
11942,0,1,0,0,1
11943,0,1,0,0,1
11944,0,0,0,1,1
11945,0,1,0,0,1
11946,0,0,0,1,1
11947,0,1,0,0,1
11948,0,1,0,0,1
11949,1,0,0,0,1
11950,0,1,0,0,1
11951,0,1,0,0,1
11952,0,1,0,0,1
11953,0,1,0,0,1
11954,0,1,0,0,1
11955,0,1,0,0,1
11956,0,1,0,0,1
11957,0,1,0,0,1
11958,0,1,0,0,1
11959,0,1,0,0,1
11960,0,1,0,0,1
11961,1,0,0,0,1
11962,0,1,0,0,1
11963,0,1,0,0,1
11964,0,1,0,0,1
11965,1,0,0,0,1
11966,0,1,0,0,1
11967,0,1,0,0,1
11968,0,1,0,0,1
11969,1,0,0,0,1
11970,1,0,0,0,1
11971,0,1,0,0,1
11972,0,1,0,0,1
11973,0,1,0,0,1
11974,0,1,0,0,1
11975,0,1,0,0,1
11976,0,1,0,0,1
11977,1,0,0,0,1
11978,0,1,0,0,1
11979,0,1,0,0,1
11980,0,1,0,0,1
11981,0,1,0,0,1
11982,0,1,0,0,1
11983,0,1,0,0,1
11984,0,1,0,0,1
11985,0,1,0,0,1
11986,0,1,0,0,1
11987,0,1,0,0,1
11988,0,1,0,0,1
11989,0,1,0,0,1
11990,0,0,0,1,1
11991,0,1,0,0,1
11992,1,0,0,0,1
11993,0,1,0,0,1
11994,0,1,0,0,1
11995,0,1,0,0,1
11996,0,1,0,0,1
11997,0,1,0,0,1
11998,0,0,1,0,1
11999,0,1,0,0,1
12000,0,1,0,0,1
12001,1,0,0,0,1
12002,0,1,0,0,1
12003,1,0,0,0,1
12004,0,1,0,0,1
12005,0,1,0,0,1
12006,0,1,0,0,1
12007,0,1,0,0,1
12008,0,1,0,0,1
12009,0,1,0,0,1
12010,0,1,0,0,1
12011,0,1,0,0,1
12012,0,1,0,0,1
12013,0,1,0,0,1
12014,0,1,0,0,1
12015,0,1,0,0,1
12016,0,1,0,0,1
12017,0,1,0,0,1
12018,0,1,0,0,1
12019,1,0,0,0,1
12020,0,1,0,0,1
12021,1,0,0,0,1
12022,0,1,0,0,1
12023,0,1,0,0,1
12024,0,1,0,0,1
12025,0,1,0,0,1
12026,0,1,0,0,1
12027,1,0,0,0,1
12028,0,1,0,0,1
12029,0,1,0,0,1
12030,0,1,0,0,1
12031,0,1,0,0,1
12032,0,1,0,0,1
12033,0,1,0,0,1
12034,0,1,0,0,1
12035,0,1,0,0,1
12036,0,1,0,0,1
12037,0,1,0,0,1
12038,1,0,0,0,1
12039,0,1,0,0,1
12040,0,1,0,0,1
12041,0,1,0,0,1
12042,0,1,0,0,1
12043,0,1,0,0,1
12044,0,1,0,0,1
12045,0,1,0,0,1
12046,1,0,0,0,1
12047,0,1,0,0,1
12048,0,1,0,0,1
12049,0,1,0,0,1
12050,0,1,0,0,1
12051,0,1,0,0,1
12052,0,1,0,0,1
12053,0,1,0,0,1
12054,0,1,0,0,1
12055,0,1,0,0,1
12056,0,1,0,0,1
12057,0,1,0,0,1
12058,0,1,0,0,1
12059,1,0,0,0,1
12060,0,1,0,0,1
12061,1,0,0,0,1
12062,0,1,0,0,1
12063,0,1,0,0,1
12064,0,0,0,1,1
12065,0,1,0,0,1
12066,0,1,0,0,1
12067,0,1,0,0,1
12068,0,1,0,0,1
12069,0,1,0,0,1
12070,0,1,0,0,1
12071,0,1,0,0,1
12072,1,0,0,0,1
12073,1,0,0,0,1
12074,0,1,0,0,1
12075,0,1,0,0,1
12076,0,1,0,0,1
12077,0,1,0,0,1
12078,0,1,0,0,1
12079,0,1,0,0,1
12080,0,1,0,0,1
12081,0,1,0,0,1
12082,0,1,0,0,1
12083,0,1,0,0,1
12084,0,1,0,0,1
12085,0,1,0,0,1
12086,0,1,0,0,1
12087,0,1,0,0,1
12088,0,1,0,0,1
12089,0,1,0,0,1
12090,0,1,0,0,1
12091,0,0,0,1,1
12092,0,1,0,0,1
12093,0,1,0,0,1
12094,0,1,0,0,1
12095,0,1,0,0,1
12096,0,1,0,0,1
12097,0,1,0,0,1
12098,1,0,0,0,1
12099,0,1,0,0,1
12100,0,1,0,0,1
12101,1,0,0,0,1
12102,0,1,0,0,1
12103,0,1,0,0,1
12104,0,1,0,0,1
12105,0,1,0,0,1
12106,0,1,0,0,1
12107,0,1,0,0,1
12108,0,1,0,0,1
12109,0,1,0,0,1
12110,0,1,0,0,1
12111,0,1,0,0,1
12112,0,1,0,0,1
12113,0,1,0,0,1
12114,0,1,0,0,1
12115,0,1,0,0,1
12116,0,1,0,0,1
12117,1,0,0,0,1
12118,0,1,0,0,1
12119,1,0,0,0,1
12120,0,1,0,0,1
12121,0,1,0,0,1
12122,0,1,0,0,1
12123,1,0,0,0,1
12124,0,1,0,0,1
12125,0,1,0,0,1
12126,0,1,0,0,1
12127,0,1,0,0,1
12128,0,0,0,1,1
12129,0,1,0,0,1
12130,1,0,0,0,1
12131,0,1,0,0,1
12132,0,1,0,0,1
12133,1,0,0,0,1
12134,0,1,0,0,1
12135,1,0,0,0,1
12136,0,1,0,0,1
12137,0,1,0,0,1
12138,0,1,0,0,1
12139,1,0,0,0,1
12140,0,1,0,0,1
12141,0,1,0,0,1
12142,1,0,0,0,1
12143,0,1,0,0,1
12144,0,1,0,0,1
12145,0,1,0,0,1
12146,0,1,0,0,1
12147,0,1,0,0,1
12148,0,1,0,0,1
12149,0,1,0,0,1
12150,0,1,0,0,1
12151,0,1,0,0,1
12152,0,1,0,0,1
12153,0,1,0,0,1
12154,1,0,0,0,1
12155,0,1,0,0,1
12156,1,0,0,0,1
12157,0,1,0,0,1
12158,0,1,0,0,1
12159,0,1,0,0,1
12160,0,1,0,0,1
12161,0,1,0,0,1
12162,0,1,0,0,1
12163,0,1,0,0,1
12164,0,1,0,0,1
12165,0,1,0,0,1
12166,0,1,0,0,1
12167,0,1,0,0,1
12168,0,1,0,0,1
12169,1,0,0,0,1
12170,0,1,0,0,1
12171,1,0,0,0,1
12172,0,0,0,1,1
12173,1,0,0,0,1
12174,0,1,0,0,1
12175,0,1,0,0,1
12176,1,0,0,0,1
12177,0,1,0,0,1
12178,1,0,0,0,1
12179,0,1,0,0,1
12180,0,1,0,0,1
12181,0,1,0,0,1
12182,0,1,0,0,1
12183,0,1,0,0,1
12184,0,1,0,0,1
12185,0,1,0,0,1
12186,0,1,0,0,1
12187,0,1,0,0,1
12188,0,0,0,1,1
12189,0,1,0,0,1
12190,0,1,0,0,1
12191,0,1,0,0,1
12192,0,1,0,0,1
12193,0,1,0,0,1
12194,0,1,0,0,1
12195,0,1,0,0,1
12196,0,1,0,0,1
12197,0,1,0,0,1
12198,0,1,0,0,1
12199,0,1,0,0,1
12200,0,1,0,0,1
12201,1,0,0,0,1
12202,0,1,0,0,1
12203,0,1,0,0,1
12204,0,1,0,0,1
12205,0,1,0,0,1
12206,0,1,0,0,1
12207,0,1,0,0,1
12208,0,1,0,0,1
12209,0,1,0,0,1
12210,1,0,0,0,1
12211,0,1,0,0,1
12212,0,1,0,0,1
12213,0,1,0,0,1
12214,0,1,0,0,1
12215,0,1,0,0,1
12216,0,1,0,0,1
12217,0,1,0,0,1
12218,1,0,0,0,1
12219,0,1,0,0,1
12220,0,1,0,0,1
12221,0,1,0,0,1
12222,0,1,0,0,1
12223,1,0,0,0,1
12224,0,1,0,0,1
12225,0,1,0,0,1
12226,1,0,0,0,1
12227,0,1,0,0,1
12228,1,0,0,0,1
12229,0,1,0,0,1
12230,0,1,0,0,1
12231,0,1,0,0,1
12232,0,1,0,0,1
12233,0,1,0,0,1
12234,0,1,0,0,1
12235,0,1,0,0,1
12236,0,1,0,0,1
12237,1,0,0,0,1
12238,0,1,0,0,1
12239,0,1,0,0,1
12240,0,1,0,0,1
12241,0,1,0,0,1
12242,0,1,0,0,1
12243,0,1,0,0,1
12244,0,1,0,0,1
12245,0,1,0,0,1
12246,0,1,0,0,1
12247,0,1,0,0,1
12248,0,0,1,0,1
12249,0,1,0,0,1
12250,0,1,0,0,1
12251,0,1,0,0,1
12252,1,0,0,0,1
12253,0,1,0,0,1
12254,0,1,0,0,1
12255,0,1,0,0,1
12256,0,1,0,0,1
12257,0,1,0,0,1
12258,0,1,0,0,1
12259,1,0,0,0,1
12260,0,1,0,0,1
12261,0,1,0,0,1
12262,1,0,0,0,1
12263,0,1,0,0,1
12264,0,1,0,0,1
12265,0,1,0,0,1
12266,0,1,0,0,1
12267,0,1,0,0,1
12268,0,1,0,0,1
12269,0,1,0,0,1
12270,0,1,0,0,1
12271,0,1,0,0,1
12272,0,1,0,0,1
12273,0,1,0,0,1
12274,0,1,0,0,1
12275,0,1,0,0,1
12276,0,1,0,0,1
12277,1,0,0,0,1
12278,0,1,0,0,1
12279,0,1,0,0,1
12280,0,1,0,0,1
12281,0,1,0,0,1
12282,0,1,0,0,1
12283,0,1,0,0,1
12284,0,1,0,0,1
12285,0,1,0,0,1
12286,0,1,0,0,1
12287,1,0,0,0,1
12288,1,0,0,0,1
12289,0,1,0,0,1
12290,0,1,0,0,1
12291,0,1,0,0,1
12292,0,1,0,0,1
12293,0,1,0,0,1
12294,1,0,0,0,1
12295,1,0,0,0,1
12296,1,0,0,0,1
12297,1,0,0,0,1
12298,0,1,0,0,1
12299,1,0,0,0,1
12300,0,1,0,0,1
12301,0,1,0,0,1
12302,0,1,0,0,1
12303,1,0,0,0,1
12304,0,1,0,0,1
12305,0,1,0,0,1
12306,0,1,0,0,1
12307,1,0,0,0,1
12308,1,0,0,0,1
12309,0,1,0,0,1
12310,1,0,0,0,1
12311,1,0,0,0,1
12312,0,1,0,0,1
12313,0,1,0,0,1
12314,0,1,0,0,1
12315,0,1,0,0,1
12316,1,0,0,0,1
12317,1,0,0,0,1
12318,1,0,0,0,1
12319,1,0,0,0,1
12320,0,1,0,0,1
12321,1,0,0,0,1
12322,0,1,0,0,1
12323,0,1,0,0,1
12324,1,0,0,0,1
12325,0,1,0,0,1
12326,0,1,0,0,1
12327,0,1,0,0,1
12328,0,1,0,0,1
12329,0,1,0,0,1
12330,0,1,0,0,1
12331,0,1,0,0,1
12332,0,1,0,0,1
12333,0,1,0,0,1
12334,0,1,0,0,1
12335,0,1,0,0,1
12336,0,1,0,0,1
12337,1,0,0,0,1
12338,0,1,0,0,1
12339,1,0,0,0,1
12340,0,1,0,0,1
12341,1,0,0,0,1
12342,0,1,0,0,1
12343,0,1,0,0,1
12344,0,1,0,0,1
12345,0,1,0,0,1
12346,0,1,0,0,1
12347,0,1,0,0,1
12348,0,1,0,0,1
12349,1,0,0,0,1
12350,1,0,0,0,1
12351,0,1,0,0,1
12352,0,1,0,0,1
12353,0,1,0,0,1
12354,1,0,0,0,1
12355,0,1,0,0,1
12356,0,1,0,0,1
12357,0,1,0,0,1
12358,0,1,0,0,1
12359,0,1,0,0,1
12360,0,1,0,0,1
12361,0,1,0,0,1
12362,0,1,0,0,1
12363,0,1,0,0,1
12364,0,1,0,0,1
12365,1,0,0,0,1
12366,0,1,0,0,1
12367,0,1,0,0,1
12368,0,1,0,0,1
12369,0,0,0,1,1
12370,0,1,0,0,1
12371,0,1,0,0,1
12372,0,1,0,0,1
12373,0,1,0,0,1
12374,0,1,0,0,1
12375,0,1,0,0,1
12376,0,1,0,0,1
12377,0,1,0,0,1
12378,0,1,0,0,1
12379,0,1,0,0,1
12380,0,1,0,0,1
12381,0,1,0,0,1
12382,0,1,0,0,1
12383,1,0,0,0,1
12384,0,1,0,0,1
12385,0,1,0,0,1
12386,0,1,0,0,1
12387,0,1,0,0,1
12388,0,1,0,0,1
12389,1,0,0,0,1
12390,0,1,0,0,1
12391,0,1,0,0,1
12392,0,1,0,0,1
12393,1,0,0,0,1
12394,0,1,0,0,1
12395,0,1,0,0,1
12396,1,0,0,0,1
12397,0,1,0,0,1
12398,0,1,0,0,1
12399,0,1,0,0,1
12400,0,1,0,0,1
12401,0,1,0,0,1
12402,0,1,0,0,1
12403,0,1,0,0,1
12404,0,1,0,0,1
12405,1,0,0,0,1
12406,0,1,0,0,1
12407,1,0,0,0,1
12408,0,1,0,0,1
12409,0,1,0,0,1
12410,0,1,0,0,1
12411,0,1,0,0,1
12412,1,0,0,0,1
12413,0,1,0,0,1
12414,0,1,0,0,1
12415,0,1,0,0,1
12416,0,1,0,0,1
12417,0,1,0,0,1
12418,0,1,0,0,1
12419,0,1,0,0,1
12420,0,1,0,0,1
12421,0,1,0,0,1
12422,0,1,0,0,1
12423,0,1,0,0,1
12424,1,0,0,0,1
12425,0,1,0,0,1
12426,0,1,0,0,1
12427,1,0,0,0,1
12428,0,1,0,0,1
12429,0,0,1,0,1
12430,0,1,0,0,1
12431,0,1,0,0,1
12432,0,1,0,0,1
12433,0,1,0,0,1
12434,0,1,0,0,1
12435,0,1,0,0,1
12436,0,1,0,0,1
12437,0,1,0,0,1
12438,0,1,0,0,1
12439,1,0,0,0,1
12440,0,1,0,0,1
12441,0,1,0,0,1
12442,0,1,0,0,1
12443,0,1,0,0,1
12444,0,1,0,0,1
12445,0,1,0,0,1
12446,0,1,0,0,1
12447,0,1,0,0,1
12448,0,1,0,0,1
12449,0,1,0,0,1
12450,0,1,0,0,1
12451,0,1,0,0,1
12452,0,1,0,0,1
12453,0,1,0,0,1
12454,0,1,0,0,1
12455,1,0,0,0,1
12456,1,0,0,0,1
12457,0,1,0,0,1
12458,0,1,0,0,1
12459,0,1,0,0,1
12460,0,1,0,0,1
12461,0,1,0,0,1
12462,0,1,0,0,1
12463,0,1,0,0,1
12464,1,0,0,0,1
12465,0,1,0,0,1
12466,0,1,0,0,1
12467,0,1,0,0,1
12468,0,1,0,0,1
12469,0,0,1,0,1
12470,0,1,0,0,1
12471,1,0,0,0,1
12472,0,1,0,0,1
12473,0,1,0,0,1
12474,0,1,0,0,1
12475,0,1,0,0,1
12476,0,0,0,1,1
12477,1,0,0,0,1
12478,0,1,0,0,1
12479,0,1,0,0,1
12480,0,1,0,0,1
12481,0,1,0,0,1
12482,0,1,0,0,1
12483,0,1,0,0,1
12484,0,1,0,0,1
12485,0,1,0,0,1
12486,0,1,0,0,1
12487,0,1,0,0,1
12488,0,1,0,0,1
12489,0,1,0,0,1
12490,0,1,0,0,1
12491,0,1,0,0,1
12492,0,1,0,0,1
12493,0,1,0,0,1
12494,0,1,0,0,1
12495,0,1,0,0,1
12496,1,0,0,0,1
12497,0,1,0,0,1
12498,0,1,0,0,1
12499,0,1,0,0,1
12500,0,1,0,0,1
12501,0,1,0,0,1
12502,0,1,0,0,1
12503,1,0,0,0,1
12504,0,1,0,0,1
12505,0,1,0,0,1
12506,1,0,0,0,1
12507,0,1,0,0,1
12508,0,1,0,0,1
12509,0,1,0,0,1
12510,0,1,0,0,1
12511,0,1,0,0,1
12512,0,1,0,0,1
12513,0,1,0,0,1
12514,0,1,0,0,1
12515,0,1,0,0,1
12516,0,1,0,0,1
12517,0,1,0,0,1
12518,0,1,0,0,1
12519,0,1,0,0,1
12520,0,1,0,0,1
12521,0,1,0,0,1
12522,0,1,0,0,1
12523,0,1,0,0,1
12524,0,1,0,0,1
12525,0,1,0,0,1
12526,0,1,0,0,1
12527,0,1,0,0,1
12528,0,1,0,0,1
12529,0,1,0,0,1
12530,0,1,0,0,1
12531,0,1,0,0,1
12532,0,1,0,0,1
12533,1,0,0,0,1
12534,1,0,0,0,1
12535,0,1,0,0,1
12536,0,1,0,0,1
12537,0,1,0,0,1
12538,0,1,0,0,1
12539,1,0,0,0,1
12540,0,1,0,0,1
12541,0,1,0,0,1
12542,0,1,0,0,1
12543,0,1,0,0,1
12544,0,1,0,0,1
12545,0,1,0,0,1
12546,1,0,0,0,1
12547,0,1,0,0,1
12548,0,1,0,0,1
12549,0,1,0,0,1
12550,0,1,0,0,1
12551,0,1,0,0,1
12552,0,1,0,0,1
12553,0,1,0,0,1
12554,0,1,0,0,1
12555,0,1,0,0,1
12556,0,1,0,0,1
12557,0,1,0,0,1
12558,0,1,0,0,1
12559,0,1,0,0,1
12560,0,1,0,0,1
12561,1,0,0,0,1
12562,0,1,0,0,1
12563,0,1,0,0,1
12564,0,0,0,1,1
12565,0,1,0,0,1
12566,0,1,0,0,1
12567,0,1,0,0,1
12568,0,1,0,0,1
12569,0,1,0,0,1
12570,0,1,0,0,1
12571,0,1,0,0,1
12572,0,1,0,0,1
12573,0,1,0,0,1
12574,0,1,0,0,1
12575,0,1,0,0,1
12576,0,1,0,0,1
12577,0,1,0,0,1
12578,0,1,0,0,1
12579,0,1,0,0,1
12580,0,1,0,0,1
12581,0,1,0,0,1
12582,0,1,0,0,1
12583,0,1,0,0,1
12584,0,1,0,0,1
12585,0,1,0,0,1
12586,0,1,0,0,1
12587,0,1,0,0,1
12588,0,1,0,0,1
12589,0,1,0,0,1
12590,0,1,0,0,1
12591,0,1,0,0,1
12592,0,1,0,0,1
12593,0,1,0,0,1
12594,0,1,0,0,1
12595,0,1,0,0,1
12596,0,1,0,0,1
12597,1,0,0,0,1
12598,0,1,0,0,1
12599,1,0,0,0,1
12600,0,1,0,0,1
12601,0,1,0,0,1
12602,0,1,0,0,1
12603,0,1,0,0,1
12604,0,1,0,0,1
12605,0,1,0,0,1
12606,0,0,1,0,1
12607,0,1,0,0,1
12608,1,0,0,0,1
12609,0,1,0,0,1
12610,1,0,0,0,1
12611,0,1,0,0,1
12612,0,1,0,0,1
12613,0,1,0,0,1
12614,0,1,0,0,1
12615,1,0,0,0,1
12616,0,1,0,0,1
12617,0,1,0,0,1
12618,0,1,0,0,1
12619,0,1,0,0,1
12620,0,1,0,0,1
12621,1,0,0,0,1
12622,1,0,0,0,1
12623,0,0,1,0,1
12624,1,0,0,0,1
12625,0,1,0,0,1
12626,0,1,0,0,1
12627,0,1,0,0,1
12628,0,1,0,0,1
12629,0,1,0,0,1
12630,0,1,0,0,1
12631,0,1,0,0,1
12632,0,1,0,0,1
12633,0,1,0,0,1
12634,0,1,0,0,1
12635,0,1,0,0,1
12636,0,1,0,0,1
12637,0,1,0,0,1
12638,0,1,0,0,1
12639,0,1,0,0,1
12640,0,1,0,0,1
12641,1,0,0,0,1
12642,0,1,0,0,1
12643,0,1,0,0,1
12644,1,0,0,0,1
12645,0,1,0,0,1
12646,0,1,0,0,1
12647,0,1,0,0,1
12648,0,1,0,0,1
12649,0,1,0,0,1
12650,0,1,0,0,1
12651,0,1,0,0,1
12652,0,1,0,0,1
12653,0,1,0,0,1
12654,0,1,0,0,1
12655,0,1,0,0,1
12656,0,1,0,0,1
12657,0,1,0,0,1
12658,0,1,0,0,1
12659,0,1,0,0,1
12660,0,1,0,0,1
12661,1,0,0,0,1
12662,0,1,0,0,1
12663,0,1,0,0,1
12664,0,1,0,0,1
12665,0,1,0,0,1
12666,0,1,0,0,1
12667,0,1,0,0,1
12668,0,1,0,0,1
12669,0,1,0,0,1
12670,0,1,0,0,1
12671,0,1,0,0,1
12672,0,1,0,0,1
12673,0,1,0,0,1
12674,0,1,0,0,1
12675,0,1,0,0,1
12676,1,0,0,0,1
12677,0,1,0,0,1
12678,1,0,0,0,1
12679,0,1,0,0,1
12680,0,1,0,0,1
12681,0,1,0,0,1
12682,0,1,0,0,1
12683,0,1,0,0,1
12684,0,1,0,0,1
12685,0,1,0,0,1
12686,0,1,0,0,1
12687,0,1,0,0,1
12688,0,0,0,1,1
12689,0,1,0,0,1
12690,0,1,0,0,1
12691,0,1,0,0,1
12692,0,1,0,0,1
12693,0,0,0,1,1
12694,0,1,0,0,1
12695,0,1,0,0,1
12696,0,1,0,0,1
12697,0,1,0,0,1
12698,0,1,0,0,1
12699,0,1,0,0,1
12700,0,1,0,0,1
12701,1,0,0,0,1
12702,0,1,0,0,1
12703,1,0,0,0,1
12704,0,1,0,0,1
12705,0,1,0,0,1
12706,0,1,0,0,1
12707,0,1,0,0,1
12708,0,1,0,0,1
12709,0,1,0,0,1
12710,0,1,0,0,1
12711,0,1,0,0,1
12712,0,1,0,0,1
12713,0,1,0,0,1
12714,0,1,0,0,1
12715,0,1,0,0,1
12716,0,1,0,0,1
12717,0,1,0,0,1
12718,0,1,0,0,1
12719,1,0,0,0,1
12720,0,1,0,0,1
12721,0,1,0,0,1
12722,0,1,0,0,1
12723,0,1,0,0,1
12724,0,1,0,0,1
12725,0,1,0,0,1
12726,0,1,0,0,1
12727,0,1,0,0,1
12728,0,1,0,0,1
12729,1,0,0,0,1
12730,0,1,0,0,1
12731,0,1,0,0,1
12732,0,0,1,0,1
12733,0,1,0,0,1
12734,0,1,0,0,1
12735,1,0,0,0,1
12736,0,1,0,0,1
12737,0,1,0,0,1
12738,0,1,0,0,1
12739,0,1,0,0,1
12740,1,0,0,0,1
12741,0,1,0,0,1
12742,0,1,0,0,1
12743,0,1,0,0,1
12744,0,1,0,0,1
12745,0,1,0,0,1
12746,0,1,0,0,1
12747,0,1,0,0,1
12748,0,1,0,0,1
12749,1,0,0,0,1
12750,0,1,0,0,1
12751,1,0,0,0,1
12752,0,1,0,0,1
12753,0,1,0,0,1
12754,0,1,0,0,1
12755,0,1,0,0,1
12756,1,0,0,0,1
12757,0,1,0,0,1
12758,0,1,0,0,1
12759,0,1,0,0,1
12760,0,1,0,0,1
12761,0,1,0,0,1
12762,0,1,0,0,1
12763,0,1,0,0,1
12764,0,1,0,0,1
12765,1,0,0,0,1
12766,0,1,0,0,1
12767,0,1,0,0,1
12768,0,0,0,1,1
12769,0,1,0,0,1
12770,0,1,0,0,1
12771,0,1,0,0,1
12772,0,1,0,0,1
12773,0,1,0,0,1
12774,0,1,0,0,1
12775,0,1,0,0,1
12776,0,1,0,0,1
12777,0,1,0,0,1
12778,0,1,0,0,1
12779,0,1,0,0,1
12780,1,0,0,0,1
12781,0,1,0,0,1
12782,0,1,0,0,1
12783,1,0,0,0,1
12784,0,1,0,0,1
12785,0,1,0,0,1
12786,0,1,0,0,1
12787,0,1,0,0,1
12788,1,0,0,0,1
12789,0,1,0,0,1
12790,0,1,0,0,1
12791,0,1,0,0,1
12792,0,1,0,0,1
12793,0,1,0,0,1
12794,0,1,0,0,1
12795,1,0,0,0,1
12796,0,1,0,0,1
12797,0,1,0,0,1
12798,0,1,0,0,1
12799,0,1,0,0,1
12800,0,1,0,0,1
12801,0,1,0,0,1
12802,0,1,0,0,1
12803,0,1,0,0,1
12804,0,1,0,0,1
12805,0,1,0,0,1
12806,1,0,0,0,1
12807,0,1,0,0,1
12808,0,1,0,0,1
12809,0,1,0,0,1
12810,0,1,0,0,1
12811,1,0,0,0,1
12812,0,1,0,0,1
12813,0,1,0,0,1
12814,0,1,0,0,1
12815,0,1,0,0,1
12816,0,1,0,0,1
12817,0,1,0,0,1
12818,0,1,0,0,1
12819,0,1,0,0,1
12820,0,1,0,0,1
12821,0,1,0,0,1
12822,1,0,0,0,1
12823,0,1,0,0,1
12824,0,1,0,0,1
12825,0,1,0,0,1
12826,0,0,1,0,1
12827,0,1,0,0,1
12828,0,1,0,0,1
12829,1,0,0,0,1
12830,0,1,0,0,1
12831,0,1,0,0,1
12832,0,1,0,0,1
12833,0,1,0,0,1
12834,0,1,0,0,1
12835,0,1,0,0,1
12836,0,1,0,0,1
12837,0,1,0,0,1
12838,0,1,0,0,1
12839,1,0,0,0,1
12840,1,0,0,0,1
12841,0,1,0,0,1
12842,0,1,0,0,1
12843,0,1,0,0,1
12844,0,1,0,0,1
12845,0,1,0,0,1
12846,0,1,0,0,1
12847,0,1,0,0,1
12848,0,1,0,0,1
12849,0,1,0,0,1
12850,0,1,0,0,1
12851,0,1,0,0,1
12852,0,1,0,0,1
12853,0,1,0,0,1
12854,0,1,0,0,1
12855,0,1,0,0,1
12856,0,1,0,0,1
12857,0,0,0,1,1
12858,0,1,0,0,1
12859,0,1,0,0,1
12860,0,1,0,0,1
12861,0,0,1,0,1
12862,0,1,0,0,1
12863,0,1,0,0,1
12864,0,1,0,0,1
12865,0,1,0,0,1
12866,0,1,0,0,1
12867,0,1,0,0,1
12868,0,1,0,0,1
12869,0,1,0,0,1
12870,0,1,0,0,1
12871,0,1,0,0,1
12872,0,1,0,0,1
12873,0,1,0,0,1
12874,1,0,0,0,1
12875,0,1,0,0,1
12876,0,1,0,0,1
12877,0,1,0,0,1
12878,0,1,0,0,1
12879,0,1,0,0,1
12880,0,1,0,0,1
12881,0,1,0,0,1
12882,0,1,0,0,1
12883,0,1,0,0,1
12884,0,1,0,0,1
12885,0,1,0,0,1
12886,0,1,0,0,1
12887,0,1,0,0,1
12888,0,1,0,0,1
12889,0,1,0,0,1
12890,0,1,0,0,1
12891,0,1,0,0,1
12892,0,1,0,0,1
12893,0,1,0,0,1
12894,0,1,0,0,1
12895,0,1,0,0,1
12896,0,0,0,1,1
12897,0,1,0,0,1
12898,0,1,0,0,1
12899,0,1,0,0,1
12900,0,1,0,0,1
12901,0,1,0,0,1
12902,0,1,0,0,1
12903,0,1,0,0,1
12904,0,1,0,0,1
12905,1,0,0,0,1
12906,0,0,1,0,1
12907,0,1,0,0,1
12908,0,1,0,0,1
12909,1,0,0,0,1
12910,0,1,0,0,1
12911,0,0,0,1,1
12912,0,1,0,0,1
12913,0,1,0,0,1
12914,0,1,0,0,1
12915,0,1,0,0,1
12916,0,1,0,0,1
12917,0,1,0,0,1
12918,0,1,0,0,1
12919,0,1,0,0,1
12920,0,1,0,0,1
12921,1,0,0,0,1
12922,0,1,0,0,1
12923,0,1,0,0,1
12924,0,1,0,0,1
12925,0,1,0,0,1
12926,0,1,0,0,1
12927,0,1,0,0,1
12928,0,1,0,0,1
12929,1,0,0,0,1
12930,1,0,0,0,1
12931,0,1,0,0,1
12932,0,1,0,0,1
12933,0,1,0,0,1
12934,0,1,0,0,1
12935,0,1,0,0,1
12936,0,1,0,0,1
12937,0,1,0,0,1
12938,0,1,0,0,1
12939,0,1,0,0,1
12940,0,1,0,0,1
12941,0,1,0,0,1
12942,0,1,0,0,1
12943,0,1,0,0,1
12944,0,1,0,0,1
12945,1,0,0,0,1
12946,0,1,0,0,1
12947,0,1,0,0,1
12948,0,1,0,0,1
12949,1,0,0,0,1
12950,0,1,0,0,1
12951,0,1,0,0,1
12952,1,0,0,0,1
12953,1,0,0,0,1
12954,0,1,0,0,1
12955,0,1,0,0,1
12956,0,1,0,0,1
12957,0,1,0,0,1
12958,0,1,0,0,1
12959,0,1,0,0,1
12960,0,1,0,0,1
12961,0,1,0,0,1
12962,0,1,0,0,1
12963,0,1,0,0,1
12964,0,1,0,0,1
12965,0,1,0,0,1
12966,0,1,0,0,1
12967,0,1,0,0,1
12968,1,0,0,0,1
12969,0,1,0,0,1
12970,0,1,0,0,1
12971,0,1,0,0,1
12972,0,1,0,0,1
12973,0,1,0,0,1
12974,0,1,0,0,1
12975,0,1,0,0,1
12976,0,0,1,0,1
12977,0,1,0,0,1
12978,0,1,0,0,1
12979,0,1,0,0,1
12980,0,1,0,0,1
12981,0,1,0,0,1
12982,0,1,0,0,1
12983,0,1,0,0,1
12984,0,1,0,0,1
12985,0,1,0,0,1
12986,0,1,0,0,1
12987,0,1,0,0,1
12988,0,1,0,0,1
12989,0,1,0,0,1
12990,0,1,0,0,1
12991,0,1,0,0,1
12992,0,1,0,0,1
12993,0,1,0,0,1
12994,0,0,0,1,1
12995,0,1,0,0,1
12996,0,1,0,0,1
12997,0,1,0,0,1
12998,0,1,0,0,1
12999,0,1,0,0,1
13000,1,0,0,0,1
13001,0,1,0,0,1
13002,0,1,0,0,1
13003,0,1,0,0,1
13004,0,1,0,0,1
13005,0,1,0,0,1
13006,0,1,0,0,1
13007,0,1,0,0,1
13008,0,1,0,0,1
13009,0,1,0,0,1
13010,0,1,0,0,1
13011,0,1,0,0,1
13012,0,1,0,0,1
13013,0,0,0,1,1
13014,0,1,0,0,1
13015,0,1,0,0,1
13016,0,1,0,0,1
13017,1,0,0,0,1
13018,0,1,0,0,1
13019,0,1,0,0,1
13020,1,0,0,0,1
13021,0,1,0,0,1
13022,0,1,0,0,1
13023,0,1,0,0,1
13024,0,1,0,0,1
13025,0,1,0,0,1
13026,0,1,0,0,1
13027,0,1,0,0,1
13028,0,1,0,0,1
13029,0,1,0,0,1
13030,0,1,0,0,1
13031,0,1,0,0,1
13032,0,1,0,0,1
13033,0,1,0,0,1
13034,0,1,0,0,1
13035,0,1,0,0,1
13036,0,1,0,0,1
13037,0,1,0,0,1
13038,0,1,0,0,1
13039,0,1,0,0,1
13040,0,1,0,0,1
13041,0,1,0,0,1
13042,0,1,0,0,1
13043,0,1,0,0,1
13044,0,1,0,0,1
13045,0,1,0,0,1
13046,0,1,0,0,1
13047,0,1,0,0,1
13048,0,1,0,0,1
13049,0,1,0,0,1
13050,0,1,0,0,1
13051,0,1,0,0,1
13052,0,1,0,0,1
13053,0,1,0,0,1
13054,0,1,0,0,1
13055,0,1,0,0,1
13056,0,0,1,0,1
13057,1,0,0,0,1
13058,0,1,0,0,1
13059,0,1,0,0,1
13060,0,1,0,0,1
13061,0,1,0,0,1
13062,0,1,0,0,1
13063,0,1,0,0,1
13064,0,1,0,0,1
13065,0,1,0,0,1
13066,0,1,0,0,1
13067,0,1,0,0,1
13068,0,1,0,0,1
13069,0,1,0,0,1
13070,0,1,0,0,1
13071,0,1,0,0,1
13072,0,1,0,0,1
13073,0,1,0,0,1
13074,0,1,0,0,1
13075,1,0,0,0,1
13076,1,0,0,0,1
13077,0,1,0,0,1
13078,0,1,0,0,1
13079,0,1,0,0,1
13080,0,1,0,0,1
13081,0,1,0,0,1
13082,0,1,0,0,1
13083,0,1,0,0,1
13084,0,1,0,0,1
13085,0,1,0,0,1
13086,0,1,0,0,1
13087,0,1,0,0,1
13088,0,1,0,0,1
13089,0,1,0,0,1
13090,1,0,0,0,1
13091,0,1,0,0,1
13092,0,1,0,0,1
13093,0,1,0,0,1
13094,0,1,0,0,1
13095,0,1,0,0,1
13096,0,1,0,0,1
13097,0,1,0,0,1
13098,0,1,0,0,1
13099,0,1,0,0,1
13100,0,1,0,0,1
13101,0,1,0,0,1
13102,0,1,0,0,1
13103,0,1,0,0,1
13104,1,0,0,0,1
13105,0,0,0,1,1
13106,1,0,0,0,1
13107,0,1,0,0,1
13108,0,1,0,0,1
13109,0,1,0,0,1
13110,0,1,0,0,1
13111,0,1,0,0,1
13112,0,1,0,0,1
13113,0,1,0,0,1
13114,0,1,0,0,1
13115,0,1,0,0,1
13116,0,1,0,0,1
13117,0,1,0,0,1
13118,0,1,0,0,1
13119,0,0,1,0,1
13120,0,1,0,0,1
13121,0,1,0,0,1
13122,0,1,0,0,1
13123,0,1,0,0,1
13124,0,1,0,0,1
13125,0,1,0,0,1
13126,1,0,0,0,1
13127,1,0,0,0,1
13128,0,1,0,0,1
13129,0,1,0,0,1
13130,0,1,0,0,1
13131,0,1,0,0,1
13132,0,1,0,0,1
13133,0,1,0,0,1
13134,0,1,0,0,1
13135,0,1,0,0,1
13136,0,1,0,0,1
13137,0,1,0,0,1
13138,0,1,0,0,1
13139,0,1,0,0,1
13140,0,1,0,0,1
13141,1,0,0,0,1
13142,0,0,0,1,1
13143,0,1,0,0,1
13144,0,1,0,0,1
13145,1,0,0,0,1
13146,0,1,0,0,1
13147,1,0,0,0,1
13148,1,0,0,0,1
13149,0,1,0,0,1
13150,1,0,0,0,1
13151,0,1,0,0,1
13152,0,1,0,0,1
13153,0,1,0,0,1
13154,0,1,0,0,1
13155,0,1,0,0,1
13156,0,1,0,0,1
13157,0,1,0,0,1
13158,0,1,0,0,1
13159,0,1,0,0,1
13160,0,1,0,0,1
13161,0,1,0,0,1
13162,0,1,0,0,1
13163,0,1,0,0,1
13164,0,1,0,0,1
13165,0,1,0,0,1
13166,0,1,0,0,1
13167,0,1,0,0,1
13168,0,1,0,0,1
13169,0,1,0,0,1
13170,1,0,0,0,1
13171,0,1,0,0,1
13172,0,1,0,0,1
13173,0,1,0,0,1
13174,0,1,0,0,1
13175,0,1,0,0,1
13176,0,1,0,0,1
13177,0,1,0,0,1
13178,0,1,0,0,1
13179,0,1,0,0,1
13180,0,1,0,0,1
13181,0,1,0,0,1
13182,0,1,0,0,1
13183,0,1,0,0,1
13184,0,1,0,0,1
13185,0,1,0,0,1
13186,0,1,0,0,1
13187,1,0,0,0,1
13188,0,1,0,0,1
13189,0,1,0,0,1
13190,0,1,0,0,1
13191,0,1,0,0,1
13192,0,1,0,0,1
13193,0,1,0,0,1
13194,1,0,0,0,1
13195,0,1,0,0,1
13196,0,1,0,0,1
13197,0,1,0,0,1
13198,0,1,0,0,1
13199,0,1,0,0,1
13200,0,1,0,0,1
13201,0,1,0,0,1
13202,0,1,0,0,1
13203,0,0,0,1,1
13204,0,1,0,0,1
13205,0,1,0,0,1
13206,0,0,0,1,1
13207,0,1,0,0,1
13208,1,0,0,0,1
13209,0,0,1,0,1
13210,0,1,0,0,1
13211,0,1,0,0,1
13212,0,1,0,0,1
13213,0,1,0,0,1
13214,0,1,0,0,1
13215,0,1,0,0,1
13216,0,1,0,0,1
13217,0,1,0,0,1
13218,0,1,0,0,1
13219,0,1,0,0,1
13220,1,0,0,0,1
13221,0,1,0,0,1
13222,0,1,0,0,1
13223,0,1,0,0,1
13224,0,1,0,0,1
13225,0,1,0,0,1
13226,0,1,0,0,1
13227,0,1,0,0,1
13228,0,1,0,0,1
13229,0,1,0,0,1
13230,1,0,0,0,1
13231,0,1,0,0,1
13232,1,0,0,0,1
13233,0,1,0,0,1
13234,1,0,0,0,1
13235,1,0,0,0,1
13236,0,1,0,0,1
13237,0,1,0,0,1
13238,1,0,0,0,1
13239,1,0,0,0,1
13240,0,1,0,0,1
13241,0,0,0,1,1
13242,0,1,0,0,1
13243,0,1,0,0,1
13244,0,1,0,0,1
13245,0,1,0,0,1
13246,0,0,0,1,1
13247,0,1,0,0,1
13248,1,0,0,0,1
13249,0,1,0,0,1
13250,0,1,0,0,1
13251,0,1,0,0,1
13252,1,0,0,0,1
13253,0,1,0,0,1
13254,0,1,0,0,1
13255,0,1,0,0,1
13256,0,1,0,0,1
13257,0,1,0,0,1
13258,0,1,0,0,1
13259,0,1,0,0,1
13260,0,1,0,0,1
13261,0,1,0,0,1
13262,0,1,0,0,1
13263,0,1,0,0,1
13264,0,1,0,0,1
13265,0,1,0,0,1
13266,0,0,1,0,1
13267,0,1,0,0,1
13268,0,1,0,0,1
13269,0,1,0,0,1
13270,0,1,0,0,1
13271,0,1,0,0,1
13272,1,0,0,0,1
13273,0,1,0,0,1
13274,0,1,0,0,1
13275,1,0,0,0,1
13276,0,1,0,0,1
13277,0,1,0,0,1
13278,0,1,0,0,1
13279,0,1,0,0,1
13280,0,1,0,0,1
13281,1,0,0,0,1
13282,0,1,0,0,1
13283,0,1,0,0,1
13284,0,1,0,0,1
13285,0,1,0,0,1
13286,0,1,0,0,1
13287,0,1,0,0,1
13288,0,1,0,0,1
13289,0,1,0,0,1
13290,0,1,0,0,1
13291,0,1,0,0,1
13292,0,1,0,0,1
13293,0,1,0,0,1
13294,1,0,0,0,1
13295,0,1,0,0,1
13296,0,1,0,0,1
13297,0,1,0,0,1
13298,0,1,0,0,1
13299,0,1,0,0,1
13300,0,1,0,0,1
13301,0,1,0,0,1
13302,0,1,0,0,1
13303,0,1,0,0,1
13304,0,1,0,0,1
13305,0,1,0,0,1
13306,0,1,0,0,1
13307,0,1,0,0,1
13308,1,0,0,0,1
13309,1,0,0,0,1
13310,0,1,0,0,1
13311,0,1,0,0,1
13312,0,1,0,0,1
13313,0,1,0,0,1
13314,0,1,0,0,1
13315,0,1,0,0,1
13316,0,1,0,0,1
13317,0,1,0,0,1
13318,0,1,0,0,1
13319,0,1,0,0,1
13320,0,1,0,0,1
13321,0,1,0,0,1
13322,0,0,0,1,1
13323,0,1,0,0,1
13324,0,1,0,0,1
13325,0,1,0,0,1
13326,0,1,0,0,1
13327,0,1,0,0,1
13328,0,1,0,0,1
13329,0,1,0,0,1
13330,0,1,0,0,1
13331,0,1,0,0,1
13332,0,1,0,0,1
13333,0,1,0,0,1
13334,0,1,0,0,1
13335,0,1,0,0,1
13336,0,1,0,0,1
13337,0,1,0,0,1
13338,1,0,0,0,1
13339,0,1,0,0,1
13340,0,1,0,0,1
13341,0,1,0,0,1
13342,0,0,0,1,1
13343,0,1,0,0,1
13344,0,1,0,0,1
13345,1,0,0,0,1
13346,0,1,0,0,1
13347,0,1,0,0,1
13348,0,1,0,0,1
13349,0,1,0,0,1
13350,0,1,0,0,1
13351,0,1,0,0,1
13352,0,1,0,0,1
13353,0,1,0,0,1
13354,0,1,0,0,1
13355,0,1,0,0,1
13356,0,1,0,0,1
13357,0,1,0,0,1
13358,0,1,0,0,1
13359,0,1,0,0,1
13360,0,1,0,0,1
13361,1,0,0,0,1
13362,0,1,0,0,1
13363,1,0,0,0,1
13364,0,0,0,1,1
13365,0,1,0,0,1
13366,0,1,0,0,1
13367,0,1,0,0,1
13368,1,0,0,0,1
13369,1,0,0,0,1
13370,1,0,0,0,1
13371,0,1,0,0,1
13372,0,1,0,0,1
13373,0,1,0,0,1
13374,0,1,0,0,1
13375,0,1,0,0,1
13376,0,1,0,0,1
13377,0,1,0,0,1
13378,1,0,0,0,1
13379,0,0,0,1,1
13380,0,1,0,0,1
13381,1,0,0,0,1
13382,0,1,0,0,1
13383,0,1,0,0,1
13384,0,1,0,0,1
13385,0,1,0,0,1
13386,0,1,0,0,1
13387,0,1,0,0,1
13388,0,1,0,0,1
13389,0,1,0,0,1
13390,0,1,0,0,1
13391,0,1,0,0,1
13392,0,1,0,0,1
13393,0,0,1,0,1
13394,0,0,0,1,1
13395,0,1,0,0,1
13396,0,1,0,0,1
13397,0,1,0,0,1
13398,0,0,0,1,1
13399,0,1,0,0,1
13400,0,1,0,0,1
13401,0,1,0,0,1
13402,0,1,0,0,1
13403,0,1,0,0,1
13404,0,1,0,0,1
13405,0,1,0,0,1
13406,0,1,0,0,1
13407,0,1,0,0,1
13408,0,1,0,0,1
13409,1,0,0,0,1
13410,0,1,0,0,1
13411,0,1,0,0,1
13412,0,1,0,0,1
13413,0,1,0,0,1
13414,0,1,0,0,1
13415,1,0,0,0,1
13416,1,0,0,0,1
13417,1,0,0,0,1
13418,0,1,0,0,1
13419,0,1,0,0,1
13420,0,1,0,0,1
13421,0,1,0,0,1
13422,0,1,0,0,1
13423,0,1,0,0,1
13424,0,1,0,0,1
13425,0,1,0,0,1
13426,0,1,0,0,1
13427,1,0,0,0,1
13428,0,1,0,0,1
13429,0,0,0,1,1
13430,0,1,0,0,1
13431,0,1,0,0,1
13432,1,0,0,0,1
13433,1,0,0,0,1
13434,0,1,0,0,1
13435,0,1,0,0,1
13436,0,1,0,0,1
13437,0,1,0,0,1
13438,0,1,0,0,1
13439,0,1,0,0,1
13440,0,1,0,0,1
13441,0,1,0,0,1
13442,0,1,0,0,1
13443,0,1,0,0,1
13444,0,1,0,0,1
13445,0,1,0,0,1
13446,0,1,0,0,1
13447,1,0,0,0,1
13448,0,1,0,0,1
13449,0,1,0,0,1
13450,0,1,0,0,1
13451,0,1,0,0,1
13452,0,1,0,0,1
13453,0,1,0,0,1
13454,1,0,0,0,1
13455,0,1,0,0,1
13456,1,0,0,0,1
13457,1,0,0,0,1
13458,0,1,0,0,1
13459,1,0,0,0,1
13460,0,1,0,0,1
13461,0,1,0,0,1
13462,0,1,0,0,1
13463,1,0,0,0,1
13464,1,0,0,0,1
13465,0,1,0,0,1
13466,0,1,0,0,1
13467,0,1,0,0,1
13468,0,1,0,0,1
13469,1,0,0,0,1
13470,0,1,0,0,1
13471,0,1,0,0,1
13472,0,1,0,0,1
13473,0,1,0,0,1
13474,0,1,0,0,1
13475,0,1,0,0,1
13476,0,1,0,0,1
13477,0,1,0,0,1
13478,0,1,0,0,1
13479,1,0,0,0,1
13480,0,1,0,0,1
13481,0,1,0,0,1
13482,0,1,0,0,1
13483,0,1,0,0,1
13484,0,1,0,0,1
13485,0,1,0,0,1
13486,0,1,0,0,1
13487,0,1,0,0,1
13488,0,1,0,0,1
13489,0,1,0,0,1
13490,1,0,0,0,1
13491,0,1,0,0,1
13492,0,1,0,0,1
13493,1,0,0,0,1
13494,0,1,0,0,1
13495,0,1,0,0,1
13496,0,1,0,0,1
13497,0,1,0,0,1
13498,0,1,0,0,1
13499,0,1,0,0,1
13500,0,1,0,0,1
13501,0,1,0,0,1
13502,0,1,0,0,1
13503,0,1,0,0,1
13504,0,1,0,0,1
13505,0,1,0,0,1
13506,0,1,0,0,1
13507,0,1,0,0,1
13508,0,1,0,0,1
13509,0,1,0,0,1
13510,0,1,0,0,1
13511,0,1,0,0,1
13512,0,1,0,0,1
13513,0,1,0,0,1
13514,0,1,0,0,1
13515,0,1,0,0,1
13516,0,1,0,0,1
13517,0,1,0,0,1
13518,0,1,0,0,1
13519,0,1,0,0,1
13520,1,0,0,0,1
13521,0,1,0,0,1
13522,1,0,0,0,1
13523,0,1,0,0,1
13524,1,0,0,0,1
13525,0,1,0,0,1
13526,0,1,0,0,1
13527,0,1,0,0,1
13528,0,1,0,0,1
13529,0,1,0,0,1
13530,0,1,0,0,1
13531,0,1,0,0,1
13532,0,1,0,0,1
13533,0,1,0,0,1
13534,0,1,0,0,1
13535,0,1,0,0,1
13536,0,1,0,0,1
13537,0,1,0,0,1
13538,0,1,0,0,1
13539,0,1,0,0,1
13540,0,1,0,0,1
13541,0,1,0,0,1
13542,0,1,0,0,1
13543,0,1,0,0,1
13544,1,0,0,0,1
13545,0,1,0,0,1
13546,0,1,0,0,1
13547,0,1,0,0,1
13548,0,1,0,0,1
13549,0,1,0,0,1
13550,0,1,0,0,1
13551,0,1,0,0,1
13552,0,1,0,0,1
13553,0,1,0,0,1
13554,0,1,0,0,1
13555,0,1,0,0,1
13556,0,1,0,0,1
13557,1,0,0,0,1
13558,0,1,0,0,1
13559,0,1,0,0,1
13560,0,1,0,0,1
13561,0,1,0,0,1
13562,0,1,0,0,1
13563,0,1,0,0,1
13564,0,0,0,1,1
13565,0,1,0,0,1
13566,0,1,0,0,1
13567,0,1,0,0,1
13568,0,1,0,0,1
13569,0,1,0,0,1
13570,1,0,0,0,1
13571,0,1,0,0,1
13572,0,1,0,0,1
13573,1,0,0,0,1
13574,0,1,0,0,1
13575,1,0,0,0,1
13576,0,1,0,0,1
13577,0,1,0,0,1
13578,1,0,0,0,1
13579,0,1,0,0,1
13580,1,0,0,0,1
13581,0,1,0,0,1
13582,0,1,0,0,1
13583,1,0,0,0,1
13584,0,1,0,0,1
13585,1,0,0,0,1
13586,0,1,0,0,1
13587,0,1,0,0,1
13588,0,1,0,0,1
13589,0,1,0,0,1
13590,0,1,0,0,1
13591,0,1,0,0,1
13592,0,1,0,0,1
13593,1,0,0,0,1
13594,0,1,0,0,1
13595,1,0,0,0,1
13596,0,1,0,0,1
13597,0,1,0,0,1
13598,0,1,0,0,1
13599,0,1,0,0,1
13600,0,1,0,0,1
13601,0,1,0,0,1
13602,0,1,0,0,1
13603,0,1,0,0,1
13604,0,1,0,0,1
13605,0,1,0,0,1
13606,0,1,0,0,1
13607,0,1,0,0,1
13608,0,1,0,0,1
13609,0,1,0,0,1
13610,0,1,0,0,1
13611,0,1,0,0,1
13612,1,0,0,0,1
13613,1,0,0,0,1
13614,1,0,0,0,1
13615,0,1,0,0,1
13616,1,0,0,0,1
13617,0,0,1,0,1
13618,1,0,0,0,1
13619,0,1,0,0,1
13620,0,1,0,0,1
13621,0,1,0,0,1
13622,1,0,0,0,1
13623,0,1,0,0,1
13624,0,1,0,0,1
13625,1,0,0,0,1
13626,0,1,0,0,1
13627,0,1,0,0,1
13628,0,1,0,0,1
13629,0,1,0,0,1
13630,0,1,0,0,1
13631,0,1,0,0,1
13632,0,1,0,0,1
13633,0,1,0,0,1
13634,0,1,0,0,1
13635,0,1,0,0,1
13636,0,1,0,0,1
13637,0,1,0,0,1
13638,1,0,0,0,1
13639,0,1,0,0,1
13640,0,1,0,0,1
13641,0,1,0,0,1
13642,1,0,0,0,1
13643,1,0,0,0,1
13644,0,1,0,0,1
13645,0,1,0,0,1
13646,1,0,0,0,1
13647,0,1,0,0,1
13648,0,1,0,0,1
13649,0,1,0,0,1
13650,0,1,0,0,1
13651,0,1,0,0,1
13652,1,0,0,0,1
13653,0,1,0,0,1
13654,0,1,0,0,1
13655,0,1,0,0,1
13656,0,1,0,0,1
13657,0,1,0,0,1
13658,0,1,0,0,1
13659,1,0,0,0,1
13660,0,1,0,0,1
13661,0,1,0,0,1
13662,0,1,0,0,1
13663,0,1,0,0,1
13664,0,1,0,0,1
13665,1,0,0,0,1
13666,1,0,0,0,1
13667,0,1,0,0,1
13668,0,1,0,0,1
13669,0,1,0,0,1
13670,0,1,0,0,1
13671,0,1,0,0,1
13672,0,1,0,0,1
13673,0,1,0,0,1
13674,0,1,0,0,1
13675,1,0,0,0,1
13676,0,1,0,0,1
13677,0,1,0,0,1
13678,0,1,0,0,1
13679,0,1,0,0,1
13680,0,0,1,0,1
13681,0,1,0,0,1
13682,0,1,0,0,1
13683,0,1,0,0,1
13684,1,0,0,0,1
13685,0,1,0,0,1
13686,1,0,0,0,1
13687,1,0,0,0,1
13688,0,1,0,0,1
13689,1,0,0,0,1
13690,1,0,0,0,1
13691,0,1,0,0,1
13692,0,1,0,0,1
13693,0,1,0,0,1
13694,0,1,0,0,1
13695,0,1,0,0,1
13696,0,1,0,0,1
13697,0,1,0,0,1
13698,0,1,0,0,1
13699,0,1,0,0,1
13700,1,0,0,0,1
13701,0,1,0,0,1
13702,0,1,0,0,1
13703,0,1,0,0,1
13704,0,1,0,0,1
13705,0,1,0,0,1
13706,1,0,0,0,1
13707,0,1,0,0,1
13708,0,1,0,0,1
13709,1,0,0,0,1
13710,1,0,0,0,1
13711,0,1,0,0,1
13712,0,1,0,0,1
13713,1,0,0,0,1
13714,0,1,0,0,1
13715,0,1,0,0,1
13716,0,1,0,0,1
13717,0,1,0,0,1
13718,0,1,0,0,1
13719,0,1,0,0,1
13720,0,1,0,0,1
13721,1,0,0,0,1
13722,0,1,0,0,1
13723,0,1,0,0,1
13724,0,1,0,0,1
13725,0,1,0,0,1
13726,0,1,0,0,1
13727,1,0,0,0,1
13728,0,1,0,0,1
13729,0,1,0,0,1
13730,0,1,0,0,1
13731,0,1,0,0,1
13732,0,1,0,0,1
13733,0,1,0,0,1
13734,0,1,0,0,1
13735,0,1,0,0,1
13736,0,1,0,0,1
13737,1,0,0,0,1
13738,0,1,0,0,1
13739,0,1,0,0,1
13740,1,0,0,0,1
13741,0,1,0,0,1
13742,0,1,0,0,1
13743,0,1,0,0,1
13744,0,1,0,0,1
13745,0,1,0,0,1
13746,0,1,0,0,1
13747,0,1,0,0,1
13748,0,1,0,0,1
13749,1,0,0,0,1
13750,0,1,0,0,1
13751,0,1,0,0,1
13752,0,1,0,0,1
13753,0,1,0,0,1
13754,0,1,0,0,1
13755,0,1,0,0,1
13756,1,0,0,0,1
13757,0,1,0,0,1
13758,0,1,0,0,1
13759,0,1,0,0,1
13760,0,1,0,0,1
13761,0,1,0,0,1
13762,0,1,0,0,1
13763,0,1,0,0,1
13764,0,1,0,0,1
13765,0,1,0,0,1
13766,0,1,0,0,1
13767,0,1,0,0,1
13768,0,1,0,0,1
13769,1,0,0,0,1
13770,0,1,0,0,1
13771,1,0,0,0,1
13772,0,1,0,0,1
13773,0,1,0,0,1
13774,0,1,0,0,1
13775,1,0,0,0,1
13776,0,0,0,1,1
13777,0,1,0,0,1
13778,0,1,0,0,1
13779,0,1,0,0,1
13780,0,1,0,0,1
13781,0,1,0,0,1
13782,0,1,0,0,1
13783,0,1,0,0,1
13784,0,1,0,0,1
13785,0,1,0,0,1
13786,0,1,0,0,1
13787,0,1,0,0,1
13788,0,1,0,0,1
13789,0,1,0,0,1
13790,0,1,0,0,1
13791,0,1,0,0,1
13792,0,1,0,0,1
13793,0,1,0,0,1
13794,1,0,0,0,1
13795,0,1,0,0,1
13796,0,1,0,0,1
13797,0,1,0,0,1
13798,0,1,0,0,1
13799,0,1,0,0,1
13800,0,1,0,0,1
13801,0,1,0,0,1
13802,1,0,0,0,1
13803,0,1,0,0,1
13804,0,1,0,0,1
13805,0,1,0,0,1
13806,0,1,0,0,1
13807,0,1,0,0,1
13808,0,1,0,0,1
13809,0,1,0,0,1
13810,0,1,0,0,1
13811,0,1,0,0,1
13812,0,1,0,0,1
13813,0,1,0,0,1
13814,0,1,0,0,1
13815,0,1,0,0,1
13816,0,1,0,0,1
13817,0,1,0,0,1
13818,0,1,0,0,1
13819,0,1,0,0,1
13820,0,1,0,0,1
13821,1,0,0,0,1
13822,1,0,0,0,1
13823,0,1,0,0,1
13824,0,1,0,0,1
13825,0,1,0,0,1
13826,0,1,0,0,1
13827,0,1,0,0,1
13828,0,1,0,0,1
13829,0,0,1,0,1
13830,1,0,0,0,1
13831,0,1,0,0,1
13832,0,1,0,0,1
13833,0,1,0,0,1
13834,0,1,0,0,1
13835,0,1,0,0,1
13836,1,0,0,0,1
13837,0,1,0,0,1
13838,0,1,0,0,1
13839,1,0,0,0,1
13840,0,1,0,0,1
13841,1,0,0,0,1
13842,0,1,0,0,1
13843,0,1,0,0,1
13844,1,0,0,0,1
13845,0,1,0,0,1
13846,0,1,0,0,1
13847,0,1,0,0,1
13848,0,1,0,0,1
13849,0,1,0,0,1
13850,0,1,0,0,1
13851,0,1,0,0,1
13852,0,1,0,0,1
13853,0,1,0,0,1
13854,0,1,0,0,1
13855,0,1,0,0,1
13856,0,1,0,0,1
13857,1,0,0,0,1
13858,0,1,0,0,1
13859,0,1,0,0,1
13860,0,1,0,0,1
13861,0,1,0,0,1
13862,0,1,0,0,1
13863,0,1,0,0,1
13864,1,0,0,0,1
13865,0,1,0,0,1
13866,0,1,0,0,1
13867,0,1,0,0,1
13868,1,0,0,0,1
13869,0,1,0,0,1
13870,0,1,0,0,1
13871,0,1,0,0,1
13872,0,1,0,0,1
13873,0,1,0,0,1
13874,0,1,0,0,1
13875,0,1,0,0,1
13876,0,1,0,0,1
13877,0,1,0,0,1
13878,0,1,0,0,1
13879,1,0,0,0,1
13880,0,1,0,0,1
13881,0,1,0,0,1
13882,0,1,0,0,1
13883,0,1,0,0,1
13884,0,1,0,0,1
13885,0,1,0,0,1
13886,0,1,0,0,1
13887,1,0,0,0,1
13888,0,1,0,0,1
13889,0,0,0,1,1
13890,0,1,0,0,1
13891,0,1,0,0,1
13892,0,1,0,0,1
13893,1,0,0,0,1
13894,0,1,0,0,1
13895,1,0,0,0,1
13896,0,1,0,0,1
13897,0,1,0,0,1
13898,0,1,0,0,1
13899,0,1,0,0,1
13900,0,1,0,0,1
13901,0,1,0,0,1
13902,0,1,0,0,1
13903,0,1,0,0,1
13904,0,1,0,0,1
13905,0,1,0,0,1
13906,1,0,0,0,1
13907,1,0,0,0,1
13908,0,1,0,0,1
13909,0,1,0,0,1
13910,0,1,0,0,1
13911,0,1,0,0,1
13912,0,1,0,0,1
13913,0,1,0,0,1
13914,0,1,0,0,1
13915,0,1,0,0,1
13916,0,1,0,0,1
13917,1,0,0,0,1
13918,0,1,0,0,1
13919,0,1,0,0,1
13920,0,1,0,0,1
13921,0,1,0,0,1
13922,0,1,0,0,1
13923,0,1,0,0,1
13924,0,1,0,0,1
13925,0,1,0,0,1
13926,0,1,0,0,1
13927,0,0,0,1,1
13928,0,1,0,0,1
13929,1,0,0,0,1
13930,0,1,0,0,1
13931,0,1,0,0,1
13932,0,0,0,1,1
13933,0,1,0,0,1
13934,1,0,0,0,1
13935,0,1,0,0,1
13936,0,1,0,0,1
13937,0,1,0,0,1
13938,0,1,0,0,1
13939,0,1,0,0,1
13940,0,1,0,0,1
13941,0,1,0,0,1
13942,1,0,0,0,1
13943,0,1,0,0,1
13944,1,0,0,0,1
13945,1,0,0,0,1
13946,0,1,0,0,1
13947,1,0,0,0,1
13948,1,0,0,0,1
13949,0,1,0,0,1
13950,0,1,0,0,1
13951,0,1,0,0,1
13952,1,0,0,0,1
13953,0,1,0,0,1
13954,0,1,0,0,1
13955,0,1,0,0,1
13956,0,0,0,1,1
13957,0,1,0,0,1
13958,0,1,0,0,1
13959,0,1,0,0,1
13960,0,1,0,0,1
13961,1,0,0,0,1
13962,0,1,0,0,1
13963,1,0,0,0,1
13964,1,0,0,0,1
13965,0,1,0,0,1
13966,1,0,0,0,1
13967,0,1,0,0,1
13968,0,1,0,0,1
13969,0,1,0,0,1
13970,0,1,0,0,1
13971,0,1,0,0,1
13972,0,1,0,0,1
13973,0,1,0,0,1
13974,0,1,0,0,1
13975,0,1,0,0,1
13976,0,1,0,0,1
13977,0,1,0,0,1
13978,0,1,0,0,1
13979,1,0,0,0,1
13980,1,0,0,0,1
13981,1,0,0,0,1
13982,0,1,0,0,1
13983,0,1,0,0,1
13984,0,1,0,0,1
13985,0,1,0,0,1
13986,0,1,0,0,1
13987,0,1,0,0,1
13988,0,1,0,0,1
13989,0,1,0,0,1
13990,0,1,0,0,1
13991,0,1,0,0,1
13992,0,1,0,0,1
13993,0,1,0,0,1
13994,1,0,0,0,1
13995,0,1,0,0,1
13996,0,1,0,0,1
13997,0,1,0,0,1
13998,0,1,0,0,1
13999,0,1,0,0,1
14000,0,1,0,0,1
14001,0,1,0,0,1
14002,0,1,0,0,1
14003,0,1,0,0,1
14004,0,1,0,0,1
14005,0,1,0,0,1
14006,0,1,0,0,1
14007,0,1,0,0,1
14008,0,1,0,0,1
14009,1,0,0,0,1
14010,0,1,0,0,1
14011,0,1,0,0,1
14012,1,0,0,0,1
14013,0,1,0,0,1
14014,0,1,0,0,1
14015,0,1,0,0,1
14016,0,1,0,0,1
14017,0,1,0,0,1
14018,1,0,0,0,1
14019,0,1,0,0,1
14020,0,1,0,0,1
14021,0,1,0,0,1
14022,1,0,0,0,1
14023,1,0,0,0,1
14024,1,0,0,0,1
14025,0,1,0,0,1
14026,0,1,0,0,1
14027,0,1,0,0,1
14028,0,1,0,0,1
14029,0,1,0,0,1
14030,0,1,0,0,1
14031,0,1,0,0,1
14032,0,1,0,0,1
14033,0,1,0,0,1
14034,0,1,0,0,1
14035,0,1,0,0,1
14036,0,1,0,0,1
14037,0,1,0,0,1
14038,0,1,0,0,1
14039,1,0,0,0,1
14040,0,1,0,0,1
14041,0,1,0,0,1
14042,0,1,0,0,1
14043,0,1,0,0,1
14044,0,1,0,0,1
14045,1,0,0,0,1
14046,0,1,0,0,1
14047,0,1,0,0,1
14048,0,1,0,0,1
14049,1,0,0,0,1
14050,0,1,0,0,1
14051,0,1,0,0,1
14052,0,1,0,0,1
14053,0,1,0,0,1
14054,0,1,0,0,1
14055,0,0,0,1,1
14056,0,1,0,0,1
14057,0,1,0,0,1
14058,0,1,0,0,1
14059,0,1,0,0,1
14060,0,1,0,0,1
14061,0,1,0,0,1
14062,1,0,0,0,1
14063,0,1,0,0,1
14064,0,1,0,0,1
14065,0,1,0,0,1
14066,0,1,0,0,1
14067,0,1,0,0,1
14068,1,0,0,0,1
14069,0,1,0,0,1
14070,0,1,0,0,1
14071,0,1,0,0,1
14072,1,0,0,0,1
14073,0,1,0,0,1
14074,0,1,0,0,1
14075,1,0,0,0,1
14076,1,0,0,0,1
14077,0,1,0,0,1
14078,0,1,0,0,1
14079,1,0,0,0,1
14080,0,1,0,0,1
14081,0,1,0,0,1
14082,0,0,0,1,1
14083,0,1,0,0,1
14084,0,1,0,0,1
14085,0,1,0,0,1
14086,0,1,0,0,1
14087,0,1,0,0,1
14088,0,1,0,0,1
14089,0,1,0,0,1
14090,0,1,0,0,1
14091,0,1,0,0,1
14092,0,1,0,0,1
14093,0,1,0,0,1
14094,0,1,0,0,1
14095,0,1,0,0,1
14096,0,1,0,0,1
14097,1,0,0,0,1
14098,0,1,0,0,1
14099,0,1,0,0,1
14100,1,0,0,0,1
14101,0,1,0,0,1
14102,0,1,0,0,1
14103,0,1,0,0,1
14104,0,1,0,0,1
14105,0,1,0,0,1
14106,1,0,0,0,1
14107,0,0,1,0,1
14108,1,0,0,0,1
14109,1,0,0,0,1
14110,0,1,0,0,1
14111,0,1,0,0,1
14112,1,0,0,0,1
14113,0,1,0,0,1
14114,0,1,0,0,1
14115,0,1,0,0,1
14116,0,1,0,0,1
14117,0,1,0,0,1
14118,0,1,0,0,1
14119,1,0,0,0,1
14120,0,1,0,0,1
14121,0,1,0,0,1
14122,0,1,0,0,1
14123,0,1,0,0,1
14124,0,1,0,0,1
14125,0,1,0,0,1
14126,0,1,0,0,1
14127,0,1,0,0,1
14128,0,0,0,1,1
14129,0,1,0,0,1
14130,0,1,0,0,1
14131,0,1,0,0,1
14132,0,1,0,0,1
14133,1,0,0,0,1
14134,0,1,0,0,1
14135,0,1,0,0,1
14136,1,0,0,0,1
14137,0,1,0,0,1
14138,0,1,0,0,1
14139,0,1,0,0,1
14140,0,1,0,0,1
14141,0,1,0,0,1
14142,1,0,0,0,1
14143,0,1,0,0,1
14144,0,1,0,0,1
14145,1,0,0,0,1
14146,0,1,0,0,1
14147,0,1,0,0,1
14148,1,0,0,0,1
14149,1,0,0,0,1
14150,0,1,0,0,1
14151,0,1,0,0,1
14152,0,1,0,0,1
14153,0,1,0,0,1
14154,0,1,0,0,1
14155,0,1,0,0,1
14156,0,1,0,0,1
14157,0,1,0,0,1
14158,0,1,0,0,1
14159,1,0,0,0,1
14160,1,0,0,0,1
14161,0,1,0,0,1
14162,0,1,0,0,1
14163,1,0,0,0,1
14164,0,1,0,0,1
14165,1,0,0,0,1
14166,0,1,0,0,1
14167,0,1,0,0,1
14168,0,1,0,0,1
14169,0,1,0,0,1
14170,0,1,0,0,1
14171,0,1,0,0,1
14172,0,1,0,0,1
14173,1,0,0,0,1
14174,0,1,0,0,1
14175,0,1,0,0,1
14176,1,0,0,0,1
14177,0,1,0,0,1
14178,0,1,0,0,1
14179,0,1,0,0,1
14180,0,1,0,0,1
14181,0,1,0,0,1
14182,0,1,0,0,1
14183,0,1,0,0,1
14184,0,1,0,0,1
14185,0,1,0,0,1
14186,0,1,0,0,1
14187,0,1,0,0,1
14188,1,0,0,0,1
14189,1,0,0,0,1
14190,0,1,0,0,1
14191,0,1,0,0,1
14192,0,1,0,0,1
14193,0,1,0,0,1
14194,0,1,0,0,1
14195,1,0,0,0,1
14196,0,1,0,0,1
14197,1,0,0,0,1
14198,0,1,0,0,1
14199,0,1,0,0,1
14200,0,1,0,0,1
14201,0,1,0,0,1
14202,0,1,0,0,1
14203,0,1,0,0,1
14204,0,1,0,0,1
14205,1,0,0,0,1
14206,0,1,0,0,1
14207,0,1,0,0,1
14208,1,0,0,0,1
14209,0,1,0,0,1
14210,1,0,0,0,1
14211,0,1,0,0,1
14212,1,0,0,0,1
14213,0,1,0,0,1
14214,0,1,0,0,1
14215,0,1,0,0,1
14216,0,1,0,0,1
14217,0,1,0,0,1
14218,0,1,0,0,1
14219,0,1,0,0,1
14220,0,1,0,0,1
14221,0,1,0,0,1
14222,0,1,0,0,1
14223,0,1,0,0,1
14224,0,1,0,0,1
14225,0,1,0,0,1
14226,0,1,0,0,1
14227,0,1,0,0,1
14228,1,0,0,0,1
14229,0,1,0,0,1
14230,0,1,0,0,1
14231,1,0,0,0,1
14232,0,1,0,0,1
14233,0,1,0,0,1
14234,0,1,0,0,1
14235,0,1,0,0,1
14236,0,1,0,0,1
14237,0,1,0,0,1
14238,1,0,0,0,1
14239,0,1,0,0,1
14240,0,1,0,0,1
14241,1,0,0,0,1
14242,0,1,0,0,1
14243,0,1,0,0,1
14244,0,1,0,0,1
14245,0,1,0,0,1
14246,0,1,0,0,1
14247,1,0,0,0,1
14248,0,1,0,0,1
14249,0,1,0,0,1
14250,0,1,0,0,1
14251,0,1,0,0,1
14252,0,1,0,0,1
14253,0,1,0,0,1
14254,1,0,0,0,1
14255,0,1,0,0,1
14256,0,1,0,0,1
14257,0,1,0,0,1
14258,0,1,0,0,1
14259,1,0,0,0,1
14260,0,1,0,0,1
14261,0,1,0,0,1
14262,0,1,0,0,1
14263,0,1,0,0,1
14264,0,1,0,0,1
14265,0,1,0,0,1
14266,0,1,0,0,1
14267,0,1,0,0,1
14268,0,1,0,0,1
14269,0,1,0,0,1
14270,0,1,0,0,1
14271,0,1,0,0,1
14272,0,1,0,0,1
14273,0,1,0,0,1
14274,1,0,0,0,1
14275,0,1,0,0,1
14276,0,1,0,0,1
14277,0,1,0,0,1
14278,0,1,0,0,1
14279,0,1,0,0,1
14280,0,1,0,0,1
14281,0,1,0,0,1
14282,1,0,0,0,1
14283,0,1,0,0,1
14284,0,1,0,0,1
14285,0,1,0,0,1
14286,1,0,0,0,1
14287,0,1,0,0,1
14288,0,1,0,0,1
14289,1,0,0,0,1
14290,1,0,0,0,1
14291,0,1,0,0,1
14292,0,1,0,0,1
14293,0,1,0,0,1
14294,0,1,0,0,1
14295,0,1,0,0,1
14296,0,1,0,0,1
14297,0,1,0,0,1
14298,0,1,0,0,1
14299,0,1,0,0,1
14300,0,1,0,0,1
14301,0,1,0,0,1
14302,0,1,0,0,1
14303,0,1,0,0,1
14304,0,1,0,0,1
14305,0,1,0,0,1
14306,0,1,0,0,1
14307,0,1,0,0,1
14308,1,0,0,0,1
14309,1,0,0,0,1
14310,0,1,0,0,1
14311,0,0,0,1,1
14312,0,1,0,0,1
14313,0,1,0,0,1
14314,0,1,0,0,1
14315,0,1,0,0,1
14316,0,1,0,0,1
14317,0,1,0,0,1
14318,0,1,0,0,1
14319,0,1,0,0,1
14320,0,1,0,0,1
14321,1,0,0,0,1
14322,0,1,0,0,1
14323,0,1,0,0,1
14324,0,1,0,0,1
14325,0,1,0,0,1
14326,0,1,0,0,1
14327,0,1,0,0,1
14328,1,0,0,0,1
14329,0,1,0,0,1
14330,0,0,0,1,1
14331,1,0,0,0,1
14332,0,1,0,0,1
14333,0,1,0,0,1
14334,0,1,0,0,1
14335,0,1,0,0,1
14336,0,1,0,0,1
14337,0,1,0,0,1
14338,0,1,0,0,1
14339,0,1,0,0,1
14340,0,1,0,0,1
14341,0,1,0,0,1
14342,0,0,0,1,1
14343,0,1,0,0,1
14344,0,1,0,0,1
14345,0,1,0,0,1
14346,0,1,0,0,1
14347,0,1,0,0,1
14348,1,0,0,0,1
14349,0,1,0,0,1
14350,1,0,0,0,1
14351,0,1,0,0,1
14352,0,1,0,0,1
14353,1,0,0,0,1
14354,0,1,0,0,1
14355,0,1,0,0,1
14356,1,0,0,0,1
14357,0,1,0,0,1
14358,0,1,0,0,1
14359,0,1,0,0,1
14360,0,1,0,0,1
14361,0,1,0,0,1
14362,0,1,0,0,1
14363,0,1,0,0,1
14364,0,1,0,0,1
14365,1,0,0,0,1
14366,0,1,0,0,1
14367,0,1,0,0,1
14368,0,1,0,0,1
14369,0,1,0,0,1
14370,0,1,0,0,1
14371,0,1,0,0,1
14372,1,0,0,0,1
14373,0,1,0,0,1
14374,0,1,0,0,1
14375,0,1,0,0,1
14376,0,1,0,0,1
14377,1,0,0,0,1
14378,1,0,0,0,1
14379,1,0,0,0,1
14380,0,1,0,0,1
14381,0,1,0,0,1
14382,0,1,0,0,1
14383,0,1,0,0,1
14384,1,0,0,0,1
14385,0,1,0,0,1
14386,1,0,0,0,1
14387,0,1,0,0,1
14388,0,1,0,0,1
14389,0,1,0,0,1
14390,1,0,0,0,1
14391,0,1,0,0,1
14392,0,1,0,0,1
14393,0,1,0,0,1
14394,1,0,0,0,1
14395,0,1,0,0,1
14396,1,0,0,0,1
14397,0,1,0,0,1
14398,0,1,0,0,1
14399,0,1,0,0,1
14400,0,1,0,0,1
14401,0,1,0,0,1
14402,1,0,0,0,1
14403,0,1,0,0,1
14404,0,1,0,0,1
14405,1,0,0,0,1
14406,0,1,0,0,1
14407,0,0,0,1,1
14408,1,0,0,0,1
14409,1,0,0,0,1
14410,0,1,0,0,1
14411,0,1,0,0,1
14412,0,1,0,0,1
14413,0,0,0,1,1
14414,0,1,0,0,1
14415,1,0,0,0,1
14416,0,1,0,0,1
14417,0,1,0,0,1
14418,1,0,0,0,1
14419,0,1,0,0,1
14420,0,1,0,0,1
14421,0,0,0,1,1
14422,1,0,0,0,1
14423,1,0,0,0,1
14424,0,1,0,0,1
14425,1,0,0,0,1
14426,0,1,0,0,1
14427,0,1,0,0,1
14428,0,1,0,0,1
14429,0,1,0,0,1
14430,0,0,0,1,1
14431,0,1,0,0,1
14432,1,0,0,0,1
14433,0,1,0,0,1
14434,0,1,0,0,1
14435,0,1,0,0,1
14436,0,1,0,0,1
14437,0,1,0,0,1
14438,0,1,0,0,1
14439,0,1,0,0,1
14440,0,1,0,0,1
14441,0,1,0,0,1
14442,0,1,0,0,1
14443,0,1,0,0,1
14444,0,1,0,0,1
14445,1,0,0,0,1
14446,0,1,0,0,1
14447,1,0,0,0,1
14448,1,0,0,0,1
14449,0,1,0,0,1
14450,0,1,0,0,1
14451,0,1,0,0,1
14452,0,1,0,0,1
14453,0,1,0,0,1
14454,0,0,0,1,1
14455,0,1,0,0,1
14456,0,1,0,0,1
14457,0,1,0,0,1
14458,0,1,0,0,1
14459,0,1,0,0,1
14460,0,1,0,0,1
14461,0,1,0,0,1
14462,0,1,0,0,1
14463,0,1,0,0,1
14464,0,1,0,0,1
14465,0,1,0,0,1
14466,1,0,0,0,1
14467,0,1,0,0,1
14468,0,1,0,0,1
14469,1,0,0,0,1
14470,0,1,0,0,1
14471,0,1,0,0,1
14472,0,1,0,0,1
14473,0,1,0,0,1
14474,0,1,0,0,1
14475,0,1,0,0,1
14476,1,0,0,0,1
14477,0,1,0,0,1
14478,0,1,0,0,1
14479,0,1,0,0,1
14480,0,1,0,0,1
14481,0,1,0,0,1
14482,0,1,0,0,1
14483,0,1,0,0,1
14484,0,1,0,0,1
14485,1,0,0,0,1
14486,0,1,0,0,1
14487,0,1,0,0,1
14488,0,1,0,0,1
14489,0,1,0,0,1
14490,0,1,0,0,1
14491,0,1,0,0,1
14492,0,1,0,0,1
14493,0,1,0,0,1
14494,0,1,0,0,1
14495,0,1,0,0,1
14496,0,1,0,0,1
14497,0,1,0,0,1
14498,1,0,0,0,1
14499,1,0,0,0,1
14500,0,0,0,1,1
14501,0,1,0,0,1
14502,0,1,0,0,1
14503,0,1,0,0,1
14504,0,0,1,0,1
14505,0,1,0,0,1
14506,1,0,0,0,1
14507,0,1,0,0,1
14508,0,1,0,0,1
14509,0,0,0,1,1
14510,0,1,0,0,1
14511,0,1,0,0,1
14512,0,1,0,0,1
14513,1,0,0,0,1
14514,0,1,0,0,1
14515,1,0,0,0,1
14516,0,1,0,0,1
14517,0,1,0,0,1
14518,0,1,0,0,1
14519,0,1,0,0,1
14520,0,1,0,0,1
14521,0,1,0,0,1
14522,0,1,0,0,1
14523,0,1,0,0,1
14524,0,1,0,0,1
14525,0,1,0,0,1
14526,1,0,0,0,1
14527,0,1,0,0,1
14528,0,0,0,1,1
14529,0,1,0,0,1
14530,0,1,0,0,1
14531,0,1,0,0,1
14532,0,1,0,0,1
14533,1,0,0,0,1
14534,0,1,0,0,1
14535,0,1,0,0,1
14536,0,1,0,0,1
14537,0,1,0,0,1
14538,1,0,0,0,1
14539,0,1,0,0,1
14540,0,1,0,0,1
14541,0,1,0,0,1
14542,0,1,0,0,1
14543,1,0,0,0,1
14544,0,1,0,0,1
14545,0,1,0,0,1
14546,0,1,0,0,1
14547,0,1,0,0,1
14548,0,1,0,0,1
14549,0,1,0,0,1
14550,0,1,0,0,1
14551,1,0,0,0,1
14552,0,1,0,0,1
14553,0,1,0,0,1
14554,0,1,0,0,1
14555,0,1,0,0,1
14556,0,1,0,0,1
14557,1,0,0,0,1
14558,1,0,0,0,1
14559,0,1,0,0,1
14560,0,1,0,0,1
14561,0,1,0,0,1
14562,0,1,0,0,1
14563,0,1,0,0,1
14564,0,1,0,0,1
14565,0,1,0,0,1
14566,1,0,0,0,1
14567,0,1,0,0,1
14568,0,1,0,0,1
14569,0,1,0,0,1
14570,0,1,0,0,1
14571,0,1,0,0,1
14572,0,1,0,0,1
14573,0,1,0,0,1
14574,0,1,0,0,1
14575,0,1,0,0,1
14576,0,1,0,0,1
14577,0,1,0,0,1
14578,0,1,0,0,1
14579,0,1,0,0,1
14580,0,1,0,0,1
14581,1,0,0,0,1
14582,0,1,0,0,1
14583,0,1,0,0,1
14584,0,1,0,0,1
14585,0,1,0,0,1
14586,1,0,0,0,1
14587,0,1,0,0,1
14588,0,1,0,0,1
14589,0,1,0,0,1
14590,0,1,0,0,1
14591,0,1,0,0,1
14592,0,1,0,0,1
14593,0,1,0,0,1
14594,0,1,0,0,1
14595,0,1,0,0,1
14596,0,1,0,0,1
14597,1,0,0,0,1
14598,1,0,0,0,1
14599,0,1,0,0,1
14600,0,1,0,0,1
14601,0,1,0,0,1
14602,0,1,0,0,1
14603,0,1,0,0,1
14604,0,1,0,0,1
14605,0,1,0,0,1
14606,1,0,0,0,1
14607,0,1,0,0,1
14608,0,1,0,0,1
14609,0,1,0,0,1
14610,0,1,0,0,1
14611,0,1,0,0,1
14612,0,1,0,0,1
14613,1,0,0,0,1
14614,1,0,0,0,1
14615,1,0,0,0,1
14616,0,1,0,0,1
14617,1,0,0,0,1
14618,0,1,0,0,1
14619,1,0,0,0,1
14620,0,1,0,0,1
14621,0,1,0,0,1
14622,0,1,0,0,1
14623,0,1,0,0,1
14624,0,1,0,0,1
14625,0,1,0,0,1
14626,1,0,0,0,1
14627,0,1,0,0,1
14628,0,1,0,0,1
14629,0,1,0,0,1
14630,0,1,0,0,1
14631,0,1,0,0,1
14632,0,1,0,0,1
14633,0,1,0,0,1
14634,0,1,0,0,1
14635,1,0,0,0,1
14636,0,1,0,0,1
14637,0,1,0,0,1
14638,0,1,0,0,1
14639,0,1,0,0,1
14640,0,1,0,0,1
14641,1,0,0,0,1
14642,0,1,0,0,1
14643,1,0,0,0,1
14644,0,1,0,0,1
14645,0,1,0,0,1
14646,0,1,0,0,1
14647,0,1,0,0,1
14648,0,1,0,0,1
14649,0,1,0,0,1
14650,0,1,0,0,1
14651,1,0,0,0,1
14652,0,1,0,0,1
14653,0,1,0,0,1
14654,1,0,0,0,1
14655,1,0,0,0,1
14656,0,1,0,0,1
14657,1,0,0,0,1
14658,0,1,0,0,1
14659,0,1,0,0,1
14660,1,0,0,0,1
14661,0,1,0,0,1
14662,0,1,0,0,1
14663,0,1,0,0,1
14664,0,1,0,0,1
14665,0,1,0,0,1
14666,0,1,0,0,1
14667,0,1,0,0,1
14668,0,1,0,0,1
14669,0,1,0,0,1
14670,0,1,0,0,1
14671,0,0,0,1,1
14672,1,0,0,0,1
14673,0,1,0,0,1
14674,0,1,0,0,1
14675,0,1,0,0,1
14676,0,1,0,0,1
14677,0,1,0,0,1
14678,0,1,0,0,1
14679,0,1,0,0,1
14680,0,1,0,0,1
14681,0,1,0,0,1
14682,0,1,0,0,1
14683,1,0,0,0,1
14684,0,1,0,0,1
14685,0,1,0,0,1
14686,0,1,0,0,1
14687,1,0,0,0,1
14688,0,1,0,0,1
14689,0,1,0,0,1
14690,0,1,0,0,1
14691,0,1,0,0,1
14692,0,1,0,0,1
14693,0,1,0,0,1
14694,0,1,0,0,1
14695,1,0,0,0,1
14696,0,1,0,0,1
14697,1,0,0,0,1
14698,0,1,0,0,1
14699,0,0,1,0,1
14700,0,1,0,0,1
14701,0,1,0,0,1
14702,0,1,0,0,1
14703,0,1,0,0,1
14704,0,1,0,0,1
14705,0,1,0,0,1
14706,1,0,0,0,1
14707,0,1,0,0,1
14708,1,0,0,0,1
14709,0,1,0,0,1
14710,0,1,0,0,1
14711,0,1,0,0,1
14712,1,0,0,0,1
14713,0,1,0,0,1
14714,0,1,0,0,1
14715,0,1,0,0,1
14716,0,1,0,0,1
14717,0,1,0,0,1
14718,0,1,0,0,1
14719,0,1,0,0,1
14720,0,1,0,0,1
14721,0,1,0,0,1
14722,0,1,0,0,1
14723,0,1,0,0,1
14724,0,1,0,0,1
14725,1,0,0,0,1
14726,0,1,0,0,1
14727,0,0,0,1,1
14728,0,1,0,0,1
14729,0,1,0,0,1
14730,0,1,0,0,1
14731,0,1,0,0,1
14732,0,1,0,0,1
14733,1,0,0,0,1
14734,0,1,0,0,1
14735,0,1,0,0,1
14736,0,1,0,0,1
14737,0,1,0,0,1
14738,1,0,0,0,1
14739,0,1,0,0,1
14740,0,1,0,0,1
14741,0,1,0,0,1
14742,0,1,0,0,1
14743,0,1,0,0,1
14744,0,1,0,0,1
14745,0,1,0,0,1
14746,0,1,0,0,1
14747,0,1,0,0,1
14748,0,1,0,0,1
14749,0,1,0,0,1
14750,0,1,0,0,1
14751,0,1,0,0,1
14752,1,0,0,0,1
14753,0,1,0,0,1
14754,0,1,0,0,1
14755,0,1,0,0,1
14756,0,1,0,0,1
14757,1,0,0,0,1
14758,1,0,0,0,1
14759,0,1,0,0,1
14760,0,1,0,0,1
14761,0,1,0,0,1
14762,0,1,0,0,1
14763,1,0,0,0,1
14764,0,1,0,0,1
14765,0,1,0,0,1
14766,0,1,0,0,1
14767,0,1,0,0,1
14768,0,1,0,0,1
14769,0,1,0,0,1
14770,0,1,0,0,1
14771,0,1,0,0,1
14772,1,0,0,0,1
14773,1,0,0,0,1
14774,0,1,0,0,1
14775,0,1,0,0,1
14776,0,1,0,0,1
14777,1,0,0,0,1
14778,1,0,0,0,1
14779,0,1,0,0,1
14780,0,1,0,0,1
14781,0,1,0,0,1
14782,0,1,0,0,1
14783,0,1,0,0,1
14784,1,0,0,0,1
14785,0,1,0,0,1
14786,0,1,0,0,1
14787,0,1,0,0,1
14788,0,1,0,0,1
14789,1,0,0,0,1
14790,1,0,0,0,1
14791,0,1,0,0,1
14792,0,1,0,0,1
14793,0,1,0,0,1
14794,0,1,0,0,1
14795,0,1,0,0,1
14796,1,0,0,0,1
14797,0,1,0,0,1
14798,1,0,0,0,1
14799,1,0,0,0,1
14800,0,1,0,0,1
14801,1,0,0,0,1
14802,0,0,1,0,1
14803,0,1,0,0,1
14804,0,1,0,0,1
14805,0,1,0,0,1
14806,1,0,0,0,1
14807,0,1,0,0,1
14808,0,1,0,0,1
14809,0,1,0,0,1
14810,0,1,0,0,1
14811,0,1,0,0,1
14812,0,1,0,0,1
14813,0,1,0,0,1
14814,0,1,0,0,1
14815,0,1,0,0,1
14816,1,0,0,0,1
14817,0,1,0,0,1
14818,0,1,0,0,1
14819,1,0,0,0,1
14820,0,1,0,0,1
14821,0,1,0,0,1
14822,0,1,0,0,1
14823,0,1,0,0,1
14824,0,1,0,0,1
14825,0,1,0,0,1
14826,0,1,0,0,1
14827,0,1,0,0,1
14828,0,1,0,0,1
14829,0,1,0,0,1
14830,0,1,0,0,1
14831,0,1,0,0,1
14832,0,1,0,0,1
14833,0,1,0,0,1
14834,1,0,0,0,1
14835,0,1,0,0,1
14836,0,1,0,0,1
14837,1,0,0,0,1
14838,1,0,0,0,1
14839,0,1,0,0,1
14840,0,1,0,0,1
14841,0,1,0,0,1
14842,1,0,0,0,1
14843,0,1,0,0,1
14844,0,1,0,0,1
14845,0,1,0,0,1
14846,0,1,0,0,1
14847,0,1,0,0,1
14848,0,1,0,0,1
14849,0,1,0,0,1
14850,0,1,0,0,1
14851,0,1,0,0,1
14852,0,1,0,0,1
14853,0,1,0,0,1
14854,1,0,0,0,1
14855,0,1,0,0,1
14856,0,1,0,0,1
14857,0,1,0,0,1
14858,0,1,0,0,1
14859,0,1,0,0,1
14860,0,1,0,0,1
14861,0,1,0,0,1
14862,0,1,0,0,1
14863,0,1,0,0,1
14864,1,0,0,0,1
14865,0,1,0,0,1
14866,0,1,0,0,1
14867,0,1,0,0,1
14868,0,1,0,0,1
14869,0,1,0,0,1
14870,0,1,0,0,1
14871,0,1,0,0,1
14872,0,1,0,0,1
14873,0,1,0,0,1
14874,0,1,0,0,1
14875,0,1,0,0,1
14876,0,1,0,0,1
14877,0,1,0,0,1
14878,0,1,0,0,1
14879,0,1,0,0,1
14880,0,1,0,0,1
14881,0,1,0,0,1
14882,0,1,0,0,1
14883,1,0,0,0,1
14884,1,0,0,0,1
14885,0,1,0,0,1
14886,0,1,0,0,1
14887,0,1,0,0,1
14888,0,1,0,0,1
14889,0,1,0,0,1
14890,0,1,0,0,1
14891,1,0,0,0,1
14892,1,0,0,0,1
14893,0,1,0,0,1
14894,0,1,0,0,1
14895,0,1,0,0,1
14896,0,1,0,0,1
14897,0,1,0,0,1
14898,0,1,0,0,1
14899,0,0,0,1,1
14900,0,1,0,0,1
14901,1,0,0,0,1
14902,0,1,0,0,1
14903,0,1,0,0,1
14904,1,0,0,0,1
14905,0,1,0,0,1
14906,0,1,0,0,1
14907,1,0,0,0,1
14908,0,1,0,0,1
14909,0,1,0,0,1
14910,0,1,0,0,1
14911,0,1,0,0,1
14912,1,0,0,0,1
14913,0,1,0,0,1
14914,1,0,0,0,1
14915,0,1,0,0,1
14916,0,1,0,0,1
14917,0,1,0,0,1
14918,0,1,0,0,1
14919,0,1,0,0,1
14920,0,1,0,0,1
14921,0,1,0,0,1
14922,0,1,0,0,1
14923,0,1,0,0,1
14924,0,1,0,0,1
14925,0,1,0,0,1
14926,0,1,0,0,1
14927,1,0,0,0,1
14928,0,1,0,0,1
14929,1,0,0,0,1
14930,0,1,0,0,1
14931,0,1,0,0,1
14932,0,1,0,0,1
14933,0,1,0,0,1
14934,0,1,0,0,1
14935,0,1,0,0,1
14936,1,0,0,0,1
14937,1,0,0,0,1
14938,0,1,0,0,1
14939,0,1,0,0,1
14940,0,1,0,0,1
14941,0,1,0,0,1
14942,1,0,0,0,1
14943,0,1,0,0,1
14944,0,1,0,0,1
14945,0,1,0,0,1
14946,0,1,0,0,1
14947,0,1,0,0,1
14948,0,1,0,0,1
14949,0,1,0,0,1
14950,1,0,0,0,1
14951,0,1,0,0,1
14952,0,1,0,0,1
14953,1,0,0,0,1
14954,0,1,0,0,1
14955,0,1,0,0,1
14956,0,1,0,0,1
14957,1,0,0,0,1
14958,0,1,0,0,1
14959,0,1,0,0,1
14960,0,1,0,0,1
14961,0,1,0,0,1
14962,1,0,0,0,1
14963,0,1,0,0,1
14964,0,1,0,0,1
14965,0,1,0,0,1
14966,0,1,0,0,1
14967,0,1,0,0,1
14968,0,1,0,0,1
14969,0,1,0,0,1
14970,0,1,0,0,1
14971,0,1,0,0,1
14972,0,1,0,0,1
14973,0,1,0,0,1
14974,1,0,0,0,1
14975,1,0,0,0,1
14976,0,1,0,0,1
14977,0,1,0,0,1
14978,0,1,0,0,1
14979,0,1,0,0,1
14980,0,1,0,0,1
14981,0,1,0,0,1
14982,0,1,0,0,1
14983,0,1,0,0,1
14984,1,0,0,0,1
14985,0,1,0,0,1
14986,0,1,0,0,1
14987,0,1,0,0,1
14988,0,1,0,0,1
14989,0,1,0,0,1
14990,1,0,0,0,1
14991,0,1,0,0,1
14992,0,1,0,0,1
14993,1,0,0,0,1
14994,0,1,0,0,1
14995,1,0,0,0,1
14996,0,1,0,0,1
14997,0,1,0,0,1
14998,0,1,0,0,1
14999,1,0,0,0,1
15000,0,1,0,0,1
15001,0,1,0,0,1
15002,0,1,0,0,1
15003,0,1,0,0,1
15004,0,1,0,0,1
15005,0,1,0,0,1
15006,1,0,0,0,1
15007,0,1,0,0,1
15008,0,1,0,0,1
15009,1,0,0,0,1
15010,0,1,0,0,1
15011,0,1,0,0,1
15012,1,0,0,0,1
15013,0,1,0,0,1
15014,0,1,0,0,1
15015,0,1,0,0,1
15016,0,1,0,0,1
15017,0,1,0,0,1
15018,0,1,0,0,1
15019,0,1,0,0,1
15020,0,1,0,0,1
15021,0,1,0,0,1
15022,0,1,0,0,1
15023,0,1,0,0,1
15024,0,1,0,0,1
15025,0,1,0,0,1
15026,0,1,0,0,1
15027,0,1,0,0,1
15028,0,1,0,0,1
15029,0,1,0,0,1
15030,0,1,0,0,1
15031,0,1,0,0,1
15032,0,1,0,0,1
15033,1,0,0,0,1
15034,0,1,0,0,1
15035,0,1,0,0,1
15036,0,1,0,0,1
15037,0,1,0,0,1
15038,0,1,0,0,1
15039,0,1,0,0,1
15040,1,0,0,0,1
15041,0,1,0,0,1
15042,0,1,0,0,1
15043,0,1,0,0,1
15044,1,0,0,0,1
15045,0,1,0,0,1
15046,0,1,0,0,1
15047,0,1,0,0,1
15048,0,1,0,0,1
15049,0,1,0,0,1
15050,0,1,0,0,1
15051,0,1,0,0,1
15052,0,1,0,0,1
15053,1,0,0,0,1
15054,1,0,0,0,1
15055,0,1,0,0,1
15056,0,1,0,0,1
15057,0,1,0,0,1
15058,0,1,0,0,1
15059,0,1,0,0,1
15060,0,1,0,0,1
15061,1,0,0,0,1
15062,0,1,0,0,1
15063,1,0,0,0,1
15064,0,1,0,0,1
15065,0,1,0,0,1
15066,0,1,0,0,1
15067,0,1,0,0,1
15068,0,1,0,0,1
15069,0,1,0,0,1
15070,1,0,0,0,1
15071,0,1,0,0,1
15072,0,1,0,0,1
15073,0,1,0,0,1
15074,0,1,0,0,1
15075,1,0,0,0,1
15076,0,1,0,0,1
15077,0,1,0,0,1
15078,0,1,0,0,1
15079,0,1,0,0,1
15080,0,1,0,0,1
15081,1,0,0,0,1
15082,0,1,0,0,1
15083,0,1,0,0,1
15084,0,1,0,0,1
15085,0,1,0,0,1
15086,0,1,0,0,1
15087,0,1,0,0,1
15088,0,1,0,0,1
15089,1,0,0,0,1
15090,0,1,0,0,1
15091,0,1,0,0,1
15092,0,1,0,0,1
15093,0,0,0,1,1
15094,0,0,0,1,1
15095,0,1,0,0,1
15096,0,1,0,0,1
15097,1,0,0,0,1
15098,0,0,0,1,1
15099,0,1,0,0,1
15100,0,1,0,0,1
15101,0,1,0,0,1
15102,0,1,0,0,1
15103,0,1,0,0,1
15104,0,1,0,0,1
15105,0,1,0,0,1
15106,1,0,0,0,1
15107,1,0,0,0,1
15108,0,1,0,0,1
15109,1,0,0,0,1
15110,0,1,0,0,1
15111,0,1,0,0,1
15112,0,1,0,0,1
15113,0,1,0,0,1
15114,0,1,0,0,1
15115,0,1,0,0,1
15116,0,1,0,0,1
15117,0,1,0,0,1
15118,0,1,0,0,1
15119,1,0,0,0,1
15120,1,0,0,0,1
15121,1,0,0,0,1
15122,0,1,0,0,1
15123,0,1,0,0,1
15124,0,1,0,0,1
15125,0,1,0,0,1
15126,0,1,0,0,1
15127,0,1,0,0,1
15128,0,1,0,0,1
15129,0,1,0,0,1
15130,0,1,0,0,1
15131,0,1,0,0,1
15132,0,1,0,0,1
15133,0,1,0,0,1
15134,0,1,0,0,1
15135,0,1,0,0,1
15136,0,1,0,0,1
15137,0,1,0,0,1
15138,1,0,0,0,1
15139,0,0,0,1,1
15140,0,1,0,0,1
15141,0,1,0,0,1
15142,0,1,0,0,1
15143,0,1,0,0,1
15144,0,1,0,0,1
15145,0,1,0,0,1
15146,0,1,0,0,1
15147,0,1,0,0,1
15148,0,1,0,0,1
15149,0,1,0,0,1
15150,0,1,0,0,1
15151,0,0,0,1,1
15152,0,1,0,0,1
15153,0,1,0,0,1
15154,0,1,0,0,1
15155,0,1,0,0,1
15156,0,1,0,0,1
15157,0,1,0,0,1
15158,0,1,0,0,1
15159,1,0,0,0,1
15160,0,1,0,0,1
15161,0,1,0,0,1
15162,0,1,0,0,1
15163,0,1,0,0,1
15164,0,1,0,0,1
15165,0,1,0,0,1
15166,0,1,0,0,1
15167,0,1,0,0,1
15168,0,1,0,0,1
15169,0,1,0,0,1
15170,0,1,0,0,1
15171,0,1,0,0,1
15172,0,1,0,0,1
15173,0,1,0,0,1
15174,0,1,0,0,1
15175,1,0,0,0,1
15176,1,0,0,0,1
15177,0,1,0,0,1
15178,0,1,0,0,1
15179,0,1,0,0,1
15180,0,1,0,0,1
15181,1,0,0,0,1
15182,0,1,0,0,1
15183,1,0,0,0,1
15184,0,1,0,0,1
15185,0,1,0,0,1
15186,0,1,0,0,1
15187,0,1,0,0,1
15188,0,1,0,0,1
15189,0,1,0,0,1
15190,0,1,0,0,1
15191,1,0,0,0,1
15192,0,1,0,0,1
15193,0,1,0,0,1
15194,0,1,0,0,1
15195,1,0,0,0,1
15196,0,1,0,0,1
15197,0,1,0,0,1
15198,1,0,0,0,1
15199,0,1,0,0,1
15200,0,1,0,0,1
15201,0,1,0,0,1
15202,1,0,0,0,1
15203,0,1,0,0,1
15204,0,0,1,0,1
15205,0,0,0,1,1
15206,0,1,0,0,1
15207,0,1,0,0,1
15208,0,1,0,0,1
15209,0,1,0,0,1
15210,0,1,0,0,1
15211,0,1,0,0,1
15212,1,0,0,0,1
15213,0,1,0,0,1
15214,0,1,0,0,1
15215,0,1,0,0,1
15216,0,1,0,0,1
15217,0,1,0,0,1
15218,0,1,0,0,1
15219,1,0,0,0,1
15220,0,1,0,0,1
15221,0,1,0,0,1
15222,1,0,0,0,1
15223,0,1,0,0,1
15224,0,1,0,0,1
15225,0,1,0,0,1
15226,0,1,0,0,1
15227,0,1,0,0,1
15228,0,1,0,0,1
15229,0,1,0,0,1
15230,0,1,0,0,1
15231,0,1,0,0,1
15232,1,0,0,0,1
15233,0,1,0,0,1
15234,1,0,0,0,1
15235,0,1,0,0,1
15236,0,1,0,0,1
15237,0,1,0,0,1
15238,0,1,0,0,1
15239,0,1,0,0,1
15240,1,0,0,0,1
15241,0,1,0,0,1
15242,0,1,0,0,1
15243,0,1,0,0,1
15244,0,0,1,0,1
15245,0,1,0,0,1
15246,1,0,0,0,1
15247,1,0,0,0,1
15248,0,1,0,0,1
15249,0,1,0,0,1
15250,0,1,0,0,1
15251,0,1,0,0,1
15252,0,1,0,0,1
15253,1,0,0,0,1
15254,0,1,0,0,1
15255,0,1,0,0,1
15256,0,1,0,0,1
15257,0,1,0,0,1
15258,1,0,0,0,1
15259,1,0,0,0,1
15260,0,1,0,0,1
15261,0,1,0,0,1
15262,1,0,0,0,1
15263,0,1,0,0,1
15264,0,1,0,0,1
15265,0,1,0,0,1
15266,0,1,0,0,1
15267,0,1,0,0,1
15268,0,1,0,0,1
15269,0,1,0,0,1
15270,0,1,0,0,1
15271,1,0,0,0,1
15272,1,0,0,0,1
15273,1,0,0,0,1
15274,0,1,0,0,1
15275,0,1,0,0,1
15276,0,1,0,0,1
15277,1,0,0,0,1
15278,1,0,0,0,1
15279,0,1,0,0,1
15280,0,1,0,0,1
15281,0,1,0,0,1
15282,0,1,0,0,1
15283,0,0,0,1,1
15284,0,1,0,0,1
15285,0,1,0,0,1
15286,0,1,0,0,1
15287,0,1,0,0,1
15288,0,1,0,0,1
15289,0,1,0,0,1
15290,1,0,0,0,1
15291,0,1,0,0,1
15292,0,1,0,0,1
15293,0,0,0,1,1
15294,0,1,0,0,1
15295,1,0,0,0,1
15296,1,0,0,0,1
15297,0,1,0,0,1
15298,1,0,0,0,1
15299,0,1,0,0,1
15300,0,1,0,0,1
15301,0,1,0,0,1
15302,0,1,0,0,1
15303,0,1,0,0,1
15304,1,0,0,0,1
15305,0,1,0,0,1
15306,0,1,0,0,1
15307,0,1,0,0,1
15308,0,0,0,1,1
15309,0,1,0,0,1
15310,0,1,0,0,1
15311,1,0,0,0,1
15312,0,1,0,0,1
15313,0,1,0,0,1
15314,1,0,0,0,1
15315,0,1,0,0,1
15316,1,0,0,0,1
15317,1,0,0,0,1
15318,0,1,0,0,1
15319,0,1,0,0,1
15320,0,1,0,0,1
15321,0,1,0,0,1
15322,0,1,0,0,1
15323,0,1,0,0,1
15324,0,1,0,0,1
15325,0,1,0,0,1
15326,0,1,0,0,1
15327,0,0,0,1,1
15328,0,1,0,0,1
15329,1,0,0,0,1
15330,0,1,0,0,1
15331,0,1,0,0,1
15332,0,0,1,0,1
15333,0,1,0,0,1
15334,0,1,0,0,1
15335,0,1,0,0,1
15336,0,1,0,0,1
15337,0,1,0,0,1
15338,0,1,0,0,1
15339,0,1,0,0,1
15340,1,0,0,0,1
15341,0,1,0,0,1
15342,0,1,0,0,1
15343,0,1,0,0,1
15344,0,1,0,0,1
15345,0,1,0,0,1
15346,0,1,0,0,1
15347,0,1,0,0,1
15348,0,1,0,0,1
15349,0,1,0,0,1
15350,0,1,0,0,1
15351,0,1,0,0,1
15352,0,1,0,0,1
15353,0,1,0,0,1
15354,0,1,0,0,1
15355,0,1,0,0,1
15356,1,0,0,0,1
15357,0,1,0,0,1
15358,1,0,0,0,1
15359,0,1,0,0,1
15360,0,1,0,0,1
15361,1,0,0,0,1
15362,0,1,0,0,1
15363,0,1,0,0,1
15364,0,1,0,0,1
15365,0,1,0,0,1
15366,0,1,0,0,1
15367,1,0,0,0,1
15368,1,0,0,0,1
15369,0,1,0,0,1
15370,0,1,0,0,1
15371,0,1,0,0,1
15372,0,1,0,0,1
15373,0,1,0,0,1
15374,0,1,0,0,1
15375,1,0,0,0,1
15376,0,1,0,0,1
15377,0,1,0,0,1
15378,1,0,0,0,1
15379,0,1,0,0,1
15380,0,1,0,0,1
15381,0,1,0,0,1
15382,0,1,0,0,1
15383,0,1,0,0,1
15384,1,0,0,0,1
15385,0,1,0,0,1
15386,0,1,0,0,1
15387,0,1,0,0,1
15388,0,1,0,0,1
15389,0,1,0,0,1
15390,0,1,0,0,1
15391,1,0,0,0,1
15392,0,1,0,0,1
15393,0,1,0,0,1
15394,0,1,0,0,1
15395,0,1,0,0,1
15396,0,1,0,0,1
15397,0,1,0,0,1
15398,0,1,0,0,1
15399,0,1,0,0,1
15400,0,1,0,0,1
15401,0,1,0,0,1
15402,0,1,0,0,1
15403,0,1,0,0,1
15404,1,0,0,0,1
15405,0,1,0,0,1
15406,0,1,0,0,1
15407,0,1,0,0,1
15408,0,1,0,0,1
15409,0,1,0,0,1
15410,0,1,0,0,1
15411,1,0,0,0,1
15412,0,1,0,0,1
15413,0,1,0,0,1
15414,0,1,0,0,1
15415,0,1,0,0,1
15416,0,1,0,0,1
15417,0,1,0,0,1
15418,0,1,0,0,1
15419,0,1,0,0,1
15420,0,1,0,0,1
15421,0,1,0,0,1
15422,0,1,0,0,1
15423,0,1,0,0,1
15424,1,0,0,0,1
15425,0,1,0,0,1
15426,0,1,0,0,1
15427,0,1,0,0,1
15428,1,0,0,0,1
15429,0,1,0,0,1
15430,0,1,0,0,1
15431,0,1,0,0,1
15432,0,1,0,0,1
15433,0,1,0,0,1
15434,0,1,0,0,1
15435,0,1,0,0,1
15436,0,1,0,0,1
15437,0,1,0,0,1
15438,0,1,0,0,1
15439,0,1,0,0,1
15440,0,1,0,0,1
15441,0,0,1,0,1
15442,0,1,0,0,1
15443,1,0,0,0,1
15444,0,1,0,0,1
15445,0,1,0,0,1
15446,0,1,0,0,1
15447,0,1,0,0,1
15448,1,0,0,0,1
15449,0,1,0,0,1
15450,0,1,0,0,1
15451,0,1,0,0,1
15452,0,1,0,0,1
15453,0,1,0,0,1
15454,0,1,0,0,1
15455,0,1,0,0,1
15456,1,0,0,0,1
15457,0,1,0,0,1
15458,0,1,0,0,1
15459,0,1,0,0,1
15460,0,1,0,0,1
15461,0,0,0,1,1
15462,0,1,0,0,1
15463,1,0,0,0,1
15464,0,1,0,0,1
15465,0,1,0,0,1
15466,0,1,0,0,1
15467,0,1,0,0,1
15468,0,1,0,0,1
15469,1,0,0,0,1
15470,0,1,0,0,1
15471,0,1,0,0,1
15472,0,1,0,0,1
15473,0,1,0,0,1
15474,1,0,0,0,1
15475,0,1,0,0,1
15476,0,1,0,0,1
15477,0,1,0,0,1
15478,0,1,0,0,1
15479,0,1,0,0,1
15480,0,1,0,0,1
15481,0,1,0,0,1
15482,0,1,0,0,1
15483,0,1,0,0,1
15484,1,0,0,0,1
15485,0,1,0,0,1
15486,0,1,0,0,1
15487,0,1,0,0,1
15488,0,1,0,0,1
15489,1,0,0,0,1
15490,0,1,0,0,1
15491,0,1,0,0,1
15492,0,1,0,0,1
15493,1,0,0,0,1
15494,0,1,0,0,1
15495,1,0,0,0,1
15496,0,1,0,0,1
15497,0,1,0,0,1
15498,0,0,0,1,1
15499,1,0,0,0,1
15500,0,1,0,0,1
15501,0,1,0,0,1
15502,0,0,1,0,1
15503,0,1,0,0,1
15504,1,0,0,0,1
15505,0,1,0,0,1
15506,0,1,0,0,1
15507,0,1,0,0,1
15508,0,1,0,0,1
15509,0,1,0,0,1
15510,0,1,0,0,1
15511,0,1,0,0,1
15512,0,1,0,0,1
15513,0,1,0,0,1
15514,0,1,0,0,1
15515,0,1,0,0,1
15516,0,1,0,0,1
15517,0,1,0,0,1
15518,0,1,0,0,1
15519,0,1,0,0,1
15520,0,1,0,0,1
15521,0,1,0,0,1
15522,0,1,0,0,1
15523,0,1,0,0,1
15524,0,1,0,0,1
15525,0,1,0,0,1
15526,0,1,0,0,1
15527,0,1,0,0,1
15528,0,1,0,0,1
15529,0,1,0,0,1
15530,0,1,0,0,1
15531,1,0,0,0,1
15532,0,1,0,0,1
15533,0,1,0,0,1
15534,1,0,0,0,1
15535,1,0,0,0,1
15536,0,1,0,0,1
15537,0,1,0,0,1
15538,1,0,0,0,1
15539,1,0,0,0,1
15540,0,1,0,0,1
15541,0,1,0,0,1
15542,0,1,0,0,1
15543,0,1,0,0,1
15544,0,1,0,0,1
15545,0,1,0,0,1
15546,0,1,0,0,1
15547,0,1,0,0,1
15548,0,1,0,0,1
15549,0,1,0,0,1
15550,0,1,0,0,1
15551,1,0,0,0,1
15552,0,1,0,0,1
15553,0,1,0,0,1
15554,0,1,0,0,1
15555,0,1,0,0,1
15556,0,1,0,0,1
15557,0,1,0,0,1
15558,0,1,0,0,1
15559,1,0,0,0,1
15560,0,1,0,0,1
15561,0,1,0,0,1
15562,1,0,0,0,1
15563,0,1,0,0,1
15564,0,1,0,0,1
15565,0,1,0,0,1
15566,0,1,0,0,1
15567,0,1,0,0,1
15568,1,0,0,0,1
15569,0,1,0,0,1
15570,0,1,0,0,1
15571,0,1,0,0,1
15572,0,1,0,0,1
15573,0,1,0,0,1
15574,0,1,0,0,1
15575,0,1,0,0,1
15576,0,1,0,0,1
15577,0,1,0,0,1
15578,0,1,0,0,1
15579,0,1,0,0,1
15580,0,1,0,0,1
15581,0,1,0,0,1
15582,0,1,0,0,1
15583,0,1,0,0,1
15584,0,1,0,0,1
15585,0,1,0,0,1
15586,0,1,0,0,1
15587,0,1,0,0,1
15588,0,1,0,0,1
15589,0,1,0,0,1
15590,0,1,0,0,1
15591,0,1,0,0,1
15592,0,1,0,0,1
15593,0,1,0,0,1
15594,0,1,0,0,1
15595,1,0,0,0,1
15596,0,1,0,0,1
15597,0,1,0,0,1
15598,0,1,0,0,1
15599,0,1,0,0,1
15600,1,0,0,0,1
15601,0,1,0,0,1
15602,0,0,0,1,1
15603,0,1,0,0,1
15604,0,1,0,0,1
15605,1,0,0,0,1
15606,0,1,0,0,1
15607,0,1,0,0,1
15608,0,1,0,0,1
15609,0,1,0,0,1
15610,0,1,0,0,1
15611,0,1,0,0,1
15612,0,1,0,0,1
15613,0,1,0,0,1
15614,0,1,0,0,1
15615,0,1,0,0,1
15616,0,1,0,0,1
15617,0,1,0,0,1
15618,0,1,0,0,1
15619,1,0,0,0,1
15620,0,1,0,0,1
15621,1,0,0,0,1
15622,0,1,0,0,1
15623,0,1,0,0,1
15624,0,1,0,0,1
15625,0,1,0,0,1
15626,0,1,0,0,1
15627,0,1,0,0,1
15628,0,1,0,0,1
15629,0,0,1,0,1
15630,0,1,0,0,1
15631,0,1,0,0,1
15632,0,1,0,0,1
15633,0,1,0,0,1
15634,1,0,0,0,1
15635,0,1,0,0,1
15636,0,1,0,0,1
15637,1,0,0,0,1
15638,0,1,0,0,1
15639,0,1,0,0,1
15640,0,1,0,0,1
15641,0,1,0,0,1
15642,0,1,0,0,1
15643,0,1,0,0,1
15644,0,1,0,0,1
15645,0,1,0,0,1
15646,0,1,0,0,1
15647,0,1,0,0,1
15648,0,1,0,0,1
15649,0,1,0,0,1
15650,0,1,0,0,1
15651,1,0,0,0,1
15652,0,1,0,0,1
15653,1,0,0,0,1
15654,0,1,0,0,1
15655,0,1,0,0,1
15656,1,0,0,0,1
15657,0,1,0,0,1
15658,0,1,0,0,1
15659,0,1,0,0,1
15660,1,0,0,0,1
15661,0,1,0,0,1
15662,0,1,0,0,1
15663,0,1,0,0,1
15664,0,1,0,0,1
15665,0,1,0,0,1
15666,0,1,0,0,1
15667,0,1,0,0,1
15668,0,1,0,0,1
15669,0,1,0,0,1
15670,0,1,0,0,1
15671,0,1,0,0,1
15672,0,1,0,0,1
15673,0,1,0,0,1
15674,0,1,0,0,1
15675,0,1,0,0,1
15676,0,1,0,0,1
15677,0,1,0,0,1
15678,0,1,0,0,1
15679,1,0,0,0,1
15680,0,1,0,0,1
15681,0,1,0,0,1
15682,0,1,0,0,1
15683,1,0,0,0,1
15684,0,1,0,0,1
15685,0,1,0,0,1
15686,0,1,0,0,1
15687,0,1,0,0,1
15688,0,1,0,0,1
15689,0,1,0,0,1
15690,1,0,0,0,1
15691,0,1,0,0,1
15692,0,1,0,0,1
15693,0,1,0,0,1
15694,0,1,0,0,1
15695,0,1,0,0,1
15696,0,1,0,0,1
15697,0,1,0,0,1
15698,0,1,0,0,1
15699,0,1,0,0,1
15700,0,1,0,0,1
15701,0,1,0,0,1
15702,0,1,0,0,1
15703,0,1,0,0,1
15704,0,1,0,0,1
15705,0,1,0,0,1
15706,1,0,0,0,1
15707,0,1,0,0,1
15708,0,1,0,0,1
15709,0,1,0,0,1
15710,0,1,0,0,1
15711,1,0,0,0,1
15712,0,1,0,0,1
15713,0,1,0,0,1
15714,0,1,0,0,1
15715,0,1,0,0,1
15716,0,1,0,0,1
15717,0,1,0,0,1
15718,0,1,0,0,1
15719,0,1,0,0,1
15720,0,1,0,0,1
15721,0,1,0,0,1
15722,0,1,0,0,1
15723,0,1,0,0,1
15724,0,1,0,0,1
15725,0,1,0,0,1
15726,0,1,0,0,1
15727,0,1,0,0,1
15728,0,1,0,0,1
15729,0,1,0,0,1
15730,0,1,0,0,1
15731,0,1,0,0,1
15732,0,1,0,0,1
15733,1,0,0,0,1
15734,0,1,0,0,1
15735,0,1,0,0,1
15736,0,1,0,0,1
15737,0,1,0,0,1
15738,1,0,0,0,1
15739,0,1,0,0,1
15740,0,1,0,0,1
15741,0,1,0,0,1
15742,0,1,0,0,1
15743,0,1,0,0,1
15744,0,1,0,0,1
15745,0,1,0,0,1
15746,0,1,0,0,1
15747,1,0,0,0,1
15748,1,0,0,0,1
15749,0,1,0,0,1
15750,0,1,0,0,1
15751,0,1,0,0,1
15752,0,1,0,0,1
15753,0,1,0,0,1
15754,0,1,0,0,1
15755,0,1,0,0,1
15756,0,1,0,0,1
15757,0,1,0,0,1
15758,1,0,0,0,1
15759,1,0,0,0,1
15760,0,1,0,0,1
15761,0,1,0,0,1
15762,0,0,0,1,1
15763,0,1,0,0,1
15764,0,1,0,0,1
15765,1,0,0,0,1
15766,0,1,0,0,1
15767,0,1,0,0,1
15768,0,0,0,1,1
15769,1,0,0,0,1
15770,0,1,0,0,1
15771,0,1,0,0,1
15772,0,1,0,0,1
15773,0,1,0,0,1
15774,0,1,0,0,1
15775,0,1,0,0,1
15776,0,1,0,0,1
15777,0,1,0,0,1
15778,0,1,0,0,1
15779,0,1,0,0,1
15780,0,1,0,0,1
15781,0,1,0,0,1
15782,0,1,0,0,1
15783,0,1,0,0,1
15784,0,1,0,0,1
15785,0,1,0,0,1
15786,0,1,0,0,1
15787,0,1,0,0,1
15788,0,1,0,0,1
15789,0,1,0,0,1
15790,0,1,0,0,1
15791,0,1,0,0,1
15792,0,1,0,0,1
15793,1,0,0,0,1
15794,0,1,0,0,1
15795,0,1,0,0,1
15796,0,1,0,0,1
15797,0,1,0,0,1
15798,0,1,0,0,1
15799,0,1,0,0,1
15800,1,0,0,0,1
15801,0,1,0,0,1
15802,0,1,0,0,1
15803,0,1,0,0,1
15804,0,1,0,0,1
15805,0,1,0,0,1
15806,0,1,0,0,1
15807,0,1,0,0,1
15808,0,1,0,0,1
15809,0,1,0,0,1
15810,0,1,0,0,1
15811,0,1,0,0,1
15812,0,1,0,0,1
15813,0,1,0,0,1
15814,0,1,0,0,1
15815,0,1,0,0,1
15816,0,1,0,0,1
15817,0,1,0,0,1
15818,0,1,0,0,1
15819,0,1,0,0,1
15820,0,1,0,0,1
15821,0,1,0,0,1
15822,0,1,0,0,1
15823,0,1,0,0,1
15824,1,0,0,0,1
15825,0,1,0,0,1
15826,0,1,0,0,1
15827,0,1,0,0,1
15828,0,1,0,0,1
15829,0,0,0,1,1
15830,0,1,0,0,1
15831,0,1,0,0,1
15832,0,1,0,0,1
15833,1,0,0,0,1
15834,0,1,0,0,1
15835,0,1,0,0,1
15836,0,1,0,0,1
15837,1,0,0,0,1
15838,0,1,0,0,1
15839,0,1,0,0,1
15840,0,1,0,0,1
15841,1,0,0,0,1
15842,0,1,0,0,1
15843,0,1,0,0,1
15844,0,1,0,0,1
15845,0,1,0,0,1
15846,0,1,0,0,1
15847,0,1,0,0,1
15848,0,1,0,0,1
15849,0,1,0,0,1
15850,0,1,0,0,1
15851,1,0,0,0,1
15852,0,1,0,0,1
15853,0,1,0,0,1
15854,0,1,0,0,1
15855,0,1,0,0,1
15856,0,1,0,0,1
15857,0,1,0,0,1
15858,0,1,0,0,1
15859,0,1,0,0,1
15860,0,1,0,0,1
15861,0,1,0,0,1
15862,1,0,0,0,1
15863,0,1,0,0,1
15864,0,1,0,0,1
15865,0,1,0,0,1
15866,1,0,0,0,1
15867,0,1,0,0,1
15868,0,1,0,0,1
15869,1,0,0,0,1
15870,0,1,0,0,1
15871,0,1,0,0,1
15872,0,1,0,0,1
15873,1,0,0,0,1
15874,0,1,0,0,1
15875,0,1,0,0,1
15876,0,1,0,0,1
15877,1,0,0,0,1
15878,0,1,0,0,1
15879,0,1,0,0,1
15880,0,1,0,0,1
15881,1,0,0,0,1
15882,0,1,0,0,1
15883,0,1,0,0,1
15884,0,1,0,0,1
15885,0,1,0,0,1
15886,0,1,0,0,1
15887,0,1,0,0,1
15888,1,0,0,0,1
15889,0,1,0,0,1
15890,0,1,0,0,1
15891,0,1,0,0,1
15892,0,1,0,0,1
15893,0,0,1,0,1
15894,0,1,0,0,1
15895,0,1,0,0,1
15896,0,1,0,0,1
15897,0,0,0,1,1
15898,0,1,0,0,1
15899,0,1,0,0,1
15900,0,1,0,0,1
15901,0,1,0,0,1
15902,0,1,0,0,1
15903,1,0,0,0,1
15904,0,1,0,0,1
15905,1,0,0,0,1
15906,0,1,0,0,1
15907,0,1,0,0,1
15908,0,1,0,0,1
15909,0,1,0,0,1
15910,0,1,0,0,1
15911,0,1,0,0,1
15912,0,1,0,0,1
15913,0,1,0,0,1
15914,1,0,0,0,1
15915,0,1,0,0,1
15916,0,1,0,0,1
15917,0,1,0,0,1
15918,1,0,0,0,1
15919,0,1,0,0,1
15920,1,0,0,0,1
15921,0,1,0,0,1
15922,0,1,0,0,1
15923,0,1,0,0,1
15924,0,1,0,0,1
15925,0,1,0,0,1
15926,0,1,0,0,1
15927,0,1,0,0,1
15928,1,0,0,0,1
15929,0,1,0,0,1
15930,1,0,0,0,1
15931,0,1,0,0,1
15932,0,1,0,0,1
15933,0,1,0,0,1
15934,1,0,0,0,1
15935,0,1,0,0,1
15936,0,1,0,0,1
15937,0,1,0,0,1
15938,0,1,0,0,1
15939,0,1,0,0,1
15940,0,1,0,0,1
15941,0,1,0,0,1
15942,0,1,0,0,1
15943,0,1,0,0,1
15944,1,0,0,0,1
15945,0,1,0,0,1
15946,0,1,0,0,1
15947,0,1,0,0,1
15948,0,1,0,0,1
15949,1,0,0,0,1
15950,0,1,0,0,1
15951,0,1,0,0,1
15952,0,1,0,0,1
15953,0,1,0,0,1
15954,0,1,0,0,1
15955,0,1,0,0,1
15956,0,1,0,0,1
15957,0,1,0,0,1
15958,0,1,0,0,1
15959,1,0,0,0,1
15960,0,1,0,0,1
15961,0,1,0,0,1
15962,0,1,0,0,1
15963,0,1,0,0,1
15964,0,1,0,0,1
15965,0,1,0,0,1
15966,0,1,0,0,1
15967,1,0,0,0,1
15968,1,0,0,0,1
15969,0,1,0,0,1
15970,0,1,0,0,1
15971,0,1,0,0,1
15972,0,1,0,0,1
15973,0,1,0,0,1
15974,0,1,0,0,1
15975,0,1,0,0,1
15976,0,1,0,0,1
15977,0,1,0,0,1
15978,0,1,0,0,1
15979,0,1,0,0,1
15980,1,0,0,0,1
15981,0,1,0,0,1
15982,0,1,0,0,1
15983,0,1,0,0,1
15984,0,1,0,0,1
15985,0,1,0,0,1
15986,0,1,0,0,1
15987,0,1,0,0,1
15988,0,0,1,0,1
15989,0,1,0,0,1
15990,0,1,0,0,1
15991,0,1,0,0,1
15992,0,1,0,0,1
15993,1,0,0,0,1
15994,1,0,0,0,1
15995,0,1,0,0,1
15996,0,1,0,0,1
15997,1,0,0,0,1
15998,0,1,0,0,1
15999,0,1,0,0,1
16000,0,1,0,0,1
16001,0,1,0,0,1
16002,0,1,0,0,1
16003,1,0,0,0,1
16004,0,1,0,0,1
16005,0,1,0,0,1
16006,0,1,0,0,1
16007,0,1,0,0,1
16008,0,1,0,0,1
16009,0,1,0,0,1
16010,0,1,0,0,1
16011,0,1,0,0,1
16012,1,0,0,0,1
16013,0,1,0,0,1
16014,0,1,0,0,1
16015,0,1,0,0,1
16016,0,1,0,0,1
16017,0,1,0,0,1
16018,0,1,0,0,1
16019,0,1,0,0,1
16020,0,1,0,0,1
16021,0,1,0,0,1
16022,0,1,0,0,1
16023,0,1,0,0,1
16024,1,0,0,0,1
16025,0,1,0,0,1
16026,0,1,0,0,1
16027,1,0,0,0,1
16028,0,1,0,0,1
16029,0,1,0,0,1
16030,0,1,0,0,1
16031,0,1,0,0,1
16032,0,1,0,0,1
16033,0,1,0,0,1
16034,0,1,0,0,1
16035,0,1,0,0,1
16036,0,1,0,0,1
16037,1,0,0,0,1
16038,0,1,0,0,1
16039,0,1,0,0,1
16040,0,1,0,0,1
16041,0,1,0,0,1
16042,0,1,0,0,1
16043,0,1,0,0,1
16044,0,1,0,0,1
16045,0,1,0,0,1
16046,0,1,0,0,1
16047,0,1,0,0,1
16048,0,1,0,0,1
16049,0,1,0,0,1
16050,0,1,0,0,1
16051,0,1,0,0,1
16052,0,1,0,0,1
16053,1,0,0,0,1
16054,0,1,0,0,1
16055,0,1,0,0,1
16056,0,1,0,0,1
16057,0,0,0,1,1
16058,1,0,0,0,1
16059,0,1,0,0,1
16060,0,1,0,0,1
16061,0,1,0,0,1
16062,1,0,0,0,1
16063,0,1,0,0,1
16064,1,0,0,0,1
16065,0,1,0,0,1
16066,0,1,0,0,1
16067,1,0,0,0,1
16068,0,1,0,0,1
16069,0,1,0,0,1
16070,1,0,0,0,1
16071,0,1,0,0,1
16072,0,1,0,0,1
16073,0,1,0,0,1
16074,0,1,0,0,1
16075,0,1,0,0,1
16076,0,1,0,0,1
16077,0,1,0,0,1
16078,0,1,0,0,1
16079,0,1,0,0,1
16080,0,1,0,0,1
16081,0,1,0,0,1
16082,0,1,0,0,1
16083,0,1,0,0,1
16084,1,0,0,0,1
16085,0,1,0,0,1
16086,0,1,0,0,1
16087,0,1,0,0,1
16088,0,1,0,0,1
16089,0,1,0,0,1
16090,0,1,0,0,1
16091,1,0,0,0,1
16092,0,1,0,0,1
16093,0,1,0,0,1
16094,0,1,0,0,1
16095,0,1,0,0,1
16096,0,1,0,0,1
16097,0,1,0,0,1
16098,0,1,0,0,1
16099,0,1,0,0,1
16100,0,1,0,0,1
16101,0,1,0,0,1
16102,0,1,0,0,1
16103,0,1,0,0,1
16104,0,1,0,0,1
16105,0,1,0,0,1
16106,0,1,0,0,1
16107,0,1,0,0,1
16108,1,0,0,0,1
16109,0,1,0,0,1
16110,1,0,0,0,1
16111,0,1,0,0,1
16112,0,1,0,0,1
16113,0,1,0,0,1
16114,0,1,0,0,1
16115,0,1,0,0,1
16116,1,0,0,0,1
16117,0,1,0,0,1
16118,0,1,0,0,1
16119,0,1,0,0,1
16120,0,1,0,0,1
16121,0,1,0,0,1
16122,0,1,0,0,1
16123,0,1,0,0,1
16124,0,1,0,0,1
16125,0,1,0,0,1
16126,0,0,0,1,1
16127,0,1,0,0,1
16128,1,0,0,0,1
16129,0,1,0,0,1
16130,1,0,0,0,1
16131,0,1,0,0,1
16132,1,0,0,0,1
16133,0,1,0,0,1
16134,1,0,0,0,1
16135,0,1,0,0,1
16136,0,1,0,0,1
16137,1,0,0,0,1
16138,0,1,0,0,1
16139,0,1,0,0,1
16140,1,0,0,0,1
16141,0,1,0,0,1
16142,0,1,0,0,1
16143,0,1,0,0,1
16144,0,1,0,0,1
16145,0,1,0,0,1
16146,0,1,0,0,1
16147,0,1,0,0,1
16148,0,1,0,0,1
16149,0,1,0,0,1
16150,0,0,0,1,1
16151,1,0,0,0,1
16152,0,1,0,0,1
16153,0,1,0,0,1
16154,1,0,0,0,1
16155,0,1,0,0,1
16156,0,1,0,0,1
16157,0,1,0,0,1
16158,0,1,0,0,1
16159,0,1,0,0,1
16160,0,1,0,0,1
16161,0,1,0,0,1
16162,0,1,0,0,1
16163,0,1,0,0,1
16164,0,1,0,0,1
16165,0,1,0,0,1
16166,0,1,0,0,1
16167,0,1,0,0,1
16168,0,1,0,0,1
16169,0,1,0,0,1
16170,1,0,0,0,1
16171,0,1,0,0,1
16172,0,1,0,0,1
16173,0,1,0,0,1
16174,0,1,0,0,1
16175,0,1,0,0,1
16176,0,1,0,0,1
16177,0,1,0,0,1
16178,0,1,0,0,1
16179,0,1,0,0,1
16180,0,1,0,0,1
16181,0,1,0,0,1
16182,0,0,1,0,1
16183,0,1,0,0,1
16184,0,1,0,0,1
16185,0,1,0,0,1
16186,0,1,0,0,1
16187,1,0,0,0,1
16188,1,0,0,0,1
16189,0,1,0,0,1
16190,0,1,0,0,1
16191,1,0,0,0,1
16192,0,1,0,0,1
16193,0,1,0,0,1
16194,0,1,0,0,1
16195,0,1,0,0,1
16196,0,1,0,0,1
16197,0,1,0,0,1
16198,0,1,0,0,1
16199,1,0,0,0,1
16200,0,1,0,0,1
16201,0,1,0,0,1
16202,0,1,0,0,1
16203,0,1,0,0,1
16204,0,1,0,0,1
16205,0,1,0,0,1
16206,0,1,0,0,1
16207,0,1,0,0,1
16208,0,1,0,0,1
16209,0,1,0,0,1
16210,0,0,0,1,1
16211,1,0,0,0,1
16212,0,1,0,0,1
16213,0,1,0,0,1
16214,1,0,0,0,1
16215,0,1,0,0,1
16216,1,0,0,0,1
16217,1,0,0,0,1
16218,0,1,0,0,1
16219,0,1,0,0,1
16220,0,1,0,0,1
16221,0,1,0,0,1
16222,1,0,0,0,1
16223,1,0,0,0,1
16224,1,0,0,0,1
16225,1,0,0,0,1
16226,0,1,0,0,1
16227,0,1,0,0,1
16228,0,1,0,0,1
16229,0,0,0,1,1
16230,0,1,0,0,1
16231,0,1,0,0,1
16232,0,1,0,0,1
16233,0,1,0,0,1
16234,1,0,0,0,1
16235,0,1,0,0,1
16236,0,1,0,0,1
16237,0,1,0,0,1
16238,1,0,0,0,1
16239,0,1,0,0,1
16240,0,1,0,0,1
16241,1,0,0,0,1
16242,0,1,0,0,1
16243,1,0,0,0,1
16244,0,1,0,0,1
16245,0,1,0,0,1
16246,0,1,0,0,1
16247,0,1,0,0,1
16248,0,1,0,0,1
16249,0,1,0,0,1
16250,0,1,0,0,1
16251,0,1,0,0,1
16252,0,1,0,0,1
16253,0,1,0,0,1
16254,0,1,0,0,1
16255,0,1,0,0,1
16256,0,1,0,0,1
16257,0,1,0,0,1
16258,0,1,0,0,1
16259,0,1,0,0,1
16260,0,1,0,0,1
16261,0,1,0,0,1
16262,0,1,0,0,1
16263,0,1,0,0,1
16264,0,1,0,0,1
16265,0,1,0,0,1
16266,0,1,0,0,1
16267,0,1,0,0,1
16268,0,1,0,0,1
16269,0,1,0,0,1
16270,0,1,0,0,1
16271,0,1,0,0,1
16272,1,0,0,0,1
16273,0,1,0,0,1
16274,0,1,0,0,1
16275,0,1,0,0,1
16276,0,1,0,0,1
16277,0,1,0,0,1
16278,0,1,0,0,1
16279,0,1,0,0,1
16280,0,1,0,0,1
16281,0,1,0,0,1
16282,0,1,0,0,1
16283,0,1,0,0,1
16284,0,1,0,0,1
16285,0,1,0,0,1
16286,0,1,0,0,1
16287,0,1,0,0,1
16288,0,1,0,0,1
16289,0,1,0,0,1
16290,0,1,0,0,1
16291,0,1,0,0,1
16292,0,1,0,0,1
16293,0,1,0,0,1
16294,0,1,0,0,1
16295,0,1,0,0,1
16296,0,1,0,0,1
16297,0,1,0,0,1
16298,0,1,0,0,1
16299,0,1,0,0,1
16300,1,0,0,0,1
16301,0,1,0,0,1
16302,0,0,0,1,1
16303,0,1,0,0,1
16304,1,0,0,0,1
16305,0,1,0,0,1
16306,1,0,0,0,1
16307,0,1,0,0,1
16308,1,0,0,0,1
16309,1,0,0,0,1
16310,0,1,0,0,1
16311,0,1,0,0,1
16312,0,1,0,0,1
16313,0,1,0,0,1
16314,0,1,0,0,1
16315,0,1,0,0,1
16316,0,1,0,0,1
16317,0,1,0,0,1
16318,0,1,0,0,1
16319,0,1,0,0,1
16320,0,1,0,0,1
16321,1,0,0,0,1
16322,0,1,0,0,1
16323,0,1,0,0,1
16324,0,1,0,0,1
16325,0,1,0,0,1
16326,0,1,0,0,1
16327,1,0,0,0,1
16328,0,1,0,0,1
16329,0,1,0,0,1
16330,0,1,0,0,1
16331,0,1,0,0,1
16332,1,0,0,0,1
16333,0,0,0,1,1
16334,0,1,0,0,1
16335,0,1,0,0,1
16336,0,1,0,0,1
16337,0,1,0,0,1
16338,0,1,0,0,1
16339,0,1,0,0,1
16340,1,0,0,0,1
16341,0,0,1,0,1
16342,0,1,0,0,1
16343,0,1,0,0,1
16344,0,1,0,0,1
16345,0,1,0,0,1
16346,0,1,0,0,1
16347,0,1,0,0,1
16348,0,1,0,0,1
16349,0,1,0,0,1
16350,0,1,0,0,1
16351,0,1,0,0,1
16352,0,1,0,0,1
16353,1,0,0,0,1
16354,0,1,0,0,1
16355,0,1,0,0,1
16356,0,1,0,0,1
16357,0,1,0,0,1
16358,0,1,0,0,1
16359,0,1,0,0,1
16360,0,1,0,0,1
16361,0,0,0,1,1
16362,0,1,0,0,1
16363,0,1,0,0,1
16364,0,1,0,0,1
16365,0,0,0,1,1
16366,0,0,0,1,1
16367,0,1,0,0,1
16368,0,1,0,0,1
16369,0,1,0,0,1
16370,0,1,0,0,1
16371,0,1,0,0,1
16372,1,0,0,0,1
16373,0,1,0,0,1
16374,0,1,0,0,1
16375,0,1,0,0,1
16376,0,1,0,0,1
16377,0,1,0,0,1
16378,0,1,0,0,1
16379,0,1,0,0,1
16380,0,1,0,0,1
16381,0,1,0,0,1
16382,1,0,0,0,1
16383,0,1,0,0,1
16384,1,0,0,0,1
16385,0,1,0,0,1
16386,0,1,0,0,1
16387,1,0,0,0,1
16388,0,1,0,0,1
16389,0,1,0,0,1
16390,0,1,0,0,1
16391,0,1,0,0,1
16392,1,0,0,0,1
16393,0,1,0,0,1
16394,0,1,0,0,1
16395,0,1,0,0,1
16396,0,1,0,0,1
16397,0,1,0,0,1
16398,0,1,0,0,1
16399,0,1,0,0,1
16400,1,0,0,0,1
16401,0,1,0,0,1
16402,0,1,0,0,1
16403,1,0,0,0,1
16404,0,1,0,0,1
16405,0,1,0,0,1
16406,0,1,0,0,1
16407,0,1,0,0,1
16408,0,1,0,0,1
16409,0,1,0,0,1
16410,0,1,0,0,1
16411,0,1,0,0,1
16412,0,1,0,0,1
16413,0,1,0,0,1
16414,0,1,0,0,1
16415,0,0,1,0,1
16416,0,0,0,1,1
16417,0,1,0,0,1
16418,0,1,0,0,1
16419,0,1,0,0,1
16420,0,1,0,0,1
16421,0,1,0,0,1
16422,0,1,0,0,1
16423,0,1,0,0,1
16424,0,1,0,0,1
16425,0,1,0,0,1
16426,0,1,0,0,1
16427,0,1,0,0,1
16428,0,1,0,0,1
16429,1,0,0,0,1
16430,0,1,0,0,1
16431,0,1,0,0,1
16432,1,0,0,0,1
16433,1,0,0,0,1
16434,0,1,0,0,1
16435,0,1,0,0,1
16436,0,1,0,0,1
16437,0,1,0,0,1
16438,1,0,0,0,1
16439,0,1,0,0,1
16440,0,1,0,0,1
16441,0,1,0,0,1
16442,0,1,0,0,1
16443,1,0,0,0,1
16444,0,1,0,0,1
16445,0,1,0,0,1
16446,0,1,0,0,1
16447,1,0,0,0,1
16448,0,1,0,0,1
16449,0,1,0,0,1
16450,0,1,0,0,1
16451,0,1,0,0,1
16452,1,0,0,0,1
16453,0,1,0,0,1
16454,0,1,0,0,1
16455,0,1,0,0,1
16456,0,1,0,0,1
16457,1,0,0,0,1
16458,0,1,0,0,1
16459,0,1,0,0,1
16460,0,1,0,0,1
16461,0,1,0,0,1
16462,0,1,0,0,1
16463,0,1,0,0,1
16464,0,1,0,0,1
16465,0,1,0,0,1
16466,0,1,0,0,1
16467,0,1,0,0,1
16468,0,1,0,0,1
16469,0,1,0,0,1
16470,0,1,0,0,1
16471,0,1,0,0,1
16472,0,1,0,0,1
16473,0,1,0,0,1
16474,1,0,0,0,1
16475,0,1,0,0,1
16476,0,1,0,0,1
16477,0,0,0,1,1
16478,0,0,0,1,1
16479,0,1,0,0,1
16480,0,1,0,0,1
16481,0,1,0,0,1
16482,0,1,0,0,1
16483,0,1,0,0,1
16484,0,1,0,0,1
16485,0,1,0,0,1
16486,0,1,0,0,1
16487,0,1,0,0,1
16488,1,0,0,0,1
16489,0,1,0,0,1
16490,0,1,0,0,1
16491,0,0,0,1,1
16492,0,1,0,0,1
16493,1,0,0,0,1
16494,0,1,0,0,1
16495,0,1,0,0,1
16496,0,1,0,0,1
16497,0,1,0,0,1
16498,0,1,0,0,1
16499,0,1,0,0,1
16500,0,1,0,0,1
16501,0,1,0,0,1
16502,0,1,0,0,1
16503,0,1,0,0,1
16504,0,1,0,0,1
16505,0,1,0,0,1
16506,0,1,0,0,1
16507,0,1,0,0,1
16508,0,1,0,0,1
16509,0,1,0,0,1
16510,0,1,0,0,1
16511,0,1,0,0,1
16512,0,0,1,0,1
16513,0,1,0,0,1
16514,0,1,0,0,1
16515,0,1,0,0,1
16516,0,1,0,0,1
16517,0,1,0,0,1
16518,0,1,0,0,1
16519,0,1,0,0,1
16520,0,1,0,0,1
16521,1,0,0,0,1
16522,0,1,0,0,1
16523,0,1,0,0,1
16524,0,1,0,0,1
16525,0,1,0,0,1
16526,0,1,0,0,1
16527,1,0,0,0,1
16528,0,1,0,0,1
16529,0,1,0,0,1
16530,0,1,0,0,1
16531,1,0,0,0,1
16532,0,1,0,0,1
16533,0,1,0,0,1
16534,0,1,0,0,1
16535,0,1,0,0,1
16536,0,0,0,1,1
16537,0,1,0,0,1
16538,0,1,0,0,1
16539,1,0,0,0,1
16540,0,1,0,0,1
16541,0,1,0,0,1
16542,0,1,0,0,1
16543,0,1,0,0,1
16544,0,1,0,0,1
16545,0,1,0,0,1
16546,0,1,0,0,1
16547,0,1,0,0,1
16548,0,1,0,0,1
16549,0,1,0,0,1
16550,0,1,0,0,1
16551,0,1,0,0,1
16552,0,1,0,0,1
16553,0,1,0,0,1
16554,0,1,0,0,1
16555,0,1,0,0,1
16556,0,1,0,0,1
16557,0,1,0,0,1
16558,0,1,0,0,1
16559,0,1,0,0,1
16560,1,0,0,0,1
16561,1,0,0,0,1
16562,0,1,0,0,1
16563,0,1,0,0,1
16564,1,0,0,0,1
16565,0,1,0,0,1
16566,0,1,0,0,1
16567,0,1,0,0,1
16568,0,1,0,0,1
16569,0,1,0,0,1
16570,0,1,0,0,1
16571,1,0,0,0,1
16572,0,1,0,0,1
16573,0,1,0,0,1
16574,0,1,0,0,1
16575,0,1,0,0,1
16576,0,0,0,1,1
16577,0,1,0,0,1
16578,0,1,0,0,1
16579,0,1,0,0,1
16580,0,1,0,0,1
16581,0,1,0,0,1
16582,0,1,0,0,1
16583,0,1,0,0,1
16584,0,1,0,0,1
16585,0,1,0,0,1
16586,0,1,0,0,1
16587,1,0,0,0,1
16588,0,1,0,0,1
16589,1,0,0,0,1
16590,0,1,0,0,1
16591,0,1,0,0,1
16592,1,0,0,0,1
16593,0,1,0,0,1
16594,0,1,0,0,1
16595,0,1,0,0,1
16596,1,0,0,0,1
16597,0,1,0,0,1
16598,0,1,0,0,1
16599,0,1,0,0,1
16600,0,1,0,0,1
16601,0,1,0,0,1
16602,0,1,0,0,1
16603,0,1,0,0,1
16604,0,1,0,0,1
16605,0,1,0,0,1
16606,0,1,0,0,1
16607,1,0,0,0,1
16608,1,0,0,0,1
16609,0,1,0,0,1
16610,0,1,0,0,1
16611,0,1,0,0,1
16612,0,1,0,0,1
16613,0,1,0,0,1
16614,0,1,0,0,1
16615,0,1,0,0,1
16616,0,1,0,0,1
16617,0,1,0,0,1
16618,0,1,0,0,1
16619,0,1,0,0,1
16620,0,1,0,0,1
16621,0,1,0,0,1
16622,0,0,0,1,1
16623,0,1,0,0,1
16624,0,1,0,0,1
16625,0,1,0,0,1
16626,0,1,0,0,1
16627,0,1,0,0,1
16628,0,1,0,0,1
16629,0,1,0,0,1
16630,0,1,0,0,1
16631,0,1,0,0,1
16632,0,1,0,0,1
16633,0,0,0,1,1
16634,0,1,0,0,1
16635,1,0,0,0,1
16636,0,1,0,0,1
16637,1,0,0,0,1
16638,0,1,0,0,1
16639,0,1,0,0,1
16640,1,0,0,0,1
16641,0,1,0,0,1
16642,0,1,0,0,1
16643,0,1,0,0,1
16644,0,1,0,0,1
16645,0,1,0,0,1
16646,0,1,0,0,1
16647,0,1,0,0,1
16648,0,1,0,0,1
16649,0,1,0,0,1
16650,0,1,0,0,1
16651,0,1,0,0,1
16652,0,1,0,0,1
16653,0,1,0,0,1
16654,0,1,0,0,1
16655,0,1,0,0,1
16656,0,1,0,0,1
16657,0,1,0,0,1
16658,0,1,0,0,1
16659,0,1,0,0,1
16660,0,1,0,0,1
16661,0,1,0,0,1
16662,0,1,0,0,1
16663,0,1,0,0,1
16664,0,1,0,0,1
16665,0,1,0,0,1
16666,0,1,0,0,1
16667,0,1,0,0,1
16668,1,0,0,0,1
16669,0,1,0,0,1
16670,0,1,0,0,1
16671,0,1,0,0,1
16672,0,1,0,0,1
16673,0,1,0,0,1
16674,0,1,0,0,1
16675,0,1,0,0,1
16676,1,0,0,0,1
16677,0,1,0,0,1
16678,0,1,0,0,1
16679,1,0,0,0,1
16680,1,0,0,0,1
16681,0,1,0,0,1
16682,1,0,0,0,1
16683,0,1,0,0,1
16684,1,0,0,0,1
16685,0,1,0,0,1
16686,1,0,0,0,1
16687,0,1,0,0,1
16688,0,1,0,0,1
16689,0,1,0,0,1
16690,0,1,0,0,1
16691,1,0,0,0,1
16692,0,1,0,0,1
16693,0,1,0,0,1
16694,0,1,0,0,1
16695,1,0,0,0,1
16696,0,1,0,0,1
16697,0,1,0,0,1
16698,0,1,0,0,1
16699,0,1,0,0,1
16700,0,1,0,0,1
16701,0,1,0,0,1
16702,0,1,0,0,1
16703,0,1,0,0,1
16704,1,0,0,0,1
16705,0,1,0,0,1
16706,0,0,0,1,1
16707,0,1,0,0,1
16708,0,1,0,0,1
16709,0,1,0,0,1
16710,0,1,0,0,1
16711,0,1,0,0,1
16712,0,1,0,0,1
16713,0,1,0,0,1
16714,0,1,0,0,1
16715,0,1,0,0,1
16716,0,1,0,0,1
16717,0,1,0,0,1
16718,1,0,0,0,1
16719,0,1,0,0,1
16720,0,1,0,0,1
16721,0,1,0,0,1
16722,0,1,0,0,1
16723,0,1,0,0,1
16724,1,0,0,0,1
16725,0,1,0,0,1
16726,0,1,0,0,1
16727,0,1,0,0,1
16728,0,1,0,0,1
16729,0,1,0,0,1
16730,0,1,0,0,1
16731,0,1,0,0,1
16732,1,0,0,0,1
16733,0,1,0,0,1
16734,0,1,0,0,1
16735,1,0,0,0,1
16736,0,1,0,0,1
16737,1,0,0,0,1
16738,0,1,0,0,1
16739,1,0,0,0,1
16740,0,1,0,0,1
16741,0,1,0,0,1
16742,0,1,0,0,1
16743,0,1,0,0,1
16744,0,1,0,0,1
16745,0,1,0,0,1
16746,0,0,0,1,1
16747,0,1,0,0,1
16748,0,1,0,0,1
16749,0,1,0,0,1
16750,0,1,0,0,1
16751,0,1,0,0,1
