,norigins,nretweets,nquotes,nreplies,ntotal
0,0,34,0,2488,2522
1,119,1130,25,97,1371
2,90,76,201,690,1057
3,5,8,90,433,536
4,435,0,0,0,435
5,68,295,14,15,392
6,0,0,190,190,380
7,0,0,181,183,364
8,114,1,199,22,336
9,26,0,117,188,331
10,0,311,0,0,311
11,40,264,0,0,304
12,42,0,249,10,301
13,34,83,62,80,259
14,32,2,103,88,225
15,48,0,112,64,224
16,3,66,2,150,221
17,0,216,0,0,216
18,176,0,2,30,208
19,3,11,44,136,194
20,0,188,0,0,188
21,9,150,2,24,185
22,0,180,0,0,180
23,22,96,57,0,175
24,24,1,119,23,167
25,43,53,67,3,166
26,25,16,50,71,162
27,2,154,0,5,161
28,49,56,0,48,153
29,27,114,11,0,152
30,22,71,12,38,143
31,1,142,0,0,143
32,30,0,51,59,140
33,10,87,0,42,139
34,28,33,56,21,138
35,0,0,0,137,137
36,95,0,40,0,135
37,4,105,9,15,133
38,29,17,17,69,132
39,0,72,0,60,132
40,17,115,0,0,132
41,0,131,0,0,131
42,1,128,0,0,129
43,12,10,67,38,127
44,0,127,0,0,127
45,0,127,0,0,127
46,5,108,8,0,121
47,58,41,16,1,116
48,16,14,26,60,116
49,5,22,78,9,114
50,18,64,11,19,112
51,59,3,18,31,111
52,49,0,37,22,108
53,1,45,4,57,107
54,13,0,3,89,105
55,1,101,0,1,103
56,0,99,0,2,101
57,83,0,0,18,101
58,1,8,0,90,99
59,0,94,0,0,94
60,1,93,0,0,94
61,1,48,14,29,92
62,1,10,5,76,92
63,80,0,11,0,91
64,0,91,0,0,91
65,11,2,11,66,90
66,4,3,2,81,90
67,1,0,0,88,89
68,3,12,0,74,89
69,0,2,41,45,88
70,15,67,6,0,88
71,64,3,13,7,87
72,62,14,2,9,87
73,0,87,0,0,87
74,86,0,0,0,86
75,2,83,0,0,85
76,0,85,0,0,85
77,14,70,0,0,84
78,63,11,3,6,83
79,11,0,64,7,82
80,0,77,3,0,80
81,14,66,0,0,80
82,1,76,0,2,79
83,2,77,0,0,79
84,1,78,0,0,79
85,1,77,0,0,78
86,5,16,55,1,77
87,1,75,0,0,76
88,3,73,0,0,76
89,2,74,0,0,76
90,0,76,0,0,76
91,2,72,1,1,76
92,10,21,30,15,76
93,1,58,0,16,75
94,10,1,1,63,75
95,21,0,9,45,75
96,21,0,0,53,74
97,49,17,1,6,73
98,9,61,3,0,73
99,0,73,0,0,73
100,0,73,0,0,73
101,3,57,11,0,71
102,36,18,12,5,71
103,14,2,54,1,71
104,0,71,0,0,71
105,1,10,0,60,71
106,30,9,30,1,70
107,51,15,1,3,70
108,0,64,2,2,68
109,13,28,15,12,68
110,26,19,18,5,68
111,0,68,0,0,68
112,0,64,0,3,67
113,20,15,32,0,67
114,0,66,0,0,66
115,3,62,0,0,65
116,0,65,0,0,65
117,0,65,0,0,65
118,0,64,0,0,64
119,5,5,26,28,64
120,3,1,0,59,63
121,1,60,0,2,63
122,1,62,0,0,63
123,0,62,0,0,62
124,2,1,0,59,62
125,14,48,0,0,62
126,0,62,0,0,62
127,0,62,0,0,62
128,55,5,0,1,61
129,7,45,5,4,61
130,0,61,0,0,61
131,0,60,0,0,60
132,7,12,0,41,60
133,33,12,9,6,60
134,4,27,25,3,59
135,0,0,0,59,59
136,3,56,0,0,59
137,59,0,0,0,59
138,3,44,3,7,57
139,0,57,0,0,57
140,2,0,10,45,57
141,1,54,0,2,57
142,0,57,0,0,57
143,0,57,0,0,57
144,2,53,2,0,57
145,9,0,18,29,56
146,0,56,0,0,56
147,41,0,14,1,56
148,43,4,1,7,55
149,11,3,25,16,55
150,39,11,2,2,54
151,0,53,0,1,54
152,0,13,0,41,54
153,0,0,0,54,54
154,33,1,1,18,53
155,32,1,11,9,53
156,5,30,0,18,53
157,25,24,1,3,53
158,2,51,0,0,53
159,6,45,2,0,53
160,5,47,0,1,53
161,13,1,39,0,53
162,9,30,13,0,52
163,32,1,2,17,52
164,1,0,1,50,52
165,2,50,0,0,52
166,0,51,1,0,52
167,0,52,0,0,52
168,13,3,36,0,52
169,0,0,26,26,52
170,34,15,1,1,51
171,0,51,0,0,51
172,34,2,15,0,51
173,8,1,26,16,51
174,12,38,0,1,51
175,16,4,27,4,51
176,0,50,0,0,50
177,0,50,0,0,50
178,0,50,0,0,50
179,0,50,0,0,50
180,0,50,0,0,50
181,0,47,2,0,49
182,40,9,0,0,49
183,27,5,11,6,49
184,4,36,0,9,49
185,12,37,0,0,49
186,2,1,16,30,49
187,0,49,0,0,49
188,10,3,11,24,48
189,0,48,0,0,48
190,3,0,0,45,48
191,8,36,4,0,48
192,13,6,8,21,48
193,1,0,0,47,48
194,1,27,15,5,48
195,0,41,3,3,47
196,0,47,0,0,47
197,0,47,0,0,47
198,41,4,1,1,47
199,0,46,0,0,46
200,7,13,23,3,46
201,0,46,0,0,46
202,0,46,0,0,46
203,1,0,1,43,45
204,0,44,0,1,45
205,3,2,3,37,45
206,0,45,0,0,45
207,0,22,0,23,45
208,3,1,1,40,45
209,7,1,9,28,45
210,0,44,0,0,44
211,14,0,30,0,44
212,11,13,17,3,44
213,0,44,0,0,44
214,2,0,20,22,44
215,8,1,33,1,43
216,9,21,12,1,43
217,0,34,0,9,43
218,4,22,3,14,43
219,0,2,10,31,43
220,8,0,35,0,43
221,0,42,0,0,42
222,0,42,0,0,42
223,7,28,1,6,42
224,14,7,9,12,42
225,9,25,3,5,42
226,11,6,24,1,42
227,4,21,8,9,42
228,23,5,12,2,42
229,0,41,1,0,42
230,3,4,12,23,42
231,3,38,0,1,42
232,14,25,0,3,42
233,8,29,1,3,41
234,1,0,0,40,41
235,30,6,0,5,41
236,0,41,0,0,41
237,0,41,0,0,41
238,31,7,0,3,41
239,0,41,0,0,41
240,1,39,0,1,41
241,0,40,0,0,40
242,0,40,0,0,40
243,3,35,0,2,40
244,0,40,0,0,40
245,0,40,0,0,40
246,0,40,0,0,40
247,0,40,0,0,40
248,2,12,25,1,40
249,5,12,19,4,40
250,21,0,13,6,40
251,0,12,2,26,40
252,0,35,0,5,40
253,1,39,0,0,40
254,0,40,0,0,40
255,0,40,0,0,40
256,2,0,9,29,40
257,0,40,0,0,40
258,2,37,0,0,39
259,0,39,0,0,39
260,2,37,0,0,39
261,0,39,0,0,39
262,39,0,0,0,39
263,6,28,5,0,39
264,1,4,0,34,39
265,0,39,0,0,39
266,0,31,4,4,39
267,9,8,14,7,38
268,5,0,2,31,38
269,5,27,2,4,38
270,2,26,3,7,38
271,0,38,0,0,38
272,1,15,1,21,38
273,6,0,32,0,38
274,0,38,0,0,38
275,1,0,0,37,38
276,0,38,0,0,38
277,11,0,21,6,38
278,0,33,4,1,38
279,2,36,0,0,38
280,2,36,0,0,38
281,2,35,0,1,38
282,0,38,0,0,38
283,7,4,9,18,38
284,0,38,0,0,38
285,17,16,2,2,37
286,1,12,0,24,37
287,2,12,5,18,37
288,1,32,4,0,37
289,4,30,2,1,37
290,0,37,0,0,37
291,1,36,0,0,37
292,1,32,1,2,36
293,5,1,23,7,36
294,0,36,0,0,36
295,9,7,20,0,36
296,7,25,4,0,36
297,0,36,0,0,36
298,2,1,1,32,36
299,2,2,2,30,36
300,5,19,12,0,36
301,0,36,0,0,36
302,4,4,3,25,36
303,1,35,0,0,36
304,4,30,2,0,36
305,0,36,0,0,36
306,23,0,12,0,35
307,35,0,0,0,35
308,16,0,9,10,35
309,0,33,0,2,35
310,1,34,0,0,35
311,0,35,0,0,35
312,24,7,1,3,35
313,15,0,17,3,35
314,13,1,19,2,35
315,8,22,1,3,34
316,4,30,0,0,34
317,0,34,0,0,34
318,3,0,0,31,34
319,21,1,1,11,34
320,1,33,0,0,34
321,2,3,2,27,34
322,0,34,0,0,34
323,2,3,7,22,34
324,7,25,0,1,33
325,0,33,0,0,33
326,0,33,0,0,33
327,0,33,0,0,33
328,0,33,0,0,33
329,0,33,0,0,33
330,14,12,0,7,33
331,0,0,1,32,33
332,0,33,0,0,33
333,2,0,5,26,33
334,0,33,0,0,33
335,0,33,0,0,33
336,0,33,0,0,33
337,0,33,0,0,33
338,0,31,1,1,33
339,25,8,0,0,33
340,0,33,0,0,33
341,0,33,0,0,33
342,0,33,0,0,33
343,0,31,0,1,32
344,28,1,3,0,32
345,2,30,0,0,32
346,0,32,0,0,32
347,2,25,5,0,32
348,0,32,0,0,32
349,4,28,0,0,32
350,1,31,0,0,32
351,1,0,2,29,32
352,4,19,3,6,32
353,15,14,3,0,32
354,23,0,6,2,31
355,1,30,0,0,31
356,1,30,0,0,31
357,0,31,0,0,31
358,0,31,0,0,31
359,17,5,9,0,31
360,8,3,16,4,31
361,29,0,0,2,31
362,0,31,0,0,31
363,0,31,0,0,31
364,31,0,0,0,31
365,6,5,12,8,31
366,8,17,1,5,31
367,1,30,0,0,31
368,1,30,0,0,31
369,0,31,0,0,31
370,1,30,0,0,31
371,2,15,0,14,31
372,26,2,2,1,31
373,5,0,2,24,31
374,2,24,1,4,31
375,3,1,27,0,31
376,0,12,0,18,30
377,0,29,0,1,30
378,0,30,0,0,30
379,2,27,0,1,30
380,19,0,0,11,30
381,3,24,1,2,30
382,0,0,1,29,30
383,0,29,1,0,30
384,1,29,0,0,30
385,5,7,0,18,30
386,0,30,0,0,30
387,0,0,0,30,30
388,0,0,0,30,30
389,0,30,0,0,30
390,10,19,0,1,30
391,9,3,8,10,30
392,1,29,0,0,30
393,18,7,3,2,30
394,0,28,1,1,30
395,0,30,0,0,30
396,1,29,0,0,30
397,0,30,0,0,30
398,7,2,9,11,29
399,4,1,24,0,29
400,0,29,0,0,29
401,8,15,4,2,29
402,0,28,0,1,29
403,5,15,0,9,29
404,0,0,0,29,29
405,3,10,8,8,29
406,0,29,0,0,29
407,0,29,0,0,29
408,2,21,1,5,29
409,21,1,0,7,29
410,16,12,1,0,29
411,13,0,9,7,29
412,1,28,0,0,29
413,18,9,0,2,29
414,0,24,1,4,29
415,1,23,3,2,29
416,1,28,0,0,29
417,6,18,3,2,29
418,25,2,0,1,28
419,2,26,0,0,28
420,0,28,0,0,28
421,21,6,1,0,28
422,0,20,8,0,28
423,0,28,0,0,28
424,0,16,0,12,28
425,4,23,0,1,28
426,0,28,0,0,28
427,0,28,0,0,28
428,0,25,0,3,28
429,0,28,0,0,28
430,8,2,8,10,28
431,0,12,9,7,28
432,0,28,0,0,28
433,19,0,1,8,28
434,1,0,1,26,28
435,14,7,0,7,28
436,2,23,0,3,28
437,0,28,0,0,28
438,2,6,3,17,28
439,21,5,1,1,28
440,22,3,1,2,28
441,0,28,0,0,28
442,0,0,1,27,28
443,4,8,15,1,28
444,0,27,0,0,27
445,3,24,0,0,27
446,0,26,0,1,27
447,9,18,0,0,27
448,0,27,0,0,27
449,0,27,0,0,27
450,17,0,4,6,27
451,3,23,0,1,27
452,0,27,0,0,27
453,0,27,0,0,27
454,2,8,14,3,27
455,0,27,0,0,27
456,1,24,0,2,27
457,0,27,0,0,27
458,25,2,0,0,27
459,6,5,0,16,27
460,0,22,0,5,27
461,0,27,0,0,27
462,5,16,6,0,27
463,0,27,0,0,27
464,0,27,0,0,27
465,0,27,0,0,27
466,0,27,0,0,27
467,0,26,1,0,27
468,0,27,0,0,27
469,0,0,0,27,27
470,1,0,5,21,27
471,0,27,0,0,27
472,1,23,1,2,27
473,0,27,0,0,27
474,0,27,0,0,27
475,2,25,0,0,27
476,4,6,5,12,27
477,2,14,2,9,27
478,2,23,1,0,26
479,5,11,0,10,26
480,0,26,0,0,26
481,0,26,0,0,26
482,0,26,0,0,26
483,3,13,10,0,26
484,0,26,0,0,26
485,0,26,0,0,26
486,0,26,0,0,26
487,25,0,0,1,26
488,0,26,0,0,26
489,4,19,3,0,26
490,0,26,0,0,26
491,2,0,20,4,26
492,4,0,5,17,26
493,0,26,0,0,26
494,0,26,0,0,26
495,0,26,0,0,26
496,0,26,0,0,26
497,0,26,0,0,26
498,4,2,3,17,26
499,2,6,3,15,26
500,3,17,2,4,26
501,4,11,0,11,26
502,0,15,0,11,26
503,0,26,0,0,26
504,0,26,0,0,26
505,26,0,0,0,26
506,18,0,0,8,26
507,0,26,0,0,26
508,0,26,0,0,26
509,1,19,0,6,26
510,14,0,10,1,25
511,0,24,1,0,25
512,1,21,0,3,25
513,2,20,3,0,25
514,1,24,0,0,25
515,5,0,9,11,25
516,0,25,0,0,25
517,0,24,0,1,25
518,0,21,0,4,25
519,0,25,0,0,25
520,0,25,0,0,25
521,0,25,0,0,25
522,1,18,2,4,25
523,4,21,0,0,25
524,10,5,4,6,25
525,0,25,0,0,25
526,12,0,9,4,25
527,2,23,0,0,25
528,1,23,0,1,25
529,0,25,0,0,25
530,12,4,7,2,25
531,1,24,0,0,25
532,1,9,1,14,25
533,17,0,2,6,25
534,17,8,0,0,25
535,0,25,0,0,25
536,0,25,0,0,25
537,1,18,5,1,25
538,0,25,0,0,25
539,0,21,4,0,25
540,4,1,20,0,25
541,10,1,7,6,24
542,0,0,0,24,24
543,6,14,0,4,24
544,5,11,2,6,24
545,0,24,0,0,24
546,0,24,0,0,24
547,0,24,0,0,24
548,0,24,0,0,24
549,0,24,0,0,24
550,0,23,0,1,24
551,1,3,0,20,24
552,5,19,0,0,24
553,1,19,1,3,24
554,7,3,6,8,24
555,0,24,0,0,24
556,0,24,0,0,24
557,3,21,0,0,24
558,0,24,0,0,24
559,5,5,14,0,24
560,0,22,0,2,24
561,0,24,0,0,24
562,0,21,2,1,24
563,17,2,3,2,24
564,4,1,5,14,24
565,1,21,1,1,24
566,0,24,0,0,24
567,0,24,0,0,24
568,2,20,0,2,24
569,21,0,1,2,24
570,0,24,0,0,24
571,0,24,0,0,24
572,5,1,5,13,24
573,0,13,0,11,24
574,6,16,0,2,24
575,1,23,0,0,24
576,12,10,1,1,24
577,2,22,0,0,24
578,7,9,3,5,24
579,0,22,1,0,23
580,0,23,0,0,23
581,7,11,2,3,23
582,3,19,0,1,23
583,0,23,0,0,23
584,0,23,0,0,23
585,0,22,1,0,23
586,4,0,0,19,23
587,21,0,0,2,23
588,0,23,0,0,23
589,3,20,0,0,23
590,0,23,0,0,23
591,21,0,0,2,23
592,0,9,14,0,23
593,0,23,0,0,23
594,0,4,0,19,23
595,2,20,1,0,23
596,0,0,0,23,23
597,1,19,1,2,23
598,21,0,1,1,23
599,4,19,0,0,23
600,14,9,0,0,23
601,0,23,0,0,23
602,0,23,0,0,23
603,14,1,1,7,23
604,2,0,1,20,23
605,9,0,11,3,23
606,0,6,2,15,23
607,2,15,5,1,23
608,0,21,0,2,23
609,0,23,0,0,23
610,0,23,0,0,23
611,0,22,0,0,22
612,0,21,0,1,22
613,2,12,0,8,22
614,1,15,0,6,22
615,0,22,0,0,22
616,1,0,3,18,22
617,1,21,0,0,22
618,2,20,0,0,22
619,0,22,0,0,22
620,0,22,0,0,22
621,4,14,0,4,22
622,0,22,0,0,22
623,0,22,0,0,22
624,4,1,5,12,22
625,2,19,1,0,22
626,0,22,0,0,22
627,0,22,0,0,22
628,1,0,19,2,22
629,0,22,0,0,22
630,2,20,0,0,22
631,0,22,0,0,22
632,0,22,0,0,22
633,9,0,1,12,22
634,0,21,0,1,22
635,0,22,0,0,22
636,0,22,0,0,22
637,3,19,0,0,22
638,3,19,0,0,22
639,2,13,4,3,22
640,6,10,6,0,22
641,0,0,0,22,22
642,11,0,11,0,22
643,0,22,0,0,22
644,1,0,3,17,21
645,0,21,0,0,21
646,0,21,0,0,21
647,0,0,0,21,21
648,17,4,0,0,21
649,0,21,0,0,21
650,1,17,1,2,21
651,0,21,0,0,21
652,0,0,12,9,21
653,0,21,0,0,21
654,0,21,0,0,21
655,9,0,3,9,21
656,0,21,0,0,21
657,0,21,0,0,21
658,7,6,3,5,21
659,0,20,1,0,21
660,1,19,1,0,21
661,7,8,0,6,21
662,0,21,0,0,21
663,0,2,11,8,21
664,0,21,0,0,21
665,3,3,0,15,21
666,0,21,0,0,21
667,0,0,0,21,21
668,21,0,0,0,21
669,0,21,0,0,21
670,0,2,2,17,21
671,1,20,0,0,21
672,7,11,3,0,21
673,0,21,0,0,21
674,3,1,17,0,21
675,0,21,0,0,21
676,2,19,0,0,21
677,0,21,0,0,21
678,1,19,0,1,21
679,8,4,5,4,21
680,0,21,0,0,21
681,3,5,4,9,21
682,1,19,0,1,21
683,0,21,0,0,21
684,0,21,0,0,21
685,0,20,0,0,20
686,0,20,0,0,20
687,0,20,0,0,20
688,18,0,1,1,20
689,1,19,0,0,20
690,1,1,18,0,20
691,8,3,1,8,20
692,2,6,3,9,20
693,0,20,0,0,20
694,1,19,0,0,20
695,2,18,0,0,20
696,5,0,7,8,20
697,0,3,0,17,20
698,0,20,0,0,20
699,0,18,1,1,20
700,0,20,0,0,20
701,0,20,0,0,20
702,11,4,2,3,20
703,0,20,0,0,20
704,0,20,0,0,20
705,0,20,0,0,20
706,0,20,0,0,20
707,1,19,0,0,20
708,9,10,1,0,20
709,1,17,0,2,20
710,0,20,0,0,20
711,19,0,1,0,20
712,0,20,0,0,20
713,0,20,0,0,20
714,0,0,0,20,20
715,3,11,6,0,20
716,9,8,3,0,20
717,3,0,17,0,20
718,3,10,0,7,20
719,1,19,0,0,20
720,2,16,2,0,20
721,0,20,0,0,20
722,1,1,7,11,20
723,0,20,0,0,20
724,0,8,0,12,20
725,4,5,11,0,20
726,5,1,2,12,20
727,0,19,0,0,19
728,4,15,0,0,19
729,0,19,0,0,19
730,19,0,0,0,19
731,0,0,0,19,19
732,14,0,2,3,19
733,0,19,0,0,19
734,0,7,1,11,19
735,15,0,4,0,19
736,0,14,4,1,19
737,1,13,5,0,19
738,0,0,1,18,19
739,0,19,0,0,19
740,0,19,0,0,19
741,0,19,0,0,19
742,4,1,14,0,19
743,0,19,0,0,19
744,19,0,0,0,19
745,0,19,0,0,19
746,16,1,0,2,19
747,0,14,3,2,19
748,0,19,0,0,19
749,3,7,4,5,19
750,0,19,0,0,19
751,0,19,0,0,19
752,0,19,0,0,19
753,0,18,0,1,19
754,1,18,0,0,19
755,2,11,0,6,19
756,1,3,2,13,19
757,8,0,7,4,19
758,0,19,0,0,19
759,14,0,5,0,19
760,11,0,4,4,19
761,0,19,0,0,19
762,4,0,0,15,19
763,1,8,4,6,19
764,0,19,0,0,19
765,2,1,0,16,19
766,0,19,0,0,19
767,0,10,1,7,18
768,0,18,0,0,18
769,2,11,4,1,18
770,14,1,1,2,18
771,0,18,0,0,18
772,18,0,0,0,18
773,10,0,1,7,18
774,0,18,0,0,18
775,4,3,3,8,18
776,0,18,0,0,18
777,3,3,0,12,18
778,0,18,0,0,18
779,0,18,0,0,18
780,0,5,0,13,18
781,7,7,3,1,18
782,18,0,0,0,18
783,7,0,1,10,18
784,3,0,0,15,18
785,0,18,0,0,18
786,3,1,4,10,18
787,0,18,0,0,18
788,0,18,0,0,18
789,2,14,0,2,18
790,0,18,0,0,18
791,1,0,0,17,18
792,0,18,0,0,18
793,2,0,1,15,18
794,0,18,0,0,18
795,1,0,6,11,18
796,0,18,0,0,18
797,0,18,0,0,18
798,0,18,0,0,18
799,13,3,1,1,18
800,6,7,5,0,18
801,1,1,6,10,18
802,3,8,7,0,18
803,18,0,0,0,18
804,1,15,2,0,18
805,0,18,0,0,18
806,3,15,0,0,18
807,0,0,0,18,18
808,0,16,0,2,18
809,2,15,1,0,18
810,1,16,0,1,18
811,5,9,3,1,18
812,5,0,4,9,18
813,0,18,0,0,18
814,2,11,5,0,18
815,1,0,0,17,18
816,2,1,0,15,18
817,0,18,0,0,18
818,0,18,0,0,18
819,0,18,0,0,18
820,0,18,0,0,18
821,2,16,0,0,18
822,0,18,0,0,18
823,3,0,15,0,18
824,0,18,0,0,18
825,11,6,0,1,18
826,0,18,0,0,18
827,0,18,0,0,18
828,1,17,0,0,18
829,1,11,0,6,18
830,7,4,3,3,17
831,0,17,0,0,17
832,2,0,1,14,17
833,0,17,0,0,17
834,15,0,0,2,17
835,1,0,16,0,17
836,0,17,0,0,17
837,2,3,9,3,17
838,0,17,0,0,17
839,16,0,0,1,17
840,0,17,0,0,17
841,5,1,9,2,17
842,4,13,0,0,17
843,0,17,0,0,17
844,0,17,0,0,17
845,0,17,0,0,17
846,1,4,1,11,17
847,4,13,0,0,17
848,1,15,1,0,17
849,2,15,0,0,17
850,0,17,0,0,17
851,0,17,0,0,17
852,2,15,0,0,17
853,0,17,0,0,17
854,0,17,0,0,17
855,1,15,0,1,17
856,0,17,0,0,17
857,12,0,0,5,17
858,0,17,0,0,17
859,3,14,0,0,17
860,1,16,0,0,17
861,0,17,0,0,17
862,0,17,0,0,17
863,15,1,0,1,17
864,0,17,0,0,17
865,0,17,0,0,17
866,1,14,0,2,17
867,0,17,0,0,17
868,0,17,0,0,17
869,2,14,0,1,17
870,0,17,0,0,17
871,2,1,0,14,17
872,0,17,0,0,17
873,0,17,0,0,17
874,0,11,0,6,17
875,0,17,0,0,17
876,0,17,0,0,17
877,1,16,0,0,17
878,0,17,0,0,17
879,1,4,4,8,17
880,1,16,0,0,17
881,4,5,5,3,17
882,9,0,6,2,17
883,5,12,0,0,17
884,0,17,0,0,17
885,0,17,0,0,17
886,4,12,1,0,17
887,1,6,3,7,17
888,0,17,0,0,17
889,16,1,0,0,17
890,0,17,0,0,17
891,8,9,0,0,17
892,0,17,0,0,17
893,1,8,0,8,17
894,0,14,0,3,17
895,17,0,0,0,17
896,0,17,0,0,17
897,0,1,0,16,17
898,9,1,7,0,17
899,1,15,1,0,17
900,0,17,0,0,17
901,10,2,1,4,17
902,0,17,0,0,17
903,0,17,0,0,17
904,0,17,0,0,17
905,1,16,0,0,17
906,8,0,8,1,17
907,16,0,0,1,17
908,1,16,0,0,17
909,6,0,11,0,17
910,0,17,0,0,17
911,0,16,0,1,17
912,8,8,0,1,17
913,15,0,2,0,17
914,1,14,0,2,17
915,0,17,0,0,17
916,0,17,0,0,17
917,0,17,0,0,17
918,0,3,1,13,17
919,0,4,0,13,17
920,8,0,5,4,17
921,0,17,0,0,17
922,0,17,0,0,17
923,0,17,0,0,17
924,0,17,0,0,17
925,6,9,2,0,17
926,1,15,1,0,17
927,0,17,0,0,17
928,0,16,0,0,16
929,4,12,0,0,16
930,2,7,0,7,16
931,1,13,0,2,16
932,0,16,0,0,16
933,4,12,0,0,16
934,0,0,0,16,16
935,10,3,0,3,16
936,0,4,10,2,16
937,1,15,0,0,16
938,0,16,0,0,16
939,0,16,0,0,16
940,0,16,0,0,16
941,0,16,0,0,16
942,0,16,0,0,16
943,0,16,0,0,16
944,0,0,4,12,16
945,5,0,3,8,16
946,0,4,2,10,16
947,8,6,1,1,16
948,0,16,0,0,16
949,3,12,0,1,16
950,0,14,0,2,16
951,0,16,0,0,16
952,0,16,0,0,16
953,2,14,0,0,16
954,0,0,0,16,16
955,0,15,0,1,16
956,0,1,10,5,16
957,3,0,10,3,16
958,0,16,0,0,16
959,1,15,0,0,16
960,0,16,0,0,16
961,7,4,3,2,16
962,0,16,0,0,16
963,8,6,1,1,16
964,0,16,0,0,16
965,7,3,0,6,16
966,2,10,4,0,16
967,1,15,0,0,16
968,3,12,0,1,16
969,1,5,0,10,16
970,0,16,0,0,16
971,0,16,0,0,16
972,4,12,0,0,16
973,0,16,0,0,16
974,2,12,0,2,16
975,1,15,0,0,16
976,0,16,0,0,16
977,4,8,2,2,16
978,1,0,0,15,16
979,2,1,8,5,16
980,1,15,0,0,16
981,16,0,0,0,16
982,0,0,0,16,16
983,0,16,0,0,16
984,0,16,0,0,16
985,0,16,0,0,16
986,1,14,1,0,16
987,4,2,0,10,16
988,0,1,0,15,16
989,0,14,2,0,16
990,0,16,0,0,16
991,2,14,0,0,16
992,3,13,0,0,16
993,6,4,2,4,16
994,1,15,0,0,16
995,7,3,4,2,16
996,8,0,2,6,16
997,0,16,0,0,16
998,11,3,0,2,16
999,0,16,0,0,16
1000,0,0,0,16,16
1001,5,10,0,1,16
1002,2,8,0,6,16
1003,0,16,0,0,16
1004,16,0,0,0,16
1005,10,6,0,0,16
1006,0,16,0,0,16
1007,7,3,2,4,16
1008,0,16,0,0,16
1009,12,0,0,4,16
1010,1,15,0,0,16
1011,1,15,0,0,16
1012,1,12,3,0,16
1013,0,16,0,0,16
1014,1,15,0,0,16
1015,4,10,2,0,16
1016,0,16,0,0,16
1017,7,7,0,2,16
1018,6,1,5,4,16
1019,0,15,0,0,15
1020,0,15,0,0,15
1021,2,0,10,3,15
1022,0,15,0,0,15
1023,4,0,11,0,15
1024,0,15,0,0,15
1025,0,15,0,0,15
1026,11,2,2,0,15
1027,10,5,0,0,15
1028,0,12,0,3,15
1029,0,15,0,0,15
1030,0,15,0,0,15
1031,1,14,0,0,15
1032,2,13,0,0,15
1033,0,14,0,1,15
1034,1,8,0,6,15
1035,0,15,0,0,15
1036,0,5,8,2,15
1037,0,5,0,10,15
1038,14,1,0,0,15
1039,9,1,2,3,15
1040,0,15,0,0,15
1041,0,0,15,0,15
1042,0,8,0,7,15
1043,0,14,0,1,15
1044,1,14,0,0,15
1045,0,15,0,0,15
1046,5,8,0,2,15
1047,4,8,3,0,15
1048,0,15,0,0,15
1049,3,11,0,1,15
1050,0,15,0,0,15
1051,0,15,0,0,15
1052,0,15,0,0,15
1053,0,0,0,15,15
1054,0,15,0,0,15
1055,0,12,1,2,15
1056,0,15,0,0,15
1057,1,2,1,11,15
1058,1,1,0,13,15
1059,0,14,1,0,15
1060,0,14,0,1,15
1061,5,9,0,1,15
1062,1,13,0,1,15
1063,0,15,0,0,15
1064,0,15,0,0,15
1065,0,3,3,9,15
1066,0,15,0,0,15
1067,1,3,7,4,15
1068,11,0,2,2,15
1069,6,0,3,6,15
1070,0,14,1,0,15
1071,1,0,0,14,15
1072,0,15,0,0,15
1073,0,15,0,0,15
1074,1,10,2,2,15
1075,0,15,0,0,15
1076,3,12,0,0,15
1077,0,15,0,0,15
1078,0,15,0,0,15
1079,0,15,0,0,15
1080,0,1,0,14,15
1081,0,15,0,0,15
1082,0,15,0,0,15
1083,1,14,0,0,15
1084,8,6,0,1,15
1085,11,2,0,2,15
1086,0,15,0,0,15
1087,0,0,1,14,15
1088,0,15,0,0,15
1089,0,15,0,0,15
1090,0,15,0,0,15
1091,0,15,0,0,15
1092,0,15,0,0,15
1093,0,15,0,0,15
1094,0,15,0,0,15
1095,10,4,1,0,15
1096,0,15,0,0,15
1097,5,10,0,0,15
1098,0,15,0,0,15
1099,4,4,3,3,14
1100,14,0,0,0,14
1101,6,8,0,0,14
1102,0,14,0,0,14
1103,0,13,0,1,14
1104,2,11,0,1,14
1105,5,2,1,6,14
1106,0,14,0,0,14
1107,0,14,0,0,14
1108,1,13,0,0,14
1109,0,14,0,0,14
1110,2,12,0,0,14
1111,0,14,0,0,14
1112,1,13,0,0,14
1113,2,11,1,0,14
1114,0,14,0,0,14
1115,0,0,0,14,14
1116,0,9,0,5,14
1117,0,14,0,0,14
1118,4,1,1,8,14
1119,0,14,0,0,14
1120,0,0,3,11,14
1121,0,14,0,0,14
1122,0,14,0,0,14
1123,1,0,6,7,14
1124,1,5,8,0,14
1125,0,14,0,0,14
1126,0,12,2,0,14
1127,9,5,0,0,14
1128,7,7,0,0,14
1129,9,3,1,1,14
1130,0,14,0,0,14
1131,1,0,4,9,14
1132,0,14,0,0,14
1133,1,13,0,0,14
1134,2,2,0,10,14
1135,0,13,0,1,14
1136,0,14,0,0,14
1137,0,14,0,0,14
1138,0,14,0,0,14
1139,0,14,0,0,14
1140,0,14,0,0,14
1141,0,0,0,14,14
1142,0,14,0,0,14
1143,0,14,0,0,14
1144,1,1,10,2,14
1145,0,14,0,0,14
1146,0,14,0,0,14
1147,0,1,0,13,14
1148,1,11,2,0,14
1149,7,1,0,6,14
1150,0,14,0,0,14
1151,0,14,0,0,14
1152,2,12,0,0,14
1153,0,14,0,0,14
1154,3,0,7,4,14
1155,0,14,0,0,14
1156,1,13,0,0,14
1157,0,14,0,0,14
1158,1,11,0,2,14
1159,0,14,0,0,14
1160,4,3,3,4,14
1161,0,14,0,0,14
1162,12,0,0,2,14
1163,7,3,4,0,14
1164,0,7,0,7,14
1165,5,0,0,9,14
1166,0,0,0,14,14
1167,0,14,0,0,14
1168,2,12,0,0,14
1169,0,10,0,4,14
1170,0,14,0,0,14
1171,10,0,0,4,14
1172,0,14,0,0,14
1173,0,14,0,0,14
1174,0,14,0,0,14
1175,1,4,7,2,14
1176,0,14,0,0,14
1177,0,14,0,0,14
1178,6,5,1,2,14
1179,0,14,0,0,14
1180,0,9,5,0,14
1181,1,9,0,4,14
1182,2,12,0,0,14
1183,0,14,0,0,14
1184,0,14,0,0,14
1185,1,13,0,0,14
1186,0,14,0,0,14
1187,6,0,1,7,14
1188,0,1,2,11,14
1189,1,12,0,1,14
1190,0,14,0,0,14
1191,0,14,0,0,14
1192,0,14,0,0,14
1193,1,13,0,0,14
1194,6,7,1,0,14
1195,0,3,0,11,14
1196,4,8,2,0,14
1197,0,14,0,0,14
1198,0,14,0,0,14
1199,8,0,3,3,14
1200,0,14,0,0,14
1201,0,14,0,0,14
1202,0,14,0,0,14
1203,1,12,0,1,14
1204,2,12,0,0,14
1205,0,14,0,0,14
1206,2,3,9,0,14
1207,0,14,0,0,14
1208,1,11,0,2,14
1209,0,14,0,0,14
1210,13,1,0,0,14
1211,0,13,1,0,14
1212,0,14,0,0,14
1213,4,6,3,1,14
1214,0,14,0,0,14
1215,0,14,0,0,14
1216,0,14,0,0,14
1217,0,12,0,2,14
1218,0,13,0,1,14
1219,0,14,0,0,14
1220,9,2,1,2,14
1221,0,0,0,14,14
1222,3,4,0,7,14
1223,0,14,0,0,14
1224,0,13,0,1,14
1225,0,14,0,0,14
1226,2,12,0,0,14
1227,2,0,12,0,14
1228,0,14,0,0,14
1229,2,1,11,0,14
1230,0,14,0,0,14
1231,0,1,8,5,14
1232,2,0,0,12,14
1233,0,13,0,0,13
1234,5,0,0,8,13
1235,0,13,0,0,13
1236,0,13,0,0,13
1237,4,1,0,8,13
1238,0,13,0,0,13
1239,0,13,0,0,13
1240,0,13,0,0,13
1241,0,12,0,1,13
1242,5,5,3,0,13
1243,0,13,0,0,13
1244,1,12,0,0,13
1245,2,4,4,3,13
1246,0,13,0,0,13
1247,1,12,0,0,13
1248,6,1,6,0,13
1249,2,0,4,7,13
1250,0,13,0,0,13
1251,2,6,0,5,13
1252,0,13,0,0,13
1253,3,0,0,10,13
1254,0,13,0,0,13
1255,0,13,0,0,13
1256,0,13,0,0,13
1257,2,4,2,5,13
1258,2,11,0,0,13
1259,2,2,0,9,13
1260,11,0,1,1,13
1261,0,12,0,1,13
1262,1,10,1,1,13
1263,0,11,2,0,13
1264,1,11,1,0,13
1265,3,6,0,4,13
1266,0,13,0,0,13
1267,0,13,0,0,13
1268,11,1,0,1,13
1269,0,13,0,0,13
1270,0,13,0,0,13
1271,0,13,0,0,13
1272,1,12,0,0,13
1273,1,12,0,0,13
1274,1,12,0,0,13
1275,0,13,0,0,13
1276,1,12,0,0,13
1277,2,11,0,0,13
1278,0,13,0,0,13
1279,1,12,0,0,13
1280,0,13,0,0,13
1281,2,10,0,1,13
1282,4,3,2,4,13
1283,0,13,0,0,13
1284,0,13,0,0,13
1285,9,4,0,0,13
1286,1,0,0,12,13
1287,3,10,0,0,13
1288,0,13,0,0,13
1289,3,10,0,0,13
1290,0,13,0,0,13
1291,3,1,1,8,13
1292,0,13,0,0,13
1293,0,13,0,0,13
1294,0,12,1,0,13
1295,0,13,0,0,13
1296,0,13,0,0,13
1297,1,0,0,12,13
1298,0,13,0,0,13
1299,0,13,0,0,13
1300,0,13,0,0,13
1301,0,13,0,0,13
1302,0,13,0,0,13
1303,2,11,0,0,13
1304,7,4,1,1,13
1305,0,13,0,0,13
1306,0,13,0,0,13
1307,0,6,0,7,13
1308,7,2,3,1,13
1309,4,8,0,1,13
1310,0,13,0,0,13
1311,0,13,0,0,13
1312,0,13,0,0,13
1313,0,13,0,0,13
1314,4,3,6,0,13
1315,0,13,0,0,13
1316,11,0,0,2,13
1317,0,13,0,0,13
1318,0,13,0,0,13
1319,0,11,0,2,13
1320,0,13,0,0,13
1321,11,1,1,0,13
1322,2,7,0,4,13
1323,12,1,0,0,13
1324,0,13,0,0,13
1325,0,13,0,0,13
1326,0,13,0,0,13
1327,0,13,0,0,13
1328,0,13,0,0,13
1329,0,13,0,0,13
1330,1,0,0,12,13
1331,0,10,0,3,13
1332,0,13,0,0,13
1333,4,9,0,0,13
1334,0,13,0,0,13
1335,0,13,0,0,13
1336,2,11,0,0,13
1337,0,13,0,0,13
1338,0,13,0,0,13
1339,0,13,0,0,13
1340,0,13,0,0,13
1341,0,13,0,0,13
1342,0,13,0,0,13
1343,4,5,3,1,13
1344,0,13,0,0,13
1345,0,13,0,0,13
1346,2,11,0,0,13
1347,4,8,0,1,13
1348,4,1,6,2,13
1349,0,13,0,0,13
1350,2,11,0,0,13
1351,1,12,0,0,13
1352,1,9,3,0,13
1353,0,2,0,11,13
1354,2,6,5,0,13
1355,1,12,0,0,13
1356,0,13,0,0,13
1357,0,13,0,0,13
1358,13,0,0,0,13
1359,0,13,0,0,13
1360,0,12,1,0,13
1361,2,9,0,2,13
1362,0,13,0,0,13
1363,5,7,1,0,13
1364,1,5,1,6,13
1365,0,0,13,0,13
1366,9,0,1,3,13
1367,0,13,0,0,13
1368,5,5,2,1,13
1369,1,12,0,0,13
1370,2,7,0,4,13
1371,3,0,4,6,13
1372,0,13,0,0,13
1373,0,12,1,0,13
1374,0,6,0,7,13
1375,2,0,0,11,13
1376,0,9,1,3,13
1377,0,13,0,0,13
1378,0,13,0,0,13
1379,0,12,0,0,12
1380,0,12,0,0,12
1381,2,2,8,0,12
1382,0,12,0,0,12
1383,2,10,0,0,12
1384,5,6,1,0,12
1385,0,12,0,0,12
1386,0,12,0,0,12
1387,1,8,0,3,12
1388,0,12,0,0,12
1389,0,10,0,2,12
1390,0,12,0,0,12
1391,2,10,0,0,12
1392,1,11,0,0,12
1393,2,1,6,3,12
1394,0,12,0,0,12
1395,2,10,0,0,12
1396,0,12,0,0,12
1397,2,10,0,0,12
1398,2,6,0,4,12
1399,0,12,0,0,12
1400,1,11,0,0,12
1401,0,12,0,0,12
1402,5,0,7,0,12
1403,0,12,0,0,12
1404,3,7,2,0,12
1405,1,8,1,2,12
1406,4,0,8,0,12
1407,0,12,0,0,12
1408,0,12,0,0,12
1409,4,4,4,0,12
1410,1,3,1,7,12
1411,4,8,0,0,12
1412,0,12,0,0,12
1413,3,0,1,8,12
1414,0,12,0,0,12
1415,3,2,3,4,12
1416,0,12,0,0,12
1417,0,10,2,0,12
1418,6,1,0,5,12
1419,1,11,0,0,12
1420,4,1,6,1,12
1421,0,12,0,0,12
1422,0,12,0,0,12
1423,0,12,0,0,12
1424,0,12,0,0,12
1425,0,12,0,0,12
1426,4,8,0,0,12
1427,0,12,0,0,12
1428,0,12,0,0,12
1429,0,11,1,0,12
1430,7,2,0,3,12
1431,3,3,6,0,12
1432,0,11,0,1,12
1433,0,12,0,0,12
1434,0,12,0,0,12
1435,3,9,0,0,12
1436,0,0,0,12,12
1437,3,8,1,0,12
1438,5,0,7,0,12
1439,0,12,0,0,12
1440,2,0,5,5,12
1441,0,12,0,0,12
1442,0,12,0,0,12
1443,0,12,0,0,12
1444,6,3,0,3,12
1445,0,12,0,0,12
1446,0,5,1,6,12
1447,0,12,0,0,12
1448,11,0,0,1,12
1449,1,9,0,2,12
1450,0,12,0,0,12
1451,0,12,0,0,12
1452,5,2,1,4,12
1453,2,10,0,0,12
1454,1,10,0,1,12
1455,0,12,0,0,12
1456,0,12,0,0,12
1457,0,12,0,0,12
1458,0,0,0,12,12
1459,1,11,0,0,12
1460,0,12,0,0,12
1461,1,7,0,4,12
1462,0,12,0,0,12
1463,0,12,0,0,12
1464,0,12,0,0,12
1465,1,10,1,0,12
1466,0,8,0,4,12
1467,6,2,1,3,12
1468,0,12,0,0,12
1469,0,5,0,7,12
1470,0,12,0,0,12
1471,0,12,0,0,12
1472,11,1,0,0,12
1473,0,12,0,0,12
1474,1,11,0,0,12
1475,0,12,0,0,12
1476,0,12,0,0,12
1477,0,12,0,0,12
1478,0,12,0,0,12
1479,11,0,1,0,12
1480,0,11,0,1,12
1481,6,6,0,0,12
1482,8,0,4,0,12
1483,0,12,0,0,12
1484,0,12,0,0,12
1485,4,2,4,2,12
1486,2,7,0,3,12
1487,0,12,0,0,12
1488,6,3,0,3,12
1489,0,12,0,0,12
1490,5,7,0,0,12
1491,1,7,0,4,12
1492,0,11,0,1,12
1493,0,4,1,7,12
1494,2,10,0,0,12
1495,0,12,0,0,12
1496,0,0,12,0,12
1497,0,12,0,0,12
1498,2,10,0,0,12
1499,7,0,3,2,12
1500,0,12,0,0,12
1501,1,11,0,0,12
1502,10,1,1,0,12
1503,0,12,0,0,12
1504,2,9,1,0,12
1505,0,12,0,0,12
1506,2,7,3,0,12
1507,0,12,0,0,12
1508,0,11,0,1,12
1509,1,11,0,0,12
1510,0,12,0,0,12
1511,0,12,0,0,12
1512,0,12,0,0,12
1513,0,11,0,1,12
1514,0,4,5,3,12
1515,2,10,0,0,12
1516,0,12,0,0,12
1517,3,4,0,5,12
1518,0,10,2,0,12
1519,0,12,0,0,12
1520,7,0,0,5,12
1521,0,12,0,0,12
1522,9,0,3,0,12
1523,12,0,0,0,12
1524,0,1,4,7,12
1525,0,12,0,0,12
1526,0,11,0,1,12
1527,11,0,0,1,12
1528,0,12,0,0,12
1529,6,0,1,5,12
1530,7,0,2,3,12
1531,0,12,0,0,12
1532,2,0,1,9,12
1533,0,12,0,0,12
1534,0,12,0,0,12
1535,2,10,0,0,12
1536,0,12,0,0,12
1537,8,0,3,1,12
1538,6,0,6,0,12
1539,1,0,9,2,12
1540,1,10,1,0,12
1541,0,12,0,0,12
1542,0,12,0,0,12
1543,0,12,0,0,12
1544,2,8,2,0,12
1545,1,0,5,6,12
1546,0,12,0,0,12
1547,0,12,0,0,12
1548,0,12,0,0,12
1549,0,12,0,0,12
1550,0,12,0,0,12
1551,1,11,0,0,12
1552,0,12,0,0,12
1553,0,12,0,0,12
1554,0,9,0,3,12
1555,0,9,0,3,12
1556,0,12,0,0,12
1557,0,12,0,0,12
1558,0,12,0,0,12
1559,4,7,1,0,12
1560,12,0,0,0,12
1561,2,4,2,4,12
1562,0,11,0,0,11
1563,11,0,0,0,11
1564,0,11,0,0,11
1565,8,1,2,0,11
1566,0,11,0,0,11
1567,0,9,0,2,11
1568,2,4,4,1,11
1569,4,4,1,2,11
1570,0,11,0,0,11
1571,2,1,0,8,11
1572,7,0,4,0,11
1573,0,11,0,0,11
1574,1,10,0,0,11
1575,5,5,0,1,11
1576,5,0,4,2,11
1577,1,9,0,1,11
1578,0,11,0,0,11
1579,0,11,0,0,11
1580,0,11,0,0,11
1581,0,10,0,1,11
1582,0,10,0,1,11
1583,8,3,0,0,11
1584,0,11,0,0,11
1585,0,4,2,5,11
1586,0,11,0,0,11
1587,1,10,0,0,11
1588,0,11,0,0,11
1589,0,11,0,0,11
1590,4,3,0,4,11
1591,2,9,0,0,11
1592,8,0,0,3,11
1593,0,11,0,0,11
1594,0,0,0,11,11
1595,0,11,0,0,11
1596,0,11,0,0,11
1597,0,11,0,0,11
1598,3,2,0,6,11
1599,0,11,0,0,11
1600,2,9,0,0,11
1601,10,0,0,1,11
1602,0,11,0,0,11
1603,0,9,2,0,11
1604,0,11,0,0,11
1605,1,7,3,0,11
1606,0,11,0,0,11
1607,0,11,0,0,11
1608,0,11,0,0,11
1609,0,11,0,0,11
1610,0,11,0,0,11
1611,8,0,2,1,11
1612,2,6,3,0,11
1613,8,0,0,3,11
1614,1,5,0,5,11
1615,0,11,0,0,11
1616,1,10,0,0,11
1617,8,2,0,1,11
1618,7,2,1,1,11
1619,0,11,0,0,11
1620,2,3,2,4,11
1621,1,10,0,0,11
1622,0,11,0,0,11
1623,0,11,0,0,11
1624,0,11,0,0,11
1625,11,0,0,0,11
1626,7,0,2,2,11
1627,1,10,0,0,11
1628,0,11,0,0,11
1629,0,11,0,0,11
1630,0,11,0,0,11
1631,0,11,0,0,11
1632,1,0,0,10,11
1633,0,10,0,1,11
1634,3,7,1,0,11
1635,9,1,0,1,11
1636,5,2,1,3,11
1637,0,9,1,1,11
1638,0,11,0,0,11
1639,8,0,2,1,11
1640,0,11,0,0,11
1641,0,11,0,0,11
1642,4,7,0,0,11
1643,2,1,2,6,11
1644,0,11,0,0,11
1645,5,2,0,4,11
1646,0,1,0,10,11
1647,0,11,0,0,11
1648,0,11,0,0,11
1649,3,0,4,4,11
1650,0,11,0,0,11
1651,0,11,0,0,11
1652,0,11,0,0,11
1653,0,11,0,0,11
1654,3,4,2,2,11
1655,0,11,0,0,11
1656,0,11,0,0,11
1657,1,10,0,0,11
1658,0,11,0,0,11
1659,5,5,1,0,11
1660,0,11,0,0,11
1661,0,11,0,0,11
1662,0,11,0,0,11
1663,0,11,0,0,11
1664,1,0,8,2,11
1665,3,1,5,2,11
1666,0,11,0,0,11
1667,0,11,0,0,11
1668,6,1,3,1,11
1669,0,11,0,0,11
1670,0,11,0,0,11
1671,0,11,0,0,11
1672,1,10,0,0,11
1673,0,11,0,0,11
1674,0,11,0,0,11
1675,10,1,0,0,11
1676,0,11,0,0,11
1677,8,0,2,1,11
1678,3,8,0,0,11
1679,0,11,0,0,11
1680,0,11,0,0,11
1681,0,11,0,0,11
1682,9,0,2,0,11
1683,0,11,0,0,11
1684,6,5,0,0,11
1685,0,11,0,0,11
1686,0,0,2,9,11
1687,0,11,0,0,11
1688,1,1,9,0,11
1689,9,0,2,0,11
1690,8,0,0,3,11
1691,0,11,0,0,11
1692,0,11,0,0,11
1693,7,4,0,0,11
1694,8,0,0,3,11
1695,0,11,0,0,11
1696,0,11,0,0,11
1697,0,11,0,0,11
1698,0,11,0,0,11
1699,4,7,0,0,11
1700,1,8,0,2,11
1701,0,11,0,0,11
1702,0,11,0,0,11
1703,0,11,0,0,11
1704,2,9,0,0,11
1705,0,4,7,0,11
1706,0,11,0,0,11
1707,0,0,0,11,11
1708,3,8,0,0,11
1709,0,11,0,0,11
1710,3,0,1,7,11
1711,11,0,0,0,11
1712,0,11,0,0,11
1713,0,10,0,1,11
1714,0,11,0,0,11
1715,0,11,0,0,11
1716,0,11,0,0,11
1717,9,0,0,2,11
1718,0,11,0,0,11
1719,0,11,0,0,11
1720,0,11,0,0,11
1721,0,11,0,0,11
1722,0,1,0,10,11
1723,0,11,0,0,11
1724,11,0,0,0,11
1725,0,11,0,0,11
1726,0,11,0,0,11
1727,0,11,0,0,11
1728,5,0,5,1,11
1729,9,2,0,0,11
1730,0,11,0,0,11
1731,0,10,0,1,11
1732,2,0,1,8,11
1733,1,0,0,10,11
1734,1,10,0,0,11
1735,0,2,0,9,11
1736,0,10,0,1,11
1737,0,11,0,0,11
1738,0,11,0,0,11
1739,1,4,0,6,11
1740,6,1,0,4,11
1741,2,0,9,0,11
1742,0,11,0,0,11
1743,0,11,0,0,11
1744,0,11,0,0,11
1745,10,0,0,1,11
1746,0,11,0,0,11
1747,0,11,0,0,11
1748,0,11,0,0,11
1749,4,7,0,0,11
1750,1,2,0,8,11
1751,1,2,1,7,11
1752,2,9,0,0,11
1753,0,11,0,0,11
1754,0,11,0,0,11
1755,0,11,0,0,11
1756,5,0,0,6,11
1757,1,10,0,0,11
1758,0,11,0,0,11
1759,0,11,0,0,11
1760,0,11,0,0,11
1761,0,11,0,0,11
1762,0,11,0,0,11
1763,0,11,0,0,11
1764,0,11,0,0,11
1765,0,10,0,0,10
1766,0,10,0,0,10
1767,0,10,0,0,10
1768,9,0,0,1,10
1769,0,10,0,0,10
1770,0,10,0,0,10
1771,0,8,0,2,10
1772,1,8,1,0,10
1773,1,9,0,0,10
1774,0,10,0,0,10
1775,2,8,0,0,10
1776,1,0,0,9,10
1777,0,10,0,0,10
1778,0,0,0,10,10
1779,0,10,0,0,10
1780,0,10,0,0,10
1781,6,4,0,0,10
1782,8,0,1,1,10
1783,0,10,0,0,10
1784,0,3,6,1,10
1785,10,0,0,0,10
1786,1,7,2,0,10
1787,0,10,0,0,10
1788,2,2,5,1,10
1789,1,9,0,0,10
1790,0,9,1,0,10
1791,0,3,2,5,10
1792,1,9,0,0,10
1793,0,10,0,0,10
1794,6,4,0,0,10
1795,5,0,3,2,10
1796,0,10,0,0,10
1797,0,9,0,1,10
1798,7,3,0,0,10
1799,0,10,0,0,10
1800,6,3,0,1,10
1801,0,10,0,0,10
1802,0,10,0,0,10
1803,1,8,0,1,10
1804,0,5,2,3,10
1805,8,1,0,1,10
1806,0,10,0,0,10
1807,0,10,0,0,10
1808,0,10,0,0,10
1809,0,10,0,0,10
1810,1,9,0,0,10
1811,0,10,0,0,10
1812,0,10,0,0,10
1813,0,10,0,0,10
1814,1,4,3,2,10
1815,6,3,0,1,10
1816,0,10,0,0,10
1817,0,10,0,0,10
1818,0,10,0,0,10
1819,1,7,2,0,10
1820,0,10,0,0,10
1821,0,10,0,0,10
1822,0,10,0,0,10
1823,2,8,0,0,10
1824,0,10,0,0,10
1825,0,10,0,0,10
1826,0,10,0,0,10
1827,2,1,6,1,10
1828,7,0,0,3,10
1829,0,10,0,0,10
1830,0,10,0,0,10
1831,5,5,0,0,10
1832,0,10,0,0,10
1833,1,9,0,0,10
1834,0,8,0,2,10
1835,0,0,0,10,10
1836,0,10,0,0,10
1837,0,3,3,4,10
1838,0,0,0,10,10
1839,0,10,0,0,10
1840,0,10,0,0,10
1841,5,3,2,0,10
1842,0,10,0,0,10
1843,0,10,0,0,10
1844,0,10,0,0,10
1845,0,10,0,0,10
1846,1,9,0,0,10
1847,2,7,0,1,10
1848,6,0,4,0,10
1849,0,10,0,0,10
1850,1,0,1,8,10
1851,0,10,0,0,10
1852,0,10,0,0,10
1853,0,9,0,1,10
1854,10,0,0,0,10
1855,9,1,0,0,10
1856,5,5,0,0,10
1857,0,10,0,0,10
1858,1,0,8,1,10
1859,0,10,0,0,10
1860,0,10,0,0,10
1861,2,1,1,6,10
1862,2,2,0,6,10
1863,3,0,0,7,10
1864,0,3,1,6,10
1865,0,10,0,0,10
1866,0,9,1,0,10
1867,0,10,0,0,10
1868,1,2,0,7,10
1869,10,0,0,0,10
1870,0,10,0,0,10
1871,0,10,0,0,10
1872,0,10,0,0,10
1873,5,2,0,3,10
1874,0,10,0,0,10
1875,8,2,0,0,10
1876,0,10,0,0,10
1877,1,9,0,0,10
1878,6,0,1,3,10
1879,3,7,0,0,10
1880,0,10,0,0,10
1881,1,9,0,0,10
1882,2,7,0,1,10
1883,0,10,0,0,10
1884,0,10,0,0,10
1885,4,6,0,0,10
1886,5,5,0,0,10
1887,1,9,0,0,10
1888,0,10,0,0,10
1889,0,10,0,0,10
1890,0,0,4,6,10
1891,6,4,0,0,10
1892,0,4,1,5,10
1893,0,7,0,3,10
1894,4,2,1,3,10
1895,0,10,0,0,10
1896,0,10,0,0,10
1897,0,10,0,0,10
1898,0,10,0,0,10
1899,2,8,0,0,10
1900,2,8,0,0,10
1901,2,0,7,1,10
1902,2,0,0,8,10
1903,6,2,2,0,10
1904,0,8,2,0,10
1905,1,9,0,0,10
1906,0,10,0,0,10
1907,5,5,0,0,10
1908,6,2,2,0,10
1909,10,0,0,0,10
1910,4,6,0,0,10
1911,0,0,0,10,10
1912,0,9,0,1,10
1913,9,1,0,0,10
1914,0,5,0,5,10
1915,0,10,0,0,10
1916,0,10,0,0,10
1917,3,4,3,0,10
1918,0,10,0,0,10
1919,0,10,0,0,10
1920,5,3,2,0,10
1921,1,0,1,8,10
1922,2,8,0,0,10
1923,1,9,0,0,10
1924,0,10,0,0,10
1925,0,10,0,0,10
1926,0,10,0,0,10
1927,4,4,2,0,10
1928,0,10,0,0,10
1929,0,10,0,0,10
1930,0,10,0,0,10
1931,0,10,0,0,10
1932,3,6,1,0,10
1933,0,9,0,1,10
1934,0,10,0,0,10
1935,0,10,0,0,10
1936,0,10,0,0,10
1937,0,10,0,0,10
1938,4,4,2,0,10
1939,1,8,0,1,10
1940,0,10,0,0,10
1941,0,5,3,2,10
1942,7,3,0,0,10
1943,1,9,0,0,10
1944,1,7,2,0,10
1945,0,10,0,0,10
1946,0,10,0,0,10
1947,6,1,1,2,10
1948,0,0,0,10,10
1949,0,10,0,0,10
1950,0,10,0,0,10
1951,1,7,0,2,10
1952,2,8,0,0,10
1953,1,8,0,1,10
1954,0,10,0,0,10
1955,7,0,1,2,10
1956,4,1,5,0,10
1957,4,4,1,1,10
1958,2,0,0,8,10
1959,0,10,0,0,10
1960,0,10,0,0,10
1961,0,10,0,0,10
1962,3,0,5,2,10
1963,0,10,0,0,10
1964,0,10,0,0,10
1965,4,2,4,0,10
1966,0,10,0,0,10
1967,0,10,0,0,10
1968,1,9,0,0,10
1969,0,0,0,10,10
1970,2,8,0,0,10
1971,1,9,0,0,10
1972,0,10,0,0,10
1973,0,10,0,0,10
1974,1,7,2,0,10
1975,1,9,0,0,10
1976,0,9,0,1,10
1977,0,10,0,0,10
1978,0,10,0,0,10
1979,0,10,0,0,10
1980,2,1,4,3,10
1981,1,9,0,0,10
1982,2,5,1,2,10
1983,1,8,1,0,10
1984,0,10,0,0,10
1985,0,10,0,0,10
1986,0,10,0,0,10
1987,0,10,0,0,10
1988,0,8,0,2,10
1989,0,10,0,0,10
1990,0,10,0,0,10
1991,3,0,3,4,10
1992,0,10,0,0,10
1993,0,10,0,0,10
1994,2,8,0,0,10
1995,7,0,1,2,10
1996,0,10,0,0,10
1997,0,10,0,0,10
1998,2,4,0,4,10
1999,0,10,0,0,10
2000,0,9,0,1,10
2001,0,10,0,0,10
2002,0,10,0,0,10
2003,0,10,0,0,10
2004,1,9,0,0,10
2005,0,10,0,0,10
2006,0,10,0,0,10
2007,0,10,0,0,10
2008,1,9,0,0,10
2009,0,10,0,0,10
2010,5,3,1,1,10
2011,0,5,5,0,10
2012,2,1,3,4,10
2013,0,10,0,0,10
2014,0,9,0,1,10
2015,0,10,0,0,10
2016,2,7,0,1,10
2017,0,10,0,0,10
2018,2,8,0,0,10
2019,1,2,6,1,10
2020,0,10,0,0,10
2021,1,9,0,0,10
2022,0,10,0,0,10
2023,1,8,1,0,10
2024,3,7,0,0,10
2025,3,2,4,1,10
2026,1,9,0,0,10
2027,4,5,1,0,10
2028,7,0,2,1,10
2029,4,6,0,0,10
2030,0,9,0,0,9
2031,0,9,0,0,9
2032,0,9,0,0,9
2033,0,9,0,0,9
2034,0,9,0,0,9
2035,0,9,0,0,9
2036,4,5,0,0,9
2037,1,8,0,0,9
2038,0,7,0,2,9
2039,0,9,0,0,9
2040,0,9,0,0,9
2041,0,8,0,1,9
2042,0,0,0,9,9
2043,2,0,3,4,9
2044,0,9,0,0,9
2045,0,9,0,0,9
2046,4,4,1,0,9
2047,0,0,0,9,9
2048,8,1,0,0,9
2049,0,0,0,9,9
2050,0,9,0,0,9
2051,3,6,0,0,9
2052,0,9,0,0,9
2053,0,5,0,4,9
2054,1,8,0,0,9
2055,0,9,0,0,9
2056,0,9,0,0,9
2057,0,9,0,0,9
2058,0,8,1,0,9
2059,2,4,2,1,9
2060,0,9,0,0,9
2061,1,8,0,0,9
2062,1,3,4,1,9
2063,0,9,0,0,9
2064,0,8,0,1,9
2065,3,3,0,3,9
2066,0,9,0,0,9
2067,0,9,0,0,9
2068,0,9,0,0,9
2069,0,9,0,0,9
2070,0,3,0,6,9
2071,0,9,0,0,9
2072,8,1,0,0,9
2073,2,6,1,0,9
2074,0,9,0,0,9
2075,0,8,0,1,9
2076,0,9,0,0,9
2077,0,9,0,0,9
2078,0,9,0,0,9
2079,0,9,0,0,9
2080,0,9,0,0,9
2081,2,6,0,1,9
2082,0,9,0,0,9
2083,1,6,0,2,9
2084,0,9,0,0,9
2085,1,8,0,0,9
2086,3,1,5,0,9
2087,0,9,0,0,9
2088,5,0,3,1,9
2089,8,1,0,0,9
2090,0,9,0,0,9
2091,5,1,3,0,9
2092,0,9,0,0,9
2093,0,9,0,0,9
2094,0,9,0,0,9
2095,0,9,0,0,9
2096,0,9,0,0,9
2097,0,9,0,0,9
2098,0,9,0,0,9
2099,2,0,0,7,9
2100,1,8,0,0,9
2101,0,9,0,0,9
2102,0,9,0,0,9
2103,0,9,0,0,9
2104,0,9,0,0,9
2105,2,5,1,1,9
2106,0,2,3,4,9
2107,0,9,0,0,9
2108,1,2,2,4,9
2109,0,9,0,0,9
2110,1,4,3,1,9
2111,0,9,0,0,9
2112,0,9,0,0,9
2113,6,0,1,2,9
2114,1,0,0,8,9
2115,0,9,0,0,9
2116,4,5,0,0,9
2117,1,7,0,1,9
2118,0,9,0,0,9
2119,0,9,0,0,9
2120,0,9,0,0,9
2121,0,9,0,0,9
2122,0,9,0,0,9
2123,0,9,0,0,9
2124,0,9,0,0,9
2125,2,7,0,0,9
2126,0,9,0,0,9
2127,1,8,0,0,9
2128,5,0,2,2,9
2129,0,8,1,0,9
2130,4,2,3,0,9
2131,0,0,1,8,9
2132,0,9,0,0,9
2133,8,0,1,0,9
2134,0,0,0,9,9
2135,0,9,0,0,9
2136,9,0,0,0,9
2137,5,1,3,0,9
2138,4,5,0,0,9
2139,0,9,0,0,9
2140,0,9,0,0,9
2141,3,5,0,1,9
2142,4,0,5,0,9
2143,0,9,0,0,9
2144,1,8,0,0,9
2145,2,4,3,0,9
2146,1,0,4,4,9
2147,5,2,2,0,9
2148,3,5,1,0,9
2149,1,8,0,0,9
2150,3,3,3,0,9
2151,0,9,0,0,9
2152,5,1,3,0,9
2153,0,9,0,0,9
2154,0,9,0,0,9
2155,0,8,1,0,9
2156,2,0,1,6,9
2157,3,1,0,5,9
2158,0,9,0,0,9
2159,0,9,0,0,9
2160,2,0,2,5,9
2161,2,5,0,2,9
2162,0,9,0,0,9
2163,9,0,0,0,9
2164,0,9,0,0,9
2165,0,9,0,0,9
2166,1,7,0,1,9
2167,4,3,1,1,9
2168,0,9,0,0,9
2169,2,7,0,0,9
2170,0,8,0,1,9
2171,0,9,0,0,9
2172,0,9,0,0,9
2173,1,0,8,0,9
2174,0,9,0,0,9
2175,0,9,0,0,9
2176,4,4,0,1,9
2177,0,0,2,7,9
2178,5,0,2,2,9
2179,1,3,0,5,9
2180,2,7,0,0,9
2181,1,8,0,0,9
2182,1,8,0,0,9
2183,1,7,0,1,9
2184,2,4,3,0,9
2185,3,0,6,0,9
2186,0,9,0,0,9
2187,0,9,0,0,9
2188,1,8,0,0,9
2189,5,1,2,1,9
2190,1,3,4,1,9
2191,9,0,0,0,9
2192,0,9,0,0,9
2193,0,9,0,0,9
2194,6,0,0,3,9
2195,0,9,0,0,9
2196,0,9,0,0,9
2197,0,9,0,0,9
2198,0,9,0,0,9
2199,5,1,1,2,9
2200,0,9,0,0,9
2201,0,9,0,0,9
2202,9,0,0,0,9
2203,3,1,2,3,9
2204,0,9,0,0,9
2205,0,9,0,0,9
2206,0,9,0,0,9
2207,0,9,0,0,9
2208,0,9,0,0,9
2209,0,9,0,0,9
2210,1,8,0,0,9
2211,6,2,1,0,9
2212,0,9,0,0,9
2213,0,9,0,0,9
2214,1,4,4,0,9
2215,0,9,0,0,9
2216,1,8,0,0,9
2217,2,7,0,0,9
2218,3,1,5,0,9
2219,3,1,2,3,9
2220,0,9,0,0,9
2221,0,9,0,0,9
2222,1,8,0,0,9
2223,0,9,0,0,9
2224,4,3,2,0,9
2225,0,9,0,0,9
2226,0,9,0,0,9
2227,3,4,0,2,9
2228,0,7,0,2,9
2229,0,9,0,0,9
2230,3,6,0,0,9
2231,1,8,0,0,9
2232,0,9,0,0,9
2233,2,7,0,0,9
2234,0,9,0,0,9
2235,1,8,0,0,9
2236,1,0,8,0,9
2237,0,9,0,0,9
2238,2,4,3,0,9
2239,0,9,0,0,9
2240,1,8,0,0,9
2241,0,9,0,0,9
2242,0,5,0,4,9
2243,0,9,0,0,9
2244,0,9,0,0,9
2245,0,9,0,0,9
2246,0,9,0,0,9
2247,0,9,0,0,9
2248,0,0,9,0,9
2249,0,9,0,0,9
2250,9,0,0,0,9
2251,0,9,0,0,9
2252,0,9,0,0,9
2253,0,9,0,0,9
2254,0,9,0,0,9
2255,0,4,1,4,9
2256,0,9,0,0,9
2257,1,6,0,2,9
2258,5,4,0,0,9
2259,0,9,0,0,9
2260,2,7,0,0,9
2261,7,2,0,0,9
2262,0,9,0,0,9
2263,5,1,2,1,9
2264,0,9,0,0,9
2265,0,8,0,1,9
2266,0,9,0,0,9
2267,0,9,0,0,9
2268,8,1,0,0,9
2269,0,9,0,0,9
2270,2,7,0,0,9
2271,0,9,0,0,9
2272,2,0,7,0,9
2273,5,4,0,0,9
2274,0,9,0,0,9
2275,0,0,0,9,9
2276,1,1,0,7,9
2277,0,9,0,0,9
2278,1,3,4,1,9
2279,4,3,2,0,9
2280,0,0,0,9,9
2281,0,9,0,0,9
2282,0,2,0,7,9
2283,0,9,0,0,9
2284,0,9,0,0,9
2285,0,9,0,0,9
2286,2,0,2,5,9
2287,0,9,0,0,9
2288,0,9,0,0,9
2289,5,4,0,0,9
2290,3,5,0,1,9
2291,0,8,1,0,9
2292,1,0,0,8,9
2293,0,9,0,0,9
2294,2,6,1,0,9
2295,1,5,3,0,9
2296,0,9,0,0,9
2297,2,7,0,0,9
2298,0,9,0,0,9
2299,2,3,2,2,9
2300,0,8,1,0,9
2301,0,9,0,0,9
2302,8,0,1,0,9
2303,1,8,0,0,9
2304,0,9,0,0,9
2305,0,9,0,0,9
2306,1,5,0,3,9
2307,0,9,0,0,9
2308,2,2,5,0,9
2309,0,9,0,0,9
2310,1,0,0,8,9
2311,4,5,0,0,9
2312,0,9,0,0,9
2313,1,2,0,6,9
2314,3,6,0,0,9
2315,0,5,0,4,9
2316,0,9,0,0,9
2317,0,9,0,0,9
2318,1,5,3,0,9
2319,0,9,0,0,9
2320,0,9,0,0,9
2321,1,8,0,0,9
2322,0,9,0,0,9
2323,0,9,0,0,9
2324,9,0,0,0,9
2325,3,0,0,6,9
2326,0,9,0,0,9
2327,0,9,0,0,9
2328,0,9,0,0,9
2329,1,7,1,0,9
2330,0,9,0,0,9
2331,0,9,0,0,9
2332,1,8,0,0,9
2333,0,3,0,6,9
2334,0,9,0,0,9
2335,0,9,0,0,9
2336,0,4,1,4,9
2337,1,8,0,0,9
2338,0,0,0,9,9
2339,0,9,0,0,9
2340,0,8,0,0,8
2341,1,3,0,4,8
2342,0,8,0,0,8
2343,4,3,0,1,8
2344,0,8,0,0,8
2345,0,8,0,0,8
2346,0,8,0,0,8
2347,0,7,0,1,8
2348,5,0,0,3,8
2349,2,0,4,2,8
2350,0,8,0,0,8
2351,1,7,0,0,8
2352,1,7,0,0,8
2353,0,4,0,4,8
2354,0,8,0,0,8
2355,0,8,0,0,8
2356,0,8,0,0,8
2357,1,5,0,2,8
2358,0,6,2,0,8
2359,0,0,8,0,8
2360,0,8,0,0,8
2361,0,8,0,0,8
2362,0,5,0,3,8
2363,0,8,0,0,8
2364,0,8,0,0,8
2365,0,8,0,0,8
2366,0,8,0,0,8
2367,0,1,2,5,8
2368,3,0,5,0,8
2369,0,8,0,0,8
2370,6,0,0,2,8
2371,1,0,0,7,8
2372,1,7,0,0,8
2373,1,6,0,1,8
2374,0,8,0,0,8
2375,0,8,0,0,8
2376,1,6,1,0,8
2377,0,8,0,0,8
2378,0,6,1,1,8
2379,7,1,0,0,8
2380,0,6,1,1,8
2381,0,8,0,0,8
2382,0,8,0,0,8
2383,0,8,0,0,8
2384,5,2,1,0,8
2385,1,7,0,0,8
2386,1,4,3,0,8
2387,0,8,0,0,8
2388,0,8,0,0,8
2389,3,0,0,5,8
2390,0,8,0,0,8
2391,1,7,0,0,8
2392,4,2,0,2,8
2393,0,8,0,0,8
2394,2,0,0,6,8
2395,0,6,1,1,8
2396,0,8,0,0,8
2397,8,0,0,0,8
2398,1,7,0,0,8
2399,0,8,0,0,8
2400,1,7,0,0,8
2401,0,8,0,0,8
2402,0,8,0,0,8
2403,0,8,0,0,8
2404,0,8,0,0,8
2405,0,8,0,0,8
2406,0,8,0,0,8
2407,0,8,0,0,8
2408,2,3,2,1,8
2409,0,8,0,0,8
2410,0,8,0,0,8
2411,7,1,0,0,8
2412,4,3,1,0,8
2413,0,8,0,0,8
2414,0,8,0,0,8
2415,0,8,0,0,8
2416,0,2,6,0,8
2417,0,8,0,0,8
2418,6,2,0,0,8
2419,2,0,6,0,8
2420,0,8,0,0,8
2421,2,6,0,0,8
2422,2,6,0,0,8
2423,1,6,1,0,8
2424,4,0,0,4,8
2425,0,8,0,0,8
2426,4,4,0,0,8
2427,3,4,1,0,8
2428,0,8,0,0,8
2429,1,7,0,0,8
2430,4,3,0,1,8
2431,0,8,0,0,8
2432,0,8,0,0,8
2433,0,8,0,0,8
2434,0,8,0,0,8
2435,0,8,0,0,8
2436,0,8,0,0,8
2437,0,8,0,0,8
2438,2,6,0,0,8
2439,2,6,0,0,8
2440,0,8,0,0,8
2441,7,0,0,1,8
2442,0,7,0,1,8
2443,0,8,0,0,8
2444,0,8,0,0,8
2445,1,4,0,3,8
2446,0,7,1,0,8
2447,2,6,0,0,8
2448,0,1,0,7,8
2449,6,0,0,2,8
2450,1,7,0,0,8
2451,2,2,0,4,8
2452,0,8,0,0,8
2453,5,3,0,0,8
2454,0,8,0,0,8
2455,5,2,1,0,8
2456,0,8,0,0,8
2457,4,0,1,3,8
2458,0,8,0,0,8
2459,1,5,2,0,8
2460,0,8,0,0,8
2461,3,5,0,0,8
2462,0,5,0,3,8
2463,1,4,0,3,8
2464,0,0,0,8,8
2465,1,0,3,4,8
2466,1,3,1,3,8
2467,0,1,0,7,8
2468,0,8,0,0,8
2469,8,0,0,0,8
2470,3,2,2,1,8
2471,0,7,0,1,8
2472,0,8,0,0,8
2473,0,8,0,0,8
2474,0,0,0,8,8
2475,0,8,0,0,8
2476,0,4,0,4,8
2477,0,8,0,0,8
2478,8,0,0,0,8
2479,0,8,0,0,8
2480,0,8,0,0,8
2481,0,8,0,0,8
2482,0,8,0,0,8
2483,3,5,0,0,8
2484,0,8,0,0,8
2485,0,8,0,0,8
2486,3,0,4,1,8
2487,0,8,0,0,8
2488,0,8,0,0,8
2489,0,8,0,0,8
2490,1,0,1,6,8
2491,0,8,0,0,8
2492,7,0,1,0,8
2493,0,8,0,0,8
2494,0,8,0,0,8
2495,0,7,0,1,8
2496,0,8,0,0,8
2497,0,8,0,0,8
2498,0,8,0,0,8
2499,0,8,0,0,8
2500,6,1,1,0,8
2501,0,8,0,0,8
2502,0,8,0,0,8
2503,1,1,1,5,8
2504,0,8,0,0,8
2505,0,8,0,0,8
2506,0,8,0,0,8
2507,0,8,0,0,8
2508,0,8,0,0,8
2509,0,8,0,0,8
2510,0,8,0,0,8
2511,0,8,0,0,8
2512,1,7,0,0,8
2513,0,8,0,0,8
2514,0,8,0,0,8
2515,0,8,0,0,8
2516,6,0,1,1,8
2517,0,8,0,0,8
2518,0,8,0,0,8
2519,3,5,0,0,8
2520,0,8,0,0,8
2521,0,8,0,0,8
2522,0,8,0,0,8
2523,1,5,0,2,8
2524,0,8,0,0,8
2525,0,8,0,0,8
2526,0,8,0,0,8
2527,3,1,0,4,8
2528,0,8,0,0,8
2529,0,8,0,0,8
2530,1,7,0,0,8
2531,1,7,0,0,8
2532,1,7,0,0,8
2533,0,8,0,0,8
2534,0,8,0,0,8
2535,0,8,0,0,8
2536,0,3,0,5,8
2537,0,2,2,4,8
2538,0,8,0,0,8
2539,0,4,2,2,8
2540,0,8,0,0,8
2541,5,3,0,0,8
2542,0,8,0,0,8
2543,0,8,0,0,8
2544,4,2,2,0,8
2545,0,4,0,4,8
2546,1,7,0,0,8
2547,0,8,0,0,8
2548,0,8,0,0,8
2549,0,0,1,7,8
2550,0,8,0,0,8
2551,0,8,0,0,8
2552,4,4,0,0,8
2553,0,8,0,0,8
2554,1,7,0,0,8
2555,0,1,0,7,8
2556,0,8,0,0,8
2557,2,6,0,0,8
2558,0,7,1,0,8
2559,0,8,0,0,8
2560,1,7,0,0,8
2561,3,0,0,5,8
2562,0,8,0,0,8
2563,4,0,0,4,8
2564,0,8,0,0,8
2565,0,8,0,0,8
2566,1,7,0,0,8
2567,1,7,0,0,8
2568,1,7,0,0,8
2569,0,8,0,0,8
2570,1,6,1,0,8
2571,1,7,0,0,8
2572,3,3,2,0,8
2573,0,8,0,0,8
2574,4,4,0,0,8
2575,7,0,1,0,8
2576,0,8,0,0,8
2577,3,5,0,0,8
2578,0,8,0,0,8
2579,0,8,0,0,8
2580,1,0,0,7,8
2581,0,8,0,0,8
2582,8,0,0,0,8
2583,0,8,0,0,8
2584,0,8,0,0,8
2585,0,8,0,0,8
2586,0,8,0,0,8
2587,6,2,0,0,8
2588,4,2,0,2,8
2589,0,8,0,0,8
2590,4,4,0,0,8
2591,0,8,0,0,8
2592,5,0,2,1,8
2593,0,4,1,3,8
2594,0,8,0,0,8
2595,0,8,0,0,8
2596,1,7,0,0,8
2597,0,0,3,5,8
2598,0,8,0,0,8
2599,0,7,1,0,8
2600,1,7,0,0,8
2601,0,8,0,0,8
2602,1,7,0,0,8
2603,0,8,0,0,8
2604,8,0,0,0,8
2605,3,3,0,2,8
2606,1,7,0,0,8
2607,0,8,0,0,8
2608,6,2,0,0,8
2609,2,6,0,0,8
2610,6,0,0,2,8
2611,0,8,0,0,8
2612,1,1,1,5,8
2613,0,8,0,0,8
2614,1,2,4,1,8
2615,8,0,0,0,8
2616,2,6,0,0,8
2617,0,0,0,8,8
2618,6,0,2,0,8
2619,0,4,0,4,8
2620,1,7,0,0,8
2621,0,6,0,2,8
2622,1,3,1,3,8
2623,0,8,0,0,8
2624,1,0,6,1,8
2625,0,8,0,0,8
2626,0,8,0,0,8
2627,1,0,6,1,8
2628,0,8,0,0,8
2629,0,8,0,0,8
2630,0,8,0,0,8
2631,4,0,4,0,8
2632,0,8,0,0,8
2633,7,0,0,1,8
2634,1,7,0,0,8
2635,6,2,0,0,8
2636,6,0,2,0,8
2637,0,8,0,0,8
2638,0,8,0,0,8
2639,0,8,0,0,8
2640,1,7,0,0,8
2641,1,6,1,0,8
2642,6,1,0,1,8
2643,0,8,0,0,8
2644,0,7,0,1,8
2645,4,1,2,1,8
2646,4,4,0,0,8
2647,0,0,0,8,8
2648,0,8,0,0,8
2649,0,8,0,0,8
2650,0,8,0,0,8
2651,8,0,0,0,8
2652,4,3,0,1,8
2653,3,5,0,0,8
2654,1,0,0,7,8
2655,0,8,0,0,8
2656,3,1,3,1,8
2657,0,8,0,0,8
2658,0,8,0,0,8
2659,0,8,0,0,8
2660,0,8,0,0,8
2661,3,2,1,2,8
2662,0,7,0,1,8
2663,0,8,0,0,8
2664,0,8,0,0,8
2665,0,8,0,0,8
2666,1,4,1,2,8
2667,0,8,0,0,8
2668,0,8,0,0,8
2669,0,8,0,0,8
2670,0,7,1,0,8
2671,0,6,2,0,8
2672,1,7,0,0,8
2673,0,8,0,0,8
2674,0,8,0,0,8
2675,0,8,0,0,8
2676,0,8,0,0,8
2677,0,8,0,0,8
2678,0,8,0,0,8
2679,1,7,0,0,8
2680,0,8,0,0,8
2681,0,8,0,0,8
2682,0,8,0,0,8
2683,0,8,0,0,8
2684,1,7,0,0,8
2685,0,7,0,1,8
2686,7,0,0,1,8
2687,0,8,0,0,8
2688,1,6,0,1,8
2689,0,8,0,0,8
2690,0,8,0,0,8
2691,1,7,0,0,8
2692,0,8,0,0,8
2693,3,0,3,2,8
2694,8,0,0,0,8
2695,0,8,0,0,8
2696,7,0,1,0,8
2697,0,8,0,0,8
2698,1,0,6,1,8
2699,0,8,0,0,8
2700,0,8,0,0,8
2701,0,8,0,0,8
2702,0,8,0,0,8
2703,0,8,0,0,8
2704,2,6,0,0,8
2705,1,7,0,0,8
2706,8,0,0,0,8
2707,0,8,0,0,8
2708,0,8,0,0,8
2709,0,7,0,1,8
2710,0,8,0,0,8
2711,0,5,0,3,8
2712,0,8,0,0,8
2713,1,7,0,0,8
2714,0,8,0,0,8
2715,0,8,0,0,8
2716,0,8,0,0,8
2717,2,6,0,0,8
2718,0,8,0,0,8
2719,0,4,2,2,8
2720,0,8,0,0,8
2721,0,8,0,0,8
2722,8,0,0,0,8
2723,0,8,0,0,8
2724,3,0,0,5,8
2725,1,6,0,1,8
2726,0,8,0,0,8
2727,6,2,0,0,8
2728,0,8,0,0,8
2729,2,1,0,5,8
2730,0,8,0,0,8
2731,3,2,1,2,8
2732,0,5,0,3,8
2733,8,0,0,0,8
2734,6,0,0,2,8
2735,0,8,0,0,8
2736,0,8,0,0,8
2737,1,6,1,0,8
2738,0,8,0,0,8
2739,0,8,0,0,8
2740,0,8,0,0,8
2741,0,8,0,0,8
2742,5,3,0,0,8
2743,4,1,0,3,8
2744,2,1,2,3,8
2745,0,8,0,0,8
2746,4,3,0,1,8
2747,0,8,0,0,8
2748,1,7,0,0,8
2749,0,8,0,0,8
2750,0,8,0,0,8
2751,0,8,0,0,8
2752,0,8,0,0,8
2753,0,4,0,4,8
2754,0,8,0,0,8
2755,0,8,0,0,8
2756,0,8,0,0,8
2757,3,5,0,0,8
2758,0,8,0,0,8
2759,0,8,0,0,8
2760,6,1,0,1,8
2761,0,8,0,0,8
2762,0,8,0,0,8
2763,0,8,0,0,8
2764,0,8,0,0,8
2765,4,0,0,4,8
2766,0,8,0,0,8
2767,0,8,0,0,8
2768,0,8,0,0,8
2769,4,1,3,0,8
2770,0,7,1,0,8
2771,0,0,0,8,8
2772,0,8,0,0,8
2773,8,0,0,0,8
2774,0,8,0,0,8
2775,1,7,0,0,8
2776,0,8,0,0,8
2777,0,2,0,5,7
2778,0,7,0,0,7
2779,0,7,0,0,7
2780,0,7,0,0,7
2781,0,0,1,6,7
2782,0,7,0,0,7
2783,3,1,1,2,7
2784,0,7,0,0,7
2785,0,7,0,0,7
2786,1,5,1,0,7
2787,0,7,0,0,7
2788,0,7,0,0,7
2789,2,3,0,2,7
2790,0,7,0,0,7
2791,1,6,0,0,7
2792,0,7,0,0,7
2793,0,7,0,0,7
2794,1,6,0,0,7
2795,0,7,0,0,7
2796,1,6,0,0,7
2797,4,3,0,0,7
2798,3,0,3,1,7
2799,0,7,0,0,7
2800,2,0,4,1,7
2801,1,3,1,2,7
2802,0,7,0,0,7
2803,1,0,1,5,7
2804,4,3,0,0,7
2805,0,7,0,0,7
2806,6,1,0,0,7
2807,0,7,0,0,7
2808,3,3,1,0,7
2809,5,2,0,0,7
2810,0,7,0,0,7
2811,0,7,0,0,7
2812,0,7,0,0,7
2813,0,7,0,0,7
2814,0,7,0,0,7
2815,4,1,2,0,7
2816,0,7,0,0,7
2817,4,0,0,3,7
2818,5,1,1,0,7
2819,0,7,0,0,7
2820,1,6,0,0,7
2821,0,7,0,0,7
2822,0,7,0,0,7
2823,6,0,1,0,7
2824,2,3,2,0,7
2825,1,6,0,0,7
2826,6,1,0,0,7
2827,4,0,3,0,7
2828,2,5,0,0,7
2829,0,7,0,0,7
2830,0,7,0,0,7
2831,0,7,0,0,7
2832,3,2,2,0,7
2833,0,7,0,0,7
2834,0,7,0,0,7
2835,1,6,0,0,7
2836,0,7,0,0,7
2837,0,7,0,0,7
2838,0,7,0,0,7
2839,0,7,0,0,7
2840,0,7,0,0,7
2841,0,7,0,0,7
2842,0,7,0,0,7
2843,0,3,1,3,7
2844,6,0,1,0,7
2845,0,7,0,0,7
2846,0,7,0,0,7
2847,0,7,0,0,7
2848,0,6,1,0,7
2849,0,2,1,4,7
2850,1,5,1,0,7
2851,0,7,0,0,7
2852,6,0,1,0,7
2853,0,7,0,0,7
2854,0,1,1,5,7
2855,2,0,0,5,7
2856,0,6,0,1,7
2857,0,7,0,0,7
2858,2,5,0,0,7
2859,5,2,0,0,7
2860,0,7,0,0,7
2861,1,5,1,0,7
2862,0,1,1,5,7
2863,0,7,0,0,7
2864,0,7,0,0,7
2865,0,7,0,0,7
2866,0,7,0,0,7
2867,1,5,0,1,7
2868,0,5,2,0,7
2869,0,6,0,1,7
2870,0,7,0,0,7
2871,0,7,0,0,7
2872,0,7,0,0,7
2873,0,7,0,0,7
2874,0,7,0,0,7
2875,0,7,0,0,7
2876,1,0,6,0,7
2877,0,7,0,0,7
2878,0,6,0,1,7
2879,3,4,0,0,7
2880,1,6,0,0,7
2881,1,3,1,2,7
2882,0,7,0,0,7
2883,1,4,0,2,7
2884,0,7,0,0,7
2885,0,7,0,0,7
2886,0,7,0,0,7
2887,7,0,0,0,7
2888,0,7,0,0,7
2889,0,7,0,0,7
2890,0,3,0,4,7
2891,0,7,0,0,7
2892,0,7,0,0,7
2893,0,0,0,7,7
2894,4,3,0,0,7
2895,0,4,3,0,7
2896,0,7,0,0,7
2897,2,5,0,0,7
2898,0,7,0,0,7
2899,0,0,1,6,7
2900,0,7,0,0,7
2901,0,7,0,0,7
2902,0,7,0,0,7
2903,5,0,1,1,7
2904,0,7,0,0,7
2905,1,6,0,0,7
2906,2,5,0,0,7
2907,0,7,0,0,7
2908,0,0,0,7,7
2909,1,6,0,0,7
2910,0,7,0,0,7
2911,0,7,0,0,7
2912,3,4,0,0,7
2913,0,3,4,0,7
2914,0,7,0,0,7
2915,3,1,0,3,7
2916,1,5,0,1,7
2917,0,7,0,0,7
2918,0,7,0,0,7
2919,0,1,0,6,7
2920,0,7,0,0,7
2921,1,5,0,1,7
2922,1,4,2,0,7
2923,0,7,0,0,7
2924,0,7,0,0,7
2925,4,0,2,1,7
2926,7,0,0,0,7
2927,0,7,0,0,7
2928,6,0,0,1,7
2929,2,5,0,0,7
2930,0,7,0,0,7
2931,4,3,0,0,7
2932,2,3,1,1,7
2933,0,7,0,0,7
2934,0,7,0,0,7
2935,0,7,0,0,7
2936,0,7,0,0,7
2937,0,5,1,1,7
2938,0,6,0,1,7
2939,0,7,0,0,7
2940,0,7,0,0,7
2941,4,1,0,2,7
2942,0,7,0,0,7
2943,5,2,0,0,7
2944,5,0,1,1,7
2945,0,7,0,0,7
2946,1,6,0,0,7
2947,3,4,0,0,7
2948,0,5,0,2,7
2949,0,7,0,0,7
2950,0,7,0,0,7
2951,0,6,1,0,7
2952,0,7,0,0,7
2953,0,5,2,0,7
2954,1,6,0,0,7
2955,0,7,0,0,7
2956,1,5,0,1,7
2957,3,4,0,0,7
2958,1,5,1,0,7
2959,0,7,0,0,7
2960,0,7,0,0,7
2961,6,1,0,0,7
2962,1,1,5,0,7
2963,0,4,0,3,7
2964,0,6,1,0,7
2965,0,7,0,0,7
2966,0,0,7,0,7
2967,0,7,0,0,7
2968,0,7,0,0,7
2969,0,7,0,0,7
2970,0,7,0,0,7
2971,2,5,0,0,7
2972,1,4,1,1,7
2973,2,2,2,1,7
2974,0,7,0,0,7
2975,0,7,0,0,7
2976,0,7,0,0,7
2977,6,1,0,0,7
2978,0,0,2,5,7
2979,1,6,0,0,7
2980,0,6,1,0,7
2981,0,1,0,6,7
2982,0,7,0,0,7
2983,0,7,0,0,7
2984,0,7,0,0,7
2985,0,7,0,0,7
2986,0,7,0,0,7
2987,0,7,0,0,7
2988,0,7,0,0,7
2989,3,4,0,0,7
2990,0,7,0,0,7
2991,0,7,0,0,7
2992,0,7,0,0,7
2993,0,7,0,0,7
2994,3,4,0,0,7
2995,0,7,0,0,7
2996,1,5,1,0,7
2997,0,7,0,0,7
2998,3,4,0,0,7
2999,0,7,0,0,7
3000,5,2,0,0,7
3001,0,7,0,0,7
3002,0,7,0,0,7
3003,0,7,0,0,7
3004,0,7,0,0,7
3005,0,7,0,0,7
3006,0,7,0,0,7
3007,1,0,0,6,7
3008,2,5,0,0,7
3009,0,7,0,0,7
3010,0,7,0,0,7
3011,0,7,0,0,7
3012,0,7,0,0,7
3013,0,7,0,0,7
3014,0,7,0,0,7
3015,0,7,0,0,7
3016,6,0,1,0,7
3017,1,6,0,0,7
3018,0,7,0,0,7
3019,0,7,0,0,7
3020,0,7,0,0,7
3021,1,6,0,0,7
3022,0,7,0,0,7
3023,0,7,0,0,7
3024,0,7,0,0,7
3025,0,1,6,0,7
3026,0,7,0,0,7
3027,0,7,0,0,7
3028,0,0,1,6,7
3029,0,7,0,0,7
3030,0,7,0,0,7
3031,1,6,0,0,7
3032,0,7,0,0,7
3033,0,7,0,0,7
3034,1,1,2,3,7
3035,0,7,0,0,7
3036,0,7,0,0,7
3037,0,7,0,0,7
3038,0,7,0,0,7
3039,0,7,0,0,7
3040,0,6,0,1,7
3041,1,6,0,0,7
3042,5,1,1,0,7
3043,0,7,0,0,7
3044,1,6,0,0,7
3045,0,7,0,0,7
3046,0,7,0,0,7
3047,0,7,0,0,7
3048,0,7,0,0,7
3049,0,7,0,0,7
3050,0,7,0,0,7
3051,0,7,0,0,7
3052,0,7,0,0,7
3053,0,7,0,0,7
3054,1,6,0,0,7
3055,0,7,0,0,7
3056,0,7,0,0,7
3057,1,6,0,0,7
3058,7,0,0,0,7
3059,7,0,0,0,7
3060,0,7,0,0,7
3061,2,3,0,2,7
3062,3,0,0,4,7
3063,3,4,0,0,7
3064,0,7,0,0,7
3065,0,3,4,0,7
3066,1,6,0,0,7
3067,0,7,0,0,7
3068,0,7,0,0,7
3069,0,7,0,0,7
3070,6,1,0,0,7
3071,0,7,0,0,7
3072,1,6,0,0,7
3073,1,6,0,0,7
3074,0,7,0,0,7
3075,0,7,0,0,7
3076,0,7,0,0,7
3077,1,6,0,0,7
3078,0,7,0,0,7
3079,1,6,0,0,7
3080,0,7,0,0,7
3081,0,7,0,0,7
3082,1,6,0,0,7
3083,0,7,0,0,7
3084,1,3,3,0,7
3085,7,0,0,0,7
3086,0,7,0,0,7
3087,0,7,0,0,7
3088,0,7,0,0,7
3089,0,4,2,1,7
3090,0,7,0,0,7
3091,1,6,0,0,7
3092,1,6,0,0,7
3093,2,3,0,2,7
3094,1,2,0,4,7
3095,5,0,1,1,7
3096,0,7,0,0,7
3097,1,4,2,0,7
3098,0,7,0,0,7
3099,2,2,0,3,7
3100,0,7,0,0,7
3101,1,6,0,0,7
3102,1,6,0,0,7
3103,4,0,1,2,7
3104,1,6,0,0,7
3105,0,0,3,4,7
3106,0,7,0,0,7
3107,0,7,0,0,7
3108,0,7,0,0,7
3109,0,7,0,0,7
3110,0,7,0,0,7
3111,2,5,0,0,7
3112,2,0,5,0,7
3113,0,7,0,0,7
3114,0,7,0,0,7
3115,0,7,0,0,7
3116,0,7,0,0,7
3117,0,7,0,0,7
3118,0,7,0,0,7
3119,0,2,0,5,7
3120,0,7,0,0,7
3121,1,6,0,0,7
3122,0,6,1,0,7
3123,0,7,0,0,7
3124,0,3,1,3,7
3125,2,4,1,0,7
3126,0,7,0,0,7
3127,0,7,0,0,7
3128,0,7,0,0,7
3129,0,7,0,0,7
3130,0,7,0,0,7
3131,0,7,0,0,7
3132,1,0,1,5,7
3133,1,1,4,1,7
3134,0,7,0,0,7
3135,0,7,0,0,7
3136,0,7,0,0,7
3137,0,7,0,0,7
3138,0,7,0,0,7
3139,0,7,0,0,7
3140,6,1,0,0,7
3141,2,4,0,1,7
3142,0,7,0,0,7
3143,0,7,0,0,7
3144,0,7,0,0,7
3145,3,0,1,3,7
3146,0,7,0,0,7
3147,0,7,0,0,7
3148,1,5,1,0,7
3149,0,7,0,0,7
3150,5,0,2,0,7
3151,5,0,1,1,7
3152,3,4,0,0,7
3153,1,6,0,0,7
3154,0,7,0,0,7
3155,0,7,0,0,7
3156,0,7,0,0,7
3157,1,6,0,0,7
3158,0,7,0,0,7
3159,0,4,0,3,7
3160,1,4,1,1,7
3161,0,7,0,0,7
3162,0,0,7,0,7
3163,1,6,0,0,7
3164,0,7,0,0,7
3165,0,7,0,0,7
3166,1,6,0,0,7
3167,0,7,0,0,7
3168,2,5,0,0,7
3169,4,0,3,0,7
3170,1,6,0,0,7
3171,0,7,0,0,7
3172,0,7,0,0,7
3173,0,7,0,0,7
3174,0,7,0,0,7
3175,1,0,6,0,7
3176,0,7,0,0,7
3177,7,0,0,0,7
3178,0,3,3,1,7
3179,1,6,0,0,7
3180,0,7,0,0,7
3181,1,6,0,0,7
3182,0,7,0,0,7
3183,7,0,0,0,7
3184,0,7,0,0,7
3185,0,5,1,1,7
3186,0,7,0,0,7
3187,0,7,0,0,7
3188,0,7,0,0,7
3189,0,7,0,0,7
3190,0,7,0,0,7
3191,7,0,0,0,7
3192,4,3,0,0,7
3193,2,5,0,0,7
3194,0,7,0,0,7
3195,0,7,0,0,7
3196,0,7,0,0,7
3197,0,7,0,0,7
3198,6,0,0,1,7
3199,6,0,1,0,7
3200,1,3,3,0,7
3201,0,7,0,0,7
3202,0,7,0,0,7
3203,3,4,0,0,7
3204,1,6,0,0,7
3205,0,7,0,0,7
3206,0,7,0,0,7
3207,0,7,0,0,7
3208,1,1,0,5,7
3209,0,7,0,0,7
3210,0,7,0,0,7
3211,0,7,0,0,7
3212,2,5,0,0,7
3213,0,7,0,0,7
3214,0,7,0,0,7
3215,0,7,0,0,7
3216,0,7,0,0,7
3217,0,7,0,0,7
3218,0,7,0,0,7
3219,0,7,0,0,7
3220,2,1,1,3,7
3221,0,7,0,0,7
3222,3,4,0,0,7
3223,0,7,0,0,7
3224,0,7,0,0,7
3225,0,7,0,0,7
3226,0,7,0,0,7
3227,2,0,5,0,7
3228,1,0,3,3,7
3229,0,7,0,0,7
3230,0,7,0,0,7
3231,3,4,0,0,7
3232,3,4,0,0,7
3233,5,1,1,0,7
3234,0,7,0,0,7
3235,7,0,0,0,7
3236,0,7,0,0,7
3237,0,7,0,0,7
3238,1,6,0,0,7
3239,1,3,2,1,7
3240,3,3,1,0,7
3241,0,7,0,0,7
3242,1,6,0,0,7
3243,0,7,0,0,7
3244,0,7,0,0,7
3245,0,7,0,0,7
3246,0,7,0,0,7
3247,0,7,0,0,7
3248,0,7,0,0,7
3249,1,6,0,0,7
3250,0,0,0,7,7
3251,0,7,0,0,7
3252,0,7,0,0,7
3253,0,7,0,0,7
3254,0,7,0,0,7
3255,0,7,0,0,7
3256,0,7,0,0,7
3257,0,7,0,0,7
3258,0,7,0,0,7
3259,0,7,0,0,7
3260,0,7,0,0,7
3261,0,0,0,7,7
3262,0,7,0,0,7
3263,0,5,1,1,7
3264,0,6,1,0,7
3265,0,7,0,0,7
3266,0,7,0,0,7
3267,6,0,1,0,7
3268,7,0,0,0,7
3269,0,7,0,0,7
3270,2,5,0,0,7
3271,2,4,1,0,7
3272,0,7,0,0,7
3273,0,0,0,7,7
3274,0,7,0,0,7
3275,0,7,0,0,7
3276,1,5,1,0,7
3277,1,3,1,2,7
3278,6,1,0,0,7
3279,4,0,3,0,7
3280,0,7,0,0,7
3281,4,3,0,0,7
3282,0,7,0,0,7
3283,1,6,0,0,7
3284,0,7,0,0,7
3285,3,4,0,0,7
3286,1,0,1,5,7
3287,0,3,0,4,7
3288,0,7,0,0,7
3289,2,1,0,4,7
3290,0,7,0,0,7
3291,0,7,0,0,7
3292,1,6,0,0,7
3293,2,5,0,0,7
3294,0,7,0,0,7
3295,1,5,0,1,7
3296,2,5,0,0,7
3297,0,7,0,0,7
3298,0,0,0,7,7
3299,2,3,2,0,7
3300,0,7,0,0,7
3301,0,7,0,0,7
3302,0,7,0,0,7
3303,0,7,0,0,7
3304,0,7,0,0,7
3305,0,7,0,0,7
3306,4,1,1,1,7
3307,3,4,0,0,7
3308,0,7,0,0,7
3309,0,7,0,0,7
3310,0,6,0,1,7
3311,0,7,0,0,7
3312,1,0,0,6,7
3313,0,7,0,0,7
3314,2,4,1,0,7
3315,0,7,0,0,7
3316,0,7,0,0,7
3317,0,7,0,0,7
3318,0,7,0,0,7
3319,0,7,0,0,7
3320,2,0,2,3,7
3321,0,7,0,0,7
3322,0,7,0,0,7
3323,2,5,0,0,7
3324,0,7,0,0,7
3325,0,7,0,0,7
3326,1,6,0,0,7
3327,3,0,0,4,7
3328,1,6,0,0,7
3329,0,0,4,3,7
3330,6,1,0,0,7
3331,0,7,0,0,7
3332,0,7,0,0,7
3333,0,7,0,0,7
3334,0,7,0,0,7
3335,0,7,0,0,7
3336,1,6,0,0,7
3337,6,1,0,0,7
3338,1,6,0,0,7
3339,0,7,0,0,7
3340,0,7,0,0,7
3341,0,7,0,0,7
3342,0,7,0,0,7
3343,1,6,0,0,7
3344,5,2,0,0,7
3345,0,7,0,0,7
3346,0,7,0,0,7
3347,1,0,0,6,7
3348,0,7,0,0,7
3349,2,4,1,0,7
3350,0,7,0,0,7
3351,2,5,0,0,7
3352,0,7,0,0,7
3353,0,6,1,0,7
3354,0,7,0,0,7
3355,7,0,0,0,7
3356,0,3,3,1,7
3357,0,7,0,0,7
3358,6,1,0,0,7
3359,0,7,0,0,7
3360,1,0,3,3,7
3361,0,7,0,0,7
3362,0,7,0,0,7
3363,0,7,0,0,7
3364,0,7,0,0,7
3365,0,7,0,0,7
3366,0,7,0,0,7
3367,0,3,0,4,7
3368,0,7,0,0,7
3369,0,7,0,0,7
3370,6,1,0,0,7
3371,0,7,0,0,7
3372,0,6,1,0,7
3373,1,6,0,0,7
3374,0,7,0,0,7
3375,2,4,0,1,7
3376,0,7,0,0,7
3377,0,7,0,0,7
3378,0,7,0,0,7
3379,2,2,1,2,7
3380,7,0,0,0,7
3381,0,7,0,0,7
3382,0,4,3,0,7
3383,0,5,0,1,6
3384,3,3,0,0,6
3385,0,6,0,0,6
3386,1,0,0,5,6
3387,0,6,0,0,6
3388,0,6,0,0,6
3389,0,0,0,6,6
3390,0,6,0,0,6
3391,0,6,0,0,6
3392,2,0,2,2,6
3393,0,6,0,0,6
3394,5,0,1,0,6
3395,0,5,0,1,6
3396,0,6,0,0,6
3397,0,6,0,0,6
3398,0,4,0,2,6
3399,0,6,0,0,6
3400,0,6,0,0,6
3401,3,2,0,1,6
3402,0,6,0,0,6
3403,0,6,0,0,6
3404,0,6,0,0,6
3405,0,2,0,4,6
3406,1,3,0,2,6
3407,2,4,0,0,6
3408,0,6,0,0,6
3409,0,6,0,0,6
3410,1,5,0,0,6
3411,0,6,0,0,6
3412,0,6,0,0,6
3413,0,6,0,0,6
3414,3,1,1,1,6
3415,0,6,0,0,6
3416,4,1,1,0,6
3417,0,6,0,0,6
3418,0,6,0,0,6
3419,0,3,0,3,6
3420,0,6,0,0,6
3421,0,0,0,6,6
3422,1,5,0,0,6
3423,3,3,0,0,6
3424,0,6,0,0,6
3425,2,3,1,0,6
3426,0,6,0,0,6
3427,0,6,0,0,6
3428,0,6,0,0,6
3429,0,6,0,0,6
3430,3,0,1,2,6
3431,0,2,1,3,6
3432,0,6,0,0,6
3433,0,6,0,0,6
3434,0,6,0,0,6
3435,4,2,0,0,6
3436,0,6,0,0,6
3437,0,6,0,0,6
3438,0,6,0,0,6
3439,0,6,0,0,6
3440,1,4,1,0,6
3441,0,1,0,5,6
3442,1,5,0,0,6
3443,0,6,0,0,6
3444,0,6,0,0,6
3445,2,0,2,2,6
3446,0,6,0,0,6
3447,1,4,1,0,6
3448,2,4,0,0,6
3449,0,6,0,0,6
3450,0,5,1,0,6
3451,6,0,0,0,6
3452,4,2,0,0,6
3453,0,6,0,0,6
3454,0,6,0,0,6
3455,3,0,0,3,6
3456,1,0,0,5,6
3457,2,4,0,0,6
3458,0,6,0,0,6
3459,3,0,3,0,6
3460,0,6,0,0,6
3461,0,6,0,0,6
3462,0,6,0,0,6
3463,2,3,0,1,6
3464,2,4,0,0,6
3465,0,6,0,0,6
3466,0,6,0,0,6
3467,0,4,1,1,6
3468,1,5,0,0,6
3469,4,0,1,1,6
3470,0,1,5,0,6
3471,0,6,0,0,6
3472,0,5,0,1,6
3473,0,6,0,0,6
3474,0,5,1,0,6
3475,0,6,0,0,6
3476,0,6,0,0,6
3477,2,4,0,0,6
3478,0,6,0,0,6
3479,1,5,0,0,6
3480,4,0,1,1,6
3481,0,6,0,0,6
3482,5,1,0,0,6
3483,3,1,0,2,6
3484,0,6,0,0,6
3485,0,6,0,0,6
3486,5,1,0,0,6
3487,3,2,0,1,6
3488,0,6,0,0,6
3489,0,6,0,0,6
3490,0,6,0,0,6
3491,2,0,3,1,6
3492,0,6,0,0,6
3493,0,6,0,0,6
3494,0,6,0,0,6
3495,0,6,0,0,6
3496,1,5,0,0,6
3497,1,5,0,0,6
3498,0,6,0,0,6
3499,0,6,0,0,6
3500,1,5,0,0,6
3501,0,6,0,0,6
3502,1,4,0,1,6
3503,0,6,0,0,6
3504,0,6,0,0,6
3505,0,6,0,0,6
3506,0,6,0,0,6
3507,2,4,0,0,6
3508,0,6,0,0,6
3509,0,6,0,0,6
3510,0,6,0,0,6
3511,0,6,0,0,6
3512,0,6,0,0,6
3513,0,6,0,0,6
3514,0,5,0,1,6
3515,1,2,2,1,6
3516,0,6,0,0,6
3517,0,6,0,0,6
3518,0,6,0,0,6
3519,1,5,0,0,6
3520,0,6,0,0,6
3521,0,6,0,0,6
3522,0,6,0,0,6
3523,1,3,2,0,6
3524,0,6,0,0,6
3525,0,6,0,0,6
3526,1,5,0,0,6
3527,1,5,0,0,6
3528,3,3,0,0,6
3529,0,6,0,0,6
3530,0,6,0,0,6
3531,0,6,0,0,6
3532,0,6,0,0,6
3533,1,5,0,0,6
3534,4,1,0,1,6
3535,0,6,0,0,6
3536,0,6,0,0,6
3537,0,5,0,1,6
3538,3,3,0,0,6
3539,4,0,1,1,6
3540,4,2,0,0,6
3541,0,6,0,0,6
3542,0,6,0,0,6
3543,0,6,0,0,6
3544,3,1,2,0,6
3545,5,0,1,0,6
3546,0,6,0,0,6
3547,3,0,3,0,6
3548,0,6,0,0,6
3549,1,2,1,2,6
3550,0,6,0,0,6
3551,1,5,0,0,6
3552,0,6,0,0,6
3553,0,6,0,0,6
3554,0,6,0,0,6
3555,0,6,0,0,6
3556,2,4,0,0,6
3557,0,1,2,3,6
3558,4,1,1,0,6
3559,0,6,0,0,6
3560,0,6,0,0,6
3561,0,6,0,0,6
3562,1,5,0,0,6
3563,0,6,0,0,6
3564,1,4,1,0,6
3565,0,6,0,0,6
3566,2,0,0,4,6
3567,0,6,0,0,6
3568,1,3,2,0,6
3569,0,6,0,0,6
3570,0,6,0,0,6
3571,0,6,0,0,6
3572,1,0,4,1,6
3573,1,5,0,0,6
3574,0,6,0,0,6
3575,0,6,0,0,6
3576,1,2,0,3,6
3577,1,3,2,0,6
3578,2,1,1,2,6
3579,0,6,0,0,6
3580,2,4,0,0,6
3581,1,0,2,3,6
3582,4,2,0,0,6
3583,0,1,0,5,6
3584,0,6,0,0,6
3585,1,5,0,0,6
3586,1,2,0,3,6
3587,0,6,0,0,6
3588,1,5,0,0,6
3589,1,4,0,1,6
3590,0,6,0,0,6
3591,0,6,0,0,6
3592,0,6,0,0,6
3593,0,6,0,0,6
3594,0,6,0,0,6
3595,0,6,0,0,6
3596,0,6,0,0,6
3597,0,6,0,0,6
3598,3,3,0,0,6
3599,0,6,0,0,6
3600,0,3,3,0,6
3601,1,5,0,0,6
3602,0,6,0,0,6
3603,0,6,0,0,6
3604,0,6,0,0,6
3605,5,1,0,0,6
3606,1,5,0,0,6
3607,1,4,0,1,6
3608,0,6,0,0,6
3609,0,6,0,0,6
3610,1,4,1,0,6
3611,0,6,0,0,6
3612,2,4,0,0,6
3613,0,6,0,0,6
3614,0,6,0,0,6
3615,0,5,1,0,6
3616,0,6,0,0,6
3617,0,6,0,0,6
3618,4,1,0,1,6
3619,5,0,0,1,6
3620,0,6,0,0,6
3621,0,6,0,0,6
3622,0,0,3,3,6
3623,0,6,0,0,6
3624,1,3,0,2,6
3625,1,5,0,0,6
3626,0,6,0,0,6
3627,0,6,0,0,6
3628,0,6,0,0,6
3629,0,6,0,0,6
3630,0,6,0,0,6
3631,0,6,0,0,6
3632,3,2,0,1,6
3633,1,5,0,0,6
3634,1,0,1,4,6
3635,0,6,0,0,6
3636,0,6,0,0,6
3637,0,6,0,0,6
3638,0,6,0,0,6
3639,0,6,0,0,6
3640,0,6,0,0,6
3641,1,5,0,0,6
3642,3,3,0,0,6
3643,0,6,0,0,6
3644,0,6,0,0,6
3645,0,4,0,2,6
3646,0,6,0,0,6
3647,0,6,0,0,6
3648,0,6,0,0,6
3649,2,1,0,3,6
3650,1,5,0,0,6
3651,0,4,1,1,6
3652,5,1,0,0,6
3653,2,4,0,0,6
3654,0,6,0,0,6
3655,0,6,0,0,6
3656,0,6,0,0,6
3657,0,6,0,0,6
3658,0,6,0,0,6
3659,4,1,0,1,6
3660,1,5,0,0,6
3661,1,5,0,0,6
3662,0,6,0,0,6
3663,0,6,0,0,6
3664,0,6,0,0,6
3665,6,0,0,0,6
3666,0,6,0,0,6
3667,0,5,1,0,6
3668,0,6,0,0,6
3669,0,6,0,0,6
3670,0,6,0,0,6
3671,0,6,0,0,6
3672,1,5,0,0,6
3673,2,0,3,1,6
3674,0,6,0,0,6
3675,0,6,0,0,6
3676,0,6,0,0,6
3677,6,0,0,0,6
3678,0,6,0,0,6
3679,0,6,0,0,6
3680,0,6,0,0,6
3681,0,6,0,0,6
3682,0,6,0,0,6
3683,0,6,0,0,6
3684,3,1,2,0,6
3685,1,4,1,0,6
3686,6,0,0,0,6
3687,6,0,0,0,6
3688,0,6,0,0,6
3689,4,2,0,0,6
3690,0,6,0,0,6
3691,1,5,0,0,6
3692,0,6,0,0,6
3693,2,2,1,1,6
3694,2,4,0,0,6
3695,3,0,1,2,6
3696,0,6,0,0,6
3697,1,5,0,0,6
3698,0,6,0,0,6
3699,0,6,0,0,6
3700,0,6,0,0,6
3701,0,6,0,0,6
3702,0,6,0,0,6
3703,0,6,0,0,6
3704,0,6,0,0,6
3705,0,6,0,0,6
3706,0,6,0,0,6
3707,3,0,1,2,6
3708,0,6,0,0,6
3709,0,6,0,0,6
3710,0,6,0,0,6
3711,1,5,0,0,6
3712,0,6,0,0,6
3713,0,6,0,0,6
3714,0,6,0,0,6
3715,0,6,0,0,6
3716,1,4,1,0,6
3717,0,6,0,0,6
3718,0,6,0,0,6
3719,1,5,0,0,6
3720,0,6,0,0,6
3721,2,0,1,3,6
3722,0,6,0,0,6
3723,0,5,1,0,6
3724,0,6,0,0,6
3725,0,6,0,0,6
3726,0,6,0,0,6
3727,2,1,3,0,6
3728,0,6,0,0,6
3729,0,6,0,0,6
3730,0,6,0,0,6
3731,0,6,0,0,6
3732,0,6,0,0,6
3733,0,6,0,0,6
3734,0,6,0,0,6
3735,0,6,0,0,6
3736,0,5,0,1,6
3737,0,6,0,0,6
3738,0,6,0,0,6
3739,3,1,2,0,6
3740,0,6,0,0,6
3741,0,6,0,0,6
3742,0,6,0,0,6
3743,3,1,1,1,6
3744,0,5,1,0,6
3745,0,5,0,1,6
3746,4,0,0,2,6
3747,0,6,0,0,6
3748,2,0,1,3,6
3749,0,6,0,0,6
3750,1,0,5,0,6
3751,0,6,0,0,6
3752,0,6,0,0,6
3753,4,1,1,0,6
3754,0,6,0,0,6
3755,2,3,0,1,6
3756,0,5,1,0,6
3757,2,1,1,2,6
3758,0,6,0,0,6
3759,0,0,0,6,6
3760,0,6,0,0,6
3761,0,6,0,0,6
3762,3,3,0,0,6
3763,2,1,1,2,6
3764,0,6,0,0,6
3765,0,6,0,0,6
3766,0,6,0,0,6
3767,0,6,0,0,6
3768,0,6,0,0,6
3769,0,6,0,0,6
3770,0,6,0,0,6
3771,1,5,0,0,6
3772,0,6,0,0,6
3773,0,3,0,3,6
3774,3,0,0,3,6
3775,0,5,0,1,6
3776,0,6,0,0,6
3777,0,6,0,0,6
3778,5,0,0,1,6
3779,0,2,0,4,6
3780,2,4,0,0,6
3781,1,5,0,0,6
3782,0,6,0,0,6
3783,0,6,0,0,6
3784,0,5,1,0,6
3785,0,6,0,0,6
3786,6,0,0,0,6
3787,1,5,0,0,6
3788,0,6,0,0,6
3789,0,6,0,0,6
3790,0,6,0,0,6
3791,0,6,0,0,6
3792,0,6,0,0,6
3793,1,5,0,0,6
3794,0,6,0,0,6
3795,5,0,1,0,6
3796,2,1,0,3,6
3797,0,6,0,0,6
3798,0,4,1,1,6
3799,1,3,0,2,6
3800,0,6,0,0,6
3801,0,6,0,0,6
3802,0,6,0,0,6
3803,0,6,0,0,6
3804,3,2,1,0,6
3805,0,5,0,1,6
3806,0,6,0,0,6
3807,1,1,0,4,6
3808,1,2,3,0,6
3809,0,5,0,1,6
3810,0,6,0,0,6
3811,0,6,0,0,6
3812,0,6,0,0,6
3813,0,6,0,0,6
3814,2,4,0,0,6
3815,0,6,0,0,6
3816,0,5,1,0,6
3817,0,6,0,0,6
3818,0,6,0,0,6
3819,3,0,0,3,6
3820,2,2,2,0,6
3821,1,5,0,0,6
3822,2,4,0,0,6
3823,0,6,0,0,6
3824,0,6,0,0,6
3825,1,5,0,0,6
3826,0,0,2,4,6
3827,0,6,0,0,6
3828,4,0,1,1,6
3829,0,6,0,0,6
3830,0,6,0,0,6
3831,0,6,0,0,6
3832,6,0,0,0,6
3833,3,0,0,3,6
3834,5,1,0,0,6
3835,0,4,0,2,6
3836,0,6,0,0,6
3837,0,6,0,0,6
3838,0,6,0,0,6
3839,0,6,0,0,6
3840,0,5,1,0,6
3841,2,4,0,0,6
3842,0,6,0,0,6
3843,0,6,0,0,6
3844,0,6,0,0,6
3845,0,6,0,0,6
3846,1,5,0,0,6
3847,0,6,0,0,6
3848,1,5,0,0,6
3849,0,6,0,0,6
3850,0,6,0,0,6
3851,0,6,0,0,6
3852,0,6,0,0,6
3853,0,6,0,0,6
3854,0,0,2,4,6
3855,3,0,0,3,6
3856,0,6,0,0,6
3857,2,4,0,0,6
3858,3,0,2,1,6
3859,2,3,0,1,6
3860,2,3,0,1,6
3861,4,2,0,0,6
3862,0,6,0,0,6
3863,2,1,3,0,6
3864,1,4,0,1,6
3865,0,6,0,0,6
3866,0,6,0,0,6
3867,4,2,0,0,6
3868,0,6,0,0,6
3869,0,6,0,0,6
3870,0,6,0,0,6
3871,0,6,0,0,6
3872,0,6,0,0,6
3873,0,6,0,0,6
3874,3,3,0,0,6
3875,0,6,0,0,6
3876,1,0,2,3,6
3877,0,6,0,0,6
3878,0,6,0,0,6
3879,0,6,0,0,6
3880,1,0,0,5,6
3881,0,6,0,0,6
3882,2,4,0,0,6
3883,0,6,0,0,6
3884,4,1,1,0,6
3885,2,2,2,0,6
3886,0,6,0,0,6
3887,0,6,0,0,6
3888,6,0,0,0,6
3889,0,6,0,0,6
3890,3,1,0,2,6
3891,0,6,0,0,6
3892,0,6,0,0,6
3893,0,6,0,0,6
3894,0,6,0,0,6
3895,0,6,0,0,6
3896,0,6,0,0,6
3897,0,6,0,0,6
3898,0,6,0,0,6
3899,0,6,0,0,6
3900,0,6,0,0,6
3901,0,2,1,3,6
3902,0,6,0,0,6
3903,0,6,0,0,6
3904,0,6,0,0,6
3905,0,6,0,0,6
3906,0,4,0,2,6
3907,0,2,0,4,6
3908,0,6,0,0,6
3909,0,6,0,0,6
3910,0,6,0,0,6
3911,0,6,0,0,6
3912,1,4,0,1,6
3913,0,6,0,0,6
3914,0,6,0,0,6
3915,6,0,0,0,6
3916,0,0,0,6,6
3917,0,6,0,0,6
3918,0,6,0,0,6
3919,4,2,0,0,6
3920,0,6,0,0,6
3921,0,6,0,0,6
3922,0,6,0,0,6
3923,0,6,0,0,6
3924,0,6,0,0,6
3925,0,6,0,0,6
3926,4,1,1,0,6
3927,1,0,0,5,6
3928,3,3,0,0,6
3929,0,6,0,0,6
3930,0,6,0,0,6
3931,0,6,0,0,6
3932,0,6,0,0,6
3933,0,2,0,4,6
3934,0,6,0,0,6
3935,0,6,0,0,6
3936,0,6,0,0,6
3937,5,1,0,0,6
3938,0,6,0,0,6
3939,2,1,3,0,6
3940,0,6,0,0,6
3941,0,5,0,1,6
3942,3,0,2,1,6
3943,6,0,0,0,6
3944,1,4,0,1,6
3945,6,0,0,0,6
3946,0,6,0,0,6
3947,2,3,1,0,6
3948,0,6,0,0,6
3949,0,6,0,0,6
3950,0,6,0,0,6
3951,0,6,0,0,6
3952,5,0,0,1,6
3953,2,3,1,0,6
3954,1,5,0,0,6
3955,0,6,0,0,6
3956,4,0,2,0,6
3957,2,1,0,3,6
3958,6,0,0,0,6
3959,5,0,1,0,6
3960,2,4,0,0,6
3961,0,6,0,0,6
3962,0,6,0,0,6
3963,0,6,0,0,6
3964,0,6,0,0,6
3965,1,0,0,5,6
3966,0,0,0,6,6
3967,0,6,0,0,6
3968,0,6,0,0,6
3969,0,6,0,0,6
3970,0,6,0,0,6
3971,0,6,0,0,6
3972,0,6,0,0,6
3973,6,0,0,0,6
3974,4,2,0,0,6
3975,5,0,0,1,6
3976,0,6,0,0,6
3977,0,6,0,0,6
3978,0,6,0,0,6
3979,0,0,0,6,6
3980,0,6,0,0,6
3981,0,6,0,0,6
3982,0,6,0,0,6
3983,0,6,0,0,6
3984,3,0,1,2,6
3985,1,5,0,0,6
3986,6,0,0,0,6
3987,0,1,3,2,6
3988,0,6,0,0,6
3989,2,4,0,0,6
3990,5,1,0,0,6
3991,0,6,0,0,6
3992,2,4,0,0,6
3993,0,6,0,0,6
3994,4,2,0,0,6
3995,0,6,0,0,6
3996,0,6,0,0,6
3997,6,0,0,0,6
3998,2,2,1,1,6
3999,1,5,0,0,6
4000,0,6,0,0,6
4001,1,5,0,0,6
4002,1,5,0,0,6
4003,0,6,0,0,6
4004,0,6,0,0,6
4005,0,6,0,0,6
4006,0,3,1,2,6
4007,0,6,0,0,6
4008,1,3,1,1,6
4009,3,0,1,2,6
4010,2,4,0,0,6
4011,0,6,0,0,6
4012,6,0,0,0,6
4013,0,6,0,0,6
4014,0,5,1,0,6
4015,0,6,0,0,6
4016,1,5,0,0,6
4017,1,5,0,0,6
4018,0,6,0,0,6
4019,0,6,0,0,6
4020,3,0,1,2,6
4021,1,0,3,2,6
4022,2,4,0,0,6
4023,0,6,0,0,6
4024,1,5,0,0,6
4025,5,0,0,1,6
4026,0,6,0,0,6
4027,6,0,0,0,6
4028,6,0,0,0,6
4029,0,6,0,0,6
4030,0,0,5,1,6
4031,0,6,0,0,6
4032,1,4,0,1,6
4033,6,0,0,0,6
4034,0,6,0,0,6
4035,1,4,0,1,6
4036,5,1,0,0,6
4037,1,1,4,0,6
4038,0,6,0,0,6
4039,0,6,0,0,6
4040,1,5,0,0,6
4041,1,4,0,1,6
4042,0,6,0,0,6
4043,4,0,1,1,6
4044,0,6,0,0,6
4045,2,3,0,1,6
4046,1,2,0,3,6
4047,0,6,0,0,6
4048,0,3,0,3,6
4049,0,6,0,0,6
4050,0,6,0,0,6
4051,3,3,0,0,6
4052,0,6,0,0,6
4053,0,6,0,0,6
4054,0,6,0,0,6
4055,0,6,0,0,6
4056,0,6,0,0,6
4057,0,6,0,0,6
4058,0,0,1,5,6
4059,0,6,0,0,6
4060,0,1,1,4,6
4061,0,6,0,0,6
4062,0,6,0,0,6
4063,0,0,0,6,6
4064,0,6,0,0,6
4065,1,5,0,0,6
4066,1,5,0,0,6
4067,1,3,0,2,6
4068,0,6,0,0,6
4069,5,0,0,1,6
4070,0,6,0,0,6
4071,0,6,0,0,6
4072,0,6,0,0,6
4073,0,6,0,0,6
4074,1,0,0,5,6
4075,0,6,0,0,6
4076,0,6,0,0,6
4077,2,4,0,0,6
4078,6,0,0,0,6
4079,0,6,0,0,6
4080,0,6,0,0,6
4081,0,6,0,0,6
4082,0,6,0,0,6
4083,0,6,0,0,6
4084,1,5,0,0,6
4085,1,2,3,0,6
4086,0,6,0,0,6
4087,0,6,0,0,6
4088,0,6,0,0,6
4089,0,6,0,0,6
4090,1,1,2,2,6
4091,1,1,4,0,6
4092,0,6,0,0,6
4093,1,5,0,0,6
4094,0,6,0,0,6
4095,0,0,0,6,6
4096,0,6,0,0,6
4097,0,6,0,0,6
4098,3,3,0,0,6
4099,0,6,0,0,6
4100,3,0,3,0,6
4101,0,0,0,6,6
4102,0,6,0,0,6
4103,0,6,0,0,6
4104,0,6,0,0,6
4105,0,6,0,0,6
4106,0,6,0,0,6
4107,0,6,0,0,6
4108,0,5,0,1,6
4109,0,6,0,0,6
4110,0,6,0,0,6
4111,0,6,0,0,6
4112,1,5,0,0,6
4113,4,2,0,0,6
4114,0,6,0,0,6
4115,0,6,0,0,6
4116,1,0,0,5,6
4117,0,6,0,0,6
4118,0,6,0,0,6
4119,1,5,0,0,6
4120,2,4,0,0,6
4121,1,0,1,4,6
4122,0,6,0,0,6
4123,4,0,0,2,6
4124,0,6,0,0,6
4125,0,6,0,0,6
4126,0,6,0,0,6
4127,0,6,0,0,6
4128,2,4,0,0,6
4129,0,6,0,0,6
4130,0,6,0,0,6
4131,0,6,0,0,6
4132,0,6,0,0,6
4133,0,4,0,2,6
4134,0,6,0,0,6
4135,0,6,0,0,6
4136,0,3,0,3,6
4137,5,0,0,1,6
4138,3,3,0,0,6
4139,1,5,0,0,6
4140,0,6,0,0,6
4141,0,6,0,0,6
4142,2,0,1,3,6
4143,2,4,0,0,6
4144,0,6,0,0,6
4145,1,5,0,0,6
4146,0,6,0,0,6
4147,0,3,3,0,6
4148,0,5,0,1,6
4149,1,5,0,0,6
4150,0,6,0,0,6
4151,0,6,0,0,6
4152,1,5,0,0,6
4153,2,4,0,0,6
4154,0,6,0,0,6
4155,1,5,0,0,6
4156,0,6,0,0,6
4157,0,6,0,0,6
4158,1,5,0,0,6
4159,0,6,0,0,6
4160,0,6,0,0,6
4161,0,6,0,0,6
4162,0,5,1,0,6
4163,0,6,0,0,6
4164,0,6,0,0,6
4165,0,6,0,0,6
4166,0,6,0,0,6
4167,0,6,0,0,6
4168,0,6,0,0,6
4169,0,6,0,0,6
4170,3,2,1,0,6
4171,0,6,0,0,6
4172,1,5,0,0,6
4173,5,1,0,0,6
4174,5,1,0,0,6
4175,0,6,0,0,6
4176,1,5,0,0,6
4177,0,6,0,0,6
4178,0,5,1,0,6
4179,0,6,0,0,6
4180,0,6,0,0,6
4181,0,6,0,0,6
4182,4,0,1,1,6
4183,0,6,0,0,6
4184,0,6,0,0,6
4185,2,3,0,1,6
4186,4,0,1,1,6
4187,0,6,0,0,6
4188,5,0,0,1,6
4189,3,0,2,1,6
4190,0,6,0,0,6
4191,0,6,0,0,6
4192,1,5,0,0,6
4193,1,5,0,0,6
4194,2,4,0,0,6
4195,0,6,0,0,6
4196,0,6,0,0,6
4197,0,4,1,1,6
4198,0,6,0,0,6
4199,1,4,0,1,6
4200,0,6,0,0,6
4201,0,6,0,0,6
4202,0,6,0,0,6
4203,0,0,6,0,6
4204,0,6,0,0,6
4205,1,2,1,2,6
4206,4,0,0,2,6
4207,2,1,2,1,6
4208,0,6,0,0,6
4209,0,6,0,0,6
4210,1,0,4,1,6
4211,0,6,0,0,6
4212,0,6,0,0,6
4213,2,0,2,2,6
4214,5,1,0,0,6
4215,5,1,0,0,6
4216,0,6,0,0,6
4217,0,6,0,0,6
4218,0,6,0,0,6
4219,0,6,0,0,6
4220,0,6,0,0,6
4221,1,4,1,0,6
4222,0,6,0,0,6
4223,0,6,0,0,6
4224,0,5,0,1,6
4225,0,6,0,0,6
4226,1,0,0,5,6
4227,1,2,0,3,6
4228,4,0,1,1,6
4229,0,6,0,0,6
4230,0,4,2,0,6
4231,0,6,0,0,6
4232,0,6,0,0,6
4233,0,6,0,0,6
4234,0,6,0,0,6
4235,1,3,1,1,6
4236,5,0,1,0,6
4237,1,1,3,1,6
4238,5,1,0,0,6
4239,6,0,0,0,6
4240,3,1,1,1,6
4241,0,2,0,4,6
4242,3,1,0,2,6
4243,0,6,0,0,6
4244,0,6,0,0,6
4245,2,1,3,0,6
4246,0,6,0,0,6
4247,4,0,1,1,6
4248,0,3,1,2,6
4249,0,6,0,0,6
4250,0,6,0,0,6
4251,0,6,0,0,6
4252,1,5,0,0,6
4253,6,0,0,0,6
4254,0,6,0,0,6
4255,0,6,0,0,6
4256,0,0,0,6,6
4257,0,6,0,0,6
4258,0,6,0,0,6
4259,0,6,0,0,6
4260,6,0,0,0,6
4261,0,6,0,0,6
4262,0,6,0,0,6
4263,0,6,0,0,6
4264,0,6,0,0,6
4265,0,6,0,0,6
4266,0,5,0,1,6
4267,0,6,0,0,6
4268,0,6,0,0,6
4269,0,6,0,0,6
4270,2,3,0,1,6
4271,0,6,0,0,6
4272,0,6,0,0,6
4273,2,4,0,0,6
4274,4,1,1,0,6
4275,0,6,0,0,6
4276,0,6,0,0,6
4277,5,0,1,0,6
4278,0,6,0,0,6
4279,0,6,0,0,6
4280,3,0,3,0,6
4281,0,6,0,0,6
4282,0,6,0,0,6
4283,0,6,0,0,6
4284,0,5,0,0,5
4285,3,0,0,2,5
4286,0,5,0,0,5
4287,0,5,0,0,5
4288,0,5,0,0,5
4289,3,2,0,0,5
4290,3,0,0,2,5
4291,2,3,0,0,5
4292,0,5,0,0,5
4293,3,1,1,0,5
4294,4,0,0,1,5
4295,0,2,3,0,5
4296,0,5,0,0,5
4297,0,5,0,0,5
4298,0,5,0,0,5
4299,0,5,0,0,5
4300,1,4,0,0,5
4301,0,5,0,0,5
4302,0,5,0,0,5
4303,4,0,1,0,5
4304,0,5,0,0,5
4305,1,4,0,0,5
4306,0,5,0,0,5
4307,1,0,1,3,5
4308,0,5,0,0,5
4309,0,5,0,0,5
4310,0,5,0,0,5
4311,0,3,2,0,5
4312,1,4,0,0,5
4313,0,4,1,0,5
4314,0,5,0,0,5
4315,0,5,0,0,5
4316,0,5,0,0,5
4317,4,1,0,0,5
4318,5,0,0,0,5
4319,0,1,0,4,5
4320,0,5,0,0,5
4321,0,5,0,0,5
4322,1,0,0,4,5
4323,0,5,0,0,5
4324,0,5,0,0,5
4325,1,3,1,0,5
4326,0,5,0,0,5
4327,0,5,0,0,5
4328,0,5,0,0,5
4329,0,2,0,3,5
4330,0,5,0,0,5
4331,1,0,0,4,5
4332,0,5,0,0,5
4333,0,5,0,0,5
4334,0,5,0,0,5
4335,0,5,0,0,5
4336,0,5,0,0,5
4337,3,0,0,2,5
4338,2,3,0,0,5
4339,5,0,0,0,5
4340,1,4,0,0,5
4341,0,5,0,0,5
4342,0,5,0,0,5
4343,2,3,0,0,5
4344,0,5,0,0,5
4345,0,5,0,0,5
4346,0,5,0,0,5
4347,0,4,0,1,5
4348,1,0,0,4,5
4349,0,5,0,0,5
4350,1,0,1,3,5
4351,0,5,0,0,5
4352,0,5,0,0,5
4353,5,0,0,0,5
4354,0,5,0,0,5
4355,4,0,1,0,5
4356,0,5,0,0,5
4357,0,5,0,0,5
4358,0,5,0,0,5
4359,0,5,0,0,5
4360,2,0,0,3,5
4361,0,4,0,1,5
4362,0,5,0,0,5
4363,2,3,0,0,5
4364,0,5,0,0,5
4365,0,0,0,5,5
4366,1,4,0,0,5
4367,0,5,0,0,5
4368,0,5,0,0,5
4369,0,5,0,0,5
4370,0,5,0,0,5
4371,4,0,0,1,5
4372,0,5,0,0,5
4373,2,0,1,2,5
4374,0,5,0,0,5
4375,0,5,0,0,5
4376,0,5,0,0,5
4377,0,5,0,0,5
4378,0,5,0,0,5
4379,0,3,0,2,5
4380,0,3,0,2,5
4381,0,5,0,0,5
4382,0,5,0,0,5
4383,0,5,0,0,5
4384,0,5,0,0,5
4385,0,5,0,0,5
4386,0,5,0,0,5
4387,0,5,0,0,5
4388,3,1,0,1,5
4389,0,5,0,0,5
4390,2,2,0,1,5
4391,5,0,0,0,5
4392,0,5,0,0,5
4393,0,5,0,0,5
4394,1,3,1,0,5
4395,1,4,0,0,5
4396,0,5,0,0,5
4397,0,5,0,0,5
4398,0,5,0,0,5
4399,0,4,1,0,5
4400,0,5,0,0,5
4401,0,5,0,0,5
4402,0,5,0,0,5
4403,4,0,1,0,5
4404,1,3,1,0,5
4405,0,5,0,0,5
4406,1,0,0,4,5
4407,0,3,0,2,5
4408,2,0,0,3,5
4409,0,5,0,0,5
4410,0,5,0,0,5
4411,0,5,0,0,5
4412,0,5,0,0,5
4413,1,3,0,1,5
4414,0,3,0,2,5
4415,0,4,1,0,5
4416,1,4,0,0,5
4417,0,5,0,0,5
4418,5,0,0,0,5
4419,0,5,0,0,5
4420,0,5,0,0,5
4421,4,0,0,1,5
4422,4,1,0,0,5
4423,0,5,0,0,5
4424,0,4,1,0,5
4425,2,2,1,0,5
4426,0,5,0,0,5
4427,0,1,0,4,5
4428,0,5,0,0,5
4429,0,5,0,0,5
4430,0,5,0,0,5
4431,0,5,0,0,5
4432,3,2,0,0,5
4433,0,5,0,0,5
4434,2,2,0,1,5
4435,0,5,0,0,5
4436,1,4,0,0,5
4437,0,5,0,0,5
4438,0,5,0,0,5
4439,0,5,0,0,5
4440,1,1,1,2,5
4441,0,4,1,0,5
4442,0,5,0,0,5
4443,4,0,1,0,5
4444,1,3,0,1,5
4445,0,5,0,0,5
4446,2,3,0,0,5
4447,0,5,0,0,5
4448,0,4,1,0,5
4449,0,5,0,0,5
4450,0,5,0,0,5
4451,0,5,0,0,5
4452,0,5,0,0,5
4453,0,3,2,0,5
4454,0,5,0,0,5
4455,0,5,0,0,5
4456,4,0,0,1,5
4457,2,3,0,0,5
4458,0,5,0,0,5
4459,0,5,0,0,5
4460,1,4,0,0,5
4461,0,5,0,0,5
4462,0,5,0,0,5
4463,0,5,0,0,5
4464,0,5,0,0,5
4465,0,5,0,0,5
4466,0,5,0,0,5
4467,0,5,0,0,5
4468,0,5,0,0,5
4469,0,5,0,0,5
4470,0,5,0,0,5
4471,1,4,0,0,5
4472,2,3,0,0,5
4473,0,5,0,0,5
4474,0,1,0,4,5
4475,0,5,0,0,5
4476,0,4,1,0,5
4477,0,5,0,0,5
4478,0,5,0,0,5
4479,4,0,0,1,5
4480,0,3,0,2,5
4481,0,5,0,0,5
4482,3,1,1,0,5
4483,2,0,1,2,5
4484,0,5,0,0,5
4485,1,4,0,0,5
4486,0,5,0,0,5
4487,0,5,0,0,5
4488,3,2,0,0,5
4489,0,0,0,5,5
4490,0,0,0,5,5
4491,2,0,1,2,5
4492,0,5,0,0,5
4493,0,5,0,0,5
4494,0,5,0,0,5
4495,0,5,0,0,5
4496,4,1,0,0,5
4497,0,5,0,0,5
4498,1,4,0,0,5
4499,0,5,0,0,5
4500,0,5,0,0,5
4501,5,0,0,0,5
4502,0,2,3,0,5
4503,0,5,0,0,5
4504,0,1,1,3,5
4505,0,5,0,0,5
4506,0,5,0,0,5
4507,0,5,0,0,5
4508,0,5,0,0,5
4509,0,5,0,0,5
4510,5,0,0,0,5
4511,2,1,0,2,5
4512,1,4,0,0,5
4513,0,5,0,0,5
4514,0,5,0,0,5
4515,0,5,0,0,5
4516,0,5,0,0,5
4517,2,3,0,0,5
4518,1,4,0,0,5
4519,0,5,0,0,5
4520,1,4,0,0,5
4521,0,5,0,0,5
4522,0,5,0,0,5
4523,0,5,0,0,5
4524,1,3,0,1,5
4525,1,4,0,0,5
4526,0,5,0,0,5
4527,1,4,0,0,5
4528,0,0,0,5,5
4529,0,5,0,0,5
4530,0,5,0,0,5
4531,0,5,0,0,5
4532,0,5,0,0,5
4533,0,5,0,0,5
4534,1,0,1,3,5
4535,0,5,0,0,5
4536,2,0,0,3,5
4537,0,5,0,0,5
4538,1,4,0,0,5
4539,2,3,0,0,5
4540,5,0,0,0,5
4541,0,5,0,0,5
4542,0,5,0,0,5
4543,0,5,0,0,5
4544,2,1,2,0,5
4545,0,5,0,0,5
4546,0,5,0,0,5
4547,0,5,0,0,5
4548,0,5,0,0,5
4549,0,3,2,0,5
4550,0,5,0,0,5
4551,0,5,0,0,5
4552,0,5,0,0,5
4553,0,5,0,0,5
4554,0,5,0,0,5
4555,0,3,0,2,5
4556,0,5,0,0,5
4557,0,5,0,0,5
4558,1,2,0,2,5
4559,0,0,2,3,5
4560,0,5,0,0,5
4561,5,0,0,0,5
4562,1,4,0,0,5
4563,0,5,0,0,5
4564,0,5,0,0,5
4565,0,5,0,0,5
4566,0,5,0,0,5
4567,0,5,0,0,5
4568,0,5,0,0,5
4569,0,5,0,0,5
4570,2,3,0,0,5
4571,1,4,0,0,5
4572,0,5,0,0,5
4573,0,1,4,0,5
4574,0,5,0,0,5
4575,0,3,0,2,5
4576,1,4,0,0,5
4577,0,5,0,0,5
4578,4,1,0,0,5
4579,0,5,0,0,5
4580,0,5,0,0,5
4581,0,5,0,0,5
4582,3,1,0,1,5
4583,0,5,0,0,5
4584,0,5,0,0,5
4585,0,1,0,4,5
4586,0,5,0,0,5
4587,0,5,0,0,5
4588,3,2,0,0,5
4589,0,5,0,0,5
4590,0,5,0,0,5
4591,0,5,0,0,5
4592,0,5,0,0,5
4593,1,4,0,0,5
4594,2,3,0,0,5
4595,3,1,1,0,5
4596,0,5,0,0,5
4597,2,3,0,0,5
4598,2,3,0,0,5
4599,0,5,0,0,5
4600,0,5,0,0,5
4601,0,5,0,0,5
4602,0,5,0,0,5
4603,0,5,0,0,5
4604,0,5,0,0,5
4605,0,5,0,0,5
4606,1,4,0,0,5
4607,1,4,0,0,5
4608,0,5,0,0,5
4609,1,4,0,0,5
4610,1,2,2,0,5
4611,0,5,0,0,5
4612,0,5,0,0,5
4613,2,3,0,0,5
4614,0,5,0,0,5
4615,0,5,0,0,5
4616,0,5,0,0,5
4617,2,2,1,0,5
4618,0,5,0,0,5
4619,0,5,0,0,5
4620,0,4,0,1,5
4621,0,4,0,1,5
4622,0,5,0,0,5
4623,2,3,0,0,5
4624,0,5,0,0,5
4625,1,4,0,0,5
4626,0,5,0,0,5
4627,0,5,0,0,5
4628,0,5,0,0,5
4629,0,5,0,0,5
4630,5,0,0,0,5
4631,0,5,0,0,5
4632,2,1,0,2,5
4633,0,5,0,0,5
4634,3,2,0,0,5
4635,0,5,0,0,5
4636,2,3,0,0,5
4637,0,5,0,0,5
4638,0,5,0,0,5
4639,0,5,0,0,5
4640,0,5,0,0,5
4641,1,3,0,1,5
4642,0,5,0,0,5
4643,0,5,0,0,5
4644,0,0,0,5,5
4645,0,5,0,0,5
4646,0,1,0,4,5
4647,0,5,0,0,5
4648,0,5,0,0,5
4649,0,5,0,0,5
4650,0,5,0,0,5
4651,0,5,0,0,5
4652,0,5,0,0,5
4653,5,0,0,0,5
4654,0,5,0,0,5
4655,0,5,0,0,5
4656,0,5,0,0,5
4657,0,5,0,0,5
4658,0,5,0,0,5
4659,1,4,0,0,5
4660,0,5,0,0,5
4661,3,0,1,1,5
4662,0,5,0,0,5
4663,0,5,0,0,5
4664,1,0,1,3,5
4665,0,5,0,0,5
4666,0,5,0,0,5
4667,1,4,0,0,5
4668,0,5,0,0,5
4669,1,4,0,0,5
4670,0,5,0,0,5
4671,1,1,2,1,5
4672,0,5,0,0,5
4673,0,5,0,0,5
4674,0,2,0,3,5
4675,0,5,0,0,5
4676,0,5,0,0,5
4677,2,2,0,1,5
4678,0,5,0,0,5
4679,0,5,0,0,5
4680,0,5,0,0,5
4681,0,5,0,0,5
4682,0,5,0,0,5
4683,0,5,0,0,5
4684,0,5,0,0,5
4685,4,0,1,0,5
4686,0,5,0,0,5
4687,0,5,0,0,5
4688,0,5,0,0,5
4689,0,5,0,0,5
4690,0,5,0,0,5
4691,0,5,0,0,5
4692,0,5,0,0,5
4693,0,5,0,0,5
4694,0,5,0,0,5
4695,0,5,0,0,5
4696,0,5,0,0,5
4697,0,5,0,0,5
4698,0,5,0,0,5
4699,3,1,1,0,5
4700,0,5,0,0,5
4701,0,5,0,0,5
4702,0,5,0,0,5
4703,3,1,1,0,5
4704,1,3,0,1,5
4705,0,5,0,0,5
4706,1,2,2,0,5
4707,5,0,0,0,5
4708,0,5,0,0,5
4709,0,5,0,0,5
4710,0,5,0,0,5
4711,3,2,0,0,5
4712,0,5,0,0,5
4713,2,2,1,0,5
4714,0,5,0,0,5
4715,0,5,0,0,5
4716,1,4,0,0,5
4717,0,5,0,0,5
4718,0,5,0,0,5
4719,0,5,0,0,5
4720,1,3,0,1,5
4721,0,4,0,1,5
4722,1,4,0,0,5
4723,0,1,0,4,5
4724,0,5,0,0,5
4725,0,4,0,1,5
4726,0,5,0,0,5
4727,0,5,0,0,5
4728,0,5,0,0,5
4729,0,4,1,0,5
4730,0,5,0,0,5
4731,0,5,0,0,5
4732,0,4,0,1,5
4733,0,5,0,0,5
4734,0,5,0,0,5
4735,0,5,0,0,5
4736,0,4,0,1,5
4737,5,0,0,0,5
4738,0,5,0,0,5
4739,0,5,0,0,5
4740,1,0,4,0,5
4741,0,5,0,0,5
4742,0,5,0,0,5
4743,5,0,0,0,5
4744,3,1,1,0,5
4745,1,4,0,0,5
4746,0,5,0,0,5
4747,0,5,0,0,5
4748,0,5,0,0,5
4749,0,5,0,0,5
4750,0,5,0,0,5
4751,0,5,0,0,5
4752,0,5,0,0,5
4753,2,3,0,0,5
4754,0,5,0,0,5
4755,0,5,0,0,5
4756,0,5,0,0,5
4757,0,5,0,0,5
4758,1,4,0,0,5
4759,0,5,0,0,5
4760,0,5,0,0,5
4761,0,5,0,0,5
4762,3,2,0,0,5
4763,0,5,0,0,5
4764,0,5,0,0,5
4765,0,5,0,0,5
4766,3,0,0,2,5
4767,0,5,0,0,5
4768,0,5,0,0,5
4769,4,1,0,0,5
4770,1,3,1,0,5
4771,0,5,0,0,5
4772,0,5,0,0,5
4773,0,5,0,0,5
4774,0,5,0,0,5
4775,2,3,0,0,5
4776,0,5,0,0,5
4777,1,3,0,1,5
4778,0,1,1,3,5
4779,0,5,0,0,5
4780,3,0,2,0,5
4781,4,0,1,0,5
4782,1,4,0,0,5
4783,0,5,0,0,5
4784,4,0,1,0,5
4785,0,5,0,0,5
4786,1,4,0,0,5
4787,2,2,0,1,5
4788,0,5,0,0,5
4789,0,5,0,0,5
4790,2,1,0,2,5
4791,0,5,0,0,5
4792,2,2,0,1,5
4793,0,5,0,0,5
4794,0,2,0,3,5
4795,1,0,3,1,5
4796,0,5,0,0,5
4797,0,5,0,0,5
4798,0,5,0,0,5
4799,0,5,0,0,5
4800,3,1,1,0,5
4801,0,4,0,1,5
4802,0,5,0,0,5
4803,1,4,0,0,5
4804,1,4,0,0,5
4805,0,5,0,0,5
4806,1,3,0,1,5
4807,2,0,0,3,5
4808,0,4,0,1,5
4809,0,5,0,0,5
4810,1,4,0,0,5
4811,0,5,0,0,5
4812,0,5,0,0,5
4813,0,5,0,0,5
4814,0,5,0,0,5
4815,0,5,0,0,5
4816,0,5,0,0,5
4817,0,5,0,0,5
4818,2,3,0,0,5
4819,2,1,1,1,5
4820,2,3,0,0,5
4821,0,5,0,0,5
4822,2,0,0,3,5
4823,0,2,1,2,5
4824,0,5,0,0,5
4825,0,2,2,1,5
4826,0,5,0,0,5
4827,1,4,0,0,5
4828,0,5,0,0,5
4829,3,2,0,0,5
4830,0,5,0,0,5
4831,0,5,0,0,5
4832,0,5,0,0,5
4833,4,1,0,0,5
4834,1,4,0,0,5
4835,0,5,0,0,5
4836,0,5,0,0,5
4837,0,5,0,0,5
4838,4,1,0,0,5
4839,0,5,0,0,5
4840,1,4,0,0,5
4841,0,5,0,0,5
4842,0,5,0,0,5
4843,0,5,0,0,5
4844,0,5,0,0,5
4845,5,0,0,0,5
4846,2,3,0,0,5
4847,0,5,0,0,5
4848,1,4,0,0,5
4849,0,5,0,0,5
4850,0,2,3,0,5
4851,0,5,0,0,5
4852,0,5,0,0,5
4853,0,5,0,0,5
4854,0,5,0,0,5
4855,3,0,0,2,5
4856,2,1,2,0,5
4857,0,5,0,0,5
4858,0,5,0,0,5
4859,0,4,1,0,5
4860,0,5,0,0,5
4861,0,5,0,0,5
4862,0,5,0,0,5
4863,0,5,0,0,5
4864,0,5,0,0,5
4865,3,1,0,1,5
4866,0,5,0,0,5
4867,0,5,0,0,5
4868,3,0,2,0,5
4869,0,5,0,0,5
4870,3,1,1,0,5
4871,0,5,0,0,5
4872,4,0,1,0,5
4873,4,1,0,0,5
4874,0,5,0,0,5
4875,0,5,0,0,5
4876,0,5,0,0,5
4877,0,5,0,0,5
4878,0,2,0,3,5
4879,0,5,0,0,5
4880,0,5,0,0,5
4881,2,0,0,3,5
4882,3,0,0,2,5
4883,0,5,0,0,5
4884,0,5,0,0,5
4885,0,5,0,0,5
4886,0,5,0,0,5
4887,0,3,0,2,5
4888,3,2,0,0,5
4889,0,5,0,0,5
4890,1,4,0,0,5
4891,2,3,0,0,5
4892,3,0,1,1,5
4893,0,5,0,0,5
4894,0,5,0,0,5
4895,0,5,0,0,5
4896,0,5,0,0,5
4897,0,5,0,0,5
4898,0,5,0,0,5
4899,0,4,0,1,5
4900,0,5,0,0,5
4901,0,5,0,0,5
4902,0,5,0,0,5
4903,0,3,0,2,5
4904,0,5,0,0,5
4905,0,5,0,0,5
4906,0,5,0,0,5
4907,0,5,0,0,5
4908,0,5,0,0,5
4909,1,4,0,0,5
4910,0,0,2,3,5
4911,3,2,0,0,5
4912,0,5,0,0,5
4913,0,5,0,0,5
4914,1,4,0,0,5
4915,2,3,0,0,5
4916,0,5,0,0,5
4917,0,5,0,0,5
4918,0,5,0,0,5
4919,1,4,0,0,5
4920,1,1,1,2,5
4921,0,0,0,5,5
4922,0,1,2,2,5
4923,2,3,0,0,5
4924,0,5,0,0,5
4925,0,5,0,0,5
4926,0,5,0,0,5
4927,0,0,0,5,5
4928,0,5,0,0,5
4929,1,3,0,1,5
4930,1,3,0,1,5
4931,5,0,0,0,5
4932,0,5,0,0,5
4933,0,5,0,0,5
4934,2,0,2,1,5
4935,0,5,0,0,5
4936,0,5,0,0,5
4937,0,5,0,0,5
4938,1,4,0,0,5
4939,3,2,0,0,5
4940,0,5,0,0,5
4941,0,5,0,0,5
4942,2,0,0,3,5
4943,0,5,0,0,5
4944,0,4,1,0,5
4945,4,1,0,0,5
4946,0,5,0,0,5
4947,0,0,0,5,5
4948,1,4,0,0,5
4949,0,5,0,0,5
4950,1,4,0,0,5
4951,0,5,0,0,5
4952,1,3,0,1,5
4953,0,5,0,0,5
4954,0,5,0,0,5
4955,0,5,0,0,5
4956,0,5,0,0,5
4957,0,5,0,0,5
4958,1,4,0,0,5
4959,0,4,0,1,5
4960,0,0,2,3,5
4961,0,5,0,0,5
4962,0,5,0,0,5
4963,1,0,0,4,5
4964,0,5,0,0,5
4965,0,3,1,1,5
4966,1,1,1,2,5
4967,1,1,1,2,5
4968,2,2,1,0,5
4969,0,5,0,0,5
4970,0,5,0,0,5
4971,0,3,2,0,5
4972,0,5,0,0,5
4973,2,1,0,2,5
4974,4,1,0,0,5
4975,0,5,0,0,5
4976,0,5,0,0,5
4977,0,5,0,0,5
4978,2,0,0,3,5
4979,0,5,0,0,5
4980,4,0,1,0,5
4981,2,2,0,1,5
4982,0,5,0,0,5
4983,2,3,0,0,5
4984,0,5,0,0,5
4985,0,5,0,0,5
4986,0,5,0,0,5
4987,1,4,0,0,5
4988,0,5,0,0,5
4989,1,4,0,0,5
4990,0,5,0,0,5
4991,0,5,0,0,5
4992,0,5,0,0,5
4993,2,3,0,0,5
4994,0,5,0,0,5
4995,0,5,0,0,5
4996,0,5,0,0,5
4997,0,5,0,0,5
4998,0,5,0,0,5
4999,0,5,0,0,5
5000,0,5,0,0,5
5001,0,0,5,0,5
5002,0,5,0,0,5
5003,0,5,0,0,5
5004,0,0,0,5,5
5005,0,5,0,0,5
5006,2,1,0,2,5
5007,0,5,0,0,5
5008,0,5,0,0,5
5009,0,5,0,0,5
5010,0,4,0,1,5
5011,0,5,0,0,5
5012,0,5,0,0,5
5013,1,4,0,0,5
5014,0,5,0,0,5
5015,1,0,0,4,5
5016,0,5,0,0,5
5017,1,3,0,1,5
5018,2,3,0,0,5
5019,0,5,0,0,5
5020,0,5,0,0,5
5021,2,1,2,0,5
5022,3,2,0,0,5
5023,1,0,0,4,5
5024,0,5,0,0,5
5025,1,3,0,1,5
5026,1,2,1,1,5
5027,0,5,0,0,5
5028,4,1,0,0,5
5029,0,3,1,1,5
5030,0,5,0,0,5
5031,0,5,0,0,5
5032,5,0,0,0,5
5033,0,5,0,0,5
5034,0,5,0,0,5
5035,0,5,0,0,5
5036,2,3,0,0,5
5037,1,4,0,0,5
5038,0,5,0,0,5
5039,0,5,0,0,5
5040,3,1,0,1,5
5041,4,1,0,0,5
5042,4,1,0,0,5
5043,1,0,3,1,5
5044,1,1,0,3,5
5045,0,5,0,0,5
5046,0,5,0,0,5
5047,0,5,0,0,5
5048,0,5,0,0,5
5049,0,0,3,2,5
5050,0,5,0,0,5
5051,0,4,0,1,5
5052,0,5,0,0,5
5053,0,5,0,0,5
5054,0,5,0,0,5
5055,1,4,0,0,5
5056,3,2,0,0,5
5057,0,5,0,0,5
5058,4,1,0,0,5
5059,5,0,0,0,5
5060,0,3,0,2,5
5061,0,5,0,0,5
5062,0,5,0,0,5
5063,0,5,0,0,5
5064,0,0,0,5,5
5065,0,5,0,0,5
5066,0,5,0,0,5
5067,0,5,0,0,5
5068,1,4,0,0,5
5069,0,5,0,0,5
5070,1,4,0,0,5
5071,3,1,1,0,5
5072,0,5,0,0,5
5073,3,2,0,0,5
5074,0,5,0,0,5
5075,1,4,0,0,5
5076,0,5,0,0,5
5077,0,5,0,0,5
5078,0,5,0,0,5
5079,0,5,0,0,5
5080,0,5,0,0,5
5081,5,0,0,0,5
5082,0,5,0,0,5
5083,0,5,0,0,5
5084,0,5,0,0,5
5085,3,0,1,1,5
5086,0,5,0,0,5
5087,0,5,0,0,5
5088,0,5,0,0,5
5089,0,5,0,0,5
5090,0,4,0,1,5
5091,0,5,0,0,5
5092,0,5,0,0,5
5093,0,5,0,0,5
5094,0,5,0,0,5
5095,0,5,0,0,5
5096,0,5,0,0,5
5097,0,5,0,0,5
5098,0,5,0,0,5
5099,4,1,0,0,5
5100,0,4,1,0,5
5101,0,5,0,0,5
5102,1,4,0,0,5
5103,0,2,3,0,5
5104,0,5,0,0,5
5105,0,5,0,0,5
5106,0,5,0,0,5
5107,0,5,0,0,5
5108,0,5,0,0,5
5109,1,4,0,0,5
5110,0,0,0,5,5
5111,0,5,0,0,5
5112,0,5,0,0,5
5113,0,0,0,5,5
5114,1,4,0,0,5
5115,0,5,0,0,5
5116,0,5,0,0,5
5117,1,4,0,0,5
5118,1,4,0,0,5
5119,1,4,0,0,5
5120,0,5,0,0,5
5121,1,0,1,3,5
5122,0,5,0,0,5
5123,0,5,0,0,5
5124,0,5,0,0,5
5125,0,0,0,5,5
5126,1,4,0,0,5
5127,0,5,0,0,5
5128,0,4,0,1,5
5129,0,5,0,0,5
5130,3,0,1,1,5
5131,2,2,0,1,5
5132,0,5,0,0,5
5133,0,5,0,0,5
5134,0,5,0,0,5
5135,0,5,0,0,5
5136,0,5,0,0,5
5137,2,3,0,0,5
5138,1,4,0,0,5
5139,0,5,0,0,5
5140,0,5,0,0,5
5141,2,3,0,0,5
5142,0,5,0,0,5
5143,0,5,0,0,5
5144,1,0,4,0,5
5145,1,4,0,0,5
5146,1,0,0,4,5
5147,0,5,0,0,5
5148,0,5,0,0,5
5149,0,5,0,0,5
5150,0,5,0,0,5
5151,0,5,0,0,5
5152,0,5,0,0,5
5153,0,5,0,0,5
5154,0,5,0,0,5
5155,1,4,0,0,5
5156,0,5,0,0,5
5157,0,1,2,2,5
5158,0,5,0,0,5
5159,0,5,0,0,5
5160,1,2,0,2,5
5161,0,5,0,0,5
5162,0,5,0,0,5
5163,0,0,1,4,5
5164,1,4,0,0,5
5165,0,5,0,0,5
5166,0,5,0,0,5
5167,4,1,0,0,5
5168,0,5,0,0,5
5169,0,5,0,0,5
5170,1,4,0,0,5
5171,5,0,0,0,5
5172,1,4,0,0,5
5173,0,5,0,0,5
5174,0,5,0,0,5
5175,2,3,0,0,5
5176,0,5,0,0,5
5177,0,5,0,0,5
5178,0,2,0,3,5
5179,0,5,0,0,5
5180,5,0,0,0,5
5181,0,5,0,0,5
5182,0,5,0,0,5
5183,0,5,0,0,5
5184,1,4,0,0,5
5185,0,5,0,0,5
5186,0,5,0,0,5
5187,0,5,0,0,5
5188,1,4,0,0,5
5189,0,4,1,0,5
5190,3,2,0,0,5
5191,0,3,0,2,5
5192,0,5,0,0,5
5193,1,4,0,0,5
5194,2,0,3,0,5
5195,0,5,0,0,5
5196,1,2,0,2,5
5197,0,0,4,1,5
5198,1,4,0,0,5
5199,0,5,0,0,5
5200,0,0,5,0,5
5201,2,2,1,0,5
5202,1,3,0,1,5
5203,0,5,0,0,5
5204,0,2,3,0,5
5205,0,5,0,0,5
5206,0,5,0,0,5
5207,0,5,0,0,5
5208,2,0,3,0,5
5209,0,5,0,0,5
5210,0,5,0,0,5
5211,0,5,0,0,5
5212,0,1,0,4,5
5213,0,5,0,0,5
5214,0,5,0,0,5
5215,0,5,0,0,5
5216,0,0,2,3,5
5217,0,5,0,0,5
5218,1,4,0,0,5
5219,0,5,0,0,5
5220,3,0,2,0,5
5221,0,0,0,5,5
5222,0,5,0,0,5
5223,0,5,0,0,5
5224,2,1,0,2,5
5225,0,5,0,0,5
5226,2,3,0,0,5
5227,0,5,0,0,5
5228,1,4,0,0,5
5229,0,5,0,0,5
5230,0,5,0,0,5
5231,0,5,0,0,5
5232,2,3,0,0,5
5233,5,0,0,0,5
5234,0,5,0,0,5
5235,1,4,0,0,5
5236,0,5,0,0,5
5237,1,1,1,2,5
5238,0,5,0,0,5
5239,0,5,0,0,5
5240,0,5,0,0,5
5241,0,5,0,0,5
5242,0,5,0,0,5
5243,0,5,0,0,5
5244,0,5,0,0,5
5245,1,0,0,4,5
5246,2,2,1,0,5
5247,0,5,0,0,5
5248,0,5,0,0,5
5249,1,4,0,0,5
5250,0,5,0,0,5
5251,0,5,0,0,5
5252,0,5,0,0,5
5253,0,5,0,0,5
5254,1,4,0,0,5
5255,2,0,1,2,5
5256,0,5,0,0,5
5257,0,5,0,0,5
5258,5,0,0,0,5
5259,3,2,0,0,5
5260,0,5,0,0,5
5261,1,4,0,0,5
5262,0,0,0,5,5
5263,0,5,0,0,5
5264,0,5,0,0,5
5265,1,2,2,0,5
5266,0,5,0,0,5
5267,0,5,0,0,5
5268,3,0,2,0,5
5269,0,5,0,0,5
5270,0,0,1,4,5
5271,0,2,0,3,5
5272,0,5,0,0,5
5273,3,2,0,0,5
5274,0,5,0,0,5
5275,0,5,0,0,5
5276,0,5,0,0,5
5277,0,5,0,0,5
5278,1,0,0,4,5
5279,0,0,0,5,5
5280,1,4,0,0,5
5281,0,5,0,0,5
5282,0,5,0,0,5
5283,0,5,0,0,5
5284,0,4,0,1,5
5285,0,0,2,3,5
5286,1,4,0,0,5
5287,0,5,0,0,5
5288,0,5,0,0,5
5289,1,1,1,2,5
5290,0,5,0,0,5
5291,2,3,0,0,5
5292,4,1,0,0,5
5293,0,5,0,0,5
5294,0,5,0,0,5
5295,0,5,0,0,5
5296,0,0,0,5,5
5297,4,0,1,0,5
5298,0,5,0,0,5
5299,1,3,0,1,5
5300,0,5,0,0,5
5301,0,5,0,0,5
5302,0,5,0,0,5
5303,0,5,0,0,5
5304,0,4,1,0,5
5305,3,0,1,1,5
5306,0,5,0,0,5
5307,0,5,0,0,5
5308,0,5,0,0,5
5309,1,3,1,0,5
5310,0,5,0,0,5
5311,1,4,0,0,5
5312,1,1,1,2,5
5313,2,3,0,0,5
5314,0,5,0,0,5
5315,0,5,0,0,5
5316,0,2,0,3,5
5317,1,1,0,3,5
5318,1,0,3,1,5
5319,0,5,0,0,5
5320,0,5,0,0,5
5321,0,5,0,0,5
5322,0,5,0,0,5
5323,0,5,0,0,5
5324,0,5,0,0,5
5325,0,4,0,1,5
5326,0,5,0,0,5
5327,0,4,1,0,5
5328,0,5,0,0,5
5329,0,5,0,0,5
5330,0,5,0,0,5
5331,4,0,0,1,5
5332,0,5,0,0,5
5333,2,3,0,0,5
5334,0,5,0,0,5
5335,0,4,0,1,5
5336,4,1,0,0,5
5337,3,0,0,2,5
5338,1,0,2,2,5
5339,0,5,0,0,5
5340,5,0,0,0,5
5341,0,1,3,1,5
5342,0,4,0,1,5
5343,0,5,0,0,5
5344,0,5,0,0,5
5345,0,5,0,0,5
5346,0,5,0,0,5
5347,1,1,2,1,5
5348,4,1,0,0,5
5349,0,5,0,0,5
5350,0,5,0,0,5
5351,0,5,0,0,5
5352,2,2,1,0,5
5353,0,5,0,0,5
5354,4,1,0,0,5
5355,1,2,0,2,5
5356,0,5,0,0,5
5357,0,5,0,0,5
5358,0,5,0,0,5
5359,0,5,0,0,5
5360,2,2,0,1,5
5361,4,1,0,0,5
5362,0,5,0,0,5
5363,0,5,0,0,5
5364,0,5,0,0,5
5365,1,0,0,4,5
5366,0,5,0,0,5
5367,0,5,0,0,5
5368,0,5,0,0,5
5369,0,5,0,0,5
5370,0,5,0,0,5
5371,0,5,0,0,5
5372,0,5,0,0,5
5373,0,5,0,0,5
5374,1,1,3,0,5
5375,0,5,0,0,5
5376,5,0,0,0,5
5377,1,1,0,3,5
5378,0,5,0,0,5
5379,0,5,0,0,5
5380,3,1,1,0,5
5381,0,5,0,0,5
5382,1,2,0,2,5
5383,5,0,0,0,5
5384,0,5,0,0,5
5385,0,5,0,0,5
5386,0,5,0,0,5
5387,0,5,0,0,5
5388,0,5,0,0,5
5389,0,5,0,0,5
5390,0,5,0,0,5
5391,3,0,2,0,5
5392,0,5,0,0,5
5393,1,4,0,0,5
5394,1,4,0,0,5
5395,0,5,0,0,5
5396,3,2,0,0,5
5397,1,4,0,0,5
5398,0,5,0,0,5
5399,0,0,3,2,5
5400,0,5,0,0,5
5401,0,5,0,0,5
5402,1,0,3,1,5
5403,2,2,1,0,5
5404,0,5,0,0,5
5405,0,5,0,0,5
5406,0,5,0,0,5
5407,2,3,0,0,5
5408,0,5,0,0,5
5409,0,5,0,0,5
5410,0,5,0,0,5
5411,0,5,0,0,5
5412,0,5,0,0,5
5413,0,0,2,3,5
5414,0,5,0,0,5
5415,1,4,0,0,5
5416,0,5,0,0,5
5417,2,0,0,3,5
5418,1,1,0,3,5
5419,0,0,0,5,5
5420,0,5,0,0,5
5421,0,5,0,0,5
5422,0,1,0,4,5
5423,0,5,0,0,5
5424,1,2,2,0,5
5425,1,0,0,4,5
5426,0,5,0,0,5
5427,0,5,0,0,5
5428,0,5,0,0,5
5429,0,5,0,0,5
5430,2,1,1,1,5
5431,0,5,0,0,5
5432,0,5,0,0,5
5433,0,5,0,0,5
5434,0,5,0,0,5
5435,0,5,0,0,5
5436,0,5,0,0,5
5437,0,5,0,0,5
5438,0,5,0,0,5
5439,0,5,0,0,5
5440,4,1,0,0,5
5441,0,5,0,0,5
5442,0,5,0,0,5
5443,0,5,0,0,5
5444,0,5,0,0,5
5445,0,5,0,0,5
5446,2,0,2,1,5
5447,0,5,0,0,5
5448,0,5,0,0,5
5449,0,5,0,0,5
5450,0,4,1,0,5
5451,1,3,1,0,5
5452,0,5,0,0,5
5453,0,5,0,0,5
5454,0,5,0,0,5
5455,0,5,0,0,5
5456,2,3,0,0,5
5457,1,3,0,1,5
5458,0,5,0,0,5
5459,3,0,2,0,5
5460,0,5,0,0,5
5461,0,5,0,0,5
5462,0,5,0,0,5
5463,1,4,0,0,5
5464,0,5,0,0,5
5465,0,5,0,0,5
5466,2,1,2,0,5
5467,0,5,0,0,5
5468,0,4,0,1,5
5469,0,5,0,0,5
5470,0,5,0,0,5
5471,0,2,0,3,5
5472,0,5,0,0,5
5473,0,5,0,0,5
5474,0,4,0,0,4
5475,1,3,0,0,4
5476,0,4,0,0,4
5477,0,4,0,0,4
5478,0,4,0,0,4
5479,0,4,0,0,4
5480,2,1,0,1,4
5481,0,4,0,0,4
5482,0,4,0,0,4
5483,0,2,0,2,4
5484,0,4,0,0,4
5485,4,0,0,0,4
5486,0,4,0,0,4
5487,0,4,0,0,4
5488,0,4,0,0,4
5489,0,2,1,1,4
5490,0,0,4,0,4
5491,0,4,0,0,4
5492,0,4,0,0,4
5493,2,2,0,0,4
5494,0,4,0,0,4
5495,0,4,0,0,4
5496,0,4,0,0,4
5497,0,4,0,0,4
5498,0,4,0,0,4
5499,0,4,0,0,4
5500,0,4,0,0,4
5501,1,3,0,0,4
5502,0,4,0,0,4
5503,0,4,0,0,4
5504,0,4,0,0,4
5505,0,4,0,0,4
5506,0,4,0,0,4
5507,0,4,0,0,4
5508,1,3,0,0,4
5509,0,4,0,0,4
5510,0,4,0,0,4
5511,0,4,0,0,4
5512,1,0,0,3,4
5513,1,0,3,0,4
5514,0,4,0,0,4
5515,0,4,0,0,4
5516,0,4,0,0,4
5517,0,4,0,0,4
5518,0,2,1,1,4
5519,0,4,0,0,4
5520,0,4,0,0,4
5521,0,4,0,0,4
5522,1,3,0,0,4
5523,1,3,0,0,4
5524,0,4,0,0,4
5525,0,4,0,0,4
5526,0,4,0,0,4
5527,2,2,0,0,4
5528,0,4,0,0,4
5529,1,3,0,0,4
5530,0,4,0,0,4
5531,0,4,0,0,4
5532,4,0,0,0,4
5533,1,1,0,2,4
5534,1,3,0,0,4
5535,0,4,0,0,4
5536,0,4,0,0,4
5537,0,4,0,0,4
5538,0,4,0,0,4
5539,0,4,0,0,4
5540,0,4,0,0,4
5541,0,4,0,0,4
5542,1,3,0,0,4
5543,0,4,0,0,4
5544,2,2,0,0,4
5545,4,0,0,0,4
5546,0,4,0,0,4
5547,1,1,2,0,4
5548,0,4,0,0,4
5549,0,4,0,0,4
5550,0,4,0,0,4
5551,0,4,0,0,4
5552,0,4,0,0,4
5553,1,3,0,0,4
5554,0,4,0,0,4
5555,0,4,0,0,4
5556,0,4,0,0,4
5557,0,0,4,0,4
5558,0,4,0,0,4
5559,0,4,0,0,4
5560,0,4,0,0,4
5561,0,0,4,0,4
5562,0,4,0,0,4
5563,1,3,0,0,4
5564,0,4,0,0,4
5565,2,2,0,0,4
5566,1,2,1,0,4
5567,0,4,0,0,4
5568,0,4,0,0,4
5569,0,4,0,0,4
5570,0,4,0,0,4
5571,0,4,0,0,4
5572,0,4,0,0,4
5573,0,4,0,0,4
5574,0,4,0,0,4
5575,1,3,0,0,4
5576,1,3,0,0,4
5577,2,2,0,0,4
5578,0,3,0,1,4
5579,0,4,0,0,4
5580,1,3,0,0,4
5581,2,0,1,1,4
5582,0,4,0,0,4
5583,0,4,0,0,4
5584,0,4,0,0,4
5585,0,4,0,0,4
5586,0,4,0,0,4
5587,0,4,0,0,4
5588,2,1,1,0,4
5589,0,4,0,0,4
5590,1,3,0,0,4
5591,0,4,0,0,4
5592,0,4,0,0,4
5593,2,2,0,0,4
5594,0,4,0,0,4
5595,0,2,2,0,4
5596,1,3,0,0,4
5597,1,0,3,0,4
5598,0,4,0,0,4
5599,0,1,0,3,4
5600,1,0,3,0,4
5601,0,4,0,0,4
5602,0,4,0,0,4
5603,0,4,0,0,4
5604,0,4,0,0,4
5605,0,4,0,0,4
5606,0,4,0,0,4
5607,0,4,0,0,4
5608,4,0,0,0,4
5609,0,4,0,0,4
5610,0,4,0,0,4
5611,0,4,0,0,4
5612,0,4,0,0,4
5613,0,4,0,0,4
5614,0,2,0,2,4
5615,0,4,0,0,4
5616,2,2,0,0,4
5617,0,4,0,0,4
5618,0,4,0,0,4
5619,2,2,0,0,4
5620,1,3,0,0,4
5621,3,1,0,0,4
5622,0,3,1,0,4
5623,0,4,0,0,4
5624,0,4,0,0,4
5625,0,4,0,0,4
5626,4,0,0,0,4
5627,0,4,0,0,4
5628,2,2,0,0,4
5629,0,4,0,0,4
5630,0,4,0,0,4
5631,1,3,0,0,4
5632,0,4,0,0,4
5633,0,3,0,1,4
5634,0,4,0,0,4
5635,0,2,0,2,4
5636,4,0,0,0,4
5637,0,4,0,0,4
5638,0,4,0,0,4
5639,0,4,0,0,4
5640,0,4,0,0,4
5641,0,4,0,0,4
5642,0,4,0,0,4
5643,0,3,0,1,4
5644,0,4,0,0,4
5645,0,4,0,0,4
5646,0,4,0,0,4
5647,0,4,0,0,4
5648,0,4,0,0,4
5649,0,4,0,0,4
5650,0,4,0,0,4
5651,3,1,0,0,4
5652,1,3,0,0,4
5653,0,4,0,0,4
5654,0,4,0,0,4
5655,2,0,1,1,4
5656,0,4,0,0,4
5657,0,4,0,0,4
5658,0,4,0,0,4
5659,0,4,0,0,4
5660,0,0,0,4,4
5661,0,4,0,0,4
5662,0,4,0,0,4
5663,0,3,1,0,4
5664,0,4,0,0,4
5665,2,2,0,0,4
5666,0,4,0,0,4
5667,0,4,0,0,4
5668,0,1,0,3,4
5669,1,3,0,0,4
5670,0,3,0,1,4
5671,0,0,2,2,4
5672,1,3,0,0,4
5673,0,4,0,0,4
5674,0,4,0,0,4
5675,0,2,0,2,4
5676,0,4,0,0,4
5677,0,4,0,0,4
5678,0,4,0,0,4
5679,0,4,0,0,4
5680,1,3,0,0,4
5681,0,4,0,0,4
5682,0,4,0,0,4
5683,2,2,0,0,4
5684,0,4,0,0,4
5685,0,4,0,0,4
5686,0,4,0,0,4
5687,1,3,0,0,4
5688,0,4,0,0,4
5689,0,4,0,0,4
5690,0,3,0,1,4
5691,0,4,0,0,4
5692,1,1,0,2,4
5693,0,4,0,0,4
5694,0,3,0,1,4
5695,0,4,0,0,4
5696,2,2,0,0,4
5697,0,4,0,0,4
5698,0,4,0,0,4
5699,0,2,0,2,4
5700,0,4,0,0,4
5701,0,4,0,0,4
5702,0,4,0,0,4
5703,0,4,0,0,4
5704,0,4,0,0,4
5705,0,4,0,0,4
5706,0,4,0,0,4
5707,0,4,0,0,4
5708,0,4,0,0,4
5709,0,4,0,0,4
5710,0,4,0,0,4
5711,1,1,2,0,4
5712,0,4,0,0,4
5713,2,0,2,0,4
5714,0,4,0,0,4
5715,0,4,0,0,4
5716,0,4,0,0,4
5717,0,4,0,0,4
5718,1,0,0,3,4
5719,0,4,0,0,4
5720,2,1,0,1,4
5721,0,4,0,0,4
5722,3,0,0,1,4
5723,0,4,0,0,4
5724,0,4,0,0,4
5725,0,2,0,2,4
5726,0,4,0,0,4
5727,0,4,0,0,4
5728,0,4,0,0,4
5729,0,4,0,0,4
5730,0,4,0,0,4
5731,1,3,0,0,4
5732,0,4,0,0,4
5733,4,0,0,0,4
5734,1,2,0,1,4
5735,0,4,0,0,4
5736,0,4,0,0,4
5737,1,2,1,0,4
5738,0,4,0,0,4
5739,0,3,0,1,4
5740,0,4,0,0,4
5741,0,4,0,0,4
5742,0,4,0,0,4
5743,0,4,0,0,4
5744,0,4,0,0,4
5745,0,4,0,0,4
5746,0,4,0,0,4
5747,2,2,0,0,4
5748,0,4,0,0,4
5749,0,4,0,0,4
5750,0,4,0,0,4
5751,0,4,0,0,4
5752,2,0,2,0,4
5753,0,4,0,0,4
5754,0,4,0,0,4
5755,0,4,0,0,4
5756,0,4,0,0,4
5757,1,3,0,0,4
5758,0,3,0,1,4
5759,4,0,0,0,4
5760,0,4,0,0,4
5761,0,3,0,1,4
5762,0,4,0,0,4
5763,0,4,0,0,4
5764,1,3,0,0,4
5765,0,4,0,0,4
5766,0,4,0,0,4
5767,0,4,0,0,4
5768,0,4,0,0,4
5769,0,0,2,2,4
5770,2,0,0,2,4
5771,0,1,0,3,4
5772,1,3,0,0,4
5773,0,4,0,0,4
5774,2,1,1,0,4
5775,0,4,0,0,4
5776,0,4,0,0,4
5777,0,4,0,0,4
5778,0,4,0,0,4
5779,1,3,0,0,4
5780,0,4,0,0,4
5781,1,3,0,0,4
5782,0,4,0,0,4
5783,0,4,0,0,4
5784,3,1,0,0,4
5785,0,4,0,0,4
5786,1,3,0,0,4
5787,4,0,0,0,4
5788,0,4,0,0,4
5789,0,4,0,0,4
5790,0,4,0,0,4
5791,0,4,0,0,4
5792,0,4,0,0,4
5793,0,4,0,0,4
5794,0,4,0,0,4
5795,0,4,0,0,4
5796,0,0,2,2,4
5797,3,1,0,0,4
5798,1,0,1,2,4
5799,0,3,1,0,4
5800,0,4,0,0,4
5801,2,2,0,0,4
5802,0,4,0,0,4
5803,1,3,0,0,4
5804,0,3,1,0,4
5805,1,3,0,0,4
5806,0,4,0,0,4
5807,0,4,0,0,4
5808,0,4,0,0,4
5809,0,4,0,0,4
5810,0,4,0,0,4
5811,0,4,0,0,4
5812,3,0,1,0,4
5813,4,0,0,0,4
5814,0,4,0,0,4
5815,0,4,0,0,4
5816,1,3,0,0,4
5817,1,2,1,0,4
5818,1,3,0,0,4
5819,0,0,1,3,4
5820,0,4,0,0,4
5821,0,4,0,0,4
5822,0,4,0,0,4
5823,1,3,0,0,4
5824,0,4,0,0,4
5825,2,2,0,0,4
5826,0,4,0,0,4
5827,0,4,0,0,4
5828,0,4,0,0,4
5829,0,4,0,0,4
5830,0,4,0,0,4
5831,0,4,0,0,4
5832,0,4,0,0,4
5833,0,4,0,0,4
5834,0,4,0,0,4
5835,0,4,0,0,4
5836,2,1,1,0,4
5837,0,4,0,0,4
5838,3,0,0,1,4
5839,0,4,0,0,4
5840,0,4,0,0,4
5841,0,4,0,0,4
5842,0,4,0,0,4
5843,0,4,0,0,4
5844,0,4,0,0,4
5845,0,4,0,0,4
5846,0,4,0,0,4
5847,0,4,0,0,4
5848,0,4,0,0,4
5849,3,1,0,0,4
5850,0,4,0,0,4
5851,0,4,0,0,4
5852,0,4,0,0,4
5853,0,2,2,0,4
5854,0,4,0,0,4
5855,0,4,0,0,4
5856,4,0,0,0,4
5857,0,4,0,0,4
5858,1,3,0,0,4
5859,0,4,0,0,4
5860,0,4,0,0,4
5861,0,4,0,0,4
5862,0,4,0,0,4
5863,3,1,0,0,4
5864,0,4,0,0,4
5865,3,0,0,1,4
5866,2,0,0,2,4
5867,0,0,0,4,4
5868,0,4,0,0,4
5869,1,3,0,0,4
5870,0,4,0,0,4
5871,0,4,0,0,4
5872,2,2,0,0,4
5873,2,2,0,0,4
5874,0,4,0,0,4
5875,0,4,0,0,4
5876,0,3,1,0,4
5877,1,3,0,0,4
5878,0,4,0,0,4
5879,0,4,0,0,4
5880,2,0,1,1,4
5881,0,4,0,0,4
5882,0,4,0,0,4
5883,0,3,0,1,4
5884,1,3,0,0,4
5885,1,3,0,0,4
5886,0,4,0,0,4
5887,0,4,0,0,4
5888,0,4,0,0,4
5889,1,2,1,0,4
5890,0,4,0,0,4
5891,0,4,0,0,4
5892,0,4,0,0,4
5893,0,4,0,0,4
5894,0,4,0,0,4
5895,3,0,1,0,4
5896,4,0,0,0,4
5897,0,4,0,0,4
5898,0,4,0,0,4
5899,2,2,0,0,4
5900,1,3,0,0,4
5901,0,4,0,0,4
5902,1,3,0,0,4
5903,0,4,0,0,4
5904,0,1,0,3,4
5905,0,4,0,0,4
5906,0,0,1,3,4
5907,0,4,0,0,4
5908,0,4,0,0,4
5909,3,0,0,1,4
5910,0,4,0,0,4
5911,0,4,0,0,4
5912,2,2,0,0,4
5913,0,3,1,0,4
5914,0,4,0,0,4
5915,0,3,1,0,4
5916,0,4,0,0,4
5917,0,4,0,0,4
5918,0,2,1,1,4
5919,0,4,0,0,4
5920,0,3,1,0,4
5921,0,4,0,0,4
5922,0,4,0,0,4
5923,2,2,0,0,4
5924,0,4,0,0,4
5925,0,4,0,0,4
5926,0,0,0,4,4
5927,0,4,0,0,4
5928,1,3,0,0,4
5929,3,0,0,1,4
5930,0,0,1,3,4
5931,0,4,0,0,4
5932,0,4,0,0,4
5933,1,3,0,0,4
5934,3,0,0,1,4
5935,4,0,0,0,4
5936,0,4,0,0,4
5937,0,4,0,0,4
5938,2,1,0,1,4
5939,0,4,0,0,4
5940,0,4,0,0,4
5941,0,4,0,0,4
5942,4,0,0,0,4
5943,0,4,0,0,4
5944,0,4,0,0,4
5945,0,4,0,0,4
5946,1,0,2,1,4
5947,2,2,0,0,4
5948,2,2,0,0,4
5949,0,4,0,0,4
5950,0,4,0,0,4
5951,2,0,0,2,4
5952,0,3,1,0,4
5953,1,0,0,3,4
5954,0,4,0,0,4
5955,0,4,0,0,4
5956,0,4,0,0,4
5957,0,2,0,2,4
5958,0,4,0,0,4
5959,0,4,0,0,4
5960,2,2,0,0,4
5961,0,4,0,0,4
5962,0,3,0,1,4
5963,0,4,0,0,4
5964,0,4,0,0,4
5965,0,4,0,0,4
5966,0,4,0,0,4
5967,0,4,0,0,4
5968,0,4,0,0,4
5969,0,4,0,0,4
5970,0,4,0,0,4
5971,0,4,0,0,4
5972,0,4,0,0,4
5973,0,4,0,0,4
5974,3,0,0,1,4
5975,0,3,1,0,4
5976,0,4,0,0,4
5977,0,4,0,0,4
5978,2,1,1,0,4
5979,2,0,2,0,4
5980,0,4,0,0,4
5981,0,2,0,2,4
5982,1,3,0,0,4
5983,0,4,0,0,4
5984,0,4,0,0,4
5985,1,2,0,1,4
5986,0,4,0,0,4
5987,0,4,0,0,4
5988,0,4,0,0,4
5989,0,0,0,4,4
5990,0,0,0,4,4
5991,4,0,0,0,4
5992,3,0,1,0,4
5993,0,4,0,0,4
5994,4,0,0,0,4
5995,1,2,1,0,4
5996,2,1,0,1,4
5997,2,2,0,0,4
5998,0,4,0,0,4
5999,0,4,0,0,4
6000,3,1,0,0,4
6001,0,4,0,0,4
6002,0,4,0,0,4
6003,3,1,0,0,4
6004,0,4,0,0,4
6005,0,4,0,0,4
6006,0,4,0,0,4
6007,0,4,0,0,4
6008,0,4,0,0,4
6009,0,4,0,0,4
6010,1,0,0,3,4
6011,0,4,0,0,4
6012,0,4,0,0,4
6013,0,4,0,0,4
6014,4,0,0,0,4
6015,0,4,0,0,4
6016,0,4,0,0,4
6017,0,4,0,0,4
6018,0,4,0,0,4
6019,0,4,0,0,4
6020,3,1,0,0,4
6021,1,3,0,0,4
6022,0,4,0,0,4
6023,0,4,0,0,4
6024,1,0,0,3,4
6025,4,0,0,0,4
6026,4,0,0,0,4
6027,0,4,0,0,4
6028,0,4,0,0,4
6029,2,2,0,0,4
6030,0,3,0,1,4
6031,0,4,0,0,4
6032,4,0,0,0,4
6033,0,4,0,0,4
6034,0,4,0,0,4
6035,0,0,1,3,4
6036,0,4,0,0,4
6037,0,4,0,0,4
6038,1,0,0,3,4
6039,1,3,0,0,4
6040,3,0,1,0,4
6041,0,4,0,0,4
6042,0,4,0,0,4
6043,0,4,0,0,4
6044,0,4,0,0,4
6045,2,1,1,0,4
6046,0,4,0,0,4
6047,0,4,0,0,4
6048,1,2,1,0,4
6049,1,1,2,0,4
6050,0,4,0,0,4
6051,0,4,0,0,4
6052,1,3,0,0,4
6053,1,1,1,1,4
6054,0,3,0,1,4
6055,2,2,0,0,4
6056,0,4,0,0,4
6057,0,4,0,0,4
6058,1,3,0,0,4
6059,2,2,0,0,4
6060,0,4,0,0,4
6061,0,4,0,0,4
6062,0,4,0,0,4
6063,0,4,0,0,4
6064,2,0,1,1,4
6065,0,4,0,0,4
6066,1,3,0,0,4
6067,0,4,0,0,4
6068,0,3,0,1,4
6069,0,4,0,0,4
6070,0,3,0,1,4
6071,0,4,0,0,4
6072,1,1,0,2,4
6073,2,2,0,0,4
6074,0,4,0,0,4
6075,0,0,4,0,4
6076,0,4,0,0,4
6077,0,4,0,0,4
6078,0,4,0,0,4
6079,4,0,0,0,4
6080,1,2,0,1,4
6081,2,2,0,0,4
6082,0,4,0,0,4
6083,2,0,2,0,4
6084,0,3,0,1,4
6085,0,4,0,0,4
6086,1,3,0,0,4
6087,2,1,1,0,4
6088,2,1,1,0,4
6089,0,4,0,0,4
6090,0,4,0,0,4
6091,0,4,0,0,4
6092,3,1,0,0,4
6093,2,2,0,0,4
6094,0,4,0,0,4
6095,0,1,3,0,4
6096,0,4,0,0,4
6097,0,4,0,0,4
6098,3,0,0,1,4
6099,0,4,0,0,4
6100,0,4,0,0,4
6101,0,4,0,0,4
6102,0,4,0,0,4
6103,0,4,0,0,4
6104,3,1,0,0,4
6105,0,4,0,0,4
6106,0,4,0,0,4
6107,0,3,1,0,4
6108,0,4,0,0,4
6109,0,2,0,2,4
6110,0,4,0,0,4
6111,1,3,0,0,4
6112,0,4,0,0,4
6113,0,4,0,0,4
6114,0,3,0,1,4
6115,0,4,0,0,4
6116,0,4,0,0,4
6117,0,4,0,0,4
6118,2,0,2,0,4
6119,0,4,0,0,4
6120,0,4,0,0,4
6121,0,4,0,0,4
6122,1,3,0,0,4
6123,0,4,0,0,4
6124,0,4,0,0,4
6125,0,4,0,0,4
6126,1,0,2,1,4
6127,0,4,0,0,4
6128,0,3,0,1,4
6129,1,3,0,0,4
6130,3,0,0,1,4
6131,0,4,0,0,4
6132,1,3,0,0,4
6133,1,0,3,0,4
6134,0,4,0,0,4
6135,1,1,2,0,4
6136,0,4,0,0,4
6137,1,3,0,0,4
6138,1,3,0,0,4
6139,3,1,0,0,4
6140,0,4,0,0,4
6141,4,0,0,0,4
6142,2,0,2,0,4
6143,0,4,0,0,4
6144,0,4,0,0,4
6145,2,2,0,0,4
6146,0,4,0,0,4
6147,0,1,1,2,4
6148,1,3,0,0,4
6149,1,2,1,0,4
6150,0,4,0,0,4
6151,0,4,0,0,4
6152,0,4,0,0,4
6153,0,1,0,3,4
6154,0,4,0,0,4
6155,0,4,0,0,4
6156,0,4,0,0,4
6157,0,3,1,0,4
6158,0,4,0,0,4
6159,0,4,0,0,4
6160,0,4,0,0,4
6161,0,4,0,0,4
6162,0,4,0,0,4
6163,0,4,0,0,4
6164,0,4,0,0,4
6165,0,4,0,0,4
6166,1,3,0,0,4
6167,0,4,0,0,4
6168,0,4,0,0,4
6169,0,4,0,0,4
6170,0,4,0,0,4
6171,0,4,0,0,4
6172,0,4,0,0,4
6173,0,0,0,4,4
6174,2,2,0,0,4
6175,0,4,0,0,4
6176,0,4,0,0,4
6177,0,4,0,0,4
6178,0,4,0,0,4
6179,0,4,0,0,4
6180,0,4,0,0,4
6181,0,4,0,0,4
6182,0,4,0,0,4
6183,0,4,0,0,4
6184,1,2,1,0,4
6185,0,4,0,0,4
6186,3,1,0,0,4
6187,0,4,0,0,4
6188,4,0,0,0,4
6189,0,0,0,4,4
6190,0,0,0,4,4
6191,0,3,1,0,4
6192,2,2,0,0,4
6193,1,2,0,1,4
6194,0,4,0,0,4
6195,0,4,0,0,4
6196,0,4,0,0,4
6197,0,4,0,0,4
6198,0,4,0,0,4
6199,1,1,2,0,4
6200,0,4,0,0,4
6201,0,4,0,0,4
6202,1,1,0,2,4
6203,0,4,0,0,4
6204,0,4,0,0,4
6205,0,4,0,0,4
6206,0,4,0,0,4
6207,0,3,0,1,4
6208,4,0,0,0,4
6209,0,4,0,0,4
6210,1,0,3,0,4
6211,0,4,0,0,4
6212,0,4,0,0,4
6213,0,4,0,0,4
6214,0,4,0,0,4
6215,1,3,0,0,4
6216,3,1,0,0,4
6217,0,4,0,0,4
6218,1,1,1,1,4
6219,0,4,0,0,4
6220,0,4,0,0,4
6221,1,3,0,0,4
6222,3,0,1,0,4
6223,0,4,0,0,4
6224,0,4,0,0,4
6225,0,4,0,0,4
6226,0,4,0,0,4
6227,2,2,0,0,4
6228,0,4,0,0,4
6229,0,4,0,0,4
6230,0,4,0,0,4
6231,4,0,0,0,4
6232,0,4,0,0,4
6233,0,4,0,0,4
6234,0,4,0,0,4
6235,1,3,0,0,4
6236,0,2,0,2,4
6237,0,4,0,0,4
6238,0,4,0,0,4
6239,3,0,0,1,4
6240,0,4,0,0,4
6241,0,3,1,0,4
6242,1,0,0,3,4
6243,2,2,0,0,4
6244,3,1,0,0,4
6245,0,4,0,0,4
6246,0,4,0,0,4
6247,0,4,0,0,4
6248,0,2,0,2,4
6249,1,2,0,1,4
6250,0,4,0,0,4
6251,0,4,0,0,4
6252,0,4,0,0,4
6253,0,1,3,0,4
6254,0,4,0,0,4
6255,0,4,0,0,4
6256,1,0,1,2,4
6257,0,4,0,0,4
6258,0,4,0,0,4
6259,0,4,0,0,4
6260,0,2,2,0,4
6261,0,4,0,0,4
6262,0,4,0,0,4
6263,0,4,0,0,4
6264,2,2,0,0,4
6265,0,4,0,0,4
6266,4,0,0,0,4
6267,0,4,0,0,4
6268,1,3,0,0,4
6269,0,2,0,2,4
6270,0,4,0,0,4
6271,0,4,0,0,4
6272,0,4,0,0,4
6273,1,2,1,0,4
6274,0,4,0,0,4
6275,2,2,0,0,4
6276,0,4,0,0,4
6277,3,1,0,0,4
6278,0,4,0,0,4
6279,0,4,0,0,4
6280,0,4,0,0,4
6281,0,4,0,0,4
6282,0,4,0,0,4
6283,1,0,3,0,4
6284,0,4,0,0,4
6285,0,4,0,0,4
6286,0,4,0,0,4
6287,0,4,0,0,4
6288,0,4,0,0,4
6289,1,3,0,0,4
6290,0,4,0,0,4
6291,2,2,0,0,4
6292,2,2,0,0,4
6293,0,4,0,0,4
6294,0,4,0,0,4
6295,0,4,0,0,4
6296,1,0,0,3,4
6297,0,4,0,0,4
6298,0,4,0,0,4
6299,3,0,0,1,4
6300,0,4,0,0,4
6301,0,4,0,0,4
6302,0,4,0,0,4
6303,3,1,0,0,4
6304,1,2,0,1,4
6305,0,0,2,2,4
6306,0,4,0,0,4
6307,0,4,0,0,4
6308,0,4,0,0,4
6309,0,4,0,0,4
6310,0,4,0,0,4
6311,0,4,0,0,4
6312,0,4,0,0,4
6313,0,4,0,0,4
6314,0,4,0,0,4
6315,0,3,0,1,4
6316,1,3,0,0,4
6317,3,1,0,0,4
6318,0,0,0,4,4
6319,0,4,0,0,4
6320,0,4,0,0,4
6321,0,0,0,4,4
6322,4,0,0,0,4
6323,0,4,0,0,4
6324,0,4,0,0,4
6325,0,4,0,0,4
6326,2,2,0,0,4
6327,0,4,0,0,4
6328,1,3,0,0,4
6329,0,4,0,0,4
6330,0,4,0,0,4
6331,3,0,0,1,4
6332,0,0,2,2,4
6333,0,4,0,0,4
6334,0,4,0,0,4
6335,0,4,0,0,4
6336,0,4,0,0,4
6337,0,3,0,1,4
6338,0,4,0,0,4
6339,0,4,0,0,4
6340,0,4,0,0,4
6341,0,4,0,0,4
6342,0,0,0,4,4
6343,0,4,0,0,4
6344,0,4,0,0,4
6345,0,4,0,0,4
6346,0,4,0,0,4
6347,3,0,1,0,4
6348,0,4,0,0,4
6349,0,4,0,0,4
6350,0,4,0,0,4
6351,0,4,0,0,4
6352,0,4,0,0,4
6353,0,4,0,0,4
6354,4,0,0,0,4
6355,0,4,0,0,4
6356,0,4,0,0,4
6357,0,4,0,0,4
6358,0,4,0,0,4
6359,0,4,0,0,4
6360,0,0,0,4,4
6361,0,4,0,0,4
6362,1,3,0,0,4
6363,0,0,0,4,4
6364,2,0,0,2,4
6365,0,4,0,0,4
6366,0,4,0,0,4
6367,3,0,1,0,4
6368,0,4,0,0,4
6369,0,4,0,0,4
6370,4,0,0,0,4
6371,0,4,0,0,4
6372,0,4,0,0,4
6373,0,4,0,0,4
6374,0,4,0,0,4
6375,0,4,0,0,4
6376,0,4,0,0,4
6377,0,4,0,0,4
6378,0,4,0,0,4
6379,0,4,0,0,4
6380,0,4,0,0,4
6381,4,0,0,0,4
6382,0,4,0,0,4
6383,0,4,0,0,4
6384,0,3,0,1,4
6385,0,4,0,0,4
6386,0,4,0,0,4
6387,3,0,0,1,4
6388,1,0,3,0,4
6389,0,4,0,0,4
6390,0,4,0,0,4
6391,2,1,1,0,4
6392,0,4,0,0,4
6393,0,4,0,0,4
6394,0,4,0,0,4
6395,0,4,0,0,4
6396,0,0,0,4,4
6397,3,0,1,0,4
6398,0,4,0,0,4
6399,0,4,0,0,4
6400,0,4,0,0,4
6401,1,1,0,2,4
6402,0,4,0,0,4
6403,0,4,0,0,4
6404,1,3,0,0,4
6405,0,4,0,0,4
6406,0,4,0,0,4
6407,0,3,1,0,4
6408,0,4,0,0,4
6409,4,0,0,0,4
6410,0,4,0,0,4
6411,0,4,0,0,4
6412,0,4,0,0,4
6413,0,4,0,0,4
6414,0,4,0,0,4
6415,0,4,0,0,4
6416,1,1,0,2,4
6417,0,4,0,0,4
6418,0,4,0,0,4
6419,0,1,0,3,4
6420,0,4,0,0,4
6421,0,4,0,0,4
6422,2,0,2,0,4
6423,0,4,0,0,4
6424,3,0,0,1,4
6425,2,2,0,0,4
6426,0,4,0,0,4
6427,0,4,0,0,4
6428,0,4,0,0,4
6429,0,4,0,0,4
6430,0,4,0,0,4
6431,0,4,0,0,4
6432,4,0,0,0,4
6433,0,4,0,0,4
6434,0,4,0,0,4
6435,0,4,0,0,4
6436,0,4,0,0,4
6437,0,4,0,0,4
6438,0,4,0,0,4
6439,0,4,0,0,4
6440,0,4,0,0,4
6441,0,4,0,0,4
6442,0,3,0,1,4
6443,0,4,0,0,4
6444,0,4,0,0,4
6445,0,4,0,0,4
6446,0,4,0,0,4
6447,2,0,0,2,4
6448,1,2,0,1,4
6449,1,3,0,0,4
6450,0,3,1,0,4
6451,0,4,0,0,4
6452,0,4,0,0,4
6453,0,4,0,0,4
6454,0,4,0,0,4
6455,0,4,0,0,4
6456,2,0,0,2,4
6457,0,4,0,0,4
6458,0,4,0,0,4
6459,1,3,0,0,4
6460,3,1,0,0,4
6461,2,1,1,0,4
6462,0,4,0,0,4
6463,0,4,0,0,4
6464,2,0,2,0,4
6465,0,4,0,0,4
6466,0,4,0,0,4
6467,0,4,0,0,4
6468,0,4,0,0,4
6469,0,4,0,0,4
6470,0,3,0,1,4
6471,0,4,0,0,4
6472,0,4,0,0,4
6473,0,3,1,0,4
6474,3,0,1,0,4
6475,2,1,0,1,4
6476,1,3,0,0,4
6477,0,4,0,0,4
6478,0,4,0,0,4
6479,0,4,0,0,4
6480,0,4,0,0,4
6481,0,4,0,0,4
6482,0,4,0,0,4
6483,0,4,0,0,4
6484,0,4,0,0,4
6485,0,4,0,0,4
6486,0,4,0,0,4
6487,0,4,0,0,4
6488,0,4,0,0,4
6489,0,3,0,1,4
6490,3,0,0,1,4
6491,2,2,0,0,4
6492,0,4,0,0,4
6493,1,2,1,0,4
6494,3,1,0,0,4
6495,3,1,0,0,4
6496,1,0,0,3,4
6497,0,4,0,0,4
6498,0,4,0,0,4
6499,3,0,0,1,4
6500,0,4,0,0,4
6501,0,4,0,0,4
6502,0,4,0,0,4
6503,1,3,0,0,4
6504,1,0,0,3,4
6505,1,3,0,0,4
6506,0,4,0,0,4
6507,0,4,0,0,4
6508,0,1,0,3,4
6509,0,4,0,0,4
6510,0,4,0,0,4
6511,0,4,0,0,4
6512,3,1,0,0,4
6513,1,3,0,0,4
6514,0,0,0,4,4
6515,0,4,0,0,4
6516,2,1,0,1,4
6517,0,4,0,0,4
6518,0,4,0,0,4
6519,0,4,0,0,4
6520,0,4,0,0,4
6521,2,2,0,0,4
6522,2,2,0,0,4
6523,0,4,0,0,4
6524,0,4,0,0,4
6525,0,1,0,3,4
6526,0,4,0,0,4
6527,1,3,0,0,4
6528,0,4,0,0,4
6529,0,4,0,0,4
6530,1,3,0,0,4
6531,0,4,0,0,4
6532,0,4,0,0,4
6533,0,4,0,0,4
6534,3,0,0,1,4
6535,0,4,0,0,4
6536,0,4,0,0,4
6537,0,4,0,0,4
6538,0,4,0,0,4
6539,0,4,0,0,4
6540,0,4,0,0,4
6541,0,4,0,0,4
6542,3,1,0,0,4
6543,1,3,0,0,4
6544,0,4,0,0,4
6545,0,4,0,0,4
6546,0,4,0,0,4
6547,0,4,0,0,4
6548,2,2,0,0,4
6549,0,4,0,0,4
6550,0,4,0,0,4
6551,2,2,0,0,4
6552,0,4,0,0,4
6553,0,4,0,0,4
6554,0,4,0,0,4
6555,0,4,0,0,4
6556,0,4,0,0,4
6557,0,4,0,0,4
6558,0,4,0,0,4
6559,0,0,1,3,4
6560,0,4,0,0,4
6561,0,4,0,0,4
6562,0,4,0,0,4
6563,1,3,0,0,4
6564,0,4,0,0,4
6565,0,4,0,0,4
6566,0,4,0,0,4
6567,1,2,1,0,4
6568,0,0,2,2,4
6569,0,4,0,0,4
6570,0,4,0,0,4
6571,0,4,0,0,4
6572,0,4,0,0,4
6573,0,0,2,2,4
6574,0,4,0,0,4
6575,2,2,0,0,4
6576,0,4,0,0,4
6577,0,1,0,3,4
6578,0,4,0,0,4
6579,0,4,0,0,4
6580,0,4,0,0,4
6581,0,0,0,4,4
6582,3,1,0,0,4
6583,4,0,0,0,4
6584,0,0,0,4,4
6585,0,4,0,0,4
6586,1,3,0,0,4
6587,0,3,1,0,4
6588,0,4,0,0,4
6589,0,4,0,0,4
6590,0,4,0,0,4
6591,0,4,0,0,4
6592,3,1,0,0,4
6593,0,4,0,0,4
6594,0,4,0,0,4
6595,0,4,0,0,4
6596,1,3,0,0,4
6597,0,4,0,0,4
6598,0,4,0,0,4
6599,0,4,0,0,4
6600,0,4,0,0,4
6601,0,4,0,0,4
6602,0,4,0,0,4
6603,3,1,0,0,4
6604,0,4,0,0,4
6605,1,0,3,0,4
6606,0,4,0,0,4
6607,4,0,0,0,4
6608,0,4,0,0,4
6609,0,4,0,0,4
6610,0,4,0,0,4
6611,0,4,0,0,4
6612,1,3,0,0,4
6613,1,3,0,0,4
6614,1,3,0,0,4
6615,0,4,0,0,4
6616,2,1,1,0,4
6617,0,4,0,0,4
6618,0,4,0,0,4
6619,0,2,0,2,4
6620,2,1,0,1,4
6621,0,4,0,0,4
6622,0,4,0,0,4
6623,0,4,0,0,4
6624,1,1,0,2,4
6625,3,1,0,0,4
6626,0,4,0,0,4
6627,0,4,0,0,4
6628,1,2,0,1,4
6629,1,3,0,0,4
6630,2,0,2,0,4
6631,0,4,0,0,4
6632,0,4,0,0,4
6633,0,0,2,2,4
6634,2,0,0,2,4
6635,0,2,0,2,4
6636,1,3,0,0,4
6637,0,4,0,0,4
6638,0,4,0,0,4
6639,1,3,0,0,4
6640,0,4,0,0,4
6641,0,1,0,3,4
6642,0,4,0,0,4
6643,0,4,0,0,4
6644,4,0,0,0,4
6645,2,2,0,0,4
6646,0,4,0,0,4
6647,0,4,0,0,4
6648,4,0,0,0,4
6649,0,4,0,0,4
6650,4,0,0,0,4
6651,1,0,3,0,4
6652,2,2,0,0,4
6653,0,4,0,0,4
6654,0,4,0,0,4
6655,4,0,0,0,4
6656,0,2,2,0,4
6657,0,4,0,0,4
6658,0,4,0,0,4
6659,4,0,0,0,4
6660,0,4,0,0,4
6661,1,1,1,1,4
6662,4,0,0,0,4
6663,2,2,0,0,4
6664,2,2,0,0,4
6665,0,4,0,0,4
6666,4,0,0,0,4
6667,0,3,0,1,4
6668,2,2,0,0,4
6669,3,0,1,0,4
6670,2,2,0,0,4
6671,0,4,0,0,4
6672,0,4,0,0,4
6673,4,0,0,0,4
6674,0,4,0,0,4
6675,0,4,0,0,4
6676,0,4,0,0,4
6677,0,4,0,0,4
6678,2,2,0,0,4
6679,0,4,0,0,4
6680,0,4,0,0,4
6681,4,0,0,0,4
6682,0,4,0,0,4
6683,0,4,0,0,4
6684,0,0,0,4,4
6685,0,4,0,0,4
6686,0,4,0,0,4
6687,0,4,0,0,4
6688,0,4,0,0,4
6689,0,4,0,0,4
6690,0,4,0,0,4
6691,2,1,1,0,4
6692,0,4,0,0,4
6693,0,4,0,0,4
6694,0,0,0,4,4
6695,0,4,0,0,4
6696,0,4,0,0,4
6697,0,4,0,0,4
6698,0,4,0,0,4
6699,1,3,0,0,4
6700,0,4,0,0,4
6701,0,4,0,0,4
6702,0,4,0,0,4
6703,0,4,0,0,4
6704,4,0,0,0,4
6705,0,3,1,0,4
6706,0,4,0,0,4
6707,1,2,0,1,4
6708,0,4,0,0,4
6709,0,2,0,2,4
6710,3,0,1,0,4
6711,0,4,0,0,4
6712,1,2,0,1,4
6713,0,4,0,0,4
6714,0,4,0,0,4
6715,0,4,0,0,4
6716,0,4,0,0,4
6717,0,4,0,0,4
6718,2,2,0,0,4
6719,0,4,0,0,4
6720,2,0,0,2,4
6721,1,0,3,0,4
6722,0,4,0,0,4
6723,0,4,0,0,4
6724,0,4,0,0,4
6725,0,4,0,0,4
6726,1,0,0,3,4
6727,0,4,0,0,4
6728,2,0,1,1,4
6729,1,3,0,0,4
6730,0,4,0,0,4
6731,0,4,0,0,4
6732,0,4,0,0,4
6733,0,4,0,0,4
6734,0,4,0,0,4
6735,1,2,1,0,4
6736,0,4,0,0,4
6737,0,4,0,0,4
6738,2,0,0,2,4
6739,0,4,0,0,4
6740,0,4,0,0,4
6741,0,4,0,0,4
6742,0,4,0,0,4
6743,1,0,3,0,4
6744,0,4,0,0,4
6745,0,4,0,0,4
6746,0,4,0,0,4
6747,2,2,0,0,4
6748,0,4,0,0,4
6749,0,4,0,0,4
6750,2,1,0,1,4
6751,2,0,0,2,4
6752,0,4,0,0,4
6753,0,4,0,0,4
6754,0,4,0,0,4
6755,0,4,0,0,4
6756,0,4,0,0,4
6757,1,0,0,3,4
6758,0,0,0,4,4
6759,4,0,0,0,4
6760,0,4,0,0,4
6761,0,4,0,0,4
6762,1,3,0,0,4
6763,0,2,0,2,4
6764,3,0,0,1,4
6765,0,4,0,0,4
6766,0,4,0,0,4
6767,0,4,0,0,4
6768,1,3,0,0,4
6769,0,0,0,4,4
6770,0,4,0,0,4
6771,0,4,0,0,4
6772,4,0,0,0,4
6773,0,4,0,0,4
6774,1,3,0,0,4
6775,0,4,0,0,4
6776,2,2,0,0,4
6777,0,4,0,0,4
6778,0,4,0,0,4
6779,2,0,1,1,4
6780,0,4,0,0,4
6781,0,4,0,0,4
6782,0,3,0,1,4
6783,0,4,0,0,4
6784,0,4,0,0,4
6785,0,4,0,0,4
6786,0,4,0,0,4
6787,0,4,0,0,4
6788,1,3,0,0,4
6789,2,2,0,0,4
6790,0,4,0,0,4
6791,0,4,0,0,4
6792,0,4,0,0,4
6793,3,1,0,0,4
6794,1,2,0,1,4
6795,0,3,0,1,4
6796,2,2,0,0,4
6797,0,4,0,0,4
6798,0,4,0,0,4
6799,2,1,0,1,4
6800,0,4,0,0,4
6801,1,2,0,1,4
6802,0,4,0,0,4
6803,0,4,0,0,4
6804,0,4,0,0,4
6805,0,4,0,0,4
6806,1,1,2,0,4
6807,0,4,0,0,4
6808,0,1,0,3,4
6809,0,4,0,0,4
6810,3,1,0,0,4
6811,0,4,0,0,4
6812,1,3,0,0,4
6813,0,4,0,0,4
6814,0,2,0,2,4
6815,4,0,0,0,4
6816,1,3,0,0,4
6817,1,0,0,3,4
6818,0,4,0,0,4
6819,1,3,0,0,4
6820,0,4,0,0,4
6821,0,2,0,2,4
6822,2,0,2,0,4
6823,0,4,0,0,4
6824,0,4,0,0,4
6825,1,3,0,0,4
6826,0,4,0,0,4
6827,0,4,0,0,4
6828,0,4,0,0,4
6829,0,4,0,0,4
6830,0,4,0,0,4
6831,3,1,0,0,4
6832,0,4,0,0,4
6833,0,4,0,0,4
6834,1,2,1,0,4
6835,3,1,0,0,4
6836,2,2,0,0,4
6837,0,4,0,0,4
6838,2,0,0,2,4
6839,1,3,0,0,4
6840,0,4,0,0,4
6841,0,4,0,0,4
6842,2,2,0,0,4
6843,1,2,0,1,4
6844,0,4,0,0,4
6845,4,0,0,0,4
6846,0,4,0,0,4
6847,2,1,1,0,4
6848,0,4,0,0,4
6849,0,4,0,0,4
6850,0,4,0,0,4
6851,0,4,0,0,4
6852,0,4,0,0,4
6853,1,0,3,0,4
6854,0,4,0,0,4
6855,0,0,1,3,4
6856,0,4,0,0,4
6857,0,4,0,0,4
6858,0,4,0,0,4
6859,0,4,0,0,4
6860,0,4,0,0,4
6861,1,3,0,0,4
6862,1,3,0,0,4
6863,0,3,1,0,4
6864,0,4,0,0,4
6865,0,4,0,0,4
6866,0,4,0,0,4
6867,0,4,0,0,4
6868,0,4,0,0,4
6869,0,4,0,0,4
6870,1,3,0,0,4
6871,1,3,0,0,4
6872,0,4,0,0,4
6873,0,4,0,0,4
6874,1,3,0,0,4
6875,0,4,0,0,4
6876,4,0,0,0,4
6877,0,4,0,0,4
6878,0,4,0,0,4
6879,0,4,0,0,4
6880,1,3,0,0,4
6881,0,4,0,0,4
6882,0,3,0,1,4
6883,0,4,0,0,4
6884,4,0,0,0,4
6885,1,3,0,0,4
6886,0,4,0,0,4
6887,0,4,0,0,4
6888,1,1,0,2,4
6889,0,4,0,0,4
6890,0,4,0,0,4
6891,0,4,0,0,4
6892,0,4,0,0,4
6893,0,4,0,0,4
6894,0,4,0,0,4
6895,0,4,0,0,4
6896,0,4,0,0,4
6897,0,0,0,4,4
6898,0,4,0,0,4
6899,0,4,0,0,4
6900,0,3,0,1,4
6901,1,3,0,0,4
6902,0,4,0,0,4
6903,0,4,0,0,4
6904,0,4,0,0,4
6905,0,4,0,0,4
6906,0,4,0,0,4
6907,1,1,0,2,4
6908,2,0,0,2,4
6909,1,0,3,0,4
6910,0,4,0,0,4
6911,0,4,0,0,4
6912,0,4,0,0,4
6913,4,0,0,0,4
6914,0,0,0,4,4
6915,0,3,0,1,4
6916,2,2,0,0,4
6917,2,2,0,0,4
6918,0,4,0,0,4
6919,0,4,0,0,4
6920,0,2,0,2,4
6921,0,4,0,0,4
6922,0,3,0,1,4
6923,0,4,0,0,4
6924,0,4,0,0,4
6925,0,4,0,0,4
6926,2,1,1,0,4
6927,0,4,0,0,4
6928,0,4,0,0,4
6929,3,1,0,0,4
6930,0,4,0,0,4
6931,0,4,0,0,4
6932,0,3,0,1,4
6933,0,4,0,0,4
6934,0,4,0,0,4
6935,1,3,0,0,4
6936,0,4,0,0,4
6937,0,4,0,0,4
6938,0,4,0,0,4
6939,1,1,0,2,4
6940,3,1,0,0,4
6941,0,3,0,1,4
6942,1,2,0,1,4
6943,0,4,0,0,4
6944,2,0,2,0,4
6945,1,3,0,0,4
6946,0,4,0,0,4
6947,0,4,0,0,4
6948,2,0,0,2,4
6949,0,3,0,1,4
6950,0,4,0,0,4
6951,0,4,0,0,4
6952,2,2,0,0,4
6953,0,4,0,0,4
6954,0,4,0,0,4
6955,4,0,0,0,4
6956,1,3,0,0,4
6957,1,3,0,0,4
6958,0,4,0,0,4
6959,0,4,0,0,4
6960,0,4,0,0,4
6961,1,3,0,0,4
6962,0,4,0,0,4
6963,3,0,0,1,4
6964,0,4,0,0,4
6965,0,4,0,0,4
6966,0,4,0,0,4
6967,0,4,0,0,4
6968,0,4,0,0,4
6969,1,0,3,0,4
6970,3,0,1,0,4
6971,0,4,0,0,4
6972,1,1,0,2,4
6973,4,0,0,0,4
6974,0,4,0,0,4
6975,0,4,0,0,4
6976,0,4,0,0,4
6977,0,4,0,0,4
6978,0,4,0,0,4
6979,0,4,0,0,4
6980,0,4,0,0,4
6981,1,3,0,0,4
6982,0,4,0,0,4
6983,0,4,0,0,4
6984,0,4,0,0,4
6985,0,4,0,0,4
6986,0,4,0,0,4
6987,1,3,0,0,4
6988,0,1,1,2,4
6989,0,4,0,0,4
6990,0,4,0,0,4
6991,0,4,0,0,4
6992,0,4,0,0,4
6993,0,3,1,0,4
6994,0,3,0,1,4
6995,4,0,0,0,4
6996,0,3,0,1,4
6997,0,2,2,0,4
6998,4,0,0,0,4
6999,0,2,1,1,4
7000,0,4,0,0,4
7001,1,0,1,2,4
7002,0,4,0,0,4
7003,0,4,0,0,4
7004,0,3,0,1,4
7005,0,4,0,0,4
7006,0,4,0,0,4
7007,0,4,0,0,4
7008,0,4,0,0,4
7009,0,4,0,0,4
7010,2,1,0,1,4
7011,0,4,0,0,4
7012,1,3,0,0,4
7013,1,0,1,2,4
7014,0,4,0,0,4
7015,0,4,0,0,4
7016,0,4,0,0,4
7017,0,2,0,2,4
7018,2,2,0,0,4
7019,0,4,0,0,4
7020,2,2,0,0,4
7021,0,4,0,0,4
7022,0,4,0,0,4
7023,0,4,0,0,4
7024,0,4,0,0,4
7025,0,4,0,0,4
7026,0,4,0,0,4
7027,0,4,0,0,4
7028,0,4,0,0,4
7029,0,4,0,0,4
7030,0,4,0,0,4
7031,0,4,0,0,4
7032,0,4,0,0,4
7033,0,4,0,0,4
7034,0,4,0,0,4
7035,0,4,0,0,4
7036,1,0,1,2,4
7037,0,4,0,0,4
7038,0,4,0,0,4
7039,0,3,0,1,4
7040,0,4,0,0,4
7041,0,4,0,0,4
7042,0,4,0,0,4
7043,0,4,0,0,4
7044,0,4,0,0,4
7045,0,1,3,0,4
7046,0,4,0,0,4
7047,0,4,0,0,4
7048,1,3,0,0,4
7049,1,0,0,3,4
7050,0,4,0,0,4
7051,0,2,2,0,4
7052,0,4,0,0,4
7053,2,0,2,0,4
7054,4,0,0,0,4
7055,0,4,0,0,4
7056,0,0,0,4,4
7057,0,4,0,0,4
7058,2,2,0,0,4
7059,0,1,0,3,4
7060,4,0,0,0,4
7061,1,3,0,0,4
7062,1,1,1,1,4
7063,0,4,0,0,4
7064,0,4,0,0,4
7065,0,4,0,0,4
7066,0,4,0,0,4
7067,3,0,1,0,4
7068,0,4,0,0,4
7069,1,3,0,0,4
7070,0,4,0,0,4
7071,0,2,1,1,4
7072,1,2,1,0,4
7073,0,4,0,0,4
7074,0,4,0,0,4
7075,0,4,0,0,4
7076,0,4,0,0,4
7077,0,0,3,1,4
7078,0,4,0,0,4
7079,2,2,0,0,4
7080,0,4,0,0,4
7081,0,4,0,0,4
7082,0,4,0,0,4
7083,0,4,0,0,4
7084,2,2,0,0,4
7085,1,3,0,0,4
7086,0,4,0,0,4
7087,0,4,0,0,4
7088,0,4,0,0,4
7089,0,4,0,0,4
7090,1,2,1,0,4
7091,0,4,0,0,4
7092,0,4,0,0,4
7093,0,4,0,0,4
7094,1,1,2,0,4
7095,1,3,0,0,4
7096,0,4,0,0,4
7097,0,4,0,0,4
7098,2,0,2,0,4
7099,0,4,0,0,4
7100,0,4,0,0,4
7101,0,4,0,0,4
7102,1,0,1,2,4
7103,0,4,0,0,4
7104,0,4,0,0,4
7105,0,4,0,0,4
7106,1,0,2,1,4
7107,0,4,0,0,4
7108,0,3,0,1,4
7109,3,1,0,0,4
7110,0,4,0,0,4
7111,0,4,0,0,4
7112,0,4,0,0,4
7113,0,4,0,0,4
7114,2,1,0,1,4
7115,4,0,0,0,4
7116,1,3,0,0,4
7117,0,4,0,0,4
7118,0,4,0,0,4
7119,0,4,0,0,4
7120,0,4,0,0,4
7121,0,4,0,0,4
7122,0,3,1,0,4
7123,0,4,0,0,4
7124,2,0,2,0,4
7125,0,4,0,0,4
7126,0,4,0,0,4
7127,0,4,0,0,4
7128,3,1,0,0,4
7129,0,4,0,0,4
7130,0,4,0,0,4
7131,0,4,0,0,4
7132,0,4,0,0,4
7133,0,4,0,0,4
7134,1,3,0,0,4
7135,0,4,0,0,4
7136,0,4,0,0,4
7137,0,4,0,0,4
7138,0,4,0,0,4
7139,0,4,0,0,4
7140,0,4,0,0,4
7141,1,3,0,0,4
7142,1,3,0,0,4
7143,2,1,0,1,4
7144,0,4,0,0,4
7145,0,4,0,0,4
7146,0,4,0,0,4
7147,0,0,1,3,4
7148,0,4,0,0,4
7149,0,4,0,0,4
7150,0,4,0,0,4
7151,0,4,0,0,4
7152,1,3,0,0,4
7153,0,4,0,0,4
7154,0,4,0,0,4
7155,4,0,0,0,4
7156,2,2,0,0,4
7157,2,0,0,2,4
7158,0,4,0,0,4
7159,0,3,1,0,4
7160,0,0,0,4,4
7161,0,4,0,0,4
7162,4,0,0,0,4
7163,2,2,0,0,4
7164,0,4,0,0,4
7165,1,3,0,0,4
7166,4,0,0,0,4
7167,3,0,0,1,4
7168,0,4,0,0,4
7169,3,0,1,0,4
7170,0,4,0,0,4
7171,1,3,0,0,4
7172,0,1,0,3,4
7173,0,4,0,0,4
7174,0,4,0,0,4
7175,0,4,0,0,4
7176,0,4,0,0,4
7177,1,3,0,0,4
7178,0,4,0,0,4
7179,1,3,0,0,4
7180,2,2,0,0,4
7181,0,0,0,4,4
7182,0,4,0,0,4
7183,0,4,0,0,4
7184,0,4,0,0,4
7185,0,4,0,0,4
7186,3,1,0,0,4
7187,2,1,0,1,4
7188,0,4,0,0,4
7189,0,4,0,0,4
7190,0,4,0,0,4
7191,1,3,0,0,4
7192,0,4,0,0,4
7193,0,4,0,0,4
7194,1,2,0,1,4
7195,0,4,0,0,4
7196,0,4,0,0,4
7197,0,4,0,0,4
7198,0,4,0,0,4
7199,4,0,0,0,4
7200,0,4,0,0,4
7201,0,4,0,0,4
7202,0,4,0,0,4
7203,0,0,0,4,4
7204,0,4,0,0,4
7205,3,1,0,0,4
7206,3,0,0,1,4
7207,0,4,0,0,4
7208,0,4,0,0,4
7209,0,4,0,0,4
7210,1,1,1,1,4
7211,0,4,0,0,4
7212,2,2,0,0,4
7213,0,4,0,0,4
7214,0,0,2,2,4
7215,2,2,0,0,4
7216,4,0,0,0,4
7217,0,4,0,0,4
7218,1,0,0,3,4
7219,0,4,0,0,4
7220,0,4,0,0,4
7221,1,3,0,0,4
7222,0,3,0,1,4
7223,0,4,0,0,4
7224,1,3,0,0,4
7225,0,4,0,0,4
7226,2,1,0,1,4
7227,0,4,0,0,4
7228,0,4,0,0,4
7229,0,1,0,3,4
7230,1,3,0,0,4
7231,0,4,0,0,4
7232,0,4,0,0,4
7233,0,4,0,0,4
7234,2,0,0,2,4
7235,0,4,0,0,4
7236,1,3,0,0,4
7237,0,4,0,0,4
7238,0,4,0,0,4
7239,0,4,0,0,4
7240,0,4,0,0,4
7241,0,4,0,0,4
7242,0,3,0,1,4
7243,0,4,0,0,4
7244,0,1,3,0,4
7245,2,2,0,0,4
7246,0,4,0,0,4
7247,1,1,0,2,4
7248,0,4,0,0,4
7249,0,4,0,0,4
7250,0,4,0,0,4
7251,0,4,0,0,4
7252,0,4,0,0,4
7253,0,4,0,0,4
7254,1,2,1,0,4
7255,0,4,0,0,4
7256,0,4,0,0,4
7257,0,4,0,0,4
7258,0,4,0,0,4
7259,0,4,0,0,4
7260,2,2,0,0,4
7261,0,4,0,0,4
7262,0,4,0,0,4
7263,1,1,2,0,4
7264,0,4,0,0,4
7265,0,4,0,0,4
7266,0,4,0,0,4
7267,2,0,0,2,4
7268,0,0,0,4,4
7269,0,4,0,0,4
7270,0,4,0,0,4
7271,0,4,0,0,4
7272,1,3,0,0,4
7273,0,3,0,1,4
7274,2,1,1,0,4
7275,0,4,0,0,4
7276,2,0,0,2,4
7277,0,4,0,0,4
7278,0,2,0,2,4
7279,0,4,0,0,4
7280,1,2,0,1,4
7281,0,4,0,0,4
7282,0,4,0,0,4
7283,2,0,0,2,4
7284,2,0,1,1,4
7285,0,3,0,1,4
7286,0,4,0,0,4
7287,0,0,0,4,4
7288,0,4,0,0,4
7289,2,2,0,0,4
7290,0,4,0,0,4
7291,4,0,0,0,4
7292,0,4,0,0,4
7293,3,1,0,0,4
7294,0,4,0,0,4
7295,2,1,0,1,4
7296,0,3,0,1,4
7297,1,3,0,0,4
7298,0,4,0,0,4
7299,0,4,0,0,4
7300,4,0,0,0,4
7301,0,2,2,0,4
7302,0,4,0,0,4
7303,1,0,0,3,4
7304,0,4,0,0,4
7305,0,4,0,0,4
7306,0,4,0,0,4
7307,3,0,0,1,4
7308,0,4,0,0,4
7309,0,4,0,0,4
7310,0,0,0,4,4
7311,0,4,0,0,4
7312,0,4,0,0,4
7313,0,4,0,0,4
7314,0,4,0,0,4
7315,0,4,0,0,4
7316,0,2,2,0,4
7317,0,4,0,0,4
7318,0,4,0,0,4
7319,0,4,0,0,4
7320,0,4,0,0,4
7321,4,0,0,0,4
7322,0,4,0,0,4
7323,0,3,1,0,4
7324,1,0,3,0,4
7325,0,4,0,0,4
7326,3,0,0,1,4
7327,0,4,0,0,4
7328,0,4,0,0,4
7329,3,1,0,0,4
7330,0,4,0,0,4
7331,2,2,0,0,4
7332,0,4,0,0,4
7333,4,0,0,0,4
7334,0,4,0,0,4
7335,0,4,0,0,4
7336,0,4,0,0,4
7337,0,4,0,0,4
7338,4,0,0,0,4
7339,0,4,0,0,4
7340,0,4,0,0,4
7341,0,3,0,1,4
7342,0,4,0,0,4
7343,3,0,0,1,4
7344,0,4,0,0,4
7345,1,3,0,0,4
7346,0,4,0,0,4
7347,0,4,0,0,4
7348,3,1,0,0,4
7349,0,4,0,0,4
7350,0,4,0,0,4
7351,1,3,0,0,4
7352,0,4,0,0,4
7353,1,0,0,3,4
7354,1,3,0,0,4
7355,0,1,3,0,4
7356,1,0,0,3,4
7357,4,0,0,0,4
7358,0,4,0,0,4
7359,0,4,0,0,4
7360,4,0,0,0,4
7361,1,3,0,0,4
7362,3,1,0,0,4
7363,0,4,0,0,4
7364,0,2,1,1,4
7365,0,4,0,0,4
7366,2,2,0,0,4
7367,4,0,0,0,4
7368,0,4,0,0,4
7369,0,4,0,0,4
7370,1,3,0,0,4
7371,0,4,0,0,4
7372,0,4,0,0,4
7373,0,4,0,0,4
7374,0,2,0,2,4
7375,4,0,0,0,4
7376,0,4,0,0,4
7377,0,4,0,0,4
7378,0,4,0,0,4
7379,0,4,0,0,4
7380,0,4,0,0,4
7381,0,4,0,0,4
7382,0,4,0,0,4
7383,0,4,0,0,4
7384,0,0,0,4,4
7385,0,4,0,0,4
7386,0,4,0,0,4
7387,0,4,0,0,4
7388,0,3,0,1,4
7389,0,4,0,0,4
7390,0,4,0,0,4
7391,0,4,0,0,4
7392,2,1,1,0,4
7393,0,4,0,0,4
7394,0,4,0,0,4
7395,0,4,0,0,4
7396,1,1,1,1,4
7397,0,4,0,0,4
7398,2,2,0,0,4
7399,0,4,0,0,4
7400,0,4,0,0,4
7401,0,4,0,0,4
7402,3,1,0,0,4
7403,0,4,0,0,4
7404,0,4,0,0,4
7405,0,4,0,0,4
7406,0,4,0,0,4
7407,0,3,0,1,4
7408,1,0,0,3,4
7409,3,1,0,0,4
7410,1,3,0,0,4
7411,0,4,0,0,4
7412,2,2,0,0,4
7413,1,3,0,0,4
7414,0,4,0,0,4
7415,1,2,0,1,4
7416,0,4,0,0,4
7417,0,4,0,0,4
7418,4,0,0,0,4
7419,1,2,0,1,4
7420,0,4,0,0,4
7421,0,4,0,0,4
7422,0,4,0,0,4
7423,0,4,0,0,4
7424,4,0,0,0,4
7425,0,4,0,0,4
7426,0,4,0,0,4
7427,0,4,0,0,4
7428,0,4,0,0,4
7429,0,4,0,0,4
7430,0,4,0,0,4
7431,0,3,1,0,4
7432,0,4,0,0,4
7433,0,4,0,0,4
7434,1,0,0,3,4
7435,1,3,0,0,4
7436,0,1,1,2,4
7437,0,4,0,0,4
7438,0,4,0,0,4
7439,0,4,0,0,4
7440,0,4,0,0,4
7441,2,2,0,0,4
7442,2,2,0,0,4
7443,0,4,0,0,4
7444,0,4,0,0,4
7445,0,4,0,0,4
7446,2,2,0,0,4
7447,1,3,0,0,4
7448,0,4,0,0,4
7449,2,2,0,0,4
7450,0,4,0,0,4
7451,0,1,3,0,4
7452,0,4,0,0,4
7453,0,4,0,0,4
7454,0,4,0,0,4
7455,0,4,0,0,4
7456,0,4,0,0,4
7457,1,3,0,0,4
7458,0,4,0,0,4
7459,2,1,0,1,4
7460,1,3,0,0,4
7461,0,3,0,1,4
7462,0,4,0,0,4
7463,0,4,0,0,4
7464,0,4,0,0,4
7465,0,4,0,0,4
7466,0,4,0,0,4
7467,1,2,0,1,4
7468,1,1,0,2,4
7469,1,3,0,0,4
7470,0,4,0,0,4
7471,0,4,0,0,4
7472,0,3,0,1,4
7473,0,4,0,0,4
7474,0,4,0,0,4
7475,0,4,0,0,4
7476,0,4,0,0,4
7477,1,3,0,0,4
7478,0,4,0,0,4
7479,0,4,0,0,4
7480,4,0,0,0,4
7481,0,4,0,0,4
7482,1,0,1,2,4
7483,0,4,0,0,4
7484,1,3,0,0,4
7485,0,4,0,0,4
7486,0,4,0,0,4
7487,0,4,0,0,4
7488,0,2,2,0,4
7489,0,4,0,0,4
7490,0,4,0,0,4
7491,2,2,0,0,4
7492,0,4,0,0,4
7493,0,4,0,0,4
7494,1,3,0,0,4
7495,0,4,0,0,4
7496,0,4,0,0,4
7497,0,3,0,1,4
7498,3,1,0,0,4
7499,0,4,0,0,4
7500,1,3,0,0,4
7501,0,4,0,0,4
7502,1,3,0,0,4
7503,1,0,3,0,4
7504,0,4,0,0,4
7505,0,4,0,0,4
7506,2,1,0,1,4
7507,0,4,0,0,4
7508,4,0,0,0,4
7509,0,3,0,0,3
7510,0,3,0,0,3
7511,0,3,0,0,3
7512,2,0,1,0,3
7513,0,3,0,0,3
7514,0,3,0,0,3
7515,0,3,0,0,3
7516,2,0,1,0,3
7517,0,3,0,0,3
7518,0,3,0,0,3
7519,0,3,0,0,3
7520,1,2,0,0,3
7521,0,3,0,0,3
7522,1,2,0,0,3
7523,0,3,0,0,3
7524,0,3,0,0,3
7525,0,3,0,0,3
7526,1,0,0,2,3
7527,0,3,0,0,3
7528,0,2,1,0,3
7529,0,3,0,0,3
7530,0,3,0,0,3
7531,0,0,2,1,3
7532,1,2,0,0,3
7533,3,0,0,0,3
7534,0,3,0,0,3
7535,1,2,0,0,3
7536,0,3,0,0,3
7537,0,3,0,0,3
7538,0,3,0,0,3
7539,3,0,0,0,3
7540,0,2,0,1,3
7541,0,3,0,0,3
7542,0,3,0,0,3
7543,0,3,0,0,3
7544,0,3,0,0,3
7545,0,3,0,0,3
7546,0,3,0,0,3
7547,0,3,0,0,3
7548,0,2,1,0,3
7549,0,0,3,0,3
7550,1,0,2,0,3
7551,0,3,0,0,3
7552,2,1,0,0,3
7553,3,0,0,0,3
7554,1,0,2,0,3
7555,0,3,0,0,3
7556,0,3,0,0,3
7557,0,3,0,0,3
7558,0,2,0,1,3
7559,0,3,0,0,3
7560,0,3,0,0,3
7561,0,3,0,0,3
7562,0,3,0,0,3
7563,0,3,0,0,3
7564,3,0,0,0,3
7565,0,3,0,0,3
7566,0,3,0,0,3
7567,0,3,0,0,3
7568,2,1,0,0,3
7569,0,3,0,0,3
7570,0,3,0,0,3
7571,2,1,0,0,3
7572,0,3,0,0,3
7573,1,0,0,2,3
7574,0,3,0,0,3
7575,2,1,0,0,3
7576,0,0,0,3,3
7577,3,0,0,0,3
7578,1,2,0,0,3
7579,3,0,0,0,3
7580,0,3,0,0,3
7581,0,3,0,0,3
7582,2,1,0,0,3
7583,0,3,0,0,3
7584,0,3,0,0,3
7585,0,3,0,0,3
7586,0,3,0,0,3
7587,1,1,1,0,3
7588,0,2,0,1,3
7589,0,3,0,0,3
7590,2,0,1,0,3
7591,0,3,0,0,3
7592,0,3,0,0,3
7593,0,3,0,0,3
7594,0,3,0,0,3
7595,0,3,0,0,3
7596,0,3,0,0,3
7597,0,3,0,0,3
7598,0,0,2,1,3
7599,0,3,0,0,3
7600,0,3,0,0,3
7601,1,2,0,0,3
7602,0,3,0,0,3
7603,0,3,0,0,3
7604,0,3,0,0,3
7605,0,3,0,0,3
7606,0,3,0,0,3
7607,0,3,0,0,3
7608,1,1,1,0,3
7609,0,3,0,0,3
7610,0,3,0,0,3
7611,1,0,2,0,3
7612,0,3,0,0,3
7613,0,3,0,0,3
7614,0,3,0,0,3
7615,0,3,0,0,3
7616,0,3,0,0,3
7617,0,3,0,0,3
7618,0,3,0,0,3
7619,0,3,0,0,3
7620,0,3,0,0,3
7621,0,3,0,0,3
7622,0,3,0,0,3
7623,0,2,0,1,3
7624,1,1,1,0,3
7625,2,1,0,0,3
7626,0,1,0,2,3
7627,0,3,0,0,3
7628,0,3,0,0,3
7629,0,3,0,0,3
7630,0,3,0,0,3
7631,0,3,0,0,3
7632,0,3,0,0,3
7633,1,1,0,1,3
7634,0,3,0,0,3
7635,0,3,0,0,3
7636,1,2,0,0,3
7637,0,3,0,0,3
7638,2,0,0,1,3
7639,1,2,0,0,3
7640,0,3,0,0,3
7641,0,3,0,0,3
7642,0,3,0,0,3
7643,0,3,0,0,3
7644,0,3,0,0,3
7645,1,1,0,1,3
7646,0,3,0,0,3
7647,0,3,0,0,3
7648,0,3,0,0,3
7649,0,3,0,0,3
7650,0,3,0,0,3
7651,0,3,0,0,3
7652,1,2,0,0,3
7653,0,3,0,0,3
7654,0,3,0,0,3
7655,1,1,0,1,3
7656,0,3,0,0,3
7657,0,3,0,0,3
7658,0,3,0,0,3
7659,0,3,0,0,3
7660,0,3,0,0,3
7661,0,3,0,0,3
7662,0,3,0,0,3
7663,0,3,0,0,3
7664,0,3,0,0,3
7665,0,3,0,0,3
7666,1,2,0,0,3
7667,0,3,0,0,3
7668,2,0,1,0,3
7669,3,0,0,0,3
7670,1,2,0,0,3
7671,0,3,0,0,3
7672,0,3,0,0,3
7673,0,3,0,0,3
7674,0,3,0,0,3
7675,0,3,0,0,3
7676,1,2,0,0,3
7677,0,3,0,0,3
7678,2,1,0,0,3
7679,0,3,0,0,3
7680,0,2,1,0,3
7681,0,1,2,0,3
7682,3,0,0,0,3
7683,0,3,0,0,3
7684,0,3,0,0,3
7685,0,3,0,0,3
7686,0,3,0,0,3
7687,0,1,0,2,3
7688,0,3,0,0,3
7689,0,2,0,1,3
7690,3,0,0,0,3
7691,0,3,0,0,3
7692,2,0,1,0,3
7693,0,3,0,0,3
7694,0,0,0,3,3
7695,0,3,0,0,3
7696,0,3,0,0,3
7697,3,0,0,0,3
7698,3,0,0,0,3
7699,0,3,0,0,3
7700,2,1,0,0,3
7701,0,3,0,0,3
7702,1,0,1,1,3
7703,0,3,0,0,3
7704,0,3,0,0,3
7705,0,3,0,0,3
7706,0,0,0,3,3
7707,2,1,0,0,3
7708,0,3,0,0,3
7709,2,0,1,0,3
7710,0,3,0,0,3
7711,0,3,0,0,3
7712,0,3,0,0,3
7713,0,3,0,0,3
7714,3,0,0,0,3
7715,2,1,0,0,3
7716,0,3,0,0,3
7717,0,3,0,0,3
7718,0,3,0,0,3
7719,0,3,0,0,3
7720,0,3,0,0,3
7721,0,3,0,0,3
7722,0,3,0,0,3
7723,0,1,1,1,3
7724,0,3,0,0,3
7725,0,3,0,0,3
7726,0,3,0,0,3
7727,0,3,0,0,3
7728,0,2,0,1,3
7729,2,1,0,0,3
7730,0,2,1,0,3
7731,3,0,0,0,3
7732,2,1,0,0,3
7733,0,3,0,0,3
7734,0,3,0,0,3
7735,0,1,0,2,3
7736,3,0,0,0,3
7737,3,0,0,0,3
7738,0,3,0,0,3
7739,2,0,1,0,3
7740,0,3,0,0,3
7741,2,0,0,1,3
7742,0,3,0,0,3
7743,1,2,0,0,3
7744,0,3,0,0,3
7745,0,3,0,0,3
7746,0,3,0,0,3
7747,2,0,1,0,3
7748,0,3,0,0,3
7749,1,2,0,0,3
7750,0,0,0,3,3
7751,0,3,0,0,3
7752,0,3,0,0,3
7753,0,3,0,0,3
7754,0,3,0,0,3
7755,3,0,0,0,3
7756,1,0,0,2,3
7757,0,3,0,0,3
7758,0,3,0,0,3
7759,0,3,0,0,3
7760,0,3,0,0,3
7761,2,0,0,1,3
7762,0,3,0,0,3
7763,0,3,0,0,3
7764,0,3,0,0,3
7765,0,3,0,0,3
7766,1,2,0,0,3
7767,1,1,1,0,3
7768,0,3,0,0,3
7769,0,3,0,0,3
7770,0,3,0,0,3
7771,0,3,0,0,3
7772,1,2,0,0,3
7773,0,3,0,0,3
7774,0,3,0,0,3
7775,3,0,0,0,3
7776,0,3,0,0,3
7777,0,3,0,0,3
7778,0,3,0,0,3
7779,0,3,0,0,3
7780,1,1,1,0,3
7781,2,0,0,1,3
7782,0,3,0,0,3
7783,0,3,0,0,3
7784,0,3,0,0,3
7785,0,3,0,0,3
7786,1,2,0,0,3
7787,1,2,0,0,3
7788,1,2,0,0,3
7789,0,3,0,0,3
7790,1,2,0,0,3
7791,3,0,0,0,3
7792,0,3,0,0,3
7793,0,3,0,0,3
7794,0,3,0,0,3
7795,2,1,0,0,3
7796,0,3,0,0,3
7797,0,3,0,0,3
7798,1,2,0,0,3
7799,0,3,0,0,3
7800,1,2,0,0,3
7801,1,2,0,0,3
7802,0,3,0,0,3
7803,0,3,0,0,3
7804,0,1,1,1,3
7805,0,3,0,0,3
7806,3,0,0,0,3
7807,0,3,0,0,3
7808,0,3,0,0,3
7809,0,3,0,0,3
7810,0,3,0,0,3
7811,0,2,1,0,3
7812,0,3,0,0,3
7813,2,0,1,0,3
7814,0,3,0,0,3
7815,0,3,0,0,3
7816,1,1,1,0,3
7817,2,1,0,0,3
7818,0,3,0,0,3
7819,2,1,0,0,3
7820,0,3,0,0,3
7821,0,3,0,0,3
7822,0,3,0,0,3
7823,0,3,0,0,3
7824,0,3,0,0,3
7825,0,3,0,0,3
7826,3,0,0,0,3
7827,0,3,0,0,3
7828,2,1,0,0,3
7829,0,2,1,0,3
7830,0,3,0,0,3
7831,0,3,0,0,3
7832,0,3,0,0,3
7833,0,3,0,0,3
7834,3,0,0,0,3
7835,0,3,0,0,3
7836,0,3,0,0,3
7837,2,1,0,0,3
7838,1,2,0,0,3
7839,0,3,0,0,3
7840,1,2,0,0,3
7841,0,3,0,0,3
7842,2,0,0,1,3
7843,0,2,0,1,3
7844,3,0,0,0,3
7845,0,3,0,0,3
7846,1,0,2,0,3
7847,3,0,0,0,3
7848,0,3,0,0,3
7849,0,3,0,0,3
7850,0,3,0,0,3
7851,1,1,0,1,3
7852,1,2,0,0,3
7853,0,3,0,0,3
7854,0,3,0,0,3
7855,0,3,0,0,3
7856,0,3,0,0,3
7857,0,0,2,1,3
7858,0,3,0,0,3
7859,1,0,1,1,3
7860,1,0,2,0,3
7861,0,3,0,0,3
7862,0,3,0,0,3
7863,2,1,0,0,3
7864,0,3,0,0,3
7865,1,2,0,0,3
7866,0,3,0,0,3
7867,1,1,1,0,3
7868,0,3,0,0,3
7869,0,3,0,0,3
7870,0,3,0,0,3
7871,0,3,0,0,3
7872,1,2,0,0,3
7873,1,2,0,0,3
7874,0,3,0,0,3
7875,0,2,0,1,3
7876,1,2,0,0,3
7877,0,3,0,0,3
7878,0,3,0,0,3
7879,1,0,2,0,3
7880,0,3,0,0,3
7881,0,3,0,0,3
7882,1,2,0,0,3
7883,0,2,0,1,3
7884,0,3,0,0,3
7885,0,3,0,0,3
7886,0,3,0,0,3
7887,0,3,0,0,3
7888,0,3,0,0,3
7889,0,3,0,0,3
7890,0,3,0,0,3
7891,0,3,0,0,3
7892,0,3,0,0,3
7893,0,3,0,0,3
7894,3,0,0,0,3
7895,0,3,0,0,3
7896,0,3,0,0,3
7897,0,3,0,0,3
7898,0,3,0,0,3
7899,0,0,0,3,3
7900,0,3,0,0,3
7901,0,1,2,0,3
7902,3,0,0,0,3
7903,0,3,0,0,3
7904,0,3,0,0,3
7905,0,3,0,0,3
7906,0,3,0,0,3
7907,0,3,0,0,3
7908,0,3,0,0,3
7909,0,3,0,0,3
7910,0,3,0,0,3
7911,0,3,0,0,3
7912,0,3,0,0,3
7913,0,3,0,0,3
7914,0,3,0,0,3
7915,0,3,0,0,3
7916,1,1,1,0,3
7917,0,3,0,0,3
7918,0,3,0,0,3
7919,0,3,0,0,3
7920,0,3,0,0,3
7921,0,3,0,0,3
7922,0,3,0,0,3
7923,0,3,0,0,3
7924,0,2,0,1,3
7925,0,3,0,0,3
7926,0,3,0,0,3
7927,0,3,0,0,3
7928,0,3,0,0,3
7929,0,3,0,0,3
7930,0,3,0,0,3
7931,0,3,0,0,3
7932,1,2,0,0,3
7933,0,2,0,1,3
7934,0,0,0,3,3
7935,2,0,0,1,3
7936,1,2,0,0,3
7937,1,0,0,2,3
7938,0,0,0,3,3
7939,0,3,0,0,3
7940,0,3,0,0,3
7941,0,3,0,0,3
7942,0,3,0,0,3
7943,0,3,0,0,3
7944,0,3,0,0,3
7945,1,2,0,0,3
7946,0,3,0,0,3
7947,0,3,0,0,3
7948,3,0,0,0,3
7949,0,3,0,0,3
7950,0,3,0,0,3
7951,1,0,0,2,3
7952,0,3,0,0,3
7953,0,3,0,0,3
7954,0,3,0,0,3
7955,0,3,0,0,3
7956,2,1,0,0,3
7957,0,2,0,1,3
7958,0,3,0,0,3
7959,0,3,0,0,3
7960,0,3,0,0,3
7961,0,3,0,0,3
7962,0,3,0,0,3
7963,3,0,0,0,3
7964,0,3,0,0,3
7965,0,2,1,0,3
7966,0,3,0,0,3
7967,0,3,0,0,3
7968,3,0,0,0,3
7969,1,2,0,0,3
7970,0,3,0,0,3
7971,0,3,0,0,3
7972,0,3,0,0,3
7973,0,3,0,0,3
7974,0,3,0,0,3
7975,0,3,0,0,3
7976,1,2,0,0,3
7977,0,3,0,0,3
7978,0,2,0,1,3
7979,2,1,0,0,3
7980,0,3,0,0,3
7981,0,3,0,0,3
7982,0,3,0,0,3
7983,0,3,0,0,3
7984,0,3,0,0,3
7985,0,3,0,0,3
7986,0,3,0,0,3
7987,0,3,0,0,3
7988,0,3,0,0,3
7989,1,2,0,0,3
7990,3,0,0,0,3
7991,0,3,0,0,3
7992,0,3,0,0,3
7993,0,3,0,0,3
7994,0,3,0,0,3
7995,0,3,0,0,3
7996,0,3,0,0,3
7997,0,3,0,0,3
7998,0,3,0,0,3
7999,1,0,1,1,3
8000,0,3,0,0,3
8001,0,3,0,0,3
8002,2,0,0,1,3
8003,0,2,0,1,3
8004,0,3,0,0,3
8005,0,3,0,0,3
8006,0,3,0,0,3
8007,0,3,0,0,3
8008,0,3,0,0,3
8009,0,3,0,0,3
8010,0,3,0,0,3
8011,3,0,0,0,3
8012,0,3,0,0,3
8013,0,3,0,0,3
8014,0,0,0,3,3
8015,0,3,0,0,3
8016,0,3,0,0,3
8017,0,3,0,0,3
8018,0,3,0,0,3
8019,0,3,0,0,3
8020,0,0,3,0,3
8021,3,0,0,0,3
8022,0,3,0,0,3
8023,1,1,1,0,3
8024,0,3,0,0,3
8025,1,1,0,1,3
8026,0,3,0,0,3
8027,0,3,0,0,3
8028,0,3,0,0,3
8029,0,3,0,0,3
8030,1,1,0,1,3
8031,0,3,0,0,3
8032,0,3,0,0,3
8033,0,3,0,0,3
8034,0,3,0,0,3
8035,0,3,0,0,3
8036,0,3,0,0,3
8037,0,3,0,0,3
8038,0,3,0,0,3
8039,1,1,1,0,3
8040,1,2,0,0,3
8041,0,3,0,0,3
8042,3,0,0,0,3
8043,0,3,0,0,3
8044,0,3,0,0,3
8045,0,3,0,0,3
8046,0,3,0,0,3
8047,0,0,0,3,3
8048,0,3,0,0,3
8049,0,3,0,0,3
8050,0,3,0,0,3
8051,0,3,0,0,3
8052,0,0,0,3,3
8053,0,3,0,0,3
8054,3,0,0,0,3
8055,0,3,0,0,3
8056,0,3,0,0,3
8057,0,3,0,0,3
8058,0,3,0,0,3
8059,0,3,0,0,3
8060,0,3,0,0,3
8061,0,3,0,0,3
8062,0,3,0,0,3
8063,2,1,0,0,3
8064,0,3,0,0,3
8065,0,3,0,0,3
8066,0,3,0,0,3
8067,0,3,0,0,3
8068,0,3,0,0,3
8069,0,3,0,0,3
8070,0,3,0,0,3
8071,0,3,0,0,3
8072,0,3,0,0,3
8073,1,1,1,0,3
8074,0,3,0,0,3
8075,0,3,0,0,3
8076,0,3,0,0,3
8077,0,3,0,0,3
8078,0,3,0,0,3
8079,0,3,0,0,3
8080,1,2,0,0,3
8081,0,3,0,0,3
8082,0,3,0,0,3
8083,0,3,0,0,3
8084,0,3,0,0,3
8085,0,3,0,0,3
8086,1,2,0,0,3
8087,0,3,0,0,3
8088,0,0,3,0,3
8089,0,3,0,0,3
8090,0,3,0,0,3
8091,0,3,0,0,3
8092,0,3,0,0,3
8093,1,2,0,0,3
8094,0,3,0,0,3
8095,3,0,0,0,3
8096,0,3,0,0,3
8097,0,0,2,1,3
8098,0,3,0,0,3
8099,0,3,0,0,3
8100,0,3,0,0,3
8101,0,3,0,0,3
8102,0,3,0,0,3
8103,0,3,0,0,3
8104,0,3,0,0,3
8105,2,1,0,0,3
8106,1,2,0,0,3
8107,0,3,0,0,3
8108,0,3,0,0,3
8109,0,3,0,0,3
8110,0,3,0,0,3
8111,0,3,0,0,3
8112,1,2,0,0,3
8113,1,0,2,0,3
8114,0,3,0,0,3
8115,0,3,0,0,3
8116,0,3,0,0,3
8117,3,0,0,0,3
8118,0,3,0,0,3
8119,0,3,0,0,3
8120,1,0,2,0,3
8121,0,3,0,0,3
8122,0,3,0,0,3
8123,1,2,0,0,3
8124,0,3,0,0,3
8125,0,3,0,0,3
8126,0,3,0,0,3
8127,0,3,0,0,3
8128,0,3,0,0,3
8129,0,3,0,0,3
8130,1,0,0,2,3
8131,0,3,0,0,3
8132,0,1,1,1,3
8133,0,3,0,0,3
8134,2,0,1,0,3
8135,0,3,0,0,3
8136,0,3,0,0,3
8137,0,3,0,0,3
8138,0,3,0,0,3
8139,0,0,0,3,3
8140,3,0,0,0,3
8141,0,3,0,0,3
8142,0,3,0,0,3
8143,0,3,0,0,3
8144,0,3,0,0,3
8145,3,0,0,0,3
8146,2,0,0,1,3
8147,0,3,0,0,3
8148,1,2,0,0,3
8149,0,1,2,0,3
8150,0,3,0,0,3
8151,0,3,0,0,3
8152,0,0,3,0,3
8153,0,3,0,0,3
8154,0,0,3,0,3
8155,0,3,0,0,3
8156,0,3,0,0,3
8157,0,2,0,1,3
8158,2,1,0,0,3
8159,0,3,0,0,3
8160,0,3,0,0,3
8161,0,3,0,0,3
8162,1,1,0,1,3
8163,0,3,0,0,3
8164,0,3,0,0,3
8165,0,3,0,0,3
8166,1,2,0,0,3
8167,0,3,0,0,3
8168,0,0,0,3,3
8169,0,3,0,0,3
8170,2,1,0,0,3
8171,1,2,0,0,3
8172,0,3,0,0,3
8173,0,3,0,0,3
8174,0,3,0,0,3
8175,0,3,0,0,3
8176,0,2,0,1,3
8177,0,3,0,0,3
8178,2,1,0,0,3
8179,0,3,0,0,3
8180,0,3,0,0,3
8181,0,2,1,0,3
8182,0,3,0,0,3
8183,3,0,0,0,3
8184,0,3,0,0,3
8185,0,0,1,2,3
8186,2,0,0,1,3
8187,0,3,0,0,3
8188,2,0,1,0,3
8189,3,0,0,0,3
8190,2,1,0,0,3
8191,0,3,0,0,3
8192,1,2,0,0,3
8193,0,3,0,0,3
8194,0,3,0,0,3
8195,0,3,0,0,3
8196,3,0,0,0,3
8197,0,2,0,1,3
8198,0,3,0,0,3
8199,0,3,0,0,3
8200,0,3,0,0,3
8201,0,3,0,0,3
8202,1,2,0,0,3
8203,1,2,0,0,3
8204,0,0,2,1,3
8205,2,0,0,1,3
8206,0,3,0,0,3
8207,0,3,0,0,3
8208,3,0,0,0,3
8209,1,1,0,1,3
8210,0,2,0,1,3
8211,2,1,0,0,3
8212,2,0,1,0,3
8213,0,2,1,0,3
8214,0,3,0,0,3
8215,0,3,0,0,3
8216,0,3,0,0,3
8217,0,3,0,0,3
8218,3,0,0,0,3
8219,0,3,0,0,3
8220,0,3,0,0,3
8221,0,3,0,0,3
8222,0,3,0,0,3
8223,0,3,0,0,3
8224,0,3,0,0,3
8225,1,1,1,0,3
8226,0,3,0,0,3
8227,3,0,0,0,3
8228,0,3,0,0,3
8229,0,3,0,0,3
8230,0,1,1,1,3
8231,0,3,0,0,3
8232,0,3,0,0,3
8233,0,3,0,0,3
8234,0,3,0,0,3
8235,2,0,1,0,3
8236,0,3,0,0,3
8237,0,0,2,1,3
8238,1,0,2,0,3
8239,0,3,0,0,3
8240,0,3,0,0,3
8241,0,3,0,0,3
8242,0,3,0,0,3
8243,3,0,0,0,3
8244,3,0,0,0,3
8245,2,1,0,0,3
8246,0,0,1,2,3
8247,0,3,0,0,3
8248,3,0,0,0,3
8249,0,0,1,2,3
8250,3,0,0,0,3
8251,0,0,0,3,3
8252,0,3,0,0,3
8253,0,3,0,0,3
8254,0,3,0,0,3
8255,0,3,0,0,3
8256,0,3,0,0,3
8257,0,3,0,0,3
8258,0,3,0,0,3
8259,0,3,0,0,3
8260,3,0,0,0,3
8261,0,3,0,0,3
8262,0,3,0,0,3
8263,0,3,0,0,3
8264,0,3,0,0,3
8265,1,2,0,0,3
8266,0,0,3,0,3
8267,0,3,0,0,3
8268,0,3,0,0,3
8269,0,3,0,0,3
8270,0,2,1,0,3
8271,1,2,0,0,3
8272,0,3,0,0,3
8273,0,3,0,0,3
8274,0,1,1,1,3
8275,0,3,0,0,3
8276,1,2,0,0,3
8277,0,3,0,0,3
8278,0,3,0,0,3
8279,0,3,0,0,3
8280,2,0,0,1,3
8281,0,3,0,0,3
8282,0,3,0,0,3
8283,1,1,0,1,3
8284,0,3,0,0,3
8285,0,3,0,0,3
8286,0,3,0,0,3
8287,1,2,0,0,3
8288,0,3,0,0,3
8289,0,3,0,0,3
8290,0,3,0,0,3
8291,1,2,0,0,3
8292,0,3,0,0,3
8293,1,2,0,0,3
8294,0,3,0,0,3
8295,0,3,0,0,3
8296,0,3,0,0,3
8297,0,3,0,0,3
8298,0,2,0,1,3
8299,3,0,0,0,3
8300,0,3,0,0,3
8301,0,3,0,0,3
8302,0,3,0,0,3
8303,0,3,0,0,3
8304,0,3,0,0,3
8305,0,3,0,0,3
8306,0,3,0,0,3
8307,1,2,0,0,3
8308,0,3,0,0,3
8309,0,3,0,0,3
8310,3,0,0,0,3
8311,0,3,0,0,3
8312,0,3,0,0,3
8313,0,3,0,0,3
8314,0,3,0,0,3
8315,3,0,0,0,3
8316,2,1,0,0,3
8317,1,2,0,0,3
8318,0,1,2,0,3
8319,0,3,0,0,3
8320,0,3,0,0,3
8321,0,3,0,0,3
8322,0,3,0,0,3
8323,0,3,0,0,3
8324,0,3,0,0,3
8325,1,2,0,0,3
8326,0,3,0,0,3
8327,0,3,0,0,3
8328,2,0,1,0,3
8329,0,3,0,0,3
8330,0,3,0,0,3
8331,2,1,0,0,3
8332,3,0,0,0,3
8333,0,3,0,0,3
8334,2,1,0,0,3
8335,0,3,0,0,3
8336,0,3,0,0,3
8337,0,3,0,0,3
8338,2,1,0,0,3
8339,0,3,0,0,3
8340,0,3,0,0,3
8341,0,3,0,0,3
8342,0,3,0,0,3
8343,0,3,0,0,3
8344,0,3,0,0,3
8345,0,3,0,0,3
8346,0,2,1,0,3
8347,0,3,0,0,3
8348,1,2,0,0,3
8349,0,3,0,0,3
8350,0,3,0,0,3
8351,1,0,1,1,3
8352,1,1,0,1,3
8353,0,3,0,0,3
8354,0,3,0,0,3
8355,0,3,0,0,3
8356,3,0,0,0,3
8357,0,3,0,0,3
8358,0,3,0,0,3
8359,1,0,0,2,3
8360,0,3,0,0,3
8361,1,1,0,1,3
8362,0,3,0,0,3
8363,3,0,0,0,3
8364,1,1,1,0,3
8365,0,3,0,0,3
8366,0,3,0,0,3
8367,0,3,0,0,3
8368,0,3,0,0,3
8369,0,3,0,0,3
8370,1,2,0,0,3
8371,1,0,0,2,3
8372,0,3,0,0,3
8373,0,0,0,3,3
8374,0,3,0,0,3
8375,1,2,0,0,3
8376,0,3,0,0,3
8377,0,3,0,0,3
8378,2,0,0,1,3
8379,1,0,0,2,3
8380,0,3,0,0,3
8381,0,3,0,0,3
8382,0,3,0,0,3
8383,0,3,0,0,3
8384,0,3,0,0,3
8385,0,3,0,0,3
8386,0,3,0,0,3
8387,0,3,0,0,3
8388,0,3,0,0,3
8389,0,0,1,2,3
8390,0,3,0,0,3
8391,0,3,0,0,3
8392,0,3,0,0,3
8393,0,2,0,1,3
8394,0,3,0,0,3
8395,0,3,0,0,3
8396,3,0,0,0,3
8397,0,3,0,0,3
8398,0,3,0,0,3
8399,0,3,0,0,3
8400,2,1,0,0,3
8401,0,2,0,1,3
8402,0,2,0,1,3
8403,0,0,1,2,3
8404,2,0,1,0,3
8405,0,0,0,3,3
8406,3,0,0,0,3
8407,0,3,0,0,3
8408,3,0,0,0,3
8409,0,3,0,0,3
8410,0,3,0,0,3
8411,1,0,0,2,3
8412,1,1,1,0,3
8413,0,3,0,0,3
8414,0,3,0,0,3
8415,0,3,0,0,3
8416,0,3,0,0,3
8417,1,2,0,0,3
8418,0,3,0,0,3
8419,0,3,0,0,3
8420,0,3,0,0,3
8421,2,1,0,0,3
8422,0,3,0,0,3
8423,0,3,0,0,3
8424,3,0,0,0,3
8425,1,2,0,0,3
8426,0,3,0,0,3
8427,0,3,0,0,3
8428,0,3,0,0,3
8429,0,3,0,0,3
8430,3,0,0,0,3
8431,0,3,0,0,3
8432,3,0,0,0,3
8433,0,3,0,0,3
8434,0,3,0,0,3
8435,0,3,0,0,3
8436,3,0,0,0,3
8437,1,0,2,0,3
8438,1,2,0,0,3
8439,0,3,0,0,3
8440,0,3,0,0,3
8441,0,3,0,0,3
8442,1,0,2,0,3
8443,0,0,0,3,3
8444,0,3,0,0,3
8445,0,3,0,0,3
8446,0,3,0,0,3
8447,0,3,0,0,3
8448,0,3,0,0,3
8449,2,0,0,1,3
8450,1,0,2,0,3
8451,0,3,0,0,3
8452,0,3,0,0,3
8453,0,3,0,0,3
8454,0,3,0,0,3
8455,2,0,0,1,3
8456,0,3,0,0,3
8457,1,2,0,0,3
8458,0,3,0,0,3
8459,1,1,1,0,3
8460,0,3,0,0,3
8461,0,3,0,0,3
8462,3,0,0,0,3
8463,0,3,0,0,3
8464,0,3,0,0,3
8465,0,3,0,0,3
8466,3,0,0,0,3
8467,0,3,0,0,3
8468,0,3,0,0,3
8469,0,3,0,0,3
8470,0,2,0,1,3
8471,0,3,0,0,3
8472,0,3,0,0,3
8473,1,2,0,0,3
8474,0,3,0,0,3
8475,0,3,0,0,3
8476,3,0,0,0,3
8477,0,3,0,0,3
8478,3,0,0,0,3
8479,0,3,0,0,3
8480,1,0,1,1,3
8481,2,1,0,0,3
8482,0,3,0,0,3
8483,0,3,0,0,3
8484,0,3,0,0,3
8485,0,0,1,2,3
8486,0,3,0,0,3
8487,0,3,0,0,3
8488,0,3,0,0,3
8489,0,3,0,0,3
8490,1,2,0,0,3
8491,0,3,0,0,3
8492,0,3,0,0,3
8493,0,0,2,1,3
8494,0,3,0,0,3
8495,1,0,0,2,3
8496,0,3,0,0,3
8497,0,3,0,0,3
8498,1,0,0,2,3
8499,0,3,0,0,3
8500,0,3,0,0,3
8501,1,2,0,0,3
8502,1,1,1,0,3
8503,0,3,0,0,3
8504,0,3,0,0,3
8505,1,1,0,1,3
8506,0,3,0,0,3
8507,0,3,0,0,3
8508,0,3,0,0,3
8509,0,3,0,0,3
8510,0,3,0,0,3
8511,2,0,0,1,3
8512,0,3,0,0,3
8513,2,1,0,0,3
8514,0,3,0,0,3
8515,0,3,0,0,3
8516,0,3,0,0,3
8517,2,1,0,0,3
8518,0,3,0,0,3
8519,0,3,0,0,3
8520,0,3,0,0,3
8521,0,3,0,0,3
8522,0,3,0,0,3
8523,2,0,1,0,3
8524,0,3,0,0,3
8525,0,1,0,2,3
8526,2,1,0,0,3
8527,0,3,0,0,3
8528,3,0,0,0,3
8529,1,1,0,1,3
8530,2,0,1,0,3
8531,0,2,0,1,3
8532,1,2,0,0,3
8533,2,0,0,1,3
8534,0,3,0,0,3
8535,1,2,0,0,3
8536,0,3,0,0,3
8537,1,0,2,0,3
8538,3,0,0,0,3
8539,0,3,0,0,3
8540,0,3,0,0,3
8541,0,3,0,0,3
8542,1,1,1,0,3
8543,0,3,0,0,3
8544,0,3,0,0,3
8545,2,1,0,0,3
8546,0,3,0,0,3
8547,1,2,0,0,3
8548,2,1,0,0,3
8549,3,0,0,0,3
8550,0,1,0,2,3
8551,0,3,0,0,3
8552,0,3,0,0,3
8553,0,3,0,0,3
8554,2,0,0,1,3
8555,0,3,0,0,3
8556,0,3,0,0,3
8557,0,3,0,0,3
8558,0,3,0,0,3
8559,0,3,0,0,3
8560,2,1,0,0,3
8561,0,3,0,0,3
8562,0,3,0,0,3
8563,0,3,0,0,3
8564,0,3,0,0,3
8565,0,3,0,0,3
8566,1,1,0,1,3
8567,0,0,0,3,3
8568,1,2,0,0,3
8569,0,3,0,0,3
8570,0,3,0,0,3
8571,0,3,0,0,3
8572,0,3,0,0,3
8573,0,3,0,0,3
8574,0,3,0,0,3
8575,0,3,0,0,3
8576,0,3,0,0,3
8577,0,3,0,0,3
8578,1,2,0,0,3
8579,0,3,0,0,3
8580,0,3,0,0,3
8581,0,3,0,0,3
8582,1,2,0,0,3
8583,0,3,0,0,3
8584,0,3,0,0,3
8585,0,3,0,0,3
8586,0,3,0,0,3
8587,0,3,0,0,3
8588,1,1,0,1,3
8589,0,3,0,0,3
8590,0,3,0,0,3
8591,0,3,0,0,3
8592,0,3,0,0,3
8593,0,3,0,0,3
8594,0,0,0,3,3
8595,0,3,0,0,3
8596,2,0,1,0,3
8597,0,3,0,0,3
8598,0,3,0,0,3
8599,0,3,0,0,3
8600,0,3,0,0,3
8601,0,3,0,0,3
8602,0,3,0,0,3
8603,2,1,0,0,3
8604,0,3,0,0,3
8605,0,3,0,0,3
8606,0,3,0,0,3
8607,0,0,3,0,3
8608,0,3,0,0,3
8609,0,3,0,0,3
8610,0,3,0,0,3
8611,2,1,0,0,3
8612,2,0,0,1,3
8613,3,0,0,0,3
8614,0,3,0,0,3
8615,2,1,0,0,3
8616,0,3,0,0,3
8617,0,2,1,0,3
8618,0,3,0,0,3
8619,0,3,0,0,3
8620,0,3,0,0,3
8621,1,2,0,0,3
8622,0,3,0,0,3
8623,0,3,0,0,3
8624,1,2,0,0,3
8625,0,3,0,0,3
8626,0,0,1,2,3
8627,0,3,0,0,3
8628,3,0,0,0,3
8629,1,2,0,0,3
8630,2,0,0,1,3
8631,0,3,0,0,3
8632,1,0,2,0,3
8633,0,3,0,0,3
8634,1,1,0,1,3
8635,2,1,0,0,3
8636,3,0,0,0,3
8637,0,3,0,0,3
8638,0,3,0,0,3
8639,0,3,0,0,3
8640,2,1,0,0,3
8641,2,0,0,1,3
8642,0,3,0,0,3
8643,1,2,0,0,3
8644,1,0,1,1,3
8645,0,2,0,1,3
8646,0,3,0,0,3
8647,0,3,0,0,3
8648,0,3,0,0,3
8649,0,3,0,0,3
8650,1,0,2,0,3
8651,2,1,0,0,3
8652,0,3,0,0,3
8653,0,3,0,0,3
8654,1,2,0,0,3
8655,0,1,2,0,3
8656,3,0,0,0,3
8657,3,0,0,0,3
8658,0,3,0,0,3
8659,0,2,0,1,3
8660,0,3,0,0,3
8661,0,2,0,1,3
8662,0,3,0,0,3
8663,0,0,0,3,3
8664,0,3,0,0,3
8665,0,3,0,0,3
8666,2,1,0,0,3
8667,0,3,0,0,3
8668,0,3,0,0,3
8669,2,1,0,0,3
8670,0,3,0,0,3
8671,2,1,0,0,3
8672,0,3,0,0,3
8673,1,2,0,0,3
8674,0,3,0,0,3
8675,1,2,0,0,3
8676,0,3,0,0,3
8677,0,3,0,0,3
8678,0,2,1,0,3
8679,0,2,0,1,3
8680,0,3,0,0,3
8681,0,3,0,0,3
8682,1,0,1,1,3
8683,0,3,0,0,3
8684,1,2,0,0,3
8685,0,3,0,0,3
8686,2,0,0,1,3
8687,0,3,0,0,3
8688,0,1,2,0,3
8689,0,3,0,0,3
8690,0,3,0,0,3
8691,1,1,0,1,3
8692,0,3,0,0,3
8693,0,3,0,0,3
8694,0,3,0,0,3
8695,0,3,0,0,3
8696,0,3,0,0,3
8697,0,3,0,0,3
8698,0,3,0,0,3
8699,0,3,0,0,3
8700,0,3,0,0,3
8701,0,3,0,0,3
8702,0,3,0,0,3
8703,0,3,0,0,3
8704,0,3,0,0,3
8705,0,3,0,0,3
8706,0,3,0,0,3
8707,0,3,0,0,3
8708,0,3,0,0,3
8709,1,2,0,0,3
8710,0,3,0,0,3
8711,0,3,0,0,3
8712,0,3,0,0,3
8713,3,0,0,0,3
8714,0,3,0,0,3
8715,0,3,0,0,3
8716,0,3,0,0,3
8717,0,3,0,0,3
8718,0,3,0,0,3
8719,0,3,0,0,3
8720,0,2,0,1,3
8721,0,3,0,0,3
8722,3,0,0,0,3
8723,3,0,0,0,3
8724,1,0,2,0,3
8725,0,3,0,0,3
8726,0,2,1,0,3
8727,0,3,0,0,3
8728,0,3,0,0,3
8729,0,3,0,0,3
8730,0,1,2,0,3
8731,1,0,2,0,3
8732,1,0,0,2,3
8733,2,1,0,0,3
8734,1,2,0,0,3
8735,1,2,0,0,3
8736,2,0,0,1,3
8737,0,3,0,0,3
8738,0,0,0,3,3
8739,0,3,0,0,3
8740,0,3,0,0,3
8741,0,3,0,0,3
8742,0,2,0,1,3
8743,0,3,0,0,3
8744,0,3,0,0,3
8745,1,2,0,0,3
8746,0,0,0,3,3
8747,0,3,0,0,3
8748,0,0,1,2,3
8749,2,1,0,0,3
8750,0,3,0,0,3
8751,0,3,0,0,3
8752,0,3,0,0,3
8753,0,3,0,0,3
8754,0,3,0,0,3
8755,0,3,0,0,3
8756,3,0,0,0,3
8757,0,3,0,0,3
8758,0,3,0,0,3
8759,0,3,0,0,3
8760,0,3,0,0,3
8761,1,2,0,0,3
8762,2,1,0,0,3
8763,1,0,1,1,3
8764,0,1,2,0,3
8765,0,3,0,0,3
8766,1,1,0,1,3
8767,0,0,0,3,3
8768,0,0,3,0,3
8769,2,1,0,0,3
8770,1,2,0,0,3
8771,0,3,0,0,3
8772,0,3,0,0,3
8773,0,0,1,2,3
8774,1,0,2,0,3
8775,0,3,0,0,3
8776,0,3,0,0,3
8777,1,0,2,0,3
8778,0,3,0,0,3
8779,1,2,0,0,3
8780,3,0,0,0,3
8781,0,3,0,0,3
8782,0,3,0,0,3
8783,1,1,1,0,3
8784,2,0,0,1,3
8785,0,3,0,0,3
8786,0,3,0,0,3
8787,0,3,0,0,3
8788,0,0,0,3,3
8789,0,3,0,0,3
8790,0,3,0,0,3
8791,0,3,0,0,3
8792,3,0,0,0,3
8793,3,0,0,0,3
8794,2,1,0,0,3
8795,1,2,0,0,3
8796,3,0,0,0,3
8797,0,1,1,1,3
8798,0,3,0,0,3
8799,0,3,0,0,3
8800,0,3,0,0,3
8801,0,3,0,0,3
8802,0,3,0,0,3
8803,1,2,0,0,3
8804,0,3,0,0,3
8805,0,3,0,0,3
8806,0,3,0,0,3
8807,0,3,0,0,3
8808,0,3,0,0,3
8809,0,3,0,0,3
8810,0,0,0,3,3
8811,0,3,0,0,3
8812,0,3,0,0,3
8813,3,0,0,0,3
8814,0,3,0,0,3
8815,1,2,0,0,3
8816,0,3,0,0,3
8817,0,3,0,0,3
8818,1,2,0,0,3
8819,0,0,0,3,3
8820,0,3,0,0,3
8821,3,0,0,0,3
8822,2,0,1,0,3
8823,0,3,0,0,3
8824,0,3,0,0,3
8825,0,3,0,0,3
8826,1,1,0,1,3
8827,0,3,0,0,3
8828,2,0,0,1,3
8829,1,2,0,0,3
8830,0,3,0,0,3
8831,0,3,0,0,3
8832,1,2,0,0,3
8833,0,3,0,0,3
8834,0,3,0,0,3
8835,0,3,0,0,3
8836,0,2,1,0,3
8837,0,3,0,0,3
8838,1,2,0,0,3
8839,1,2,0,0,3
8840,1,0,0,2,3
8841,0,3,0,0,3
8842,0,3,0,0,3
8843,0,3,0,0,3
8844,2,1,0,0,3
8845,0,3,0,0,3
8846,0,0,0,3,3
8847,0,3,0,0,3
8848,1,2,0,0,3
8849,0,3,0,0,3
8850,0,0,0,3,3
8851,0,3,0,0,3
8852,0,3,0,0,3
8853,1,2,0,0,3
8854,0,3,0,0,3
8855,3,0,0,0,3
8856,0,3,0,0,3
8857,0,3,0,0,3
8858,0,3,0,0,3
8859,0,3,0,0,3
8860,0,3,0,0,3
8861,2,1,0,0,3
8862,0,3,0,0,3
8863,2,0,1,0,3
8864,1,0,2,0,3
8865,0,3,0,0,3
8866,1,2,0,0,3
8867,0,3,0,0,3
8868,1,2,0,0,3
8869,2,1,0,0,3
8870,0,3,0,0,3
8871,0,3,0,0,3
8872,1,2,0,0,3
8873,0,0,0,3,3
8874,2,0,1,0,3
8875,0,3,0,0,3
8876,0,3,0,0,3
8877,1,1,1,0,3
8878,0,3,0,0,3
8879,1,2,0,0,3
8880,1,2,0,0,3
8881,1,1,1,0,3
8882,0,3,0,0,3
8883,0,3,0,0,3
8884,0,3,0,0,3
8885,0,3,0,0,3
8886,0,3,0,0,3
8887,0,3,0,0,3
8888,0,3,0,0,3
8889,0,3,0,0,3
8890,0,0,1,2,3
8891,0,3,0,0,3
8892,0,3,0,0,3
8893,0,3,0,0,3
8894,0,3,0,0,3
8895,0,1,0,2,3
8896,1,2,0,0,3
8897,0,3,0,0,3
8898,0,3,0,0,3
8899,1,2,0,0,3
8900,0,3,0,0,3
8901,0,3,0,0,3
8902,1,0,1,1,3
8903,2,1,0,0,3
8904,3,0,0,0,3
8905,1,0,2,0,3
8906,0,2,1,0,3
8907,0,3,0,0,3
8908,0,3,0,0,3
8909,0,1,0,2,3
8910,1,0,0,2,3
8911,1,2,0,0,3
8912,0,3,0,0,3
8913,0,3,0,0,3
8914,0,3,0,0,3
8915,1,2,0,0,3
8916,0,3,0,0,3
8917,0,3,0,0,3
8918,0,2,1,0,3
8919,0,3,0,0,3
8920,1,1,0,1,3
8921,3,0,0,0,3
8922,0,3,0,0,3
8923,1,2,0,0,3
8924,0,3,0,0,3
8925,0,3,0,0,3
8926,1,2,0,0,3
8927,0,3,0,0,3
8928,0,3,0,0,3
8929,0,0,0,3,3
8930,0,3,0,0,3
8931,0,3,0,0,3
8932,0,3,0,0,3
8933,0,3,0,0,3
8934,0,3,0,0,3
8935,0,3,0,0,3
8936,1,0,1,1,3
8937,0,3,0,0,3
8938,1,0,0,2,3
8939,0,3,0,0,3
8940,0,3,0,0,3
8941,0,3,0,0,3
8942,0,3,0,0,3
8943,1,2,0,0,3
8944,0,0,1,2,3
8945,0,3,0,0,3
8946,3,0,0,0,3
8947,0,3,0,0,3
8948,0,3,0,0,3
8949,0,3,0,0,3
8950,2,1,0,0,3
8951,0,3,0,0,3
8952,3,0,0,0,3
8953,3,0,0,0,3
8954,0,3,0,0,3
8955,0,3,0,0,3
8956,0,3,0,0,3
8957,0,3,0,0,3
8958,0,3,0,0,3
8959,2,1,0,0,3
8960,0,3,0,0,3
8961,0,3,0,0,3
8962,0,3,0,0,3
8963,0,2,0,1,3
8964,0,3,0,0,3
8965,1,2,0,0,3
8966,0,3,0,0,3
8967,0,3,0,0,3
8968,0,3,0,0,3
8969,0,0,0,3,3
8970,0,3,0,0,3
8971,0,3,0,0,3
8972,2,0,1,0,3
8973,2,1,0,0,3
8974,0,3,0,0,3
8975,0,3,0,0,3
8976,0,3,0,0,3
8977,0,3,0,0,3
8978,0,3,0,0,3
8979,0,3,0,0,3
8980,0,3,0,0,3
8981,0,3,0,0,3
8982,0,0,0,3,3
8983,0,3,0,0,3
8984,0,3,0,0,3
8985,0,3,0,0,3
8986,0,2,1,0,3
8987,0,3,0,0,3
8988,0,3,0,0,3
8989,0,3,0,0,3
8990,0,0,0,3,3
8991,0,1,0,2,3
8992,0,3,0,0,3
8993,1,1,0,1,3
8994,0,3,0,0,3
8995,0,3,0,0,3
8996,2,1,0,0,3
8997,1,2,0,0,3
8998,0,3,0,0,3
8999,0,3,0,0,3
9000,0,3,0,0,3
9001,0,3,0,0,3
9002,0,3,0,0,3
9003,0,3,0,0,3
9004,0,3,0,0,3
9005,0,3,0,0,3
9006,0,3,0,0,3
9007,0,3,0,0,3
9008,0,2,1,0,3
9009,0,3,0,0,3
9010,0,2,0,1,3
9011,0,3,0,0,3
9012,0,3,0,0,3
9013,0,3,0,0,3
9014,0,3,0,0,3
9015,0,3,0,0,3
9016,0,3,0,0,3
9017,0,3,0,0,3
9018,0,3,0,0,3
9019,2,0,1,0,3
9020,0,1,0,2,3
9021,0,3,0,0,3
9022,0,3,0,0,3
9023,1,0,1,1,3
9024,1,2,0,0,3
9025,0,3,0,0,3
9026,1,2,0,0,3
9027,0,3,0,0,3
9028,0,0,1,2,3
9029,0,3,0,0,3
9030,0,3,0,0,3
9031,0,2,0,1,3
9032,0,3,0,0,3
9033,0,3,0,0,3
9034,0,3,0,0,3
9035,3,0,0,0,3
9036,0,3,0,0,3
9037,2,0,0,1,3
9038,0,3,0,0,3
9039,0,3,0,0,3
9040,0,3,0,0,3
9041,0,1,1,1,3
9042,0,3,0,0,3
9043,0,3,0,0,3
9044,1,2,0,0,3
9045,0,3,0,0,3
9046,0,3,0,0,3
9047,0,3,0,0,3
9048,0,3,0,0,3
9049,0,3,0,0,3
9050,1,2,0,0,3
9051,0,0,0,3,3
9052,2,0,1,0,3
9053,0,3,0,0,3
9054,0,1,2,0,3
9055,0,3,0,0,3
9056,0,3,0,0,3
9057,1,2,0,0,3
9058,0,3,0,0,3
9059,0,1,2,0,3
9060,0,3,0,0,3
9061,0,3,0,0,3
9062,0,3,0,0,3
9063,0,3,0,0,3
9064,0,3,0,0,3
9065,0,3,0,0,3
9066,1,0,0,2,3
9067,0,3,0,0,3
9068,2,1,0,0,3
9069,0,3,0,0,3
9070,0,3,0,0,3
9071,0,3,0,0,3
9072,0,3,0,0,3
9073,0,3,0,0,3
9074,0,3,0,0,3
9075,1,0,2,0,3
9076,1,2,0,0,3
9077,0,3,0,0,3
9078,1,1,0,1,3
9079,0,3,0,0,3
9080,0,2,0,1,3
9081,0,3,0,0,3
9082,0,3,0,0,3
9083,0,3,0,0,3
9084,0,3,0,0,3
9085,0,3,0,0,3
9086,0,3,0,0,3
9087,0,3,0,0,3
9088,0,3,0,0,3
9089,0,3,0,0,3
9090,0,3,0,0,3
9091,0,3,0,0,3
9092,0,3,0,0,3
9093,1,0,0,2,3
9094,0,0,2,1,3
9095,0,3,0,0,3
9096,0,3,0,0,3
9097,0,3,0,0,3
9098,0,3,0,0,3
9099,0,3,0,0,3
9100,0,3,0,0,3
9101,0,3,0,0,3
9102,0,3,0,0,3
9103,3,0,0,0,3
9104,0,3,0,0,3
9105,0,3,0,0,3
9106,0,0,0,3,3
9107,0,3,0,0,3
9108,0,3,0,0,3
9109,1,2,0,0,3
9110,0,3,0,0,3
9111,0,3,0,0,3
9112,2,1,0,0,3
9113,0,3,0,0,3
9114,0,3,0,0,3
9115,3,0,0,0,3
9116,0,3,0,0,3
9117,0,3,0,0,3
9118,0,3,0,0,3
9119,3,0,0,0,3
9120,0,3,0,0,3
9121,0,3,0,0,3
9122,0,3,0,0,3
9123,0,3,0,0,3
9124,0,3,0,0,3
9125,1,2,0,0,3
9126,0,3,0,0,3
9127,1,2,0,0,3
9128,0,3,0,0,3
9129,0,3,0,0,3
9130,0,3,0,0,3
9131,1,1,1,0,3
9132,2,0,0,1,3
9133,0,3,0,0,3
9134,0,3,0,0,3
9135,0,3,0,0,3
9136,2,0,1,0,3
9137,0,3,0,0,3
9138,2,1,0,0,3
9139,0,3,0,0,3
9140,0,3,0,0,3
9141,0,3,0,0,3
9142,1,2,0,0,3
9143,0,3,0,0,3
9144,0,3,0,0,3
9145,1,0,2,0,3
9146,0,3,0,0,3
9147,0,2,0,1,3
9148,1,2,0,0,3
9149,2,1,0,0,3
9150,0,3,0,0,3
9151,0,3,0,0,3
9152,0,3,0,0,3
9153,0,3,0,0,3
9154,0,0,0,3,3
9155,0,3,0,0,3
9156,0,3,0,0,3
9157,0,3,0,0,3
9158,0,2,1,0,3
9159,0,3,0,0,3
9160,0,3,0,0,3
9161,0,3,0,0,3
9162,0,3,0,0,3
9163,0,2,0,1,3
9164,0,3,0,0,3
9165,1,2,0,0,3
9166,3,0,0,0,3
9167,0,3,0,0,3
9168,0,0,0,3,3
9169,3,0,0,0,3
9170,0,3,0,0,3
9171,2,1,0,0,3
9172,0,3,0,0,3
9173,3,0,0,0,3
9174,0,2,1,0,3
9175,0,3,0,0,3
9176,1,0,0,2,3
9177,0,2,0,1,3
9178,1,1,0,1,3
9179,0,3,0,0,3
9180,0,3,0,0,3
9181,1,2,0,0,3
9182,0,2,1,0,3
9183,0,3,0,0,3
9184,2,1,0,0,3
9185,0,3,0,0,3
9186,0,2,0,1,3
9187,2,0,1,0,3
9188,0,3,0,0,3
9189,0,3,0,0,3
9190,0,3,0,0,3
9191,0,3,0,0,3
9192,0,3,0,0,3
9193,2,1,0,0,3
9194,0,3,0,0,3
9195,0,3,0,0,3
9196,0,3,0,0,3
9197,0,3,0,0,3
9198,0,3,0,0,3
9199,0,3,0,0,3
9200,0,3,0,0,3
9201,0,3,0,0,3
9202,0,3,0,0,3
9203,1,2,0,0,3
9204,1,2,0,0,3
9205,0,3,0,0,3
9206,3,0,0,0,3
9207,0,3,0,0,3
9208,0,3,0,0,3
9209,0,3,0,0,3
9210,0,3,0,0,3
9211,0,3,0,0,3
9212,1,2,0,0,3
9213,0,3,0,0,3
9214,0,3,0,0,3
9215,0,3,0,0,3
9216,0,3,0,0,3
9217,0,3,0,0,3
9218,3,0,0,0,3
9219,3,0,0,0,3
9220,2,0,1,0,3
9221,2,1,0,0,3
9222,0,3,0,0,3
9223,0,3,0,0,3
9224,0,3,0,0,3
9225,0,3,0,0,3
9226,0,3,0,0,3
9227,0,3,0,0,3
9228,0,3,0,0,3
9229,0,3,0,0,3
9230,0,3,0,0,3
9231,1,2,0,0,3
9232,0,3,0,0,3
9233,0,3,0,0,3
9234,0,3,0,0,3
9235,1,0,0,2,3
9236,0,3,0,0,3
9237,0,0,0,3,3
9238,1,1,1,0,3
9239,1,2,0,0,3
9240,0,3,0,0,3
9241,0,3,0,0,3
9242,0,3,0,0,3
9243,2,0,0,1,3
9244,0,3,0,0,3
9245,0,3,0,0,3
9246,0,3,0,0,3
9247,0,0,0,3,3
9248,0,3,0,0,3
9249,0,3,0,0,3
9250,1,2,0,0,3
9251,3,0,0,0,3
9252,0,3,0,0,3
9253,3,0,0,0,3
9254,1,1,1,0,3
9255,0,3,0,0,3
9256,2,1,0,0,3
9257,0,3,0,0,3
9258,0,3,0,0,3
9259,0,3,0,0,3
9260,0,3,0,0,3
9261,0,3,0,0,3
9262,0,3,0,0,3
9263,0,3,0,0,3
9264,0,3,0,0,3
9265,0,3,0,0,3
9266,0,3,0,0,3
9267,1,2,0,0,3
9268,0,3,0,0,3
9269,0,3,0,0,3
9270,0,3,0,0,3
9271,0,3,0,0,3
9272,0,3,0,0,3
9273,0,3,0,0,3
9274,0,3,0,0,3
9275,0,3,0,0,3
9276,0,3,0,0,3
9277,0,3,0,0,3
9278,0,3,0,0,3
9279,0,3,0,0,3
9280,0,2,1,0,3
9281,1,2,0,0,3
9282,0,3,0,0,3
9283,1,0,1,1,3
9284,2,0,0,1,3
9285,1,2,0,0,3
9286,0,1,0,2,3
9287,0,3,0,0,3
9288,0,0,0,3,3
9289,1,1,0,1,3
9290,0,3,0,0,3
9291,0,3,0,0,3
9292,1,1,1,0,3
9293,0,3,0,0,3
9294,0,3,0,0,3
9295,0,3,0,0,3
9296,0,3,0,0,3
9297,1,2,0,0,3
9298,0,3,0,0,3
9299,0,3,0,0,3
9300,0,3,0,0,3
9301,0,3,0,0,3
9302,0,3,0,0,3
9303,0,3,0,0,3
9304,0,3,0,0,3
9305,0,3,0,0,3
9306,3,0,0,0,3
9307,1,1,0,1,3
9308,0,3,0,0,3
9309,3,0,0,0,3
9310,0,3,0,0,3
9311,0,3,0,0,3
9312,1,2,0,0,3
9313,1,2,0,0,3
9314,0,3,0,0,3
9315,0,3,0,0,3
9316,0,3,0,0,3
9317,1,2,0,0,3
9318,0,3,0,0,3
9319,0,3,0,0,3
9320,0,2,0,1,3
9321,0,2,1,0,3
9322,0,3,0,0,3
9323,0,3,0,0,3
9324,0,3,0,0,3
9325,2,1,0,0,3
9326,2,1,0,0,3
9327,0,3,0,0,3
9328,0,3,0,0,3
9329,0,3,0,0,3
9330,0,1,1,1,3
9331,0,3,0,0,3
9332,0,3,0,0,3
9333,0,3,0,0,3
9334,0,3,0,0,3
9335,0,3,0,0,3
9336,0,3,0,0,3
9337,0,3,0,0,3
9338,0,3,0,0,3
9339,0,3,0,0,3
9340,0,3,0,0,3
9341,0,3,0,0,3
9342,0,3,0,0,3
9343,0,3,0,0,3
9344,0,3,0,0,3
9345,2,1,0,0,3
9346,0,3,0,0,3
9347,1,2,0,0,3
9348,0,3,0,0,3
9349,0,3,0,0,3
9350,0,3,0,0,3
9351,0,0,2,1,3
9352,0,2,0,1,3
9353,0,3,0,0,3
9354,2,0,1,0,3
9355,1,2,0,0,3
9356,2,1,0,0,3
9357,0,3,0,0,3
9358,3,0,0,0,3
9359,1,2,0,0,3
9360,3,0,0,0,3
9361,0,1,0,2,3
9362,0,3,0,0,3
9363,0,2,1,0,3
9364,0,3,0,0,3
9365,1,2,0,0,3
9366,2,0,0,1,3
9367,0,3,0,0,3
9368,0,3,0,0,3
9369,0,3,0,0,3
9370,0,3,0,0,3
9371,0,0,2,1,3
9372,0,3,0,0,3
9373,0,3,0,0,3
9374,0,3,0,0,3
9375,1,2,0,0,3
9376,0,3,0,0,3
9377,3,0,0,0,3
9378,0,3,0,0,3
9379,2,1,0,0,3
9380,0,2,1,0,3
9381,0,3,0,0,3
9382,0,3,0,0,3
9383,3,0,0,0,3
9384,0,3,0,0,3
9385,0,3,0,0,3
9386,0,3,0,0,3
9387,0,3,0,0,3
9388,2,1,0,0,3
9389,0,3,0,0,3
9390,0,3,0,0,3
9391,0,3,0,0,3
9392,1,2,0,0,3
9393,2,1,0,0,3
9394,0,3,0,0,3
9395,2,0,0,1,3
9396,0,2,1,0,3
9397,0,3,0,0,3
9398,0,3,0,0,3
9399,2,1,0,0,3
9400,0,3,0,0,3
9401,0,3,0,0,3
9402,0,3,0,0,3
9403,3,0,0,0,3
9404,1,2,0,0,3
9405,0,3,0,0,3
9406,0,3,0,0,3
9407,0,3,0,0,3
9408,0,3,0,0,3
9409,0,1,1,1,3
9410,3,0,0,0,3
9411,1,2,0,0,3
9412,0,3,0,0,3
9413,0,3,0,0,3
9414,2,1,0,0,3
9415,1,2,0,0,3
9416,3,0,0,0,3
9417,0,3,0,0,3
9418,2,1,0,0,3
9419,3,0,0,0,3
9420,2,1,0,0,3
9421,0,3,0,0,3
9422,2,1,0,0,3
9423,2,1,0,0,3
9424,0,3,0,0,3
9425,0,3,0,0,3
9426,0,0,3,0,3
9427,1,2,0,0,3
9428,0,3,0,0,3
9429,2,0,1,0,3
9430,3,0,0,0,3
9431,2,1,0,0,3
9432,3,0,0,0,3
9433,0,3,0,0,3
9434,0,3,0,0,3
9435,2,0,0,1,3
9436,0,3,0,0,3
9437,0,3,0,0,3
9438,1,1,0,1,3
9439,0,3,0,0,3
9440,0,3,0,0,3
9441,0,3,0,0,3
9442,2,0,0,1,3
9443,1,2,0,0,3
9444,0,3,0,0,3
9445,0,3,0,0,3
9446,0,3,0,0,3
9447,3,0,0,0,3
9448,0,3,0,0,3
9449,0,3,0,0,3
9450,0,3,0,0,3
9451,0,3,0,0,3
9452,0,3,0,0,3
9453,3,0,0,0,3
9454,0,3,0,0,3
9455,0,3,0,0,3
9456,1,1,0,1,3
9457,3,0,0,0,3
9458,0,3,0,0,3
9459,0,3,0,0,3
9460,0,1,2,0,3
9461,1,2,0,0,3
9462,0,3,0,0,3
9463,0,3,0,0,3
9464,2,0,0,1,3
9465,0,3,0,0,3
9466,0,3,0,0,3
9467,3,0,0,0,3
9468,3,0,0,0,3
9469,0,3,0,0,3
9470,0,3,0,0,3
9471,0,3,0,0,3
9472,0,3,0,0,3
9473,1,2,0,0,3
9474,0,3,0,0,3
9475,0,3,0,0,3
9476,0,2,0,1,3
9477,1,1,0,1,3
9478,0,3,0,0,3
9479,0,1,0,2,3
9480,1,2,0,0,3
9481,0,3,0,0,3
9482,0,3,0,0,3
9483,0,3,0,0,3
9484,0,3,0,0,3
9485,1,2,0,0,3
9486,1,1,0,1,3
9487,2,0,1,0,3
9488,0,0,2,1,3
9489,0,3,0,0,3
9490,0,3,0,0,3
9491,0,3,0,0,3
9492,0,2,0,1,3
9493,2,1,0,0,3
9494,0,0,0,3,3
9495,0,3,0,0,3
9496,0,3,0,0,3
9497,1,2,0,0,3
9498,0,3,0,0,3
9499,0,3,0,0,3
9500,0,2,0,1,3
9501,1,2,0,0,3
9502,0,3,0,0,3
9503,0,2,0,1,3
9504,1,0,0,2,3
9505,0,3,0,0,3
9506,0,3,0,0,3
9507,0,3,0,0,3
9508,0,3,0,0,3
9509,0,3,0,0,3
9510,0,3,0,0,3
9511,2,1,0,0,3
9512,2,1,0,0,3
9513,0,3,0,0,3
9514,0,3,0,0,3
9515,0,3,0,0,3
9516,0,3,0,0,3
9517,0,3,0,0,3
9518,1,2,0,0,3
9519,0,3,0,0,3
9520,0,3,0,0,3
9521,0,3,0,0,3
9522,0,3,0,0,3
9523,0,3,0,0,3
9524,0,3,0,0,3
9525,0,3,0,0,3
9526,0,3,0,0,3
9527,0,3,0,0,3
9528,0,3,0,0,3
9529,1,2,0,0,3
9530,0,3,0,0,3
9531,3,0,0,0,3
9532,0,0,0,3,3
9533,0,3,0,0,3
9534,1,0,2,0,3
9535,0,3,0,0,3
9536,2,0,0,1,3
9537,0,3,0,0,3
9538,2,0,0,1,3
9539,0,3,0,0,3
9540,0,3,0,0,3
9541,0,3,0,0,3
9542,0,2,1,0,3
9543,0,3,0,0,3
9544,0,3,0,0,3
9545,0,3,0,0,3
9546,0,3,0,0,3
9547,3,0,0,0,3
9548,3,0,0,0,3
9549,0,3,0,0,3
9550,2,0,0,1,3
9551,0,3,0,0,3
9552,0,3,0,0,3
9553,0,3,0,0,3
9554,0,3,0,0,3
9555,1,2,0,0,3
9556,2,1,0,0,3
9557,0,0,1,2,3
9558,3,0,0,0,3
9559,0,3,0,0,3
9560,2,0,0,1,3
9561,2,1,0,0,3
9562,0,3,0,0,3
9563,0,3,0,0,3
9564,0,2,0,1,3
9565,0,3,0,0,3
9566,0,3,0,0,3
9567,0,3,0,0,3
9568,0,3,0,0,3
9569,0,3,0,0,3
9570,0,3,0,0,3
9571,0,3,0,0,3
9572,0,3,0,0,3
9573,0,3,0,0,3
9574,0,3,0,0,3
9575,0,3,0,0,3
9576,0,3,0,0,3
9577,0,3,0,0,3
9578,0,0,3,0,3
9579,0,2,0,1,3
9580,0,3,0,0,3
9581,0,3,0,0,3
9582,2,0,0,1,3
9583,0,3,0,0,3
9584,0,3,0,0,3
9585,3,0,0,0,3
9586,0,3,0,0,3
9587,0,3,0,0,3
9588,0,3,0,0,3
9589,0,3,0,0,3
9590,0,3,0,0,3
9591,0,3,0,0,3
9592,0,3,0,0,3
9593,3,0,0,0,3
9594,0,3,0,0,3
9595,1,0,2,0,3
9596,0,3,0,0,3
9597,0,3,0,0,3
9598,0,3,0,0,3
9599,0,2,0,1,3
9600,0,3,0,0,3
9601,0,3,0,0,3
9602,0,3,0,0,3
9603,0,3,0,0,3
9604,0,3,0,0,3
9605,3,0,0,0,3
9606,0,3,0,0,3
9607,1,1,0,1,3
9608,3,0,0,0,3
9609,0,3,0,0,3
9610,0,2,1,0,3
9611,0,3,0,0,3
9612,0,3,0,0,3
9613,0,3,0,0,3
9614,0,3,0,0,3
9615,0,3,0,0,3
9616,0,3,0,0,3
9617,0,3,0,0,3
9618,0,3,0,0,3
9619,2,0,1,0,3
9620,0,3,0,0,3
9621,0,3,0,0,3
9622,1,2,0,0,3
9623,1,2,0,0,3
9624,0,0,2,1,3
9625,2,0,1,0,3
9626,1,2,0,0,3
9627,1,2,0,0,3
9628,0,3,0,0,3
9629,2,0,0,1,3
9630,0,3,0,0,3
9631,0,3,0,0,3
9632,3,0,0,0,3
9633,0,3,0,0,3
9634,0,3,0,0,3
9635,0,3,0,0,3
9636,2,0,1,0,3
9637,0,3,0,0,3
9638,0,3,0,0,3
9639,0,0,2,1,3
9640,3,0,0,0,3
9641,0,3,0,0,3
9642,0,3,0,0,3
9643,0,3,0,0,3
9644,0,3,0,0,3
9645,2,1,0,0,3
9646,0,1,2,0,3
9647,0,3,0,0,3
9648,0,1,1,1,3
9649,0,3,0,0,3
9650,0,3,0,0,3
9651,0,3,0,0,3
9652,0,3,0,0,3
9653,0,3,0,0,3
9654,0,3,0,0,3
9655,2,1,0,0,3
9656,1,0,0,2,3
9657,0,3,0,0,3
9658,0,3,0,0,3
9659,0,3,0,0,3
9660,1,2,0,0,3
9661,1,0,2,0,3
9662,0,1,0,2,3
9663,1,2,0,0,3
9664,0,3,0,0,3
9665,1,2,0,0,3
9666,3,0,0,0,3
9667,1,2,0,0,3
9668,0,3,0,0,3
9669,0,3,0,0,3
9670,0,3,0,0,3
9671,0,3,0,0,3
9672,0,3,0,0,3
9673,0,3,0,0,3
9674,0,3,0,0,3
9675,1,2,0,0,3
9676,1,1,0,1,3
9677,2,0,0,1,3
9678,0,3,0,0,3
9679,0,1,0,2,3
9680,1,2,0,0,3
9681,2,1,0,0,3
9682,0,3,0,0,3
9683,0,3,0,0,3
9684,0,3,0,0,3
9685,0,3,0,0,3
9686,0,3,0,0,3
9687,0,3,0,0,3
9688,1,0,0,2,3
9689,0,3,0,0,3
9690,0,3,0,0,3
9691,0,3,0,0,3
9692,1,2,0,0,3
9693,0,3,0,0,3
9694,0,3,0,0,3
9695,1,0,0,2,3
9696,1,0,0,2,3
9697,0,3,0,0,3
9698,0,3,0,0,3
9699,2,0,0,1,3
9700,1,2,0,0,3
9701,3,0,0,0,3
9702,2,1,0,0,3
9703,0,3,0,0,3
9704,0,3,0,0,3
9705,1,0,0,2,3
9706,1,0,2,0,3
9707,0,3,0,0,3
9708,2,0,1,0,3
9709,0,0,1,2,3
9710,0,3,0,0,3
9711,0,3,0,0,3
9712,0,0,0,3,3
9713,0,3,0,0,3
9714,1,0,2,0,3
9715,0,3,0,0,3
9716,1,2,0,0,3
9717,2,0,0,1,3
9718,0,3,0,0,3
9719,0,3,0,0,3
9720,0,2,1,0,3
9721,2,0,0,1,3
9722,0,3,0,0,3
9723,0,2,0,1,3
9724,0,3,0,0,3
9725,0,3,0,0,3
9726,1,2,0,0,3
9727,0,3,0,0,3
9728,0,3,0,0,3
9729,1,2,0,0,3
9730,0,3,0,0,3
9731,0,3,0,0,3
9732,3,0,0,0,3
9733,0,3,0,0,3
9734,0,3,0,0,3
9735,1,0,1,1,3
9736,0,3,0,0,3
9737,1,2,0,0,3
9738,0,3,0,0,3
9739,0,0,0,3,3
9740,0,3,0,0,3
9741,2,1,0,0,3
9742,0,3,0,0,3
9743,1,2,0,0,3
9744,0,3,0,0,3
9745,0,1,2,0,3
9746,0,3,0,0,3
9747,0,3,0,0,3
9748,0,3,0,0,3
9749,0,3,0,0,3
9750,0,1,0,2,3
9751,2,1,0,0,3
9752,0,3,0,0,3
9753,0,3,0,0,3
9754,1,2,0,0,3
9755,0,3,0,0,3
9756,0,3,0,0,3
9757,0,3,0,0,3
9758,0,3,0,0,3
9759,0,3,0,0,3
9760,0,3,0,0,3
9761,0,1,2,0,3
9762,0,3,0,0,3
9763,2,1,0,0,3
9764,0,3,0,0,3
9765,3,0,0,0,3
9766,0,3,0,0,3
9767,0,0,0,3,3
9768,0,3,0,0,3
9769,1,2,0,0,3
9770,1,2,0,0,3
9771,0,3,0,0,3
9772,0,3,0,0,3
9773,0,3,0,0,3
9774,0,3,0,0,3
9775,0,3,0,0,3
9776,1,2,0,0,3
9777,1,1,1,0,3
9778,0,3,0,0,3
9779,0,3,0,0,3
9780,0,3,0,0,3
9781,2,1,0,0,3
9782,0,3,0,0,3
9783,0,3,0,0,3
9784,1,1,0,1,3
9785,0,3,0,0,3
9786,0,3,0,0,3
9787,0,3,0,0,3
9788,0,3,0,0,3
9789,0,3,0,0,3
9790,0,3,0,0,3
9791,0,3,0,0,3
9792,0,3,0,0,3
9793,1,1,1,0,3
9794,0,3,0,0,3
9795,0,3,0,0,3
9796,0,3,0,0,3
9797,0,3,0,0,3
9798,1,2,0,0,3
9799,0,3,0,0,3
9800,0,3,0,0,3
9801,0,3,0,0,3
9802,0,3,0,0,3
9803,0,3,0,0,3
9804,0,3,0,0,3
9805,1,2,0,0,3
9806,0,3,0,0,3
9807,2,1,0,0,3
9808,0,3,0,0,3
9809,1,2,0,0,3
9810,0,3,0,0,3
9811,0,3,0,0,3
9812,0,2,0,1,3
9813,0,3,0,0,3
9814,0,3,0,0,3
9815,0,3,0,0,3
9816,0,3,0,0,3
9817,0,2,1,0,3
9818,0,3,0,0,3
9819,0,3,0,0,3
9820,0,3,0,0,3
9821,0,0,0,3,3
9822,0,2,1,0,3
9823,0,3,0,0,3
9824,0,2,0,1,3
9825,0,3,0,0,3
9826,0,3,0,0,3
9827,0,3,0,0,3
9828,0,3,0,0,3
9829,0,3,0,0,3
9830,1,2,0,0,3
9831,1,2,0,0,3
9832,0,3,0,0,3
9833,0,3,0,0,3
9834,0,3,0,0,3
9835,0,3,0,0,3
9836,0,3,0,0,3
9837,0,3,0,0,3
9838,2,0,1,0,3
9839,1,2,0,0,3
9840,0,3,0,0,3
9841,0,3,0,0,3
9842,1,0,0,2,3
9843,0,3,0,0,3
9844,0,3,0,0,3
9845,0,3,0,0,3
9846,0,3,0,0,3
9847,0,3,0,0,3
9848,0,3,0,0,3
9849,0,3,0,0,3
9850,0,3,0,0,3
9851,0,0,0,3,3
9852,1,1,1,0,3
9853,3,0,0,0,3
9854,3,0,0,0,3
9855,0,3,0,0,3
9856,0,3,0,0,3
9857,0,3,0,0,3
9858,0,3,0,0,3
9859,1,2,0,0,3
9860,0,3,0,0,3
9861,0,3,0,0,3
9862,0,3,0,0,3
9863,0,0,0,3,3
9864,0,1,1,1,3
9865,0,2,1,0,3
9866,0,3,0,0,3
9867,3,0,0,0,3
9868,3,0,0,0,3
9869,2,1,0,0,3
9870,0,3,0,0,3
9871,3,0,0,0,3
9872,0,3,0,0,3
9873,2,0,1,0,3
9874,0,3,0,0,3
9875,0,3,0,0,3
9876,0,3,0,0,3
9877,0,3,0,0,3
9878,1,2,0,0,3
9879,0,3,0,0,3
9880,1,2,0,0,3
9881,0,3,0,0,3
9882,0,3,0,0,3
9883,0,3,0,0,3
9884,0,3,0,0,3
9885,0,3,0,0,3
9886,0,3,0,0,3
9887,0,3,0,0,3
9888,0,3,0,0,3
9889,0,3,0,0,3
9890,0,3,0,0,3
9891,0,3,0,0,3
9892,2,0,1,0,3
9893,2,1,0,0,3
9894,1,2,0,0,3
9895,0,3,0,0,3
9896,1,1,0,1,3
9897,0,0,0,3,3
9898,0,3,0,0,3
9899,0,3,0,0,3
9900,0,0,0,3,3
9901,2,0,1,0,3
9902,0,3,0,0,3
9903,2,0,1,0,3
9904,0,3,0,0,3
9905,0,3,0,0,3
9906,0,3,0,0,3
9907,0,3,0,0,3
9908,0,3,0,0,3
9909,0,3,0,0,3
9910,0,3,0,0,3
9911,0,3,0,0,3
9912,0,3,0,0,3
9913,1,0,2,0,3
9914,0,3,0,0,3
9915,2,1,0,0,3
9916,0,3,0,0,3
9917,0,3,0,0,3
9918,0,3,0,0,3
9919,0,3,0,0,3
9920,0,3,0,0,3
9921,0,3,0,0,3
9922,0,3,0,0,3
9923,1,0,1,1,3
9924,0,3,0,0,3
9925,0,3,0,0,3
9926,0,3,0,0,3
9927,3,0,0,0,3
9928,0,3,0,0,3
9929,1,0,2,0,3
9930,0,1,1,1,3
9931,2,0,1,0,3
9932,0,3,0,0,3
9933,0,3,0,0,3
9934,0,0,0,3,3
9935,0,3,0,0,3
9936,0,3,0,0,3
9937,0,3,0,0,3
9938,2,1,0,0,3
9939,0,3,0,0,3
9940,2,0,0,1,3
9941,0,3,0,0,3
9942,0,3,0,0,3
9943,0,2,0,1,3
9944,1,0,0,2,3
9945,1,2,0,0,3
9946,0,3,0,0,3
9947,0,3,0,0,3
9948,0,0,0,3,3
9949,0,3,0,0,3
9950,1,1,1,0,3
9951,0,3,0,0,3
9952,0,3,0,0,3
9953,2,0,0,1,3
9954,0,3,0,0,3
9955,0,3,0,0,3
9956,0,3,0,0,3
9957,0,3,0,0,3
9958,2,1,0,0,3
9959,0,3,0,0,3
9960,0,3,0,0,3
9961,0,1,0,2,3
9962,0,3,0,0,3
9963,1,1,1,0,3
9964,0,3,0,0,3
9965,2,0,0,1,3
9966,0,3,0,0,3
9967,0,3,0,0,3
9968,0,3,0,0,3
9969,0,3,0,0,3
9970,0,1,0,2,3
9971,0,3,0,0,3
9972,0,2,0,1,3
9973,0,3,0,0,3
9974,0,3,0,0,3
9975,2,1,0,0,3
9976,0,3,0,0,3
9977,0,3,0,0,3
9978,0,3,0,0,3
9979,0,2,1,0,3
9980,0,3,0,0,3
9981,0,3,0,0,3
9982,0,3,0,0,3
9983,1,0,0,2,3
9984,0,3,0,0,3
9985,3,0,0,0,3
9986,2,1,0,0,3
9987,0,0,0,3,3
9988,0,3,0,0,3
9989,0,3,0,0,3
9990,1,2,0,0,3
9991,0,3,0,0,3
9992,0,3,0,0,3
9993,0,3,0,0,3
9994,2,1,0,0,3
9995,0,3,0,0,3
9996,0,3,0,0,3
9997,1,0,2,0,3
9998,0,3,0,0,3
9999,0,3,0,0,3
10000,0,3,0,0,3
10001,0,3,0,0,3
10002,0,3,0,0,3
10003,3,0,0,0,3
10004,0,3,0,0,3
10005,0,2,0,1,3
10006,0,1,2,0,3
10007,0,2,1,0,3
10008,0,3,0,0,3
10009,0,3,0,0,3
10010,1,2,0,0,3
10011,0,3,0,0,3
10012,0,3,0,0,3
10013,2,1,0,0,3
10014,2,1,0,0,3
10015,0,3,0,0,3
10016,1,2,0,0,3
10017,0,3,0,0,3
10018,1,1,0,1,3
10019,1,2,0,0,3
10020,0,3,0,0,3
10021,0,3,0,0,3
10022,1,0,2,0,3
10023,2,0,1,0,3
10024,0,3,0,0,3
10025,0,3,0,0,3
10026,3,0,0,0,3
10027,0,3,0,0,3
10028,0,3,0,0,3
10029,0,3,0,0,3
10030,0,3,0,0,3
10031,0,3,0,0,3
10032,1,2,0,0,3
10033,0,3,0,0,3
10034,1,2,0,0,3
10035,0,3,0,0,3
10036,0,3,0,0,3
10037,1,2,0,0,3
10038,0,3,0,0,3
10039,0,3,0,0,3
10040,0,3,0,0,3
10041,2,1,0,0,3
10042,0,3,0,0,3
10043,3,0,0,0,3
10044,0,2,0,1,3
10045,0,3,0,0,3
10046,1,2,0,0,3
10047,0,3,0,0,3
10048,0,3,0,0,3
10049,0,3,0,0,3
10050,0,1,1,1,3
10051,0,3,0,0,3
10052,0,3,0,0,3
10053,1,2,0,0,3
10054,0,3,0,0,3
10055,0,3,0,0,3
10056,0,3,0,0,3
10057,3,0,0,0,3
10058,0,3,0,0,3
10059,1,1,0,1,3
10060,0,3,0,0,3
10061,0,3,0,0,3
10062,0,3,0,0,3
10063,1,2,0,0,3
10064,0,3,0,0,3
10065,1,0,0,2,3
10066,0,3,0,0,3
10067,0,3,0,0,3
10068,0,3,0,0,3
10069,0,1,2,0,3
10070,0,3,0,0,3
10071,0,3,0,0,3
10072,1,0,0,2,3
10073,1,0,2,0,3
10074,0,3,0,0,3
10075,0,3,0,0,3
10076,0,1,0,2,3
10077,0,3,0,0,3
10078,0,3,0,0,3
10079,0,0,3,0,3
10080,1,2,0,0,3
10081,0,3,0,0,3
10082,0,3,0,0,3
10083,0,3,0,0,3
10084,3,0,0,0,3
10085,0,3,0,0,3
10086,0,3,0,0,3
10087,0,3,0,0,3
10088,0,3,0,0,3
10089,0,3,0,0,3
10090,0,3,0,0,3
10091,1,2,0,0,3
10092,0,0,0,3,3
10093,3,0,0,0,3
10094,0,3,0,0,3
10095,1,2,0,0,3
10096,2,1,0,0,3
10097,0,3,0,0,3
10098,0,2,0,1,3
10099,0,3,0,0,3
10100,1,2,0,0,3
10101,0,3,0,0,3
10102,0,1,1,1,3
10103,0,3,0,0,3
10104,0,3,0,0,3
10105,0,3,0,0,3
10106,0,3,0,0,3
10107,2,1,0,0,3
10108,0,3,0,0,3
10109,0,3,0,0,3
10110,1,2,0,0,3
10111,0,2,1,0,3
10112,0,1,1,1,3
10113,1,2,0,0,3
10114,2,1,0,0,3
10115,0,3,0,0,3
10116,0,3,0,0,3
10117,3,0,0,0,3
10118,2,0,1,0,3
10119,0,3,0,0,3
10120,0,3,0,0,3
10121,0,3,0,0,3
10122,2,0,1,0,3
10123,0,3,0,0,3
10124,2,1,0,0,3
10125,0,3,0,0,3
10126,0,3,0,0,3
10127,2,0,0,1,3
10128,0,3,0,0,3
10129,0,3,0,0,3
10130,0,3,0,0,3
10131,0,3,0,0,3
10132,0,3,0,0,3
10133,2,1,0,0,3
10134,0,3,0,0,3
10135,2,0,0,1,3
10136,3,0,0,0,3
10137,0,3,0,0,3
10138,0,3,0,0,3
10139,2,1,0,0,3
10140,0,3,0,0,3
10141,0,3,0,0,3
10142,0,3,0,0,3
10143,0,3,0,0,3
10144,0,3,0,0,3
10145,0,3,0,0,3
10146,0,3,0,0,3
10147,0,3,0,0,3
10148,0,3,0,0,3
10149,3,0,0,0,3
10150,0,3,0,0,3
10151,0,3,0,0,3
10152,0,3,0,0,3
10153,0,0,3,0,3
10154,1,0,2,0,3
10155,0,3,0,0,3
10156,0,3,0,0,3
10157,0,3,0,0,3
10158,0,3,0,0,3
10159,1,2,0,0,3
10160,2,0,0,1,3
10161,0,3,0,0,3
10162,0,3,0,0,3
10163,0,3,0,0,3
10164,0,0,0,3,3
10165,0,3,0,0,3
10166,0,3,0,0,3
10167,0,2,0,1,3
10168,0,3,0,0,3
10169,0,3,0,0,3
10170,0,3,0,0,3
10171,0,3,0,0,3
10172,0,3,0,0,3
10173,0,0,1,2,3
10174,1,2,0,0,3
10175,0,3,0,0,3
10176,1,1,0,1,3
10177,0,3,0,0,3
10178,0,3,0,0,3
10179,0,3,0,0,3
10180,0,3,0,0,3
10181,3,0,0,0,3
10182,0,3,0,0,3
10183,0,3,0,0,3
10184,3,0,0,0,3
10185,1,1,0,1,3
10186,1,2,0,0,3
10187,1,2,0,0,3
10188,0,3,0,0,3
10189,0,3,0,0,3
10190,3,0,0,0,3
10191,0,3,0,0,3
10192,0,3,0,0,3
10193,0,3,0,0,3
10194,0,3,0,0,3
10195,1,2,0,0,3
10196,1,0,0,2,3
10197,0,3,0,0,3
10198,1,0,2,0,3
10199,0,3,0,0,3
10200,0,1,0,2,3
10201,0,3,0,0,3
10202,0,3,0,0,3
10203,0,0,1,2,3
10204,1,2,0,0,3
10205,0,3,0,0,3
10206,0,3,0,0,3
10207,3,0,0,0,3
10208,0,3,0,0,3
10209,0,3,0,0,3
10210,0,3,0,0,3
10211,0,3,0,0,3
10212,0,3,0,0,3
10213,0,3,0,0,3
10214,0,3,0,0,3
10215,1,2,0,0,3
10216,0,3,0,0,3
10217,0,3,0,0,3
10218,0,3,0,0,3
10219,0,3,0,0,3
10220,0,3,0,0,3
10221,0,3,0,0,3
10222,0,3,0,0,3
10223,1,2,0,0,3
10224,1,0,1,1,3
10225,0,3,0,0,3
10226,0,3,0,0,3
10227,0,3,0,0,3
10228,0,0,2,1,3
10229,0,3,0,0,3
10230,0,3,0,0,3
10231,3,0,0,0,3
10232,0,3,0,0,3
10233,1,2,0,0,3
10234,0,3,0,0,3
10235,0,3,0,0,3
10236,2,1,0,0,3
10237,0,0,0,3,3
10238,1,2,0,0,3
10239,3,0,0,0,3
10240,0,3,0,0,3
10241,0,3,0,0,3
10242,0,3,0,0,3
10243,0,3,0,0,3
10244,0,3,0,0,3
10245,0,3,0,0,3
10246,0,3,0,0,3
10247,0,3,0,0,3
10248,0,3,0,0,3
10249,0,3,0,0,3
10250,0,3,0,0,3
10251,0,3,0,0,3
10252,3,0,0,0,3
10253,0,3,0,0,3
10254,0,3,0,0,3
10255,0,3,0,0,3
10256,0,0,3,0,3
10257,0,3,0,0,3
10258,0,3,0,0,3
10259,0,3,0,0,3
10260,1,1,1,0,3
10261,0,3,0,0,3
10262,3,0,0,0,3
10263,1,0,2,0,3
10264,0,3,0,0,3
10265,0,3,0,0,3
10266,0,3,0,0,3
10267,0,3,0,0,3
10268,0,3,0,0,3
10269,0,3,0,0,3
10270,0,0,0,3,3
10271,0,3,0,0,3
10272,2,1,0,0,3
10273,0,3,0,0,3
10274,0,3,0,0,3
10275,0,3,0,0,3
10276,0,3,0,0,3
10277,0,3,0,0,3
10278,0,3,0,0,3
10279,0,3,0,0,3
10280,1,2,0,0,3
10281,0,3,0,0,3
10282,0,3,0,0,3
10283,0,3,0,0,3
10284,0,3,0,0,3
10285,3,0,0,0,3
10286,0,3,0,0,3
10287,2,0,0,1,3
10288,0,0,0,3,3
10289,0,2,0,1,3
10290,0,3,0,0,3
10291,3,0,0,0,3
10292,0,3,0,0,3
10293,0,3,0,0,3
10294,0,3,0,0,3
10295,0,3,0,0,3
10296,0,3,0,0,3
10297,0,3,0,0,3
10298,1,0,2,0,3
10299,0,3,0,0,3
10300,1,1,1,0,3
10301,0,2,1,0,3
10302,3,0,0,0,3
10303,0,0,0,3,3
10304,0,3,0,0,3
10305,0,2,0,1,3
10306,0,3,0,0,3
10307,0,3,0,0,3
10308,0,3,0,0,3
10309,0,3,0,0,3
10310,0,3,0,0,3
10311,0,3,0,0,3
10312,0,3,0,0,3
10313,1,1,0,1,3
10314,0,3,0,0,3
10315,0,3,0,0,3
10316,0,3,0,0,3
10317,2,1,0,0,3
10318,0,3,0,0,3
10319,0,2,1,0,3
10320,0,3,0,0,3
10321,0,3,0,0,3
10322,1,2,0,0,3
10323,0,3,0,0,3
10324,3,0,0,0,3
10325,0,3,0,0,3
10326,0,0,0,3,3
10327,0,3,0,0,3
10328,0,3,0,0,3
10329,0,3,0,0,3
10330,0,3,0,0,3
10331,0,3,0,0,3
10332,0,0,0,3,3
10333,0,3,0,0,3
10334,0,3,0,0,3
10335,0,3,0,0,3
10336,0,3,0,0,3
10337,2,0,1,0,3
10338,0,3,0,0,3
10339,0,3,0,0,3
10340,0,1,0,2,3
10341,0,2,0,1,3
10342,0,3,0,0,3
10343,0,3,0,0,3
10344,0,3,0,0,3
10345,0,1,0,2,3
10346,0,3,0,0,3
10347,0,3,0,0,3
10348,0,3,0,0,3
10349,0,3,0,0,3
10350,0,3,0,0,3
10351,0,3,0,0,3
10352,0,3,0,0,3
10353,0,3,0,0,3
10354,3,0,0,0,3
10355,3,0,0,0,3
10356,0,3,0,0,3
10357,0,3,0,0,3
10358,1,1,1,0,3
10359,0,3,0,0,3
10360,0,3,0,0,3
10361,3,0,0,0,3
10362,0,3,0,0,3
10363,0,0,0,3,3
10364,1,1,1,0,3
10365,0,3,0,0,3
10366,0,3,0,0,3
10367,0,3,0,0,3
10368,1,0,1,1,3
10369,2,0,0,1,3
10370,0,3,0,0,3
10371,0,1,1,1,3
10372,0,3,0,0,3
10373,0,3,0,0,3
10374,0,3,0,0,3
10375,0,3,0,0,3
10376,0,3,0,0,3
10377,2,1,0,0,3
10378,0,3,0,0,3
10379,0,0,0,3,3
10380,0,3,0,0,3
10381,0,3,0,0,3
10382,1,2,0,0,3
10383,0,3,0,0,3
10384,0,3,0,0,3
10385,0,2,1,0,3
10386,0,3,0,0,3
10387,3,0,0,0,3
10388,1,2,0,0,3
10389,0,2,0,1,3
10390,2,0,0,1,3
10391,1,2,0,0,3
10392,1,1,1,0,3
10393,1,0,0,2,3
10394,0,3,0,0,3
10395,2,0,0,1,3
10396,0,3,0,0,3
10397,2,0,0,1,3
10398,0,3,0,0,3
10399,2,0,1,0,3
10400,1,0,2,0,3
10401,0,3,0,0,3
10402,0,3,0,0,3
10403,1,2,0,0,3
10404,1,2,0,0,3
10405,0,3,0,0,3
10406,1,2,0,0,3
10407,0,3,0,0,3
10408,0,3,0,0,3
10409,0,1,0,2,3
10410,0,3,0,0,3
10411,0,3,0,0,3
10412,1,2,0,0,3
10413,0,2,0,1,3
10414,0,3,0,0,3
10415,0,3,0,0,3
10416,0,3,0,0,3
10417,3,0,0,0,3
10418,1,2,0,0,3
10419,0,3,0,0,3
10420,0,3,0,0,3
10421,0,3,0,0,3
10422,0,3,0,0,3
10423,0,3,0,0,3
10424,0,3,0,0,3
10425,0,1,0,2,3
10426,0,3,0,0,3
10427,1,2,0,0,3
10428,0,3,0,0,3
10429,0,3,0,0,3
10430,0,3,0,0,3
10431,0,3,0,0,3
10432,0,3,0,0,3
10433,0,3,0,0,3
10434,0,3,0,0,3
10435,0,3,0,0,3
10436,0,3,0,0,3
10437,0,3,0,0,3
10438,2,0,0,1,3
10439,0,3,0,0,3
10440,0,3,0,0,3
10441,0,3,0,0,3
10442,0,3,0,0,3
10443,0,3,0,0,3
10444,0,3,0,0,3
10445,0,3,0,0,3
10446,1,2,0,0,3
10447,2,1,0,0,3
10448,0,0,0,3,3
10449,2,0,0,1,3
10450,0,3,0,0,3
10451,0,3,0,0,3
10452,2,0,0,1,3
10453,0,3,0,0,3
10454,0,3,0,0,3
10455,0,3,0,0,3
10456,3,0,0,0,3
10457,3,0,0,0,3
10458,0,3,0,0,3
10459,0,3,0,0,3
10460,0,3,0,0,3
10461,2,1,0,0,3
10462,2,0,1,0,3
10463,1,2,0,0,3
10464,2,0,1,0,3
10465,0,3,0,0,3
10466,1,2,0,0,3
10467,3,0,0,0,3
10468,0,3,0,0,3
10469,0,3,0,0,3
10470,0,2,0,1,3
10471,0,3,0,0,3
10472,2,0,0,1,3
10473,0,3,0,0,3
10474,0,3,0,0,3
10475,0,2,1,0,3
10476,0,2,0,1,3
10477,0,3,0,0,3
10478,3,0,0,0,3
10479,0,3,0,0,3
10480,0,3,0,0,3
10481,0,3,0,0,3
10482,0,3,0,0,3
10483,0,3,0,0,3
10484,0,3,0,0,3
10485,1,0,0,2,3
10486,0,3,0,0,3
10487,0,3,0,0,3
10488,0,3,0,0,3
10489,0,0,0,3,3
10490,2,0,0,1,3
10491,0,3,0,0,3
10492,0,3,0,0,3
10493,1,2,0,0,3
10494,0,3,0,0,3
10495,3,0,0,0,3
10496,3,0,0,0,3
10497,0,3,0,0,3
10498,0,3,0,0,3
10499,0,3,0,0,3
10500,0,3,0,0,3
10501,0,3,0,0,3
10502,1,2,0,0,3
10503,0,3,0,0,3
10504,0,3,0,0,3
10505,0,3,0,0,3
10506,0,3,0,0,3
10507,1,0,0,2,3
10508,0,3,0,0,3
10509,0,3,0,0,3
10510,0,3,0,0,3
10511,2,1,0,0,3
10512,0,3,0,0,3
10513,0,3,0,0,3
10514,1,2,0,0,3
10515,2,1,0,0,3
10516,0,3,0,0,3
10517,0,3,0,0,3
10518,0,3,0,0,3
10519,0,3,0,0,3
10520,2,1,0,0,3
10521,0,3,0,0,3
10522,0,3,0,0,3
10523,2,1,0,0,3
10524,1,0,2,0,3
10525,0,3,0,0,3
10526,1,1,0,1,3
10527,0,3,0,0,3
10528,0,3,0,0,3
10529,0,3,0,0,3
10530,0,3,0,0,3
10531,0,3,0,0,3
10532,0,3,0,0,3
10533,0,1,0,2,3
10534,0,3,0,0,3
10535,0,3,0,0,3
10536,2,0,1,0,3
10537,2,0,0,1,3
10538,0,3,0,0,3
10539,0,3,0,0,3
10540,0,3,0,0,3
10541,3,0,0,0,3
10542,1,0,2,0,3
10543,0,3,0,0,3
10544,1,2,0,0,3
10545,0,3,0,0,3
10546,0,3,0,0,3
10547,0,3,0,0,3
10548,3,0,0,0,3
10549,0,3,0,0,3
10550,0,3,0,0,3
10551,1,2,0,0,3
10552,1,2,0,0,3
10553,3,0,0,0,3
10554,1,1,0,1,3
10555,0,2,1,0,3
10556,0,0,3,0,3
10557,0,3,0,0,3
10558,1,0,0,2,3
10559,0,3,0,0,3
10560,0,2,0,1,3
10561,2,1,0,0,3
10562,3,0,0,0,3
10563,0,3,0,0,3
10564,0,3,0,0,3
10565,0,3,0,0,3
10566,0,1,2,0,3
10567,1,2,0,0,3
10568,0,3,0,0,3
10569,0,3,0,0,3
10570,1,2,0,0,3
10571,0,3,0,0,3
10572,0,3,0,0,3
10573,0,3,0,0,3
10574,0,0,0,3,3
10575,0,3,0,0,3
10576,0,3,0,0,3
10577,3,0,0,0,3
10578,0,3,0,0,3
10579,1,2,0,0,3
10580,0,3,0,0,3
10581,0,3,0,0,3
10582,1,2,0,0,3
10583,0,3,0,0,3
10584,3,0,0,0,3
10585,0,2,0,1,3
10586,0,3,0,0,3
10587,0,3,0,0,3
10588,0,3,0,0,3
10589,0,3,0,0,3
10590,0,3,0,0,3
10591,1,2,0,0,3
10592,0,2,0,1,3
10593,0,3,0,0,3
10594,0,3,0,0,3
10595,0,3,0,0,3
10596,0,3,0,0,3
10597,0,3,0,0,3
10598,0,0,0,3,3
10599,1,0,0,2,3
10600,3,0,0,0,3
10601,2,0,1,0,3
10602,0,3,0,0,3
10603,0,3,0,0,3
10604,3,0,0,0,3
10605,1,2,0,0,3
10606,0,3,0,0,3
10607,0,3,0,0,3
10608,0,3,0,0,3
10609,0,3,0,0,3
10610,2,0,1,0,3
10611,1,2,0,0,3
10612,2,1,0,0,3
10613,0,3,0,0,3
10614,0,3,0,0,3
10615,0,3,0,0,3
10616,0,3,0,0,3
10617,0,3,0,0,3
10618,0,0,0,3,3
10619,0,2,1,0,3
10620,0,3,0,0,3
10621,0,2,1,0,3
10622,0,3,0,0,3
10623,0,3,0,0,3
10624,0,3,0,0,3
10625,0,3,0,0,3
10626,0,3,0,0,3
10627,0,3,0,0,3
10628,0,2,0,1,3
10629,0,3,0,0,3
10630,0,3,0,0,3
10631,0,3,0,0,3
10632,0,3,0,0,3
10633,0,3,0,0,3
10634,0,3,0,0,3
10635,3,0,0,0,3
10636,0,3,0,0,3
10637,0,3,0,0,3
10638,0,3,0,0,3
10639,0,3,0,0,3
10640,0,3,0,0,3
10641,0,3,0,0,3
10642,0,3,0,0,3
10643,0,3,0,0,3
10644,0,3,0,0,3
10645,0,3,0,0,3
10646,0,3,0,0,3
10647,3,0,0,0,3
10648,1,0,0,2,3
10649,1,2,0,0,3
10650,0,3,0,0,3
10651,0,3,0,0,3
10652,0,3,0,0,3
10653,0,3,0,0,3
10654,0,3,0,0,3
10655,0,3,0,0,3
10656,0,1,1,1,3
10657,3,0,0,0,3
10658,3,0,0,0,3
10659,0,3,0,0,3
10660,0,2,1,0,3
10661,0,0,3,0,3
10662,0,3,0,0,3
10663,0,3,0,0,3
10664,1,2,0,0,3
10665,0,3,0,0,3
10666,0,3,0,0,3
10667,0,3,0,0,3
10668,1,2,0,0,3
10669,1,2,0,0,3
10670,0,3,0,0,3
10671,0,3,0,0,3
10672,0,3,0,0,3
10673,0,3,0,0,3
10674,0,3,0,0,3
10675,0,0,0,3,3
10676,0,3,0,0,3
10677,0,3,0,0,3
10678,0,3,0,0,3
10679,0,3,0,0,3
10680,0,3,0,0,3
10681,0,3,0,0,3
10682,0,3,0,0,3
10683,2,0,0,1,3
10684,0,3,0,0,3
10685,0,3,0,0,3
10686,1,0,1,1,3
10687,0,3,0,0,3
10688,1,2,0,0,3
10689,1,0,2,0,3
10690,1,2,0,0,3
10691,0,3,0,0,3
10692,0,3,0,0,3
10693,0,3,0,0,3
10694,1,2,0,0,3
10695,2,1,0,0,3
10696,0,3,0,0,3
10697,0,3,0,0,3
10698,1,2,0,0,3
10699,0,3,0,0,3
10700,0,3,0,0,3
10701,0,3,0,0,3
10702,0,3,0,0,3
10703,0,3,0,0,3
10704,0,3,0,0,3
10705,3,0,0,0,3
10706,0,3,0,0,3
10707,0,3,0,0,3
10708,0,3,0,0,3
10709,0,3,0,0,3
10710,0,3,0,0,3
10711,2,1,0,0,3
10712,0,3,0,0,3
10713,0,3,0,0,3
10714,0,3,0,0,3
10715,0,3,0,0,3
10716,1,2,0,0,3
10717,2,0,0,1,3
10718,0,3,0,0,3
10719,0,3,0,0,3
10720,1,0,2,0,3
10721,0,3,0,0,3
10722,0,3,0,0,3
10723,0,1,0,2,3
10724,0,3,0,0,3
10725,0,3,0,0,3
10726,0,2,0,1,3
10727,2,0,1,0,3
10728,0,3,0,0,3
10729,0,3,0,0,3
10730,0,3,0,0,3
10731,0,3,0,0,3
10732,0,3,0,0,3
10733,0,3,0,0,3
10734,0,3,0,0,3
10735,0,3,0,0,3
10736,0,3,0,0,3
10737,0,3,0,0,3
10738,0,3,0,0,3
10739,0,3,0,0,3
10740,1,0,0,2,3
10741,1,1,1,0,3
10742,0,2,1,0,3
10743,0,3,0,0,3
10744,0,3,0,0,3
10745,0,3,0,0,3
10746,0,3,0,0,3
10747,3,0,0,0,3
10748,0,3,0,0,3
10749,0,3,0,0,3
10750,0,3,0,0,3
10751,0,0,2,1,3
10752,1,2,0,0,3
10753,0,3,0,0,3
10754,0,3,0,0,3
10755,0,3,0,0,3
10756,0,0,0,3,3
10757,3,0,0,0,3
10758,2,0,1,0,3
10759,0,3,0,0,3
10760,0,3,0,0,3
10761,1,0,0,2,3
10762,0,3,0,0,3
10763,0,1,2,0,3
10764,0,3,0,0,3
10765,0,2,1,0,3
10766,0,0,1,2,3
10767,0,3,0,0,3
10768,0,3,0,0,3
10769,0,3,0,0,3
10770,2,0,1,0,3
10771,0,2,1,0,3
10772,0,0,0,3,3
10773,1,1,1,0,3
10774,0,3,0,0,3
10775,2,1,0,0,3
10776,0,3,0,0,3
10777,0,3,0,0,3
10778,0,3,0,0,3
10779,2,0,1,0,3
10780,2,1,0,0,3
10781,0,3,0,0,3
10782,0,3,0,0,3
10783,0,3,0,0,3
10784,0,3,0,0,3
10785,2,0,0,1,3
10786,0,3,0,0,3
10787,0,3,0,0,3
10788,0,3,0,0,3
10789,1,2,0,0,3
10790,0,3,0,0,3
10791,0,3,0,0,3
10792,0,3,0,0,3
10793,0,3,0,0,3
10794,3,0,0,0,3
10795,1,2,0,0,3
10796,0,3,0,0,3
10797,3,0,0,0,3
10798,3,0,0,0,3
10799,0,3,0,0,3
10800,0,3,0,0,3
10801,3,0,0,0,3
10802,0,3,0,0,3
10803,0,3,0,0,3
10804,0,3,0,0,3
10805,0,3,0,0,3
10806,0,3,0,0,3
10807,0,3,0,0,3
10808,3,0,0,0,3
10809,0,3,0,0,3
10810,1,2,0,0,3
10811,0,3,0,0,3
10812,0,3,0,0,3
10813,1,0,2,0,3
10814,0,3,0,0,3
10815,1,0,0,2,3
10816,0,3,0,0,3
10817,2,0,1,0,3
10818,1,2,0,0,3
10819,0,3,0,0,3
10820,0,3,0,0,3
10821,1,2,0,0,3
10822,0,3,0,0,3
10823,0,3,0,0,3
10824,0,3,0,0,3
10825,1,2,0,0,3
10826,0,3,0,0,3
10827,0,1,2,0,3
10828,0,3,0,0,3
10829,0,3,0,0,3
10830,0,3,0,0,3
10831,3,0,0,0,3
10832,0,3,0,0,3
10833,0,3,0,0,3
10834,0,3,0,0,3
10835,0,3,0,0,3
10836,0,3,0,0,3
10837,0,3,0,0,3
10838,0,3,0,0,3
10839,1,2,0,0,3
10840,0,3,0,0,3
10841,1,2,0,0,3
10842,0,3,0,0,3
10843,0,3,0,0,3
10844,0,3,0,0,3
10845,0,0,3,0,3
10846,0,3,0,0,3
10847,0,3,0,0,3
10848,0,3,0,0,3
10849,0,3,0,0,3
10850,0,3,0,0,3
10851,0,3,0,0,3
10852,3,0,0,0,3
10853,2,0,0,1,3
10854,0,3,0,0,3
10855,0,3,0,0,3
10856,0,3,0,0,3
10857,0,3,0,0,3
10858,3,0,0,0,3
10859,3,0,0,0,3
10860,0,3,0,0,3
10861,0,3,0,0,3
10862,0,3,0,0,3
10863,0,3,0,0,3
10864,0,3,0,0,3
10865,1,2,0,0,3
10866,0,3,0,0,3
10867,0,0,1,2,3
10868,2,1,0,0,3
10869,0,3,0,0,3
10870,0,3,0,0,3
10871,1,2,0,0,3
10872,0,3,0,0,3
10873,0,3,0,0,3
10874,0,3,0,0,3
10875,0,3,0,0,3
10876,1,2,0,0,3
10877,3,0,0,0,3
10878,0,3,0,0,3
10879,0,2,0,1,3
10880,1,2,0,0,3
10881,0,0,0,3,3
10882,0,3,0,0,3
10883,0,3,0,0,3
10884,2,0,0,1,3
10885,0,3,0,0,3
10886,0,3,0,0,3
10887,1,2,0,0,3
10888,0,3,0,0,3
10889,0,3,0,0,3
10890,0,3,0,0,3
10891,0,3,0,0,3
10892,0,1,0,2,3
10893,0,3,0,0,3
10894,0,3,0,0,3
10895,1,2,0,0,3
10896,0,3,0,0,3
10897,1,1,0,1,3
10898,0,3,0,0,3
10899,0,3,0,0,3
10900,1,2,0,0,3
10901,1,0,2,0,3
10902,0,3,0,0,3
10903,0,3,0,0,3
10904,3,0,0,0,3
10905,0,3,0,0,3
10906,0,3,0,0,3
10907,0,3,0,0,3
10908,0,3,0,0,3
10909,0,3,0,0,3
10910,1,2,0,0,3
10911,0,3,0,0,3
10912,0,2,1,0,3
10913,0,2,0,1,3
10914,1,1,0,1,3
10915,0,3,0,0,3
10916,2,1,0,0,3
10917,0,3,0,0,3
10918,0,3,0,0,3
10919,1,2,0,0,3
10920,0,3,0,0,3
10921,0,3,0,0,3
10922,0,3,0,0,3
10923,0,3,0,0,3
10924,3,0,0,0,3
10925,3,0,0,0,3
10926,0,1,0,2,3
10927,0,3,0,0,3
10928,2,0,0,1,3
10929,0,3,0,0,3
10930,0,3,0,0,3
10931,1,0,2,0,3
10932,0,3,0,0,3
10933,0,0,0,3,3
10934,0,3,0,0,3
10935,0,3,0,0,3
10936,0,3,0,0,3
10937,3,0,0,0,3
10938,0,3,0,0,3
10939,0,3,0,0,3
10940,0,3,0,0,3
10941,0,3,0,0,3
10942,1,0,2,0,3
10943,0,2,0,1,3
10944,2,1,0,0,3
10945,0,3,0,0,3
10946,3,0,0,0,3
10947,0,3,0,0,3
10948,3,0,0,0,3
10949,0,0,0,3,3
10950,1,0,2,0,3
10951,0,3,0,0,3
10952,1,0,1,1,3
10953,0,3,0,0,3
10954,1,0,1,1,3
10955,2,1,0,0,3
10956,0,3,0,0,3
10957,0,1,0,2,3
10958,0,3,0,0,3
10959,0,3,0,0,3
10960,0,2,0,1,3
10961,0,3,0,0,3
10962,0,3,0,0,3
10963,1,2,0,0,3
10964,3,0,0,0,3
10965,0,0,1,2,3
10966,0,3,0,0,3
10967,0,3,0,0,3
10968,0,3,0,0,3
10969,0,0,0,3,3
10970,0,3,0,0,3
10971,0,3,0,0,3
10972,0,3,0,0,3
10973,0,0,3,0,3
10974,0,3,0,0,3
10975,1,1,0,1,3
10976,0,3,0,0,3
10977,0,3,0,0,3
10978,0,3,0,0,3
10979,0,3,0,0,3
10980,2,1,0,0,3
10981,0,3,0,0,3
10982,0,3,0,0,3
10983,0,3,0,0,3
10984,0,3,0,0,3
10985,1,1,0,1,3
10986,0,3,0,0,3
10987,1,1,0,1,3
10988,0,3,0,0,3
10989,0,3,0,0,3
10990,0,3,0,0,3
10991,0,3,0,0,3
10992,0,3,0,0,3
10993,0,3,0,0,3
10994,0,3,0,0,3
10995,1,2,0,0,3
10996,1,2,0,0,3
10997,0,3,0,0,3
10998,0,3,0,0,3
10999,0,3,0,0,3
11000,0,3,0,0,3
11001,0,3,0,0,3
11002,0,3,0,0,3
11003,1,1,1,0,3
11004,0,3,0,0,3
11005,0,3,0,0,3
11006,0,0,3,0,3
11007,0,2,1,0,3
11008,0,3,0,0,3
11009,1,1,1,0,3
11010,0,3,0,0,3
11011,0,3,0,0,3
11012,1,2,0,0,3
11013,2,0,0,1,3
11014,0,3,0,0,3
11015,3,0,0,0,3
11016,2,0,0,1,3
11017,0,3,0,0,3
11018,0,2,1,0,3
11019,2,1,0,0,3
11020,0,3,0,0,3
11021,0,3,0,0,3
11022,0,3,0,0,3
11023,2,1,0,0,3
11024,2,0,0,1,3
11025,0,3,0,0,3
11026,0,3,0,0,3
11027,1,1,0,1,3
11028,0,3,0,0,3
11029,0,3,0,0,3
11030,0,3,0,0,3
11031,0,2,1,0,3
11032,0,3,0,0,3
11033,0,3,0,0,3
11034,0,3,0,0,3
11035,0,3,0,0,3
11036,0,3,0,0,3
11037,1,2,0,0,3
11038,0,3,0,0,3
11039,0,3,0,0,3
11040,0,3,0,0,3
11041,0,3,0,0,3
11042,0,3,0,0,3
11043,1,2,0,0,3
11044,1,2,0,0,3
11045,0,3,0,0,3
11046,0,3,0,0,3
11047,0,3,0,0,3
11048,2,0,1,0,3
11049,1,2,0,0,3
11050,0,3,0,0,3
11051,2,1,0,0,3
11052,0,3,0,0,3
11053,0,3,0,0,3
11054,0,3,0,0,3
11055,0,3,0,0,3
11056,1,2,0,0,3
11057,0,3,0,0,3
11058,0,3,0,0,3
11059,0,3,0,0,3
11060,0,3,0,0,3
11061,2,1,0,0,3
11062,0,3,0,0,3
11063,0,3,0,0,3
11064,2,1,0,0,3
11065,0,3,0,0,3
11066,0,3,0,0,3
11067,0,3,0,0,3
11068,3,0,0,0,3
11069,0,3,0,0,3
11070,0,2,1,0,3
11071,0,3,0,0,3
11072,0,3,0,0,3
11073,2,1,0,0,3
11074,0,3,0,0,3
11075,0,3,0,0,3
11076,1,0,2,0,3
11077,0,3,0,0,3
11078,0,3,0,0,3
11079,2,1,0,0,3
11080,0,1,2,0,3
11081,0,3,0,0,3
11082,0,1,1,1,3
11083,0,3,0,0,3
11084,0,1,0,2,3
11085,0,3,0,0,3
11086,0,3,0,0,3
11087,1,0,0,2,3
11088,1,0,0,2,3
11089,0,3,0,0,3
11090,0,3,0,0,3
11091,0,3,0,0,3
11092,0,3,0,0,3
11093,0,3,0,0,3
11094,0,3,0,0,3
11095,0,3,0,0,3
11096,0,3,0,0,3
11097,0,3,0,0,3
11098,0,3,0,0,3
11099,0,3,0,0,3
11100,0,3,0,0,3
11101,0,3,0,0,3
11102,0,3,0,0,3
11103,0,3,0,0,3
11104,0,3,0,0,3
11105,0,3,0,0,3
11106,0,3,0,0,3
11107,0,3,0,0,3
11108,0,3,0,0,3
11109,3,0,0,0,3
11110,0,3,0,0,3
11111,0,2,0,1,3
11112,0,2,1,0,3
11113,0,3,0,0,3
11114,0,3,0,0,3
11115,1,2,0,0,3
11116,0,3,0,0,3
11117,0,3,0,0,3
11118,0,3,0,0,3
11119,0,3,0,0,3
11120,0,3,0,0,3
11121,0,3,0,0,3
11122,1,1,0,1,3
11123,0,3,0,0,3
11124,0,3,0,0,3
11125,0,1,0,2,3
11126,0,3,0,0,3
11127,0,3,0,0,3
11128,0,3,0,0,3
11129,3,0,0,0,3
11130,0,3,0,0,3
11131,0,3,0,0,3
11132,0,3,0,0,3
11133,1,2,0,0,3
11134,0,3,0,0,3
11135,1,0,2,0,3
11136,1,1,0,1,3
11137,0,3,0,0,3
11138,1,0,1,1,3
11139,0,3,0,0,3
11140,0,3,0,0,3
11141,0,3,0,0,3
11142,1,2,0,0,3
11143,0,3,0,0,3
11144,2,0,1,0,3
11145,3,0,0,0,3
11146,0,3,0,0,3
11147,0,3,0,0,3
11148,0,3,0,0,3
11149,0,3,0,0,3
11150,0,3,0,0,3
11151,0,3,0,0,3
11152,0,3,0,0,3
11153,0,3,0,0,3
11154,1,2,0,0,3
11155,0,3,0,0,3
11156,3,0,0,0,3
11157,1,2,0,0,3
11158,0,0,2,1,3
11159,0,3,0,0,3
11160,0,3,0,0,3
11161,1,0,0,2,3
11162,3,0,0,0,3
11163,0,2,0,0,2
11164,0,2,0,0,2
11165,0,2,0,0,2
11166,0,2,0,0,2
11167,0,2,0,0,2
11168,2,0,0,0,2
11169,1,1,0,0,2
11170,0,2,0,0,2
11171,0,0,0,2,2
11172,0,1,0,1,2
11173,0,0,0,2,2
11174,0,2,0,0,2
11175,0,2,0,0,2
11176,2,0,0,0,2
11177,0,2,0,0,2
11178,0,0,2,0,2
11179,0,2,0,0,2
11180,0,2,0,0,2
11181,0,2,0,0,2
11182,1,1,0,0,2
11183,0,2,0,0,2
11184,0,2,0,0,2
11185,0,2,0,0,2
11186,0,2,0,0,2
11187,2,0,0,0,2
11188,0,2,0,0,2
11189,2,0,0,0,2
11190,1,1,0,0,2
11191,0,2,0,0,2
11192,0,2,0,0,2
11193,0,2,0,0,2
11194,0,2,0,0,2
11195,2,0,0,0,2
11196,0,2,0,0,2
11197,0,2,0,0,2
11198,0,2,0,0,2
11199,0,2,0,0,2
11200,1,1,0,0,2
11201,0,2,0,0,2
11202,1,1,0,0,2
11203,0,2,0,0,2
11204,0,2,0,0,2
11205,0,2,0,0,2
11206,0,2,0,0,2
11207,0,0,0,2,2
11208,0,2,0,0,2
11209,0,2,0,0,2
11210,0,2,0,0,2
11211,0,2,0,0,2
11212,1,1,0,0,2
11213,0,2,0,0,2
11214,0,2,0,0,2
11215,0,2,0,0,2
11216,0,2,0,0,2
11217,0,1,0,1,2
11218,0,2,0,0,2
11219,0,2,0,0,2
11220,0,0,0,2,2
11221,0,2,0,0,2
11222,1,1,0,0,2
11223,0,2,0,0,2
11224,0,2,0,0,2
11225,0,2,0,0,2
11226,0,2,0,0,2
11227,2,0,0,0,2
11228,0,2,0,0,2
11229,0,2,0,0,2
11230,0,2,0,0,2
11231,0,2,0,0,2
11232,0,2,0,0,2
11233,2,0,0,0,2
11234,0,2,0,0,2
11235,0,2,0,0,2
11236,0,2,0,0,2
11237,0,2,0,0,2
11238,0,2,0,0,2
11239,0,2,0,0,2
11240,0,2,0,0,2
11241,0,2,0,0,2
11242,0,2,0,0,2
11243,0,2,0,0,2
11244,0,1,1,0,2
11245,0,2,0,0,2
11246,1,0,0,1,2
11247,0,2,0,0,2
11248,0,2,0,0,2
11249,0,2,0,0,2
11250,0,2,0,0,2
11251,0,2,0,0,2
11252,0,2,0,0,2
11253,2,0,0,0,2
11254,1,1,0,0,2
11255,0,2,0,0,2
11256,0,2,0,0,2
11257,0,2,0,0,2
11258,0,2,0,0,2
11259,0,2,0,0,2
11260,0,2,0,0,2
11261,2,0,0,0,2
11262,0,2,0,0,2
11263,0,2,0,0,2
11264,0,2,0,0,2
11265,0,2,0,0,2
11266,0,2,0,0,2
11267,0,2,0,0,2
11268,0,2,0,0,2
11269,0,2,0,0,2
11270,0,2,0,0,2
11271,0,2,0,0,2
11272,0,2,0,0,2
11273,0,2,0,0,2
11274,0,2,0,0,2
11275,1,1,0,0,2
11276,0,2,0,0,2
11277,0,2,0,0,2
11278,0,2,0,0,2
11279,0,0,1,1,2
11280,0,2,0,0,2
11281,2,0,0,0,2
11282,0,0,2,0,2
11283,2,0,0,0,2
11284,0,2,0,0,2
11285,0,2,0,0,2
11286,0,0,0,2,2
11287,0,1,1,0,2
11288,1,1,0,0,2
11289,0,2,0,0,2
11290,0,2,0,0,2
11291,0,2,0,0,2
11292,0,2,0,0,2
11293,0,2,0,0,2
11294,0,2,0,0,2
11295,0,2,0,0,2
11296,0,2,0,0,2
11297,0,2,0,0,2
11298,0,2,0,0,2
11299,0,2,0,0,2
11300,2,0,0,0,2
11301,0,2,0,0,2
11302,0,2,0,0,2
11303,1,1,0,0,2
11304,1,1,0,0,2
11305,0,2,0,0,2
11306,1,0,1,0,2
11307,0,2,0,0,2
11308,0,2,0,0,2
11309,0,2,0,0,2
11310,0,2,0,0,2
11311,0,2,0,0,2
11312,0,2,0,0,2
11313,0,2,0,0,2
11314,0,2,0,0,2
11315,0,2,0,0,2
11316,0,2,0,0,2
11317,0,0,1,1,2
11318,0,2,0,0,2
11319,0,2,0,0,2
11320,0,2,0,0,2
11321,1,0,1,0,2
11322,0,2,0,0,2
11323,2,0,0,0,2
11324,0,2,0,0,2
11325,0,2,0,0,2
11326,0,2,0,0,2
11327,2,0,0,0,2
11328,0,2,0,0,2
11329,0,2,0,0,2
11330,0,2,0,0,2
11331,0,2,0,0,2
11332,2,0,0,0,2
11333,0,2,0,0,2
11334,0,2,0,0,2
11335,2,0,0,0,2
11336,0,2,0,0,2
11337,0,2,0,0,2
11338,0,2,0,0,2
11339,0,1,1,0,2
11340,0,2,0,0,2
11341,0,2,0,0,2
11342,0,1,1,0,2
11343,0,2,0,0,2
11344,0,2,0,0,2
11345,0,2,0,0,2
11346,0,2,0,0,2
11347,0,2,0,0,2
11348,0,2,0,0,2
11349,0,2,0,0,2
11350,0,2,0,0,2
11351,2,0,0,0,2
11352,0,0,0,2,2
11353,0,2,0,0,2
11354,0,2,0,0,2
11355,0,2,0,0,2
11356,0,2,0,0,2
11357,0,2,0,0,2
11358,0,2,0,0,2
11359,0,2,0,0,2
11360,1,1,0,0,2
11361,1,1,0,0,2
11362,0,2,0,0,2
11363,0,2,0,0,2
11364,0,2,0,0,2
11365,0,2,0,0,2
11366,0,2,0,0,2
11367,2,0,0,0,2
11368,0,2,0,0,2
11369,0,2,0,0,2
11370,0,2,0,0,2
11371,0,2,0,0,2
11372,0,2,0,0,2
11373,0,2,0,0,2
11374,0,2,0,0,2
11375,0,2,0,0,2
11376,0,2,0,0,2
11377,0,2,0,0,2
11378,0,2,0,0,2
11379,0,2,0,0,2
11380,0,1,0,1,2
11381,0,2,0,0,2
11382,0,2,0,0,2
11383,1,1,0,0,2
11384,0,2,0,0,2
11385,0,2,0,0,2
11386,0,2,0,0,2
11387,0,2,0,0,2
11388,0,2,0,0,2
11389,0,2,0,0,2
11390,2,0,0,0,2
11391,0,2,0,0,2
11392,1,0,0,1,2
11393,0,2,0,0,2
11394,2,0,0,0,2
11395,0,2,0,0,2
11396,0,2,0,0,2
11397,0,2,0,0,2
11398,0,2,0,0,2
11399,0,1,1,0,2
11400,0,2,0,0,2
11401,0,2,0,0,2
11402,0,2,0,0,2
11403,0,0,0,2,2
11404,2,0,0,0,2
11405,1,0,0,1,2
11406,0,2,0,0,2
11407,0,2,0,0,2
11408,1,0,0,1,2
11409,0,2,0,0,2
11410,0,2,0,0,2
11411,2,0,0,0,2
11412,2,0,0,0,2
11413,0,2,0,0,2
11414,0,2,0,0,2
11415,0,2,0,0,2
11416,0,2,0,0,2
11417,0,2,0,0,2
11418,0,2,0,0,2
11419,0,2,0,0,2
11420,2,0,0,0,2
11421,0,2,0,0,2
11422,0,2,0,0,2
11423,0,2,0,0,2
11424,0,2,0,0,2
11425,0,2,0,0,2
11426,2,0,0,0,2
11427,0,2,0,0,2
11428,0,2,0,0,2
11429,2,0,0,0,2
11430,0,2,0,0,2
11431,0,2,0,0,2
11432,0,2,0,0,2
11433,0,2,0,0,2
11434,0,2,0,0,2
11435,0,2,0,0,2
11436,0,2,0,0,2
11437,0,2,0,0,2
11438,0,2,0,0,2
11439,0,2,0,0,2
11440,0,2,0,0,2
11441,1,1,0,0,2
11442,0,2,0,0,2
11443,0,2,0,0,2
11444,1,0,0,1,2
11445,0,2,0,0,2
11446,0,2,0,0,2
11447,0,0,1,1,2
11448,0,2,0,0,2
11449,1,1,0,0,2
11450,0,0,2,0,2
11451,0,0,0,2,2
11452,2,0,0,0,2
11453,0,2,0,0,2
11454,0,2,0,0,2
11455,1,1,0,0,2
11456,0,2,0,0,2
11457,0,2,0,0,2
11458,2,0,0,0,2
11459,0,2,0,0,2
11460,0,0,1,1,2
11461,0,2,0,0,2
11462,0,2,0,0,2
11463,0,0,0,2,2
11464,0,2,0,0,2
11465,0,2,0,0,2
11466,0,2,0,0,2
11467,0,2,0,0,2
11468,0,2,0,0,2
11469,0,2,0,0,2
11470,0,2,0,0,2
11471,0,2,0,0,2
11472,0,2,0,0,2
11473,0,2,0,0,2
11474,0,2,0,0,2
11475,0,2,0,0,2
11476,0,2,0,0,2
11477,0,2,0,0,2
11478,0,2,0,0,2
11479,2,0,0,0,2
11480,0,2,0,0,2
11481,0,2,0,0,2
11482,0,0,1,1,2
11483,0,2,0,0,2
11484,0,2,0,0,2
11485,0,1,1,0,2
11486,0,2,0,0,2
11487,0,2,0,0,2
11488,2,0,0,0,2
11489,0,2,0,0,2
11490,0,2,0,0,2
11491,1,1,0,0,2
11492,0,2,0,0,2
11493,0,2,0,0,2
11494,0,2,0,0,2
11495,0,2,0,0,2
11496,0,2,0,0,2
11497,1,1,0,0,2
11498,0,2,0,0,2
11499,0,2,0,0,2
11500,0,2,0,0,2
11501,0,2,0,0,2
11502,1,0,1,0,2
11503,0,2,0,0,2
11504,0,2,0,0,2
11505,0,2,0,0,2
11506,2,0,0,0,2
11507,0,2,0,0,2
11508,0,0,0,2,2
11509,1,0,0,1,2
11510,0,2,0,0,2
11511,0,2,0,0,2
11512,1,1,0,0,2
11513,0,2,0,0,2
11514,0,2,0,0,2
11515,0,2,0,0,2
11516,0,2,0,0,2
11517,1,1,0,0,2
11518,0,2,0,0,2
11519,0,1,1,0,2
11520,0,2,0,0,2
11521,0,2,0,0,2
11522,0,2,0,0,2
11523,0,2,0,0,2
11524,0,2,0,0,2
11525,2,0,0,0,2
11526,0,2,0,0,2
11527,0,2,0,0,2
11528,0,0,0,2,2
11529,0,2,0,0,2
11530,0,1,1,0,2
11531,0,2,0,0,2
11532,0,2,0,0,2
11533,0,2,0,0,2
11534,0,2,0,0,2
11535,0,2,0,0,2
11536,2,0,0,0,2
11537,2,0,0,0,2
11538,0,2,0,0,2
11539,1,1,0,0,2
11540,0,2,0,0,2
11541,0,2,0,0,2
11542,2,0,0,0,2
11543,0,2,0,0,2
11544,0,2,0,0,2
11545,1,1,0,0,2
11546,0,2,0,0,2
11547,0,2,0,0,2
11548,0,2,0,0,2
11549,0,2,0,0,2
11550,0,2,0,0,2
11551,2,0,0,0,2
11552,1,1,0,0,2
11553,1,0,0,1,2
11554,0,2,0,0,2
11555,0,2,0,0,2
11556,0,2,0,0,2
11557,0,1,0,1,2
11558,0,2,0,0,2
11559,0,1,0,1,2
11560,1,0,1,0,2
11561,0,2,0,0,2
11562,0,0,0,2,2
11563,1,1,0,0,2
11564,0,2,0,0,2
11565,0,2,0,0,2
11566,0,0,1,1,2
11567,0,2,0,0,2
11568,0,2,0,0,2
11569,0,2,0,0,2
11570,0,2,0,0,2
11571,2,0,0,0,2
11572,0,2,0,0,2
11573,0,2,0,0,2
11574,1,0,0,1,2
11575,0,0,0,2,2
11576,0,2,0,0,2
11577,0,2,0,0,2
11578,2,0,0,0,2
11579,0,2,0,0,2
11580,0,2,0,0,2
11581,1,0,1,0,2
11582,0,2,0,0,2
11583,2,0,0,0,2
11584,0,1,0,1,2
11585,0,2,0,0,2
11586,0,2,0,0,2
11587,0,2,0,0,2
11588,1,1,0,0,2
11589,0,2,0,0,2
11590,0,2,0,0,2
11591,0,2,0,0,2
11592,0,2,0,0,2
11593,0,2,0,0,2
11594,0,1,1,0,2
11595,0,2,0,0,2
11596,0,2,0,0,2
11597,0,2,0,0,2
11598,2,0,0,0,2
11599,0,2,0,0,2
11600,0,2,0,0,2
11601,0,2,0,0,2
11602,2,0,0,0,2
11603,0,2,0,0,2
11604,0,2,0,0,2
11605,0,2,0,0,2
11606,2,0,0,0,2
11607,0,2,0,0,2
11608,0,2,0,0,2
11609,0,2,0,0,2
11610,1,0,1,0,2
11611,1,1,0,0,2
11612,0,2,0,0,2
11613,0,2,0,0,2
11614,0,2,0,0,2
11615,0,2,0,0,2
11616,1,1,0,0,2
11617,0,2,0,0,2
11618,0,0,1,1,2
11619,0,2,0,0,2
11620,0,2,0,0,2
11621,0,2,0,0,2
11622,0,2,0,0,2
11623,1,0,1,0,2
11624,0,2,0,0,2
11625,0,2,0,0,2
11626,0,2,0,0,2
11627,0,2,0,0,2
11628,1,0,1,0,2
11629,0,2,0,0,2
11630,1,0,0,1,2
11631,2,0,0,0,2
11632,0,2,0,0,2
11633,0,2,0,0,2
11634,0,2,0,0,2
11635,0,2,0,0,2
11636,0,2,0,0,2
11637,0,2,0,0,2
11638,0,2,0,0,2
11639,0,2,0,0,2
11640,0,2,0,0,2
11641,0,0,2,0,2
11642,0,2,0,0,2
11643,0,2,0,0,2
11644,0,2,0,0,2
11645,0,2,0,0,2
11646,1,1,0,0,2
11647,0,2,0,0,2
11648,0,0,1,1,2
11649,0,2,0,0,2
11650,0,2,0,0,2
11651,0,1,0,1,2
11652,1,0,1,0,2
11653,0,2,0,0,2
11654,0,2,0,0,2
11655,0,2,0,0,2
11656,0,2,0,0,2
11657,0,1,1,0,2
11658,0,2,0,0,2
11659,0,0,2,0,2
11660,2,0,0,0,2
11661,0,2,0,0,2
11662,1,0,1,0,2
11663,0,2,0,0,2
11664,0,2,0,0,2
11665,0,2,0,0,2
11666,0,2,0,0,2
11667,0,2,0,0,2
11668,0,2,0,0,2
11669,0,2,0,0,2
11670,0,2,0,0,2
11671,0,2,0,0,2
11672,0,2,0,0,2
11673,0,2,0,0,2
11674,0,2,0,0,2
11675,0,2,0,0,2
11676,0,2,0,0,2
11677,0,2,0,0,2
11678,1,0,1,0,2
11679,0,2,0,0,2
11680,0,2,0,0,2
11681,0,2,0,0,2
11682,0,2,0,0,2
11683,0,2,0,0,2
11684,0,1,0,1,2
11685,0,2,0,0,2
11686,0,1,0,1,2
11687,0,1,0,1,2
11688,0,2,0,0,2
11689,0,2,0,0,2
11690,0,2,0,0,2
11691,2,0,0,0,2
11692,2,0,0,0,2
11693,0,2,0,0,2
11694,0,2,0,0,2
11695,1,1,0,0,2
11696,0,2,0,0,2
11697,2,0,0,0,2
11698,0,2,0,0,2
11699,0,2,0,0,2
11700,1,1,0,0,2
11701,0,2,0,0,2
11702,0,2,0,0,2
11703,0,2,0,0,2
11704,0,2,0,0,2
11705,1,1,0,0,2
11706,0,2,0,0,2
11707,0,2,0,0,2
11708,1,1,0,0,2
11709,2,0,0,0,2
11710,0,2,0,0,2
11711,0,2,0,0,2
11712,0,2,0,0,2
11713,0,2,0,0,2
11714,0,2,0,0,2
11715,0,1,0,1,2
11716,0,2,0,0,2
11717,2,0,0,0,2
11718,0,2,0,0,2
11719,0,2,0,0,2
11720,2,0,0,0,2
11721,0,2,0,0,2
11722,0,2,0,0,2
11723,0,2,0,0,2
11724,0,2,0,0,2
11725,2,0,0,0,2
11726,2,0,0,0,2
11727,1,0,0,1,2
11728,0,1,1,0,2
11729,0,2,0,0,2
11730,0,2,0,0,2
11731,1,1,0,0,2
11732,0,2,0,0,2
11733,0,2,0,0,2
11734,1,1,0,0,2
11735,2,0,0,0,2
11736,1,1,0,0,2
11737,0,2,0,0,2
11738,0,2,0,0,2
11739,0,2,0,0,2
11740,2,0,0,0,2
11741,0,2,0,0,2
11742,2,0,0,0,2
11743,0,2,0,0,2
11744,0,2,0,0,2
11745,0,2,0,0,2
11746,0,2,0,0,2
11747,1,1,0,0,2
11748,0,2,0,0,2
11749,0,2,0,0,2
11750,0,2,0,0,2
11751,0,2,0,0,2
11752,0,2,0,0,2
11753,0,2,0,0,2
11754,0,1,1,0,2
11755,2,0,0,0,2
11756,0,2,0,0,2
11757,0,2,0,0,2
11758,0,0,1,1,2
11759,0,2,0,0,2
11760,0,2,0,0,2
11761,0,2,0,0,2
11762,1,1,0,0,2
11763,0,2,0,0,2
11764,0,2,0,0,2
11765,2,0,0,0,2
11766,0,2,0,0,2
11767,0,2,0,0,2
11768,0,1,0,1,2
11769,1,0,0,1,2
11770,0,2,0,0,2
11771,0,2,0,0,2
11772,0,2,0,0,2
11773,0,2,0,0,2
11774,0,2,0,0,2
11775,0,2,0,0,2
11776,1,1,0,0,2
11777,0,2,0,0,2
11778,0,2,0,0,2
11779,2,0,0,0,2
11780,0,2,0,0,2
11781,0,2,0,0,2
11782,0,2,0,0,2
11783,0,2,0,0,2
11784,0,2,0,0,2
11785,0,2,0,0,2
11786,0,2,0,0,2
11787,0,2,0,0,2
11788,0,2,0,0,2
11789,0,2,0,0,2
11790,0,2,0,0,2
11791,0,2,0,0,2
11792,0,1,0,1,2
11793,0,1,0,1,2
11794,0,2,0,0,2
11795,0,2,0,0,2
11796,0,2,0,0,2
11797,1,1,0,0,2
11798,0,2,0,0,2
11799,1,1,0,0,2
11800,1,0,1,0,2
11801,0,2,0,0,2
11802,1,1,0,0,2
11803,1,0,0,1,2
11804,0,2,0,0,2
11805,0,2,0,0,2
11806,0,2,0,0,2
11807,0,2,0,0,2
11808,0,2,0,0,2
11809,0,2,0,0,2
11810,0,2,0,0,2
11811,0,2,0,0,2
11812,0,2,0,0,2
11813,0,2,0,0,2
11814,0,2,0,0,2
11815,0,2,0,0,2
11816,2,0,0,0,2
11817,0,2,0,0,2
11818,0,2,0,0,2
11819,1,1,0,0,2
11820,0,2,0,0,2
11821,0,2,0,0,2
11822,0,2,0,0,2
11823,0,2,0,0,2
11824,0,2,0,0,2
11825,0,2,0,0,2
11826,1,0,0,1,2
11827,0,2,0,0,2
11828,2,0,0,0,2
11829,0,2,0,0,2
11830,0,2,0,0,2
11831,2,0,0,0,2
11832,0,2,0,0,2
11833,0,2,0,0,2
11834,0,2,0,0,2
11835,0,2,0,0,2
11836,0,2,0,0,2
11837,0,2,0,0,2
11838,0,0,1,1,2
11839,0,2,0,0,2
11840,0,2,0,0,2
11841,2,0,0,0,2
11842,0,2,0,0,2
11843,0,2,0,0,2
11844,0,2,0,0,2
11845,1,1,0,0,2
11846,0,2,0,0,2
11847,0,2,0,0,2
11848,0,2,0,0,2
11849,0,2,0,0,2
11850,0,0,2,0,2
11851,0,2,0,0,2
11852,0,2,0,0,2
11853,0,2,0,0,2
11854,1,1,0,0,2
11855,0,2,0,0,2
11856,1,1,0,0,2
11857,0,1,1,0,2
11858,0,2,0,0,2
11859,0,2,0,0,2
11860,2,0,0,0,2
11861,0,2,0,0,2
11862,0,2,0,0,2
11863,0,2,0,0,2
11864,0,2,0,0,2
11865,0,2,0,0,2
11866,0,2,0,0,2
11867,1,1,0,0,2
11868,0,2,0,0,2
11869,1,1,0,0,2
11870,0,2,0,0,2
11871,0,2,0,0,2
11872,0,2,0,0,2
11873,0,2,0,0,2
11874,2,0,0,0,2
11875,0,2,0,0,2
11876,0,2,0,0,2
11877,0,2,0,0,2
11878,1,1,0,0,2
11879,1,0,0,1,2
11880,0,2,0,0,2
11881,0,2,0,0,2
11882,0,2,0,0,2
11883,0,2,0,0,2
11884,0,2,0,0,2
11885,0,2,0,0,2
11886,0,2,0,0,2
11887,1,1,0,0,2
11888,0,2,0,0,2
11889,0,2,0,0,2
11890,1,1,0,0,2
11891,0,2,0,0,2
11892,0,2,0,0,2
11893,0,2,0,0,2
11894,1,0,1,0,2
11895,0,2,0,0,2
11896,2,0,0,0,2
11897,0,1,1,0,2
11898,0,2,0,0,2
11899,0,2,0,0,2
11900,0,2,0,0,2
11901,0,2,0,0,2
11902,0,2,0,0,2
11903,0,2,0,0,2
11904,0,2,0,0,2
11905,1,1,0,0,2
11906,2,0,0,0,2
11907,2,0,0,0,2
11908,0,2,0,0,2
11909,2,0,0,0,2
11910,0,1,0,1,2
11911,0,2,0,0,2
11912,0,2,0,0,2
11913,1,1,0,0,2
11914,0,2,0,0,2
11915,0,2,0,0,2
11916,0,2,0,0,2
11917,0,2,0,0,2
11918,0,2,0,0,2
11919,0,2,0,0,2
11920,0,2,0,0,2
11921,0,2,0,0,2
11922,0,2,0,0,2
11923,0,2,0,0,2
11924,0,1,0,1,2
11925,0,2,0,0,2
11926,0,2,0,0,2
11927,0,2,0,0,2
11928,0,2,0,0,2
11929,0,2,0,0,2
11930,0,2,0,0,2
11931,0,2,0,0,2
11932,0,0,0,2,2
11933,0,2,0,0,2
11934,2,0,0,0,2
11935,0,2,0,0,2
11936,0,2,0,0,2
11937,0,2,0,0,2
11938,0,1,0,1,2
11939,0,0,2,0,2
11940,0,2,0,0,2
11941,0,2,0,0,2
11942,0,2,0,0,2
11943,0,2,0,0,2
11944,0,2,0,0,2
11945,0,2,0,0,2
11946,0,2,0,0,2
11947,0,2,0,0,2
11948,0,2,0,0,2
11949,0,2,0,0,2
11950,0,2,0,0,2
11951,1,0,1,0,2
11952,0,2,0,0,2
11953,0,2,0,0,2
11954,0,2,0,0,2
11955,1,1,0,0,2
11956,2,0,0,0,2
11957,0,2,0,0,2
11958,0,1,1,0,2
11959,0,0,1,1,2
11960,0,0,1,1,2
11961,0,2,0,0,2
11962,0,2,0,0,2
11963,0,2,0,0,2
11964,0,2,0,0,2
11965,0,2,0,0,2
11966,2,0,0,0,2
11967,0,2,0,0,2
11968,0,2,0,0,2
11969,0,1,1,0,2
11970,1,1,0,0,2
11971,0,1,0,1,2
11972,0,2,0,0,2
11973,0,2,0,0,2
11974,0,2,0,0,2
11975,2,0,0,0,2
11976,0,2,0,0,2
11977,0,2,0,0,2
11978,0,2,0,0,2
11979,0,2,0,0,2
11980,0,2,0,0,2
11981,1,1,0,0,2
11982,0,2,0,0,2
11983,0,2,0,0,2
11984,0,2,0,0,2
11985,0,2,0,0,2
11986,0,2,0,0,2
11987,0,2,0,0,2
11988,2,0,0,0,2
11989,0,2,0,0,2
11990,0,0,2,0,2
11991,0,2,0,0,2
11992,0,2,0,0,2
11993,0,2,0,0,2
11994,1,0,1,0,2
11995,0,2,0,0,2
11996,1,0,0,1,2
11997,0,2,0,0,2
11998,1,1,0,0,2
11999,0,2,0,0,2
12000,0,2,0,0,2
12001,0,2,0,0,2
12002,0,2,0,0,2
12003,0,2,0,0,2
12004,0,0,0,2,2
12005,0,2,0,0,2
12006,0,1,0,1,2
12007,1,1,0,0,2
12008,0,2,0,0,2
12009,0,1,0,1,2
12010,0,2,0,0,2
12011,0,2,0,0,2
12012,0,2,0,0,2
12013,2,0,0,0,2
12014,0,2,0,0,2
12015,0,2,0,0,2
12016,0,2,0,0,2
12017,0,2,0,0,2
12018,0,2,0,0,2
12019,1,1,0,0,2
12020,0,2,0,0,2
12021,0,1,1,0,2
12022,1,0,0,1,2
12023,0,2,0,0,2
12024,0,2,0,0,2
12025,0,2,0,0,2
12026,0,2,0,0,2
12027,0,2,0,0,2
12028,1,0,0,1,2
12029,0,2,0,0,2
12030,0,2,0,0,2
12031,0,2,0,0,2
12032,0,2,0,0,2
12033,0,2,0,0,2
12034,0,2,0,0,2
12035,0,2,0,0,2
12036,0,1,0,1,2
12037,0,2,0,0,2
12038,0,2,0,0,2
12039,0,1,1,0,2
12040,0,2,0,0,2
12041,1,1,0,0,2
12042,0,2,0,0,2
12043,0,2,0,0,2
12044,0,2,0,0,2
12045,0,2,0,0,2
12046,0,2,0,0,2
12047,1,1,0,0,2
12048,0,2,0,0,2
12049,0,2,0,0,2
12050,0,2,0,0,2
12051,1,0,1,0,2
12052,0,2,0,0,2
12053,0,2,0,0,2
12054,1,1,0,0,2
12055,1,1,0,0,2
12056,0,2,0,0,2
12057,0,2,0,0,2
12058,0,2,0,0,2
12059,0,2,0,0,2
12060,0,1,1,0,2
12061,0,2,0,0,2
12062,0,2,0,0,2
12063,0,2,0,0,2
12064,0,2,0,0,2
12065,0,2,0,0,2
12066,0,2,0,0,2
12067,0,2,0,0,2
12068,0,2,0,0,2
12069,0,0,0,2,2
12070,0,2,0,0,2
12071,0,1,0,1,2
12072,0,2,0,0,2
12073,0,2,0,0,2
12074,0,2,0,0,2
12075,0,2,0,0,2
12076,1,0,1,0,2
12077,0,0,0,2,2
12078,0,2,0,0,2
12079,0,2,0,0,2
12080,0,2,0,0,2
12081,1,0,0,1,2
12082,0,2,0,0,2
12083,0,2,0,0,2
12084,2,0,0,0,2
12085,0,2,0,0,2
12086,1,0,0,1,2
12087,0,2,0,0,2
12088,0,2,0,0,2
12089,2,0,0,0,2
12090,0,2,0,0,2
12091,0,2,0,0,2
12092,1,1,0,0,2
12093,0,2,0,0,2
12094,0,2,0,0,2
12095,0,2,0,0,2
12096,0,2,0,0,2
12097,0,2,0,0,2
12098,0,2,0,0,2
12099,0,2,0,0,2
12100,2,0,0,0,2
12101,0,2,0,0,2
12102,1,1,0,0,2
12103,0,2,0,0,2
12104,0,0,0,2,2
12105,0,2,0,0,2
12106,0,2,0,0,2
12107,0,2,0,0,2
12108,0,2,0,0,2
12109,1,1,0,0,2
12110,2,0,0,0,2
12111,0,2,0,0,2
12112,0,2,0,0,2
12113,0,2,0,0,2
12114,0,2,0,0,2
12115,0,2,0,0,2
12116,1,1,0,0,2
12117,0,2,0,0,2
12118,1,1,0,0,2
12119,0,2,0,0,2
12120,0,2,0,0,2
12121,0,2,0,0,2
12122,0,2,0,0,2
12123,0,2,0,0,2
12124,2,0,0,0,2
12125,0,2,0,0,2
12126,0,2,0,0,2
12127,0,2,0,0,2
12128,0,2,0,0,2
12129,0,2,0,0,2
12130,2,0,0,0,2
12131,0,1,1,0,2
12132,0,2,0,0,2
12133,0,2,0,0,2
12134,0,2,0,0,2
12135,1,1,0,0,2
12136,0,2,0,0,2
12137,0,2,0,0,2
12138,0,2,0,0,2
12139,0,2,0,0,2
12140,0,2,0,0,2
12141,1,1,0,0,2
12142,2,0,0,0,2
12143,0,2,0,0,2
12144,0,2,0,0,2
12145,1,1,0,0,2
12146,0,2,0,0,2
12147,0,2,0,0,2
12148,2,0,0,0,2
12149,0,2,0,0,2
12150,0,2,0,0,2
12151,0,2,0,0,2
12152,0,2,0,0,2
12153,0,2,0,0,2
12154,0,2,0,0,2
12155,2,0,0,0,2
12156,0,2,0,0,2
12157,0,2,0,0,2
12158,0,2,0,0,2
12159,0,2,0,0,2
12160,0,2,0,0,2
12161,1,1,0,0,2
12162,0,2,0,0,2
12163,0,2,0,0,2
12164,0,2,0,0,2
12165,2,0,0,0,2
12166,0,1,0,1,2
12167,0,2,0,0,2
12168,0,2,0,0,2
12169,2,0,0,0,2
12170,0,2,0,0,2
12171,0,2,0,0,2
12172,0,2,0,0,2
12173,2,0,0,0,2
12174,0,2,0,0,2
12175,0,2,0,0,2
12176,0,2,0,0,2
12177,1,1,0,0,2
12178,0,2,0,0,2
12179,2,0,0,0,2
12180,0,2,0,0,2
12181,0,2,0,0,2
12182,0,2,0,0,2
12183,0,2,0,0,2
12184,0,2,0,0,2
12185,0,2,0,0,2
12186,0,2,0,0,2
12187,0,0,0,2,2
12188,0,2,0,0,2
12189,0,2,0,0,2
12190,0,2,0,0,2
12191,0,2,0,0,2
12192,0,2,0,0,2
12193,0,2,0,0,2
12194,0,2,0,0,2
12195,0,2,0,0,2
12196,0,1,0,1,2
12197,0,2,0,0,2
12198,0,2,0,0,2
12199,0,2,0,0,2
12200,0,2,0,0,2
12201,0,2,0,0,2
12202,0,2,0,0,2
12203,1,1,0,0,2
12204,0,2,0,0,2
12205,2,0,0,0,2
12206,0,2,0,0,2
12207,0,2,0,0,2
12208,0,1,1,0,2
12209,0,2,0,0,2
12210,0,2,0,0,2
12211,0,2,0,0,2
12212,0,2,0,0,2
12213,0,2,0,0,2
12214,0,2,0,0,2
12215,0,2,0,0,2
12216,0,2,0,0,2
12217,0,2,0,0,2
12218,0,2,0,0,2
12219,0,2,0,0,2
12220,2,0,0,0,2
12221,1,1,0,0,2
12222,0,2,0,0,2
12223,0,2,0,0,2
12224,0,2,0,0,2
12225,0,2,0,0,2
12226,2,0,0,0,2
12227,0,2,0,0,2
12228,0,2,0,0,2
12229,0,2,0,0,2
12230,0,2,0,0,2
12231,0,2,0,0,2
12232,0,2,0,0,2
12233,0,2,0,0,2
12234,0,2,0,0,2
12235,1,1,0,0,2
12236,0,2,0,0,2
12237,2,0,0,0,2
12238,0,2,0,0,2
12239,0,2,0,0,2
12240,0,2,0,0,2
12241,0,2,0,0,2
12242,0,2,0,0,2
12243,2,0,0,0,2
12244,0,2,0,0,2
12245,0,2,0,0,2
12246,0,2,0,0,2
12247,0,2,0,0,2
12248,0,2,0,0,2
12249,0,2,0,0,2
12250,0,2,0,0,2
12251,2,0,0,0,2
12252,0,2,0,0,2
12253,0,2,0,0,2
12254,0,2,0,0,2
12255,1,1,0,0,2
12256,0,2,0,0,2
12257,0,2,0,0,2
12258,0,2,0,0,2
12259,0,1,1,0,2
12260,0,2,0,0,2
12261,0,2,0,0,2
12262,0,2,0,0,2
12263,0,0,1,1,2
12264,2,0,0,0,2
12265,0,2,0,0,2
12266,0,1,1,0,2
12267,1,1,0,0,2
12268,0,2,0,0,2
12269,1,1,0,0,2
12270,1,1,0,0,2
12271,0,2,0,0,2
12272,0,2,0,0,2
12273,0,2,0,0,2
12274,0,2,0,0,2
12275,1,0,1,0,2
12276,2,0,0,0,2
12277,0,2,0,0,2
12278,0,2,0,0,2
12279,2,0,0,0,2
12280,0,2,0,0,2
12281,1,1,0,0,2
12282,2,0,0,0,2
12283,0,2,0,0,2
12284,0,2,0,0,2
12285,0,2,0,0,2
12286,0,2,0,0,2
12287,2,0,0,0,2
12288,0,2,0,0,2
12289,0,2,0,0,2
12290,0,2,0,0,2
12291,0,2,0,0,2
12292,0,2,0,0,2
12293,0,2,0,0,2
12294,0,2,0,0,2
12295,0,0,0,2,2
12296,0,2,0,0,2
12297,0,2,0,0,2
12298,1,1,0,0,2
12299,0,2,0,0,2
12300,0,2,0,0,2
12301,0,2,0,0,2
12302,0,1,1,0,2
12303,0,2,0,0,2
12304,0,2,0,0,2
12305,1,0,0,1,2
12306,0,2,0,0,2
12307,1,1,0,0,2
12308,2,0,0,0,2
12309,0,2,0,0,2
12310,0,2,0,0,2
12311,0,2,0,0,2
12312,0,2,0,0,2
12313,0,2,0,0,2
12314,0,2,0,0,2
12315,0,2,0,0,2
12316,2,0,0,0,2
12317,0,2,0,0,2
12318,0,0,1,1,2
12319,0,2,0,0,2
12320,0,2,0,0,2
12321,1,0,1,0,2
12322,2,0,0,0,2
12323,2,0,0,0,2
12324,0,2,0,0,2
12325,0,2,0,0,2
12326,0,2,0,0,2
12327,0,2,0,0,2
12328,2,0,0,0,2
12329,0,2,0,0,2
12330,0,2,0,0,2
12331,0,2,0,0,2
12332,1,1,0,0,2
12333,0,2,0,0,2
12334,0,2,0,0,2
12335,0,2,0,0,2
12336,0,2,0,0,2
12337,2,0,0,0,2
12338,0,2,0,0,2
12339,1,1,0,0,2
12340,0,2,0,0,2
12341,0,2,0,0,2
12342,1,0,0,1,2
12343,2,0,0,0,2
12344,0,2,0,0,2
12345,0,2,0,0,2
12346,2,0,0,0,2
12347,0,2,0,0,2
12348,1,1,0,0,2
12349,0,1,0,1,2
12350,0,2,0,0,2
12351,0,2,0,0,2
12352,1,1,0,0,2
12353,0,2,0,0,2
12354,1,1,0,0,2
12355,0,2,0,0,2
12356,0,2,0,0,2
12357,0,2,0,0,2
12358,1,1,0,0,2
12359,0,2,0,0,2
12360,0,2,0,0,2
12361,0,2,0,0,2
12362,2,0,0,0,2
12363,0,2,0,0,2
12364,1,0,1,0,2
12365,0,2,0,0,2
12366,0,2,0,0,2
12367,0,2,0,0,2
12368,1,1,0,0,2
12369,0,2,0,0,2
12370,0,2,0,0,2
12371,1,0,1,0,2
12372,0,2,0,0,2
12373,0,2,0,0,2
12374,2,0,0,0,2
12375,0,2,0,0,2
12376,0,1,1,0,2
12377,0,2,0,0,2
12378,0,2,0,0,2
12379,1,1,0,0,2
12380,0,2,0,0,2
12381,2,0,0,0,2
12382,0,2,0,0,2
12383,0,0,0,2,2
12384,0,2,0,0,2
12385,0,2,0,0,2
12386,1,1,0,0,2
12387,0,2,0,0,2
12388,0,2,0,0,2
12389,0,2,0,0,2
12390,0,2,0,0,2
12391,0,2,0,0,2
12392,0,2,0,0,2
12393,0,2,0,0,2
12394,0,2,0,0,2
12395,0,2,0,0,2
12396,0,0,0,2,2
12397,0,2,0,0,2
12398,2,0,0,0,2
12399,0,2,0,0,2
12400,0,2,0,0,2
12401,0,2,0,0,2
12402,0,2,0,0,2
12403,0,1,0,1,2
12404,0,2,0,0,2
12405,0,2,0,0,2
12406,0,2,0,0,2
12407,0,2,0,0,2
12408,0,2,0,0,2
12409,2,0,0,0,2
12410,0,2,0,0,2
12411,1,0,0,1,2
12412,0,2,0,0,2
12413,0,2,0,0,2
12414,0,2,0,0,2
12415,0,2,0,0,2
12416,0,2,0,0,2
12417,0,2,0,0,2
12418,0,2,0,0,2
12419,0,2,0,0,2
12420,0,2,0,0,2
12421,2,0,0,0,2
12422,0,2,0,0,2
12423,0,2,0,0,2
12424,2,0,0,0,2
12425,0,2,0,0,2
12426,2,0,0,0,2
12427,1,1,0,0,2
12428,0,2,0,0,2
12429,0,2,0,0,2
12430,0,2,0,0,2
12431,0,2,0,0,2
12432,0,2,0,0,2
12433,0,2,0,0,2
12434,0,2,0,0,2
12435,0,2,0,0,2
12436,0,2,0,0,2
12437,0,2,0,0,2
12438,2,0,0,0,2
12439,0,2,0,0,2
12440,2,0,0,0,2
12441,0,2,0,0,2
12442,0,0,0,2,2
12443,0,2,0,0,2
12444,0,2,0,0,2
12445,0,2,0,0,2
12446,2,0,0,0,2
12447,0,2,0,0,2
12448,0,2,0,0,2
12449,0,2,0,0,2
12450,0,2,0,0,2
12451,0,2,0,0,2
12452,0,2,0,0,2
12453,2,0,0,0,2
12454,2,0,0,0,2
12455,0,2,0,0,2
12456,0,2,0,0,2
12457,1,1,0,0,2
12458,0,2,0,0,2
12459,0,2,0,0,2
12460,0,2,0,0,2
12461,0,2,0,0,2
12462,0,2,0,0,2
12463,2,0,0,0,2
12464,1,0,0,1,2
12465,0,1,0,1,2
12466,0,2,0,0,2
12467,2,0,0,0,2
12468,0,1,0,1,2
12469,0,2,0,0,2
12470,1,0,0,1,2
12471,0,2,0,0,2
12472,0,1,0,1,2
12473,1,1,0,0,2
12474,0,1,1,0,2
12475,0,2,0,0,2
12476,0,2,0,0,2
12477,0,2,0,0,2
12478,0,2,0,0,2
12479,0,2,0,0,2
12480,2,0,0,0,2
12481,0,2,0,0,2
12482,0,2,0,0,2
12483,0,2,0,0,2
12484,0,2,0,0,2
12485,0,2,0,0,2
12486,0,2,0,0,2
12487,0,2,0,0,2
12488,0,2,0,0,2
12489,0,2,0,0,2
12490,0,2,0,0,2
12491,0,2,0,0,2
12492,0,2,0,0,2
12493,0,2,0,0,2
12494,0,2,0,0,2
12495,0,2,0,0,2
12496,2,0,0,0,2
12497,0,2,0,0,2
12498,0,2,0,0,2
12499,0,2,0,0,2
12500,0,2,0,0,2
12501,0,2,0,0,2
12502,2,0,0,0,2
12503,0,2,0,0,2
12504,0,2,0,0,2
12505,0,2,0,0,2
12506,0,2,0,0,2
12507,2,0,0,0,2
12508,0,2,0,0,2
12509,0,2,0,0,2
12510,1,0,0,1,2
12511,1,1,0,0,2
12512,0,2,0,0,2
12513,0,1,1,0,2
12514,2,0,0,0,2
12515,0,2,0,0,2
12516,2,0,0,0,2
12517,0,2,0,0,2
12518,1,0,1,0,2
12519,0,2,0,0,2
12520,0,2,0,0,2
12521,0,1,0,1,2
12522,0,2,0,0,2
12523,0,2,0,0,2
12524,0,2,0,0,2
12525,0,2,0,0,2
12526,0,2,0,0,2
12527,2,0,0,0,2
12528,1,1,0,0,2
12529,0,2,0,0,2
12530,0,2,0,0,2
12531,0,0,2,0,2
12532,0,2,0,0,2
12533,0,2,0,0,2
12534,2,0,0,0,2
12535,0,2,0,0,2
12536,0,2,0,0,2
12537,0,2,0,0,2
12538,0,2,0,0,2
12539,0,2,0,0,2
12540,0,2,0,0,2
12541,1,1,0,0,2
12542,0,2,0,0,2
12543,1,0,1,0,2
12544,0,2,0,0,2
12545,2,0,0,0,2
12546,0,2,0,0,2
12547,0,2,0,0,2
12548,2,0,0,0,2
12549,2,0,0,0,2
12550,0,2,0,0,2
12551,0,2,0,0,2
12552,0,2,0,0,2
12553,0,2,0,0,2
12554,0,2,0,0,2
12555,0,2,0,0,2
12556,1,1,0,0,2
12557,0,2,0,0,2
12558,0,2,0,0,2
12559,0,2,0,0,2
12560,0,2,0,0,2
12561,2,0,0,0,2
12562,1,1,0,0,2
12563,2,0,0,0,2
12564,0,2,0,0,2
12565,1,1,0,0,2
12566,0,2,0,0,2
12567,0,2,0,0,2
12568,1,0,1,0,2
12569,1,0,0,1,2
12570,0,2,0,0,2
12571,1,0,0,1,2
12572,0,2,0,0,2
12573,0,2,0,0,2
12574,2,0,0,0,2
12575,0,2,0,0,2
12576,0,2,0,0,2
12577,2,0,0,0,2
12578,0,2,0,0,2
12579,2,0,0,0,2
12580,0,2,0,0,2
12581,0,2,0,0,2
12582,0,2,0,0,2
12583,0,2,0,0,2
12584,0,2,0,0,2
12585,0,0,1,1,2
12586,0,2,0,0,2
12587,0,2,0,0,2
12588,0,2,0,0,2
12589,0,2,0,0,2
12590,0,2,0,0,2
12591,0,2,0,0,2
12592,0,2,0,0,2
12593,0,2,0,0,2
12594,0,2,0,0,2
12595,0,2,0,0,2
12596,0,2,0,0,2
12597,0,2,0,0,2
12598,0,2,0,0,2
12599,0,0,0,2,2
12600,2,0,0,0,2
12601,0,2,0,0,2
12602,0,2,0,0,2
12603,0,1,1,0,2
12604,1,0,0,1,2
12605,0,2,0,0,2
12606,0,0,2,0,2
12607,2,0,0,0,2
12608,0,2,0,0,2
12609,1,1,0,0,2
12610,1,1,0,0,2
12611,0,2,0,0,2
12612,0,2,0,0,2
12613,0,2,0,0,2
12614,0,2,0,0,2
12615,0,2,0,0,2
12616,0,2,0,0,2
12617,1,1,0,0,2
12618,0,2,0,0,2
12619,2,0,0,0,2
12620,0,2,0,0,2
12621,0,0,0,2,2
12622,0,2,0,0,2
12623,0,2,0,0,2
12624,1,0,1,0,2
12625,0,2,0,0,2
12626,0,2,0,0,2
12627,0,2,0,0,2
12628,0,0,0,2,2
12629,0,2,0,0,2
12630,0,2,0,0,2
12631,0,2,0,0,2
12632,1,0,0,1,2
12633,2,0,0,0,2
12634,0,2,0,0,2
12635,1,1,0,0,2
12636,1,0,0,1,2
12637,0,2,0,0,2
12638,0,2,0,0,2
12639,0,2,0,0,2
12640,0,2,0,0,2
12641,0,2,0,0,2
12642,0,2,0,0,2
12643,0,2,0,0,2
12644,2,0,0,0,2
12645,0,1,0,1,2
12646,0,2,0,0,2
12647,0,2,0,0,2
12648,0,2,0,0,2
12649,0,2,0,0,2
12650,0,2,0,0,2
12651,0,2,0,0,2
12652,2,0,0,0,2
12653,0,2,0,0,2
12654,0,2,0,0,2
12655,0,2,0,0,2
12656,0,2,0,0,2
12657,1,1,0,0,2
12658,1,1,0,0,2
12659,0,2,0,0,2
12660,0,2,0,0,2
12661,0,1,0,1,2
12662,0,2,0,0,2
12663,0,2,0,0,2
12664,0,2,0,0,2
12665,0,2,0,0,2
12666,0,2,0,0,2
12667,0,2,0,0,2
12668,2,0,0,0,2
12669,0,2,0,0,2
12670,1,1,0,0,2
12671,0,2,0,0,2
12672,0,2,0,0,2
12673,0,2,0,0,2
12674,0,2,0,0,2
12675,0,2,0,0,2
12676,0,2,0,0,2
12677,0,2,0,0,2
12678,0,2,0,0,2
12679,0,2,0,0,2
12680,0,2,0,0,2
12681,0,0,1,1,2
12682,2,0,0,0,2
12683,0,2,0,0,2
12684,0,2,0,0,2
12685,0,2,0,0,2
12686,0,2,0,0,2
12687,0,2,0,0,2
12688,0,2,0,0,2
12689,0,2,0,0,2
12690,0,2,0,0,2
12691,0,2,0,0,2
12692,0,2,0,0,2
12693,0,2,0,0,2
12694,0,2,0,0,2
12695,0,2,0,0,2
12696,0,2,0,0,2
12697,1,0,0,1,2
12698,0,2,0,0,2
12699,0,2,0,0,2
12700,1,1,0,0,2
12701,1,0,0,1,2
12702,0,2,0,0,2
12703,0,2,0,0,2
12704,0,2,0,0,2
12705,1,1,0,0,2
12706,0,2,0,0,2
12707,0,2,0,0,2
12708,0,2,0,0,2
12709,0,2,0,0,2
12710,0,2,0,0,2
12711,0,2,0,0,2
12712,0,2,0,0,2
12713,2,0,0,0,2
12714,2,0,0,0,2
12715,0,1,0,1,2
12716,0,2,0,0,2
12717,0,2,0,0,2
12718,2,0,0,0,2
12719,1,1,0,0,2
12720,0,2,0,0,2
12721,1,0,1,0,2
12722,0,0,2,0,2
12723,0,2,0,0,2
12724,0,2,0,0,2
12725,0,2,0,0,2
12726,0,2,0,0,2
12727,0,2,0,0,2
12728,0,2,0,0,2
12729,0,2,0,0,2
12730,0,0,0,2,2
12731,0,2,0,0,2
12732,1,1,0,0,2
12733,0,1,1,0,2
12734,0,0,1,1,2
12735,0,2,0,0,2
12736,0,0,0,2,2
12737,0,2,0,0,2
12738,0,2,0,0,2
12739,0,2,0,0,2
12740,0,2,0,0,2
12741,0,2,0,0,2
12742,0,2,0,0,2
12743,0,2,0,0,2
12744,0,2,0,0,2
12745,2,0,0,0,2
12746,0,2,0,0,2
12747,1,0,1,0,2
12748,0,2,0,0,2
12749,0,2,0,0,2
12750,0,2,0,0,2
12751,0,2,0,0,2
12752,0,2,0,0,2
12753,0,0,0,2,2
12754,0,2,0,0,2
12755,0,2,0,0,2
12756,0,2,0,0,2
12757,2,0,0,0,2
12758,0,2,0,0,2
12759,0,2,0,0,2
12760,0,2,0,0,2
12761,0,2,0,0,2
12762,0,2,0,0,2
12763,0,2,0,0,2
12764,0,2,0,0,2
12765,0,1,1,0,2
12766,2,0,0,0,2
12767,0,2,0,0,2
12768,0,1,0,1,2
12769,0,2,0,0,2
12770,0,2,0,0,2
12771,0,2,0,0,2
12772,0,0,2,0,2
12773,0,2,0,0,2
12774,0,2,0,0,2
12775,0,2,0,0,2
12776,0,2,0,0,2
12777,1,1,0,0,2
12778,0,2,0,0,2
12779,0,2,0,0,2
12780,0,2,0,0,2
12781,0,2,0,0,2
12782,0,2,0,0,2
12783,0,2,0,0,2
12784,0,2,0,0,2
12785,0,2,0,0,2
12786,0,2,0,0,2
12787,0,2,0,0,2
12788,0,2,0,0,2
12789,0,2,0,0,2
12790,0,2,0,0,2
12791,1,1,0,0,2
12792,0,2,0,0,2
12793,0,2,0,0,2
12794,0,2,0,0,2
12795,1,0,0,1,2
12796,0,2,0,0,2
12797,0,2,0,0,2
12798,0,2,0,0,2
12799,0,2,0,0,2
12800,0,2,0,0,2
12801,0,2,0,0,2
12802,0,2,0,0,2
12803,0,2,0,0,2
12804,0,2,0,0,2
12805,0,2,0,0,2
12806,2,0,0,0,2
12807,0,2,0,0,2
12808,2,0,0,0,2
12809,2,0,0,0,2
12810,2,0,0,0,2
12811,0,1,0,1,2
12812,0,2,0,0,2
12813,0,2,0,0,2
12814,2,0,0,0,2
12815,0,2,0,0,2
12816,0,2,0,0,2
12817,0,2,0,0,2
12818,0,2,0,0,2
12819,0,2,0,0,2
12820,0,2,0,0,2
12821,0,2,0,0,2
12822,0,2,0,0,2
12823,2,0,0,0,2
12824,0,2,0,0,2
12825,2,0,0,0,2
12826,2,0,0,0,2
12827,0,2,0,0,2
12828,0,2,0,0,2
12829,2,0,0,0,2
12830,0,1,1,0,2
12831,0,2,0,0,2
12832,0,2,0,0,2
12833,0,2,0,0,2
12834,0,2,0,0,2
12835,0,2,0,0,2
12836,0,2,0,0,2
12837,0,2,0,0,2
12838,0,2,0,0,2
12839,0,2,0,0,2
12840,1,0,0,1,2
12841,1,1,0,0,2
12842,0,2,0,0,2
12843,1,1,0,0,2
12844,0,1,0,1,2
12845,0,2,0,0,2
12846,0,2,0,0,2
12847,0,2,0,0,2
12848,1,1,0,0,2
12849,0,2,0,0,2
12850,2,0,0,0,2
12851,2,0,0,0,2
12852,0,2,0,0,2
12853,0,2,0,0,2
12854,0,2,0,0,2
12855,0,2,0,0,2
12856,2,0,0,0,2
12857,0,2,0,0,2
12858,1,1,0,0,2
12859,0,2,0,0,2
12860,0,2,0,0,2
12861,0,2,0,0,2
12862,0,2,0,0,2
12863,0,2,0,0,2
12864,0,2,0,0,2
12865,0,2,0,0,2
12866,0,2,0,0,2
12867,0,2,0,0,2
12868,0,2,0,0,2
12869,1,1,0,0,2
12870,0,2,0,0,2
12871,1,0,1,0,2
12872,0,2,0,0,2
12873,1,0,0,1,2
12874,1,1,0,0,2
12875,0,0,0,2,2
12876,1,1,0,0,2
12877,1,0,1,0,2
12878,0,2,0,0,2
12879,0,2,0,0,2
12880,0,2,0,0,2
12881,0,2,0,0,2
12882,1,1,0,0,2
12883,1,0,0,1,2
12884,0,2,0,0,2
12885,0,2,0,0,2
12886,1,1,0,0,2
12887,0,2,0,0,2
12888,2,0,0,0,2
12889,0,2,0,0,2
12890,0,2,0,0,2
12891,0,2,0,0,2
12892,1,1,0,0,2
12893,0,2,0,0,2
12894,0,2,0,0,2
12895,0,2,0,0,2
12896,0,2,0,0,2
12897,1,1,0,0,2
12898,0,2,0,0,2
12899,0,2,0,0,2
12900,0,2,0,0,2
12901,0,2,0,0,2
12902,0,2,0,0,2
12903,0,2,0,0,2
12904,0,2,0,0,2
12905,2,0,0,0,2
12906,0,2,0,0,2
12907,0,2,0,0,2
12908,0,0,2,0,2
12909,0,2,0,0,2
12910,0,2,0,0,2
12911,0,0,1,1,2
12912,0,2,0,0,2
12913,0,0,0,2,2
12914,0,2,0,0,2
12915,1,1,0,0,2
12916,0,2,0,0,2
12917,2,0,0,0,2
12918,0,2,0,0,2
12919,0,2,0,0,2
12920,2,0,0,0,2
12921,2,0,0,0,2
12922,0,2,0,0,2
12923,0,2,0,0,2
12924,0,2,0,0,2
12925,0,2,0,0,2
12926,2,0,0,0,2
12927,0,2,0,0,2
12928,0,2,0,0,2
12929,0,2,0,0,2
12930,0,2,0,0,2
12931,0,2,0,0,2
12932,0,2,0,0,2
12933,0,2,0,0,2
12934,0,2,0,0,2
12935,0,2,0,0,2
12936,0,2,0,0,2
12937,0,2,0,0,2
12938,0,2,0,0,2
12939,0,0,0,2,2
12940,0,2,0,0,2
12941,0,2,0,0,2
12942,0,2,0,0,2
12943,1,0,0,1,2
12944,2,0,0,0,2
12945,0,2,0,0,2
12946,0,2,0,0,2
12947,0,2,0,0,2
12948,0,2,0,0,2
12949,0,2,0,0,2
12950,0,2,0,0,2
12951,0,2,0,0,2
12952,0,2,0,0,2
12953,0,2,0,0,2
12954,1,1,0,0,2
12955,0,2,0,0,2
12956,0,2,0,0,2
12957,0,2,0,0,2
12958,0,2,0,0,2
12959,0,2,0,0,2
12960,0,2,0,0,2
12961,1,1,0,0,2
12962,0,2,0,0,2
12963,0,2,0,0,2
12964,0,2,0,0,2
12965,0,2,0,0,2
12966,0,2,0,0,2
12967,0,2,0,0,2
12968,0,2,0,0,2
12969,0,2,0,0,2
12970,2,0,0,0,2
12971,0,2,0,0,2
12972,0,0,0,2,2
12973,2,0,0,0,2
12974,0,2,0,0,2
12975,0,2,0,0,2
12976,1,1,0,0,2
12977,1,1,0,0,2
12978,0,2,0,0,2
12979,0,0,0,2,2
12980,1,1,0,0,2
12981,0,2,0,0,2
12982,0,2,0,0,2
12983,0,2,0,0,2
12984,0,2,0,0,2
12985,0,2,0,0,2
12986,1,0,0,1,2
12987,0,2,0,0,2
12988,0,2,0,0,2
12989,0,2,0,0,2
12990,2,0,0,0,2
12991,0,2,0,0,2
12992,0,2,0,0,2
12993,0,2,0,0,2
12994,0,2,0,0,2
12995,1,1,0,0,2
12996,2,0,0,0,2
12997,0,2,0,0,2
12998,0,2,0,0,2
12999,0,2,0,0,2
13000,0,2,0,0,2
13001,0,2,0,0,2
13002,0,2,0,0,2
13003,0,2,0,0,2
13004,0,2,0,0,2
13005,2,0,0,0,2
13006,1,1,0,0,2
13007,0,2,0,0,2
13008,0,2,0,0,2
13009,0,2,0,0,2
13010,0,2,0,0,2
13011,0,2,0,0,2
13012,0,2,0,0,2
13013,0,2,0,0,2
13014,0,2,0,0,2
13015,0,2,0,0,2
13016,0,0,0,2,2
13017,1,1,0,0,2
13018,0,2,0,0,2
13019,2,0,0,0,2
13020,0,2,0,0,2
13021,0,0,2,0,2
13022,0,2,0,0,2
13023,0,2,0,0,2
13024,0,2,0,0,2
13025,2,0,0,0,2
13026,0,2,0,0,2
13027,0,2,0,0,2
13028,0,2,0,0,2
13029,0,2,0,0,2
13030,0,2,0,0,2
13031,0,2,0,0,2
13032,0,2,0,0,2
13033,0,2,0,0,2
13034,0,2,0,0,2
13035,1,1,0,0,2
13036,0,2,0,0,2
13037,2,0,0,0,2
13038,0,2,0,0,2
13039,0,2,0,0,2
13040,1,1,0,0,2
13041,0,2,0,0,2
13042,0,2,0,0,2
13043,1,1,0,0,2
13044,0,2,0,0,2
13045,0,2,0,0,2
13046,0,2,0,0,2
13047,0,2,0,0,2
13048,1,1,0,0,2
13049,0,2,0,0,2
13050,1,0,1,0,2
13051,0,2,0,0,2
13052,1,1,0,0,2
13053,1,0,0,1,2
13054,1,1,0,0,2
13055,0,2,0,0,2
13056,0,2,0,0,2
13057,0,1,0,1,2
13058,0,2,0,0,2
13059,0,2,0,0,2
13060,0,2,0,0,2
13061,0,0,2,0,2
13062,0,2,0,0,2
13063,0,2,0,0,2
13064,1,1,0,0,2
13065,1,0,1,0,2
13066,0,2,0,0,2
13067,0,2,0,0,2
13068,0,2,0,0,2
13069,0,2,0,0,2
13070,0,2,0,0,2
13071,0,2,0,0,2
13072,0,2,0,0,2
13073,2,0,0,0,2
13074,0,2,0,0,2
13075,0,2,0,0,2
13076,0,2,0,0,2
13077,0,2,0,0,2
13078,0,2,0,0,2
13079,0,2,0,0,2
13080,1,0,1,0,2
13081,2,0,0,0,2
13082,0,2,0,0,2
13083,0,2,0,0,2
13084,0,0,1,1,2
13085,0,2,0,0,2
13086,0,2,0,0,2
13087,0,2,0,0,2
13088,0,2,0,0,2
13089,0,2,0,0,2
13090,2,0,0,0,2
13091,0,2,0,0,2
13092,2,0,0,0,2
13093,0,2,0,0,2
13094,0,2,0,0,2
13095,0,2,0,0,2
13096,0,2,0,0,2
13097,0,2,0,0,2
13098,1,1,0,0,2
13099,0,2,0,0,2
13100,0,2,0,0,2
13101,0,2,0,0,2
13102,0,2,0,0,2
13103,1,0,0,1,2
13104,0,2,0,0,2
13105,0,2,0,0,2
13106,1,1,0,0,2
13107,0,2,0,0,2
13108,0,2,0,0,2
13109,0,2,0,0,2
13110,0,2,0,0,2
13111,0,2,0,0,2
13112,0,2,0,0,2
13113,0,2,0,0,2
13114,0,2,0,0,2
13115,0,2,0,0,2
13116,0,2,0,0,2
13117,0,2,0,0,2
13118,0,2,0,0,2
13119,0,2,0,0,2
13120,2,0,0,0,2
13121,0,2,0,0,2
13122,0,2,0,0,2
13123,0,2,0,0,2
13124,0,2,0,0,2
13125,0,2,0,0,2
13126,1,0,0,1,2
13127,0,2,0,0,2
13128,1,1,0,0,2
13129,0,2,0,0,2
13130,0,2,0,0,2
13131,0,2,0,0,2
13132,0,2,0,0,2
13133,0,2,0,0,2
13134,2,0,0,0,2
13135,0,2,0,0,2
13136,0,2,0,0,2
13137,1,1,0,0,2
13138,2,0,0,0,2
13139,0,2,0,0,2
13140,0,2,0,0,2
13141,0,2,0,0,2
13142,1,1,0,0,2
13143,0,2,0,0,2
13144,0,2,0,0,2
13145,2,0,0,0,2
13146,1,1,0,0,2
13147,0,2,0,0,2
13148,2,0,0,0,2
13149,0,2,0,0,2
13150,0,2,0,0,2
13151,0,2,0,0,2
13152,0,0,0,2,2
13153,0,2,0,0,2
13154,0,2,0,0,2
13155,0,2,0,0,2
13156,2,0,0,0,2
13157,0,2,0,0,2
13158,2,0,0,0,2
13159,0,2,0,0,2
13160,0,1,1,0,2
13161,0,2,0,0,2
13162,0,2,0,0,2
13163,2,0,0,0,2
13164,0,2,0,0,2
13165,0,2,0,0,2
13166,1,1,0,0,2
13167,0,0,0,2,2
13168,0,0,0,2,2
13169,0,2,0,0,2
13170,0,2,0,0,2
13171,0,2,0,0,2
13172,0,2,0,0,2
13173,0,2,0,0,2
13174,0,2,0,0,2
13175,0,2,0,0,2
13176,1,1,0,0,2
13177,2,0,0,0,2
13178,1,1,0,0,2
13179,0,1,1,0,2
13180,0,2,0,0,2
13181,0,2,0,0,2
13182,0,2,0,0,2
13183,0,2,0,0,2
13184,1,1,0,0,2
13185,0,2,0,0,2
13186,1,0,0,1,2
13187,0,2,0,0,2
13188,0,2,0,0,2
13189,0,2,0,0,2
13190,0,0,1,1,2
13191,0,2,0,0,2
13192,0,2,0,0,2
13193,0,2,0,0,2
13194,0,2,0,0,2
13195,2,0,0,0,2
13196,1,1,0,0,2
13197,2,0,0,0,2
13198,0,2,0,0,2
13199,0,2,0,0,2
13200,1,1,0,0,2
13201,0,2,0,0,2
13202,0,2,0,0,2
13203,2,0,0,0,2
13204,0,2,0,0,2
13205,0,2,0,0,2
13206,0,2,0,0,2
13207,0,2,0,0,2
13208,0,2,0,0,2
13209,1,1,0,0,2
13210,0,2,0,0,2
13211,0,1,1,0,2
13212,0,2,0,0,2
13213,2,0,0,0,2
13214,1,1,0,0,2
13215,0,2,0,0,2
13216,1,1,0,0,2
13217,0,2,0,0,2
13218,0,2,0,0,2
13219,0,2,0,0,2
13220,0,2,0,0,2
13221,0,2,0,0,2
13222,0,2,0,0,2
13223,0,2,0,0,2
13224,0,2,0,0,2
13225,0,2,0,0,2
13226,0,2,0,0,2
13227,0,2,0,0,2
13228,0,2,0,0,2
13229,0,2,0,0,2
13230,0,2,0,0,2
13231,0,2,0,0,2
13232,0,2,0,0,2
13233,0,1,1,0,2
13234,0,2,0,0,2
13235,1,1,0,0,2
13236,0,2,0,0,2
13237,2,0,0,0,2
13238,2,0,0,0,2
13239,0,2,0,0,2
13240,0,2,0,0,2
13241,0,2,0,0,2
13242,0,0,0,2,2
13243,0,2,0,0,2
13244,1,1,0,0,2
13245,0,0,0,2,2
13246,0,2,0,0,2
13247,0,2,0,0,2
13248,0,1,1,0,2
13249,1,1,0,0,2
13250,0,2,0,0,2
13251,0,2,0,0,2
13252,0,2,0,0,2
13253,0,2,0,0,2
13254,0,2,0,0,2
13255,0,2,0,0,2
13256,0,2,0,0,2
13257,0,2,0,0,2
13258,0,2,0,0,2
13259,0,2,0,0,2
13260,1,1,0,0,2
13261,0,1,0,1,2
13262,0,2,0,0,2
13263,0,2,0,0,2
13264,0,2,0,0,2
13265,0,2,0,0,2
13266,1,1,0,0,2
13267,0,2,0,0,2
13268,0,2,0,0,2
13269,2,0,0,0,2
13270,0,2,0,0,2
13271,0,1,1,0,2
13272,0,0,1,1,2
13273,0,2,0,0,2
13274,0,2,0,0,2
13275,0,2,0,0,2
13276,0,2,0,0,2
13277,0,2,0,0,2
13278,0,0,2,0,2
13279,1,1,0,0,2
13280,0,2,0,0,2
13281,0,2,0,0,2
13282,1,1,0,0,2
13283,0,2,0,0,2
13284,0,2,0,0,2
13285,0,2,0,0,2
13286,0,2,0,0,2
13287,0,2,0,0,2
13288,0,2,0,0,2
13289,2,0,0,0,2
13290,0,2,0,0,2
13291,0,2,0,0,2
13292,1,0,0,1,2
13293,0,2,0,0,2
13294,0,2,0,0,2
13295,1,0,0,1,2
13296,2,0,0,0,2
13297,0,2,0,0,2
13298,0,2,0,0,2
13299,0,2,0,0,2
13300,0,2,0,0,2
13301,2,0,0,0,2
13302,0,2,0,0,2
13303,0,2,0,0,2
13304,0,2,0,0,2
13305,0,2,0,0,2
13306,2,0,0,0,2
13307,0,2,0,0,2
13308,0,2,0,0,2
13309,2,0,0,0,2
13310,0,2,0,0,2
13311,1,1,0,0,2
13312,1,1,0,0,2
13313,0,2,0,0,2
13314,2,0,0,0,2
13315,0,2,0,0,2
13316,1,1,0,0,2
13317,0,2,0,0,2
13318,0,2,0,0,2
13319,0,2,0,0,2
13320,0,2,0,0,2
13321,0,2,0,0,2
13322,0,0,1,1,2
13323,0,2,0,0,2
13324,1,0,0,1,2
13325,2,0,0,0,2
13326,2,0,0,0,2
13327,0,2,0,0,2
13328,0,2,0,0,2
13329,0,2,0,0,2
13330,0,2,0,0,2
13331,0,2,0,0,2
13332,0,0,2,0,2
13333,0,2,0,0,2
13334,0,2,0,0,2
13335,0,0,1,1,2
13336,1,1,0,0,2
13337,0,2,0,0,2
13338,0,2,0,0,2
13339,1,1,0,0,2
13340,0,2,0,0,2
13341,0,2,0,0,2
13342,1,0,1,0,2
13343,2,0,0,0,2
13344,0,0,0,2,2
13345,0,2,0,0,2
13346,0,2,0,0,2
13347,1,0,0,1,2
13348,0,2,0,0,2
13349,0,2,0,0,2
13350,0,0,2,0,2
13351,0,0,0,2,2
13352,0,2,0,0,2
13353,0,2,0,0,2
13354,1,1,0,0,2
13355,0,2,0,0,2
13356,0,2,0,0,2
13357,0,2,0,0,2
13358,0,2,0,0,2
13359,0,2,0,0,2
13360,0,2,0,0,2
13361,2,0,0,0,2
13362,0,2,0,0,2
13363,0,2,0,0,2
13364,0,2,0,0,2
13365,0,2,0,0,2
13366,0,2,0,0,2
13367,0,2,0,0,2
13368,0,2,0,0,2
13369,0,2,0,0,2
13370,0,2,0,0,2
13371,0,2,0,0,2
13372,0,2,0,0,2
13373,2,0,0,0,2
13374,0,2,0,0,2
13375,0,2,0,0,2
13376,0,2,0,0,2
13377,0,2,0,0,2
13378,0,2,0,0,2
13379,2,0,0,0,2
13380,1,1,0,0,2
13381,0,0,1,1,2
13382,1,1,0,0,2
13383,1,0,0,1,2
13384,0,2,0,0,2
13385,0,2,0,0,2
13386,0,2,0,0,2
13387,0,2,0,0,2
13388,0,2,0,0,2
13389,0,2,0,0,2
13390,2,0,0,0,2
13391,1,1,0,0,2
13392,0,2,0,0,2
13393,2,0,0,0,2
13394,0,2,0,0,2
13395,0,2,0,0,2
13396,1,0,0,1,2
13397,0,2,0,0,2
13398,1,0,1,0,2
13399,0,2,0,0,2
13400,0,2,0,0,2
13401,0,2,0,0,2
13402,0,2,0,0,2
13403,0,2,0,0,2
13404,0,2,0,0,2
13405,1,1,0,0,2
13406,1,1,0,0,2
13407,0,2,0,0,2
13408,0,2,0,0,2
13409,0,2,0,0,2
13410,0,2,0,0,2
13411,0,2,0,0,2
13412,0,2,0,0,2
13413,0,2,0,0,2
13414,1,1,0,0,2
13415,0,2,0,0,2
13416,0,2,0,0,2
13417,0,2,0,0,2
13418,0,2,0,0,2
13419,0,2,0,0,2
13420,0,0,2,0,2
13421,1,1,0,0,2
13422,0,2,0,0,2
13423,0,2,0,0,2
13424,0,2,0,0,2
13425,0,2,0,0,2
13426,0,2,0,0,2
13427,0,2,0,0,2
13428,2,0,0,0,2
13429,0,2,0,0,2
13430,0,2,0,0,2
13431,0,2,0,0,2
13432,0,2,0,0,2
13433,0,2,0,0,2
13434,0,2,0,0,2
13435,0,2,0,0,2
13436,0,2,0,0,2
13437,0,2,0,0,2
13438,0,1,1,0,2
13439,0,2,0,0,2
13440,1,1,0,0,2
13441,0,2,0,0,2
13442,1,1,0,0,2
13443,0,2,0,0,2
13444,0,2,0,0,2
13445,0,2,0,0,2
13446,0,2,0,0,2
13447,0,2,0,0,2
13448,0,2,0,0,2
13449,1,1,0,0,2
13450,0,1,0,1,2
13451,0,2,0,0,2
13452,0,2,0,0,2
13453,0,2,0,0,2
13454,0,1,0,1,2
13455,2,0,0,0,2
13456,2,0,0,0,2
13457,0,2,0,0,2
13458,2,0,0,0,2
13459,2,0,0,0,2
13460,0,2,0,0,2
13461,0,2,0,0,2
13462,0,0,0,2,2
13463,0,2,0,0,2
13464,2,0,0,0,2
13465,0,2,0,0,2
13466,0,2,0,0,2
13467,0,1,1,0,2
13468,0,2,0,0,2
13469,0,2,0,0,2
13470,0,2,0,0,2
13471,1,0,1,0,2
13472,0,2,0,0,2
13473,0,1,0,1,2
13474,2,0,0,0,2
13475,0,2,0,0,2
13476,0,2,0,0,2
13477,0,2,0,0,2
13478,0,2,0,0,2
13479,0,2,0,0,2
13480,0,0,0,2,2
13481,1,0,0,1,2
13482,1,1,0,0,2
13483,0,2,0,0,2
13484,0,2,0,0,2
13485,2,0,0,0,2
13486,0,2,0,0,2
13487,0,2,0,0,2
13488,2,0,0,0,2
13489,0,2,0,0,2
13490,0,2,0,0,2
13491,0,2,0,0,2
13492,0,1,1,0,2
13493,0,2,0,0,2
13494,1,0,1,0,2
13495,1,1,0,0,2
13496,0,2,0,0,2
13497,0,2,0,0,2
13498,1,1,0,0,2
13499,0,2,0,0,2
13500,0,1,0,1,2
13501,2,0,0,0,2
13502,0,2,0,0,2
13503,1,0,1,0,2
13504,0,2,0,0,2
13505,2,0,0,0,2
13506,0,2,0,0,2
13507,0,2,0,0,2
13508,1,0,0,1,2
13509,1,0,0,1,2
13510,0,2,0,0,2
13511,0,2,0,0,2
13512,2,0,0,0,2
13513,0,2,0,0,2
13514,0,2,0,0,2
13515,2,0,0,0,2
13516,0,2,0,0,2
13517,0,2,0,0,2
13518,0,0,0,2,2
13519,0,0,1,1,2
13520,0,2,0,0,2
13521,0,0,0,2,2
13522,0,2,0,0,2
13523,2,0,0,0,2
13524,0,2,0,0,2
13525,0,2,0,0,2
13526,2,0,0,0,2
13527,2,0,0,0,2
13528,0,2,0,0,2
13529,0,2,0,0,2
13530,0,2,0,0,2
13531,2,0,0,0,2
13532,0,2,0,0,2
13533,0,0,0,2,2
13534,1,1,0,0,2
13535,1,1,0,0,2
13536,0,2,0,0,2
13537,2,0,0,0,2
13538,0,2,0,0,2
13539,0,2,0,0,2
13540,1,1,0,0,2
13541,0,2,0,0,2
13542,0,2,0,0,2
13543,0,2,0,0,2
13544,0,0,0,2,2
13545,0,2,0,0,2
13546,0,2,0,0,2
13547,2,0,0,0,2
13548,0,2,0,0,2
13549,0,2,0,0,2
13550,0,2,0,0,2
13551,0,2,0,0,2
13552,0,2,0,0,2
13553,0,2,0,0,2
13554,0,2,0,0,2
13555,0,2,0,0,2
13556,0,2,0,0,2
13557,2,0,0,0,2
13558,0,2,0,0,2
13559,0,2,0,0,2
13560,0,0,2,0,2
13561,2,0,0,0,2
13562,0,2,0,0,2
13563,0,2,0,0,2
13564,1,1,0,0,2
13565,0,2,0,0,2
13566,1,1,0,0,2
13567,0,2,0,0,2
13568,0,2,0,0,2
13569,0,2,0,0,2
13570,0,2,0,0,2
13571,0,2,0,0,2
13572,0,2,0,0,2
13573,0,0,0,2,2
13574,0,2,0,0,2
13575,0,2,0,0,2
13576,0,2,0,0,2
13577,0,2,0,0,2
13578,0,2,0,0,2
13579,0,2,0,0,2
13580,0,2,0,0,2
13581,0,2,0,0,2
13582,0,2,0,0,2
13583,0,2,0,0,2
13584,0,2,0,0,2
13585,0,2,0,0,2
13586,0,2,0,0,2
13587,0,2,0,0,2
13588,0,2,0,0,2
13589,1,1,0,0,2
13590,0,2,0,0,2
13591,0,2,0,0,2
13592,0,2,0,0,2
13593,0,2,0,0,2
13594,0,2,0,0,2
13595,0,2,0,0,2
13596,0,2,0,0,2
13597,0,2,0,0,2
13598,0,2,0,0,2
13599,2,0,0,0,2
13600,0,2,0,0,2
13601,0,2,0,0,2
13602,1,0,1,0,2
13603,0,2,0,0,2
13604,0,2,0,0,2
13605,1,1,0,0,2
13606,0,2,0,0,2
13607,0,2,0,0,2
13608,0,2,0,0,2
13609,0,2,0,0,2
13610,0,2,0,0,2
13611,0,2,0,0,2
13612,2,0,0,0,2
13613,0,2,0,0,2
13614,1,1,0,0,2
13615,0,2,0,0,2
13616,0,2,0,0,2
13617,0,2,0,0,2
13618,0,2,0,0,2
13619,0,0,2,0,2
13620,0,2,0,0,2
13621,0,2,0,0,2
13622,0,0,1,1,2
13623,0,0,0,2,2
13624,0,2,0,0,2
13625,1,1,0,0,2
13626,1,1,0,0,2
13627,0,2,0,0,2
13628,0,2,0,0,2
13629,0,2,0,0,2
13630,0,2,0,0,2
13631,0,2,0,0,2
13632,0,2,0,0,2
13633,0,2,0,0,2
13634,1,0,0,1,2
13635,0,2,0,0,2
13636,0,2,0,0,2
13637,0,2,0,0,2
13638,0,2,0,0,2
13639,0,2,0,0,2
13640,0,2,0,0,2
13641,0,2,0,0,2
13642,0,2,0,0,2
13643,0,2,0,0,2
13644,1,1,0,0,2
13645,2,0,0,0,2
13646,2,0,0,0,2
13647,1,1,0,0,2
13648,2,0,0,0,2
13649,0,2,0,0,2
13650,0,2,0,0,2
13651,1,1,0,0,2
13652,1,1,0,0,2
13653,0,2,0,0,2
13654,0,2,0,0,2
13655,0,2,0,0,2
13656,0,2,0,0,2
13657,0,2,0,0,2
13658,0,2,0,0,2
13659,0,2,0,0,2
13660,0,2,0,0,2
13661,2,0,0,0,2
13662,0,2,0,0,2
13663,0,2,0,0,2
13664,0,2,0,0,2
13665,0,0,1,1,2
13666,2,0,0,0,2
13667,0,2,0,0,2
13668,0,2,0,0,2
13669,0,2,0,0,2
13670,0,2,0,0,2
13671,0,2,0,0,2
13672,2,0,0,0,2
13673,2,0,0,0,2
13674,0,2,0,0,2
13675,0,2,0,0,2
13676,1,1,0,0,2
13677,1,1,0,0,2
13678,0,1,0,1,2
13679,0,2,0,0,2
13680,0,2,0,0,2
13681,0,1,1,0,2
13682,0,2,0,0,2
13683,0,2,0,0,2
13684,0,2,0,0,2
13685,1,0,0,1,2
13686,0,2,0,0,2
13687,0,2,0,0,2
13688,0,2,0,0,2
13689,0,2,0,0,2
13690,0,2,0,0,2
13691,2,0,0,0,2
13692,0,2,0,0,2
13693,1,0,0,1,2
13694,0,2,0,0,2
13695,0,2,0,0,2
13696,1,1,0,0,2
13697,0,2,0,0,2
13698,0,2,0,0,2
13699,0,2,0,0,2
13700,0,2,0,0,2
13701,0,2,0,0,2
13702,1,1,0,0,2
13703,0,2,0,0,2
13704,0,2,0,0,2
13705,0,2,0,0,2
13706,0,2,0,0,2
13707,0,2,0,0,2
13708,0,2,0,0,2
13709,0,2,0,0,2
13710,0,2,0,0,2
13711,1,0,1,0,2
13712,1,1,0,0,2
13713,0,2,0,0,2
13714,0,2,0,0,2
13715,0,2,0,0,2
13716,0,2,0,0,2
13717,0,2,0,0,2
13718,0,2,0,0,2
13719,0,2,0,0,2
13720,0,2,0,0,2
13721,2,0,0,0,2
13722,0,2,0,0,2
13723,0,2,0,0,2
13724,0,2,0,0,2
13725,1,0,0,1,2
13726,0,0,0,2,2
13727,1,0,0,1,2
13728,0,2,0,0,2
13729,2,0,0,0,2
13730,1,1,0,0,2
13731,0,2,0,0,2
13732,0,2,0,0,2
13733,0,2,0,0,2
13734,0,1,0,1,2
13735,0,0,0,2,2
13736,2,0,0,0,2
13737,0,2,0,0,2
13738,0,0,0,2,2
13739,0,2,0,0,2
13740,0,2,0,0,2
13741,0,2,0,0,2
13742,0,2,0,0,2
13743,0,2,0,0,2
13744,0,2,0,0,2
13745,0,2,0,0,2
13746,0,2,0,0,2
13747,0,2,0,0,2
13748,1,1,0,0,2
13749,0,2,0,0,2
13750,0,2,0,0,2
13751,0,2,0,0,2
13752,0,2,0,0,2
13753,0,2,0,0,2
13754,1,1,0,0,2
13755,1,1,0,0,2
13756,1,0,0,1,2
13757,0,2,0,0,2
13758,1,1,0,0,2
13759,0,2,0,0,2
13760,0,2,0,0,2
13761,0,2,0,0,2
13762,2,0,0,0,2
13763,0,2,0,0,2
13764,1,0,1,0,2
13765,0,2,0,0,2
13766,0,0,0,2,2
13767,0,2,0,0,2
13768,0,2,0,0,2
13769,0,2,0,0,2
13770,0,2,0,0,2
13771,0,2,0,0,2
13772,1,1,0,0,2
13773,2,0,0,0,2
13774,0,2,0,0,2
13775,0,2,0,0,2
13776,0,2,0,0,2
13777,0,2,0,0,2
13778,0,2,0,0,2
13779,2,0,0,0,2
13780,0,2,0,0,2
13781,0,2,0,0,2
13782,0,2,0,0,2
13783,0,2,0,0,2
13784,0,2,0,0,2
13785,1,1,0,0,2
13786,0,2,0,0,2
13787,0,2,0,0,2
13788,0,2,0,0,2
13789,2,0,0,0,2
13790,0,2,0,0,2
13791,2,0,0,0,2
13792,0,2,0,0,2
13793,2,0,0,0,2
13794,0,2,0,0,2
13795,0,2,0,0,2
13796,0,2,0,0,2
13797,0,2,0,0,2
13798,0,2,0,0,2
13799,0,2,0,0,2
13800,0,2,0,0,2
13801,0,0,2,0,2
13802,1,1,0,0,2
13803,1,0,1,0,2
13804,0,0,0,2,2
13805,0,2,0,0,2
13806,0,2,0,0,2
13807,0,2,0,0,2
13808,0,2,0,0,2
13809,0,2,0,0,2
13810,2,0,0,0,2
13811,1,1,0,0,2
13812,0,2,0,0,2
13813,0,2,0,0,2
13814,0,2,0,0,2
13815,0,2,0,0,2
13816,0,2,0,0,2
13817,0,2,0,0,2
13818,2,0,0,0,2
13819,0,2,0,0,2
13820,0,2,0,0,2
13821,1,1,0,0,2
13822,0,2,0,0,2
13823,0,2,0,0,2
13824,0,2,0,0,2
13825,0,2,0,0,2
13826,2,0,0,0,2
13827,0,2,0,0,2
13828,0,2,0,0,2
13829,0,2,0,0,2
13830,0,2,0,0,2
13831,0,2,0,0,2
13832,1,1,0,0,2
13833,0,2,0,0,2
13834,0,0,0,2,2
13835,0,1,1,0,2
13836,0,2,0,0,2
13837,1,0,1,0,2
13838,0,2,0,0,2
13839,1,0,1,0,2
13840,0,2,0,0,2
13841,0,2,0,0,2
13842,0,2,0,0,2
13843,0,2,0,0,2
13844,0,2,0,0,2
13845,0,2,0,0,2
13846,0,2,0,0,2
13847,2,0,0,0,2
13848,0,0,0,2,2
13849,0,2,0,0,2
13850,0,2,0,0,2
13851,0,2,0,0,2
13852,0,2,0,0,2
13853,1,0,1,0,2
13854,0,2,0,0,2
13855,0,2,0,0,2
13856,1,1,0,0,2
13857,0,2,0,0,2
13858,2,0,0,0,2
13859,0,2,0,0,2
13860,0,2,0,0,2
13861,0,2,0,0,2
13862,0,2,0,0,2
13863,0,2,0,0,2
13864,0,2,0,0,2
13865,0,2,0,0,2
13866,0,2,0,0,2
13867,0,2,0,0,2
13868,0,2,0,0,2
13869,0,2,0,0,2
13870,0,2,0,0,2
13871,1,0,0,1,2
13872,0,2,0,0,2
13873,0,2,0,0,2
13874,2,0,0,0,2
13875,0,2,0,0,2
13876,0,2,0,0,2
13877,0,2,0,0,2
13878,2,0,0,0,2
13879,0,2,0,0,2
13880,0,2,0,0,2
13881,0,2,0,0,2
13882,0,2,0,0,2
13883,0,2,0,0,2
13884,0,2,0,0,2
13885,0,2,0,0,2
13886,0,2,0,0,2
13887,0,2,0,0,2
13888,0,2,0,0,2
13889,0,2,0,0,2
13890,0,2,0,0,2
13891,0,2,0,0,2
13892,0,1,0,1,2
13893,0,2,0,0,2
13894,1,1,0,0,2
13895,2,0,0,0,2
13896,0,2,0,0,2
13897,0,2,0,0,2
13898,0,2,0,0,2
13899,0,2,0,0,2
13900,0,2,0,0,2
13901,1,1,0,0,2
13902,0,2,0,0,2
13903,0,2,0,0,2
13904,0,2,0,0,2
13905,0,2,0,0,2
13906,0,1,0,1,2
13907,0,2,0,0,2
13908,0,2,0,0,2
13909,0,2,0,0,2
13910,0,2,0,0,2
13911,0,2,0,0,2
13912,0,2,0,0,2
13913,0,2,0,0,2
13914,1,0,1,0,2
13915,1,1,0,0,2
13916,1,0,0,1,2
13917,0,2,0,0,2
13918,0,2,0,0,2
13919,0,2,0,0,2
13920,0,2,0,0,2
13921,0,2,0,0,2
13922,0,2,0,0,2
13923,2,0,0,0,2
13924,0,2,0,0,2
13925,2,0,0,0,2
13926,0,2,0,0,2
13927,0,2,0,0,2
13928,0,1,0,1,2
13929,0,2,0,0,2
13930,0,2,0,0,2
13931,0,2,0,0,2
13932,0,2,0,0,2
13933,1,0,1,0,2
13934,0,2,0,0,2
13935,0,2,0,0,2
13936,0,0,2,0,2
13937,0,2,0,0,2
13938,0,2,0,0,2
13939,0,2,0,0,2
13940,0,2,0,0,2
13941,0,2,0,0,2
13942,0,2,0,0,2
13943,0,2,0,0,2
13944,0,2,0,0,2
13945,0,1,1,0,2
13946,0,2,0,0,2
13947,0,2,0,0,2
13948,0,2,0,0,2
13949,0,2,0,0,2
13950,1,1,0,0,2
13951,0,2,0,0,2
13952,0,2,0,0,2
13953,0,2,0,0,2
13954,0,2,0,0,2
13955,0,2,0,0,2
13956,0,0,0,2,2
13957,0,2,0,0,2
13958,0,2,0,0,2
13959,0,2,0,0,2
13960,0,2,0,0,2
13961,0,2,0,0,2
13962,1,1,0,0,2
13963,0,2,0,0,2
13964,0,0,1,1,2
13965,1,1,0,0,2
13966,0,2,0,0,2
13967,1,1,0,0,2
13968,2,0,0,0,2
13969,2,0,0,0,2
13970,0,2,0,0,2
13971,0,2,0,0,2
13972,0,2,0,0,2
13973,0,2,0,0,2
13974,0,2,0,0,2
13975,1,1,0,0,2
13976,0,2,0,0,2
13977,0,2,0,0,2
13978,0,2,0,0,2
13979,0,2,0,0,2
13980,0,2,0,0,2
13981,0,1,1,0,2
13982,2,0,0,0,2
13983,0,2,0,0,2
13984,0,2,0,0,2
13985,0,2,0,0,2
13986,0,2,0,0,2
13987,0,1,0,1,2
13988,0,2,0,0,2
13989,0,2,0,0,2
13990,0,2,0,0,2
13991,0,2,0,0,2
13992,0,2,0,0,2
13993,0,2,0,0,2
13994,0,2,0,0,2
13995,0,2,0,0,2
13996,0,2,0,0,2
13997,0,2,0,0,2
13998,2,0,0,0,2
13999,2,0,0,0,2
14000,0,0,2,0,2
14001,0,2,0,0,2
14002,0,2,0,0,2
14003,0,1,1,0,2
14004,1,0,1,0,2
14005,1,1,0,0,2
14006,0,2,0,0,2
14007,2,0,0,0,2
14008,0,2,0,0,2
14009,0,2,0,0,2
14010,2,0,0,0,2
14011,0,2,0,0,2
14012,0,2,0,0,2
14013,0,2,0,0,2
14014,0,2,0,0,2
14015,0,2,0,0,2
14016,0,2,0,0,2
14017,0,2,0,0,2
14018,1,1,0,0,2
14019,0,2,0,0,2
14020,0,2,0,0,2
14021,1,1,0,0,2
14022,0,2,0,0,2
14023,0,2,0,0,2
14024,2,0,0,0,2
14025,0,2,0,0,2
14026,1,1,0,0,2
14027,2,0,0,0,2
14028,0,2,0,0,2
14029,0,1,1,0,2
14030,1,1,0,0,2
14031,0,2,0,0,2
14032,0,2,0,0,2
14033,2,0,0,0,2
14034,0,2,0,0,2
14035,0,2,0,0,2
14036,0,0,0,2,2
14037,0,2,0,0,2
14038,0,2,0,0,2
14039,0,2,0,0,2
14040,0,2,0,0,2
14041,0,2,0,0,2
14042,2,0,0,0,2
14043,1,1,0,0,2
14044,0,2,0,0,2
14045,0,2,0,0,2
14046,1,1,0,0,2
14047,0,2,0,0,2
14048,0,2,0,0,2
14049,0,2,0,0,2
14050,0,2,0,0,2
14051,0,2,0,0,2
14052,0,2,0,0,2
14053,0,2,0,0,2
14054,1,1,0,0,2
14055,1,0,1,0,2
14056,0,2,0,0,2
14057,0,2,0,0,2
14058,1,0,0,1,2
14059,0,2,0,0,2
14060,0,2,0,0,2
14061,0,2,0,0,2
14062,0,2,0,0,2
14063,0,2,0,0,2
14064,0,2,0,0,2
14065,0,2,0,0,2
14066,1,0,1,0,2
14067,2,0,0,0,2
14068,2,0,0,0,2
14069,0,2,0,0,2
14070,2,0,0,0,2
14071,0,2,0,0,2
14072,0,2,0,0,2
14073,0,2,0,0,2
14074,0,2,0,0,2
14075,0,2,0,0,2
14076,0,2,0,0,2
14077,0,2,0,0,2
14078,2,0,0,0,2
14079,0,2,0,0,2
14080,2,0,0,0,2
14081,0,2,0,0,2
14082,0,2,0,0,2
14083,2,0,0,0,2
14084,0,2,0,0,2
14085,1,1,0,0,2
14086,0,2,0,0,2
14087,0,2,0,0,2
14088,0,2,0,0,2
14089,0,2,0,0,2
14090,0,0,1,1,2
14091,0,2,0,0,2
14092,0,2,0,0,2
14093,2,0,0,0,2
14094,0,2,0,0,2
14095,0,2,0,0,2
14096,0,2,0,0,2
14097,0,0,1,1,2
14098,0,2,0,0,2
14099,0,2,0,0,2
14100,1,1,0,0,2
14101,0,2,0,0,2
14102,0,2,0,0,2
14103,0,1,1,0,2
14104,0,2,0,0,2
14105,0,2,0,0,2
14106,0,2,0,0,2
14107,0,2,0,0,2
14108,0,2,0,0,2
14109,0,2,0,0,2
14110,0,1,0,1,2
14111,0,2,0,0,2
14112,0,2,0,0,2
14113,0,2,0,0,2
14114,0,2,0,0,2
14115,0,2,0,0,2
14116,0,2,0,0,2
14117,0,2,0,0,2
14118,1,1,0,0,2
14119,0,0,0,2,2
14120,1,1,0,0,2
14121,0,2,0,0,2
14122,2,0,0,0,2
14123,0,2,0,0,2
14124,0,2,0,0,2
14125,0,1,0,1,2
14126,0,2,0,0,2
14127,0,2,0,0,2
14128,0,2,0,0,2
14129,0,2,0,0,2
14130,0,2,0,0,2
14131,0,2,0,0,2
14132,0,2,0,0,2
14133,0,2,0,0,2
14134,0,2,0,0,2
14135,0,2,0,0,2
14136,0,2,0,0,2
14137,0,2,0,0,2
14138,0,2,0,0,2
14139,0,2,0,0,2
14140,0,2,0,0,2
14141,0,2,0,0,2
14142,0,2,0,0,2
14143,0,2,0,0,2
14144,0,2,0,0,2
14145,0,2,0,0,2
14146,0,2,0,0,2
14147,2,0,0,0,2
14148,0,2,0,0,2
14149,0,2,0,0,2
14150,1,0,0,1,2
14151,0,2,0,0,2
14152,0,1,1,0,2
14153,0,2,0,0,2
14154,0,2,0,0,2
14155,0,2,0,0,2
14156,0,2,0,0,2
14157,0,2,0,0,2
14158,0,2,0,0,2
14159,0,0,0,2,2
14160,0,0,1,1,2
14161,0,2,0,0,2
14162,0,2,0,0,2
14163,0,2,0,0,2
14164,0,2,0,0,2
14165,0,2,0,0,2
14166,0,2,0,0,2
14167,0,2,0,0,2
14168,0,2,0,0,2
14169,0,2,0,0,2
14170,0,2,0,0,2
14171,2,0,0,0,2
14172,0,2,0,0,2
14173,0,2,0,0,2
14174,0,1,1,0,2
14175,0,2,0,0,2
14176,0,2,0,0,2
14177,0,1,0,1,2
14178,1,1,0,0,2
14179,0,2,0,0,2
14180,0,2,0,0,2
14181,0,2,0,0,2
14182,0,2,0,0,2
14183,1,0,0,1,2
14184,0,2,0,0,2
14185,0,1,1,0,2
14186,2,0,0,0,2
14187,0,2,0,0,2
14188,0,2,0,0,2
14189,0,2,0,0,2
14190,0,2,0,0,2
14191,0,2,0,0,2
14192,0,2,0,0,2
14193,0,0,0,2,2
14194,0,2,0,0,2
14195,0,2,0,0,2
14196,0,2,0,0,2
14197,2,0,0,0,2
14198,1,1,0,0,2
14199,0,2,0,0,2
14200,0,2,0,0,2
14201,0,2,0,0,2
14202,0,2,0,0,2
14203,0,2,0,0,2
14204,0,2,0,0,2
14205,0,2,0,0,2
14206,0,2,0,0,2
14207,0,2,0,0,2
14208,1,1,0,0,2
14209,0,2,0,0,2
14210,0,2,0,0,2
14211,0,2,0,0,2
14212,1,1,0,0,2
14213,0,2,0,0,2
14214,0,2,0,0,2
14215,0,2,0,0,2
14216,0,2,0,0,2
14217,0,2,0,0,2
14218,0,1,0,1,2
14219,0,2,0,0,2
14220,0,2,0,0,2
14221,0,2,0,0,2
14222,0,1,1,0,2
14223,0,2,0,0,2
14224,0,1,1,0,2
14225,0,2,0,0,2
14226,1,0,0,1,2
14227,0,2,0,0,2
14228,0,2,0,0,2
14229,0,2,0,0,2
14230,0,1,0,1,2
14231,0,2,0,0,2
14232,0,2,0,0,2
14233,0,2,0,0,2
14234,1,0,0,1,2
14235,2,0,0,0,2
14236,0,2,0,0,2
14237,0,2,0,0,2
14238,0,2,0,0,2
14239,0,2,0,0,2
14240,0,2,0,0,2
14241,2,0,0,0,2
14242,1,0,0,1,2
14243,0,2,0,0,2
14244,2,0,0,0,2
14245,0,2,0,0,2
14246,0,2,0,0,2
14247,1,1,0,0,2
14248,0,2,0,0,2
14249,0,2,0,0,2
14250,0,2,0,0,2
14251,0,2,0,0,2
14252,2,0,0,0,2
14253,1,1,0,0,2
14254,0,2,0,0,2
14255,0,2,0,0,2
14256,2,0,0,0,2
14257,2,0,0,0,2
14258,0,2,0,0,2
14259,2,0,0,0,2
14260,0,2,0,0,2
14261,1,1,0,0,2
14262,0,2,0,0,2
14263,0,2,0,0,2
14264,1,0,0,1,2
14265,0,2,0,0,2
14266,0,2,0,0,2
14267,0,2,0,0,2
14268,0,2,0,0,2
14269,1,0,1,0,2
14270,0,2,0,0,2
14271,0,2,0,0,2
14272,0,2,0,0,2
14273,0,0,0,2,2
14274,1,0,1,0,2
14275,0,2,0,0,2
14276,0,2,0,0,2
14277,0,2,0,0,2
14278,0,2,0,0,2
14279,0,2,0,0,2
14280,0,2,0,0,2
14281,0,2,0,0,2
14282,0,0,2,0,2
14283,0,2,0,0,2
14284,0,0,2,0,2
14285,2,0,0,0,2
14286,0,2,0,0,2
14287,0,2,0,0,2
14288,0,2,0,0,2
14289,0,2,0,0,2
14290,0,1,1,0,2
14291,0,2,0,0,2
14292,0,2,0,0,2
14293,0,2,0,0,2
14294,0,2,0,0,2
14295,0,2,0,0,2
14296,0,2,0,0,2
14297,0,2,0,0,2
14298,0,2,0,0,2
14299,0,2,0,0,2
14300,0,2,0,0,2
14301,0,2,0,0,2
14302,0,2,0,0,2
14303,0,0,1,1,2
14304,0,2,0,0,2
14305,2,0,0,0,2
14306,0,2,0,0,2
14307,1,1,0,0,2
14308,0,2,0,0,2
14309,2,0,0,0,2
14310,0,2,0,0,2
14311,0,2,0,0,2
14312,0,0,2,0,2
14313,0,2,0,0,2
14314,0,2,0,0,2
14315,0,2,0,0,2
14316,1,1,0,0,2
14317,0,2,0,0,2
14318,0,2,0,0,2
14319,0,2,0,0,2
14320,0,2,0,0,2
14321,0,2,0,0,2
14322,0,2,0,0,2
14323,0,2,0,0,2
14324,0,1,0,1,2
14325,0,2,0,0,2
14326,0,2,0,0,2
14327,1,1,0,0,2
14328,0,2,0,0,2
14329,0,2,0,0,2
14330,1,1,0,0,2
14331,0,2,0,0,2
14332,0,2,0,0,2
14333,0,2,0,0,2
14334,0,2,0,0,2
14335,0,0,2,0,2
14336,1,1,0,0,2
14337,0,2,0,0,2
14338,0,2,0,0,2
14339,2,0,0,0,2
14340,0,2,0,0,2
14341,0,2,0,0,2
14342,2,0,0,0,2
14343,0,2,0,0,2
14344,0,0,2,0,2
14345,0,2,0,0,2
14346,0,2,0,0,2
14347,0,2,0,0,2
14348,1,1,0,0,2
14349,0,2,0,0,2
14350,2,0,0,0,2
14351,0,2,0,0,2
14352,0,1,0,1,2
14353,0,2,0,0,2
14354,2,0,0,0,2
14355,0,2,0,0,2
14356,0,2,0,0,2
14357,1,0,1,0,2
14358,0,2,0,0,2
14359,0,2,0,0,2
14360,0,2,0,0,2
14361,0,2,0,0,2
14362,0,2,0,0,2
14363,0,2,0,0,2
14364,0,2,0,0,2
14365,1,0,0,1,2
14366,1,1,0,0,2
14367,0,0,2,0,2
14368,0,2,0,0,2
14369,0,1,0,1,2
14370,0,2,0,0,2
14371,0,2,0,0,2
14372,0,2,0,0,2
14373,0,2,0,0,2
14374,0,2,0,0,2
14375,0,2,0,0,2
14376,0,0,0,2,2
14377,0,2,0,0,2
14378,0,2,0,0,2
14379,0,2,0,0,2
14380,0,2,0,0,2
14381,0,1,0,1,2
14382,2,0,0,0,2
14383,0,2,0,0,2
14384,1,0,0,1,2
14385,0,2,0,0,2
14386,0,2,0,0,2
14387,0,2,0,0,2
14388,0,2,0,0,2
14389,2,0,0,0,2
14390,0,2,0,0,2
14391,1,1,0,0,2
14392,0,2,0,0,2
14393,0,2,0,0,2
14394,0,2,0,0,2
14395,0,2,0,0,2
14396,1,0,1,0,2
14397,0,0,2,0,2
14398,0,2,0,0,2
14399,0,1,0,1,2
14400,0,0,2,0,2
14401,0,2,0,0,2
14402,0,2,0,0,2
14403,1,0,0,1,2
14404,0,2,0,0,2
14405,0,2,0,0,2
14406,0,2,0,0,2
14407,0,2,0,0,2
14408,0,2,0,0,2
14409,0,0,1,1,2
14410,0,2,0,0,2
14411,0,2,0,0,2
14412,0,2,0,0,2
14413,0,2,0,0,2
14414,0,2,0,0,2
14415,0,2,0,0,2
14416,0,1,1,0,2
14417,1,1,0,0,2
14418,0,2,0,0,2
14419,0,0,0,2,2
14420,0,0,0,2,2
14421,0,2,0,0,2
14422,0,2,0,0,2
14423,0,2,0,0,2
14424,2,0,0,0,2
14425,0,2,0,0,2
14426,2,0,0,0,2
14427,1,1,0,0,2
14428,0,1,0,1,2
14429,0,2,0,0,2
14430,0,2,0,0,2
14431,2,0,0,0,2
14432,0,2,0,0,2
14433,0,2,0,0,2
14434,0,2,0,0,2
14435,1,1,0,0,2
14436,1,1,0,0,2
14437,1,1,0,0,2
14438,0,0,0,2,2
14439,2,0,0,0,2
14440,0,2,0,0,2
14441,0,2,0,0,2
14442,0,2,0,0,2
14443,0,2,0,0,2
14444,0,2,0,0,2
14445,0,2,0,0,2
14446,0,2,0,0,2
14447,0,2,0,0,2
14448,1,1,0,0,2
14449,0,2,0,0,2
14450,0,2,0,0,2
14451,0,2,0,0,2
14452,0,0,0,2,2
14453,0,1,0,1,2
14454,0,2,0,0,2
14455,0,2,0,0,2
14456,2,0,0,0,2
14457,0,2,0,0,2
14458,0,2,0,0,2
14459,0,2,0,0,2
14460,0,2,0,0,2
14461,0,2,0,0,2
14462,0,2,0,0,2
14463,0,2,0,0,2
14464,0,2,0,0,2
14465,1,0,1,0,2
14466,0,2,0,0,2
14467,1,1,0,0,2
14468,0,2,0,0,2
14469,2,0,0,0,2
14470,0,0,1,1,2
14471,0,2,0,0,2
14472,1,1,0,0,2
14473,0,2,0,0,2
14474,0,2,0,0,2
14475,0,2,0,0,2
14476,0,2,0,0,2
14477,0,2,0,0,2
14478,0,2,0,0,2
14479,0,2,0,0,2
14480,2,0,0,0,2
14481,0,0,0,2,2
14482,0,2,0,0,2
14483,1,0,1,0,2
14484,0,2,0,0,2
14485,0,2,0,0,2
14486,0,2,0,0,2
14487,0,2,0,0,2
14488,1,1,0,0,2
14489,0,2,0,0,2
14490,2,0,0,0,2
14491,1,1,0,0,2
14492,0,2,0,0,2
14493,0,2,0,0,2
14494,0,2,0,0,2
14495,0,2,0,0,2
14496,0,2,0,0,2
14497,0,2,0,0,2
14498,1,1,0,0,2
14499,0,2,0,0,2
14500,0,2,0,0,2
14501,0,2,0,0,2
14502,0,2,0,0,2
14503,0,2,0,0,2
14504,0,2,0,0,2
14505,2,0,0,0,2
14506,0,2,0,0,2
14507,0,2,0,0,2
14508,0,2,0,0,2
14509,1,1,0,0,2
14510,0,2,0,0,2
14511,0,0,0,2,2
14512,0,2,0,0,2
14513,0,2,0,0,2
14514,0,2,0,0,2
14515,0,2,0,0,2
14516,0,2,0,0,2
14517,2,0,0,0,2
14518,2,0,0,0,2
14519,0,2,0,0,2
14520,1,1,0,0,2
14521,1,0,1,0,2
14522,1,1,0,0,2
14523,0,2,0,0,2
14524,0,2,0,0,2
14525,0,0,1,1,2
14526,0,2,0,0,2
14527,0,2,0,0,2
14528,0,2,0,0,2
14529,0,2,0,0,2
14530,0,2,0,0,2
14531,0,2,0,0,2
14532,0,2,0,0,2
14533,0,2,0,0,2
14534,0,2,0,0,2
14535,1,1,0,0,2
14536,0,2,0,0,2
14537,0,2,0,0,2
14538,0,2,0,0,2
14539,0,2,0,0,2
14540,0,2,0,0,2
14541,2,0,0,0,2
14542,0,2,0,0,2
14543,0,2,0,0,2
14544,0,2,0,0,2
14545,1,1,0,0,2
14546,0,2,0,0,2
14547,0,2,0,0,2
14548,0,2,0,0,2
14549,2,0,0,0,2
14550,0,2,0,0,2
14551,0,2,0,0,2
14552,0,2,0,0,2
14553,0,2,0,0,2
14554,0,1,0,1,2
14555,0,2,0,0,2
14556,0,2,0,0,2
14557,0,1,0,1,2
14558,1,1,0,0,2
14559,0,2,0,0,2
14560,0,2,0,0,2
14561,0,0,2,0,2
14562,0,2,0,0,2
14563,0,2,0,0,2
14564,1,1,0,0,2
14565,0,2,0,0,2
14566,2,0,0,0,2
14567,0,2,0,0,2
14568,0,2,0,0,2
14569,1,0,1,0,2
14570,0,2,0,0,2
14571,0,2,0,0,2
14572,0,2,0,0,2
14573,0,2,0,0,2
14574,2,0,0,0,2
14575,0,1,0,1,2
14576,0,2,0,0,2
14577,0,2,0,0,2
14578,1,1,0,0,2
14579,0,1,1,0,2
14580,1,0,1,0,2
14581,0,2,0,0,2
14582,0,2,0,0,2
14583,0,2,0,0,2
14584,0,2,0,0,2
14585,1,1,0,0,2
14586,0,2,0,0,2
14587,0,2,0,0,2
14588,0,2,0,0,2
14589,0,2,0,0,2
14590,0,2,0,0,2
14591,0,2,0,0,2
14592,0,2,0,0,2
14593,0,2,0,0,2
14594,1,1,0,0,2
14595,1,1,0,0,2
14596,1,1,0,0,2
14597,0,0,0,2,2
14598,0,2,0,0,2
14599,0,2,0,0,2
14600,0,2,0,0,2
14601,0,2,0,0,2
14602,0,2,0,0,2
14603,0,0,0,2,2
14604,0,2,0,0,2
14605,1,1,0,0,2
14606,0,2,0,0,2
14607,0,2,0,0,2
14608,0,2,0,0,2
14609,0,2,0,0,2
14610,1,0,1,0,2
14611,0,2,0,0,2
14612,1,1,0,0,2
14613,0,2,0,0,2
14614,1,0,0,1,2
14615,2,0,0,0,2
14616,0,0,2,0,2
14617,0,2,0,0,2
14618,0,2,0,0,2
14619,0,2,0,0,2
14620,2,0,0,0,2
14621,2,0,0,0,2
14622,1,0,1,0,2
14623,2,0,0,0,2
14624,0,2,0,0,2
14625,2,0,0,0,2
14626,0,2,0,0,2
14627,0,2,0,0,2
14628,0,2,0,0,2
14629,0,2,0,0,2
14630,1,1,0,0,2
14631,0,2,0,0,2
14632,0,0,0,2,2
14633,0,2,0,0,2
14634,0,2,0,0,2
14635,0,2,0,0,2
14636,1,0,0,1,2
14637,0,2,0,0,2
14638,0,2,0,0,2
14639,2,0,0,0,2
14640,2,0,0,0,2
14641,0,0,0,2,2
14642,0,2,0,0,2
14643,0,2,0,0,2
14644,0,2,0,0,2
14645,2,0,0,0,2
14646,0,2,0,0,2
14647,0,2,0,0,2
14648,0,2,0,0,2
14649,2,0,0,0,2
14650,0,2,0,0,2
14651,0,2,0,0,2
14652,0,2,0,0,2
14653,0,2,0,0,2
14654,0,2,0,0,2
14655,0,2,0,0,2
14656,0,2,0,0,2
14657,1,1,0,0,2
14658,0,2,0,0,2
14659,0,2,0,0,2
14660,0,2,0,0,2
14661,0,2,0,0,2
14662,0,1,0,1,2
14663,0,2,0,0,2
14664,0,2,0,0,2
14665,0,2,0,0,2
14666,0,2,0,0,2
14667,2,0,0,0,2
14668,0,0,0,2,2
14669,0,2,0,0,2
14670,0,2,0,0,2
14671,0,2,0,0,2
14672,0,2,0,0,2
14673,0,2,0,0,2
14674,0,2,0,0,2
14675,2,0,0,0,2
14676,0,2,0,0,2
14677,0,2,0,0,2
14678,0,2,0,0,2
14679,0,2,0,0,2
14680,2,0,0,0,2
14681,0,2,0,0,2
14682,0,2,0,0,2
14683,0,2,0,0,2
14684,2,0,0,0,2
14685,0,2,0,0,2
14686,0,2,0,0,2
14687,0,2,0,0,2
14688,0,2,0,0,2
14689,1,1,0,0,2
14690,0,2,0,0,2
14691,0,2,0,0,2
14692,0,2,0,0,2
14693,0,2,0,0,2
14694,0,2,0,0,2
14695,0,2,0,0,2
14696,1,0,1,0,2
14697,0,2,0,0,2
14698,0,2,0,0,2
14699,0,2,0,0,2
14700,0,2,0,0,2
14701,0,0,0,2,2
14702,0,2,0,0,2
14703,0,2,0,0,2
14704,0,2,0,0,2
14705,0,2,0,0,2
14706,0,2,0,0,2
14707,2,0,0,0,2
14708,0,2,0,0,2
14709,0,2,0,0,2
14710,0,1,0,1,2
14711,2,0,0,0,2
14712,0,2,0,0,2
14713,0,2,0,0,2
14714,1,1,0,0,2
14715,0,2,0,0,2
14716,1,1,0,0,2
14717,0,2,0,0,2
14718,0,2,0,0,2
14719,0,2,0,0,2
14720,2,0,0,0,2
14721,2,0,0,0,2
14722,2,0,0,0,2
14723,2,0,0,0,2
14724,1,1,0,0,2
14725,0,0,2,0,2
14726,0,2,0,0,2
14727,0,2,0,0,2
14728,2,0,0,0,2
14729,0,2,0,0,2
14730,0,1,0,1,2
14731,0,2,0,0,2
14732,2,0,0,0,2
14733,0,2,0,0,2
14734,0,2,0,0,2
14735,0,2,0,0,2
14736,0,2,0,0,2
14737,1,0,0,1,2
14738,0,2,0,0,2
14739,0,2,0,0,2
14740,0,2,0,0,2
14741,0,2,0,0,2
14742,0,1,1,0,2
14743,0,2,0,0,2
14744,0,2,0,0,2
14745,2,0,0,0,2
14746,0,2,0,0,2
14747,2,0,0,0,2
14748,1,1,0,0,2
14749,0,2,0,0,2
14750,0,2,0,0,2
14751,1,0,0,1,2
14752,0,2,0,0,2
14753,0,2,0,0,2
14754,0,2,0,0,2
14755,1,0,1,0,2
14756,0,2,0,0,2
14757,0,2,0,0,2
14758,0,2,0,0,2
14759,0,2,0,0,2
14760,0,2,0,0,2
14761,0,2,0,0,2
14762,0,2,0,0,2
14763,0,2,0,0,2
14764,0,2,0,0,2
14765,0,2,0,0,2
14766,0,2,0,0,2
14767,0,2,0,0,2
14768,0,2,0,0,2
14769,0,1,0,1,2
14770,0,2,0,0,2
14771,0,2,0,0,2
14772,2,0,0,0,2
14773,0,2,0,0,2
14774,0,2,0,0,2
14775,0,2,0,0,2
14776,1,1,0,0,2
14777,0,2,0,0,2
14778,0,2,0,0,2
14779,0,2,0,0,2
14780,2,0,0,0,2
14781,0,2,0,0,2
14782,0,2,0,0,2
14783,0,2,0,0,2
14784,0,2,0,0,2
14785,0,2,0,0,2
14786,0,2,0,0,2
14787,0,2,0,0,2
14788,1,1,0,0,2
14789,1,1,0,0,2
14790,2,0,0,0,2
14791,0,2,0,0,2
14792,0,2,0,0,2
14793,0,2,0,0,2
14794,0,2,0,0,2
14795,0,2,0,0,2
14796,0,2,0,0,2
14797,0,2,0,0,2
14798,0,0,2,0,2
14799,0,2,0,0,2
14800,0,2,0,0,2
14801,1,1,0,0,2
14802,0,2,0,0,2
14803,0,2,0,0,2
14804,1,0,1,0,2
14805,0,0,0,2,2
14806,0,2,0,0,2
14807,1,1,0,0,2
14808,0,2,0,0,2
14809,0,2,0,0,2
14810,1,1,0,0,2
14811,1,0,0,1,2
14812,1,0,0,1,2
14813,0,0,0,2,2
14814,2,0,0,0,2
14815,1,1,0,0,2
14816,0,2,0,0,2
14817,0,2,0,0,2
14818,0,2,0,0,2
14819,0,2,0,0,2
14820,0,2,0,0,2
14821,0,2,0,0,2
14822,1,1,0,0,2
14823,0,2,0,0,2
14824,0,2,0,0,2
14825,0,1,1,0,2
14826,0,2,0,0,2
14827,0,2,0,0,2
14828,0,2,0,0,2
14829,2,0,0,0,2
14830,2,0,0,0,2
14831,0,2,0,0,2
14832,0,2,0,0,2
14833,0,2,0,0,2
14834,0,2,0,0,2
14835,0,2,0,0,2
14836,0,2,0,0,2
14837,0,2,0,0,2
14838,0,2,0,0,2
14839,0,2,0,0,2
14840,1,1,0,0,2
14841,0,2,0,0,2
14842,0,2,0,0,2
14843,2,0,0,0,2
14844,0,2,0,0,2
14845,0,2,0,0,2
14846,1,0,0,1,2
14847,0,2,0,0,2
14848,0,2,0,0,2
14849,0,2,0,0,2
14850,0,2,0,0,2
14851,0,2,0,0,2
14852,0,2,0,0,2
14853,0,2,0,0,2
14854,0,1,1,0,2
14855,0,2,0,0,2
14856,0,0,1,1,2
14857,0,2,0,0,2
14858,0,2,0,0,2
14859,0,2,0,0,2
14860,0,2,0,0,2
14861,1,0,0,1,2
14862,0,2,0,0,2
14863,0,2,0,0,2
14864,0,2,0,0,2
14865,0,2,0,0,2
14866,0,2,0,0,2
14867,0,2,0,0,2
14868,0,2,0,0,2
14869,0,2,0,0,2
14870,1,1,0,0,2
14871,0,2,0,0,2
14872,0,2,0,0,2
14873,0,2,0,0,2
14874,1,1,0,0,2
14875,0,2,0,0,2
14876,0,2,0,0,2
14877,2,0,0,0,2
14878,0,2,0,0,2
14879,0,2,0,0,2
14880,0,2,0,0,2
14881,0,2,0,0,2
14882,0,2,0,0,2
14883,0,2,0,0,2
14884,0,0,2,0,2
14885,1,1,0,0,2
14886,1,1,0,0,2
14887,1,1,0,0,2
14888,1,1,0,0,2
14889,0,2,0,0,2
14890,0,2,0,0,2
14891,0,2,0,0,2
14892,0,2,0,0,2
14893,0,2,0,0,2
14894,0,2,0,0,2
14895,0,2,0,0,2
14896,0,2,0,0,2
14897,0,2,0,0,2
14898,2,0,0,0,2
14899,0,0,0,2,2
14900,2,0,0,0,2
14901,2,0,0,0,2
14902,0,2,0,0,2
14903,0,2,0,0,2
14904,0,2,0,0,2
14905,0,2,0,0,2
14906,0,1,0,1,2
14907,0,2,0,0,2
14908,0,2,0,0,2
14909,2,0,0,0,2
14910,0,2,0,0,2
14911,0,2,0,0,2
14912,0,2,0,0,2
14913,0,2,0,0,2
14914,0,0,2,0,2
14915,0,1,0,1,2
14916,0,2,0,0,2
14917,0,2,0,0,2
14918,0,2,0,0,2
14919,0,2,0,0,2
14920,2,0,0,0,2
14921,0,2,0,0,2
14922,0,2,0,0,2
14923,0,2,0,0,2
14924,1,1,0,0,2
14925,0,2,0,0,2
14926,0,0,0,2,2
14927,0,2,0,0,2
14928,0,2,0,0,2
14929,0,2,0,0,2
14930,2,0,0,0,2
14931,0,2,0,0,2
14932,0,2,0,0,2
14933,0,2,0,0,2
14934,0,2,0,0,2
14935,0,2,0,0,2
14936,0,2,0,0,2
14937,1,1,0,0,2
14938,1,0,1,0,2
14939,2,0,0,0,2
14940,0,2,0,0,2
14941,0,2,0,0,2
14942,1,1,0,0,2
14943,0,2,0,0,2
14944,1,1,0,0,2
14945,0,2,0,0,2
14946,0,2,0,0,2
14947,0,2,0,0,2
14948,0,2,0,0,2
14949,0,2,0,0,2
14950,0,2,0,0,2
14951,0,2,0,0,2
14952,0,2,0,0,2
14953,2,0,0,0,2
14954,0,2,0,0,2
14955,0,0,0,2,2
14956,0,2,0,0,2
14957,1,1,0,0,2
14958,0,2,0,0,2
14959,0,2,0,0,2
14960,0,2,0,0,2
14961,1,1,0,0,2
14962,0,2,0,0,2
14963,0,2,0,0,2
14964,0,2,0,0,2
14965,0,2,0,0,2
14966,2,0,0,0,2
14967,0,2,0,0,2
14968,0,2,0,0,2
14969,0,2,0,0,2
14970,1,1,0,0,2
14971,0,2,0,0,2
14972,0,2,0,0,2
14973,0,2,0,0,2
14974,2,0,0,0,2
14975,2,0,0,0,2
14976,0,2,0,0,2
14977,0,2,0,0,2
14978,0,0,0,2,2
14979,0,2,0,0,2
14980,1,1,0,0,2
14981,0,2,0,0,2
14982,0,2,0,0,2
14983,1,1,0,0,2
14984,1,0,0,1,2
14985,1,1,0,0,2
14986,0,2,0,0,2
14987,0,2,0,0,2
14988,0,2,0,0,2
14989,0,2,0,0,2
14990,0,2,0,0,2
14991,0,2,0,0,2
14992,0,2,0,0,2
14993,0,2,0,0,2
14994,0,0,0,2,2
14995,1,1,0,0,2
14996,1,0,0,1,2
14997,0,2,0,0,2
14998,1,0,1,0,2
14999,0,2,0,0,2
15000,0,0,0,2,2
15001,2,0,0,0,2
15002,0,2,0,0,2
15003,2,0,0,0,2
15004,0,2,0,0,2
15005,1,1,0,0,2
15006,1,1,0,0,2
15007,0,2,0,0,2
15008,2,0,0,0,2
15009,0,2,0,0,2
15010,1,1,0,0,2
15011,0,2,0,0,2
15012,0,2,0,0,2
15013,2,0,0,0,2
15014,0,2,0,0,2
15015,1,1,0,0,2
15016,0,2,0,0,2
15017,0,2,0,0,2
15018,2,0,0,0,2
15019,0,2,0,0,2
15020,0,2,0,0,2
15021,1,1,0,0,2
15022,0,2,0,0,2
15023,1,1,0,0,2
15024,0,2,0,0,2
15025,0,2,0,0,2
15026,0,2,0,0,2
15027,0,2,0,0,2
15028,0,2,0,0,2
15029,0,2,0,0,2
15030,0,2,0,0,2
15031,0,2,0,0,2
15032,0,2,0,0,2
15033,0,2,0,0,2
15034,0,2,0,0,2
15035,0,2,0,0,2
15036,0,1,0,1,2
15037,2,0,0,0,2
15038,0,2,0,0,2
15039,0,2,0,0,2
15040,2,0,0,0,2
15041,0,2,0,0,2
15042,0,2,0,0,2
15043,0,2,0,0,2
15044,0,2,0,0,2
15045,0,2,0,0,2
15046,0,2,0,0,2
15047,1,0,1,0,2
15048,1,1,0,0,2
15049,1,1,0,0,2
15050,1,0,1,0,2
15051,0,2,0,0,2
15052,0,0,0,2,2
15053,0,2,0,0,2
15054,0,2,0,0,2
15055,0,2,0,0,2
15056,0,2,0,0,2
15057,1,1,0,0,2
15058,0,2,0,0,2
15059,0,2,0,0,2
15060,0,2,0,0,2
15061,0,2,0,0,2
15062,0,2,0,0,2
15063,0,2,0,0,2
15064,0,2,0,0,2
15065,0,2,0,0,2
15066,0,2,0,0,2
15067,0,2,0,0,2
15068,2,0,0,0,2
15069,1,0,1,0,2
15070,1,1,0,0,2
15071,0,2,0,0,2
15072,0,2,0,0,2
15073,0,2,0,0,2
15074,0,2,0,0,2
15075,1,1,0,0,2
15076,1,1,0,0,2
15077,1,1,0,0,2
15078,0,2,0,0,2
15079,0,2,0,0,2
15080,0,2,0,0,2
15081,0,1,0,1,2
15082,2,0,0,0,2
15083,1,1,0,0,2
15084,0,2,0,0,2
15085,0,2,0,0,2
15086,0,2,0,0,2
15087,0,2,0,0,2
15088,0,2,0,0,2
15089,0,2,0,0,2
15090,0,2,0,0,2
15091,0,2,0,0,2
15092,0,2,0,0,2
15093,1,0,1,0,2
15094,0,2,0,0,2
15095,0,1,0,1,2
15096,0,0,0,2,2
15097,2,0,0,0,2
15098,2,0,0,0,2
15099,0,2,0,0,2
15100,1,1,0,0,2
15101,0,2,0,0,2
15102,1,1,0,0,2
15103,0,2,0,0,2
15104,0,2,0,0,2
15105,2,0,0,0,2
15106,0,2,0,0,2
15107,0,2,0,0,2
15108,2,0,0,0,2
15109,0,2,0,0,2
15110,0,2,0,0,2
15111,2,0,0,0,2
15112,0,1,0,1,2
15113,0,1,0,1,2
15114,0,2,0,0,2
15115,2,0,0,0,2
15116,0,2,0,0,2
15117,0,2,0,0,2
15118,0,2,0,0,2
15119,2,0,0,0,2
15120,2,0,0,0,2
15121,0,2,0,0,2
15122,0,2,0,0,2
15123,0,2,0,0,2
15124,0,2,0,0,2
15125,0,1,1,0,2
15126,0,1,0,1,2
15127,0,2,0,0,2
15128,0,2,0,0,2
15129,0,2,0,0,2
15130,0,2,0,0,2
15131,0,2,0,0,2
15132,0,2,0,0,2
15133,0,2,0,0,2
15134,0,2,0,0,2
15135,0,2,0,0,2
15136,0,2,0,0,2
15137,2,0,0,0,2
15138,0,2,0,0,2
15139,0,2,0,0,2
15140,0,2,0,0,2
15141,0,2,0,0,2
15142,0,2,0,0,2
15143,0,2,0,0,2
15144,0,2,0,0,2
15145,2,0,0,0,2
15146,0,2,0,0,2
15147,2,0,0,0,2
15148,0,2,0,0,2
15149,0,2,0,0,2
15150,0,2,0,0,2
15151,0,2,0,0,2
15152,0,2,0,0,2
15153,2,0,0,0,2
15154,0,2,0,0,2
15155,1,1,0,0,2
15156,0,2,0,0,2
15157,0,2,0,0,2
15158,1,1,0,0,2
15159,0,2,0,0,2
15160,0,2,0,0,2
15161,0,2,0,0,2
15162,2,0,0,0,2
15163,0,2,0,0,2
15164,0,2,0,0,2
15165,0,2,0,0,2
15166,0,2,0,0,2
15167,0,2,0,0,2
15168,0,2,0,0,2
15169,0,2,0,0,2
15170,0,2,0,0,2
15171,0,2,0,0,2
15172,0,2,0,0,2
15173,1,0,1,0,2
15174,0,2,0,0,2
15175,0,2,0,0,2
15176,0,2,0,0,2
15177,0,2,0,0,2
15178,0,2,0,0,2
15179,2,0,0,0,2
15180,0,2,0,0,2
15181,0,2,0,0,2
15182,0,2,0,0,2
15183,0,2,0,0,2
15184,0,0,0,2,2
15185,0,2,0,0,2
15186,1,1,0,0,2
15187,0,2,0,0,2
15188,0,2,0,0,2
15189,0,1,1,0,2
15190,0,2,0,0,2
15191,0,1,0,1,2
15192,1,1,0,0,2
15193,1,1,0,0,2
15194,2,0,0,0,2
15195,0,2,0,0,2
15196,1,1,0,0,2
15197,0,2,0,0,2
15198,1,0,0,1,2
15199,0,2,0,0,2
15200,0,0,0,2,2
15201,0,2,0,0,2
15202,0,0,0,2,2
15203,2,0,0,0,2
15204,0,2,0,0,2
15205,0,2,0,0,2
15206,0,2,0,0,2
15207,0,2,0,0,2
15208,0,0,2,0,2
15209,0,2,0,0,2
15210,2,0,0,0,2
15211,0,2,0,0,2
15212,0,2,0,0,2
15213,0,2,0,0,2
15214,0,2,0,0,2
15215,1,1,0,0,2
15216,0,2,0,0,2
15217,0,2,0,0,2
15218,0,2,0,0,2
15219,0,2,0,0,2
15220,1,1,0,0,2
15221,0,2,0,0,2
15222,0,2,0,0,2
15223,0,2,0,0,2
15224,0,2,0,0,2
15225,1,1,0,0,2
15226,0,2,0,0,2
15227,0,2,0,0,2
15228,0,2,0,0,2
15229,0,2,0,0,2
15230,0,2,0,0,2
15231,1,1,0,0,2
15232,0,2,0,0,2
15233,0,2,0,0,2
15234,0,2,0,0,2
15235,0,1,1,0,2
15236,1,1,0,0,2
15237,0,2,0,0,2
15238,0,2,0,0,2
15239,2,0,0,0,2
15240,2,0,0,0,2
15241,1,0,1,0,2
15242,0,2,0,0,2
15243,0,2,0,0,2
15244,0,2,0,0,2
15245,0,2,0,0,2
15246,0,2,0,0,2
15247,0,2,0,0,2
15248,0,0,1,1,2
15249,0,2,0,0,2
15250,1,0,0,1,2
15251,0,2,0,0,2
15252,1,1,0,0,2
15253,0,2,0,0,2
15254,0,2,0,0,2
15255,0,2,0,0,2
15256,0,2,0,0,2
15257,0,2,0,0,2
15258,0,2,0,0,2
15259,0,2,0,0,2
15260,0,2,0,0,2
15261,0,2,0,0,2
15262,0,2,0,0,2
15263,0,2,0,0,2
15264,1,0,0,1,2
15265,0,2,0,0,2
15266,0,2,0,0,2
15267,0,2,0,0,2
15268,1,1,0,0,2
15269,0,2,0,0,2
15270,0,2,0,0,2
15271,2,0,0,0,2
15272,1,1,0,0,2
15273,0,2,0,0,2
15274,0,2,0,0,2
15275,1,0,1,0,2
15276,0,1,1,0,2
15277,0,2,0,0,2
15278,0,2,0,0,2
15279,0,2,0,0,2
15280,1,0,1,0,2
15281,0,2,0,0,2
15282,0,2,0,0,2
15283,0,2,0,0,2
15284,0,1,1,0,2
15285,0,2,0,0,2
15286,0,2,0,0,2
15287,0,2,0,0,2
15288,0,2,0,0,2
15289,0,2,0,0,2
15290,0,2,0,0,2
15291,2,0,0,0,2
15292,0,0,1,1,2
15293,0,2,0,0,2
15294,0,2,0,0,2
15295,0,2,0,0,2
15296,0,2,0,0,2
15297,0,2,0,0,2
15298,0,2,0,0,2
15299,0,2,0,0,2
15300,0,2,0,0,2
15301,0,2,0,0,2
15302,0,1,1,0,2
15303,0,2,0,0,2
15304,0,2,0,0,2
15305,0,2,0,0,2
15306,2,0,0,0,2
15307,0,2,0,0,2
15308,0,2,0,0,2
15309,0,2,0,0,2
15310,0,0,1,1,2
15311,0,2,0,0,2
15312,0,2,0,0,2
15313,0,2,0,0,2
15314,0,2,0,0,2
15315,0,0,0,2,2
15316,0,2,0,0,2
15317,0,2,0,0,2
15318,2,0,0,0,2
15319,0,0,0,2,2
15320,0,2,0,0,2
15321,0,2,0,0,2
15322,1,0,0,1,2
15323,0,2,0,0,2
15324,1,1,0,0,2
15325,1,1,0,0,2
15326,0,2,0,0,2
15327,0,2,0,0,2
15328,0,2,0,0,2
15329,0,2,0,0,2
15330,0,2,0,0,2
15331,0,2,0,0,2
15332,0,2,0,0,2
15333,0,2,0,0,2
15334,1,1,0,0,2
15335,0,2,0,0,2
15336,0,2,0,0,2
15337,0,2,0,0,2
15338,0,2,0,0,2
15339,0,2,0,0,2
15340,0,0,1,1,2
15341,0,2,0,0,2
15342,1,1,0,0,2
15343,0,2,0,0,2
15344,0,2,0,0,2
15345,0,1,0,1,2
15346,0,2,0,0,2
15347,0,2,0,0,2
15348,0,2,0,0,2
15349,0,2,0,0,2
15350,0,2,0,0,2
15351,0,2,0,0,2
15352,0,2,0,0,2
15353,0,2,0,0,2
15354,0,2,0,0,2
15355,2,0,0,0,2
15356,0,2,0,0,2
15357,0,2,0,0,2
15358,0,0,2,0,2
15359,0,2,0,0,2
15360,0,2,0,0,2
15361,0,2,0,0,2
15362,0,2,0,0,2
15363,1,1,0,0,2
15364,0,2,0,0,2
15365,0,1,1,0,2
15366,0,2,0,0,2
15367,0,0,0,2,2
15368,0,2,0,0,2
15369,0,2,0,0,2
15370,0,0,0,2,2
15371,0,2,0,0,2
15372,0,2,0,0,2
15373,0,2,0,0,2
15374,0,2,0,0,2
15375,0,2,0,0,2
15376,2,0,0,0,2
15377,0,2,0,0,2
15378,0,2,0,0,2
15379,0,2,0,0,2
15380,0,2,0,0,2
15381,0,2,0,0,2
15382,0,2,0,0,2
15383,0,2,0,0,2
15384,0,2,0,0,2
15385,0,1,0,1,2
15386,0,2,0,0,2
15387,0,2,0,0,2
15388,2,0,0,0,2
15389,0,2,0,0,2
15390,0,2,0,0,2
15391,0,2,0,0,2
15392,0,2,0,0,2
15393,0,2,0,0,2
15394,0,2,0,0,2
15395,0,2,0,0,2
15396,0,2,0,0,2
15397,0,2,0,0,2
15398,0,2,0,0,2
15399,0,2,0,0,2
15400,0,2,0,0,2
15401,0,2,0,0,2
15402,0,2,0,0,2
15403,0,2,0,0,2
15404,0,2,0,0,2
15405,0,2,0,0,2
15406,0,2,0,0,2
15407,0,2,0,0,2
15408,0,2,0,0,2
15409,0,1,0,1,2
15410,0,2,0,0,2
15411,0,2,0,0,2
15412,0,2,0,0,2
15413,0,2,0,0,2
15414,0,2,0,0,2
15415,0,2,0,0,2
15416,0,2,0,0,2
15417,0,0,2,0,2
15418,2,0,0,0,2
15419,0,2,0,0,2
15420,0,0,0,2,2
15421,0,2,0,0,2
15422,0,2,0,0,2
15423,0,2,0,0,2
15424,0,2,0,0,2
15425,0,2,0,0,2
15426,0,2,0,0,2
15427,0,2,0,0,2
15428,2,0,0,0,2
15429,0,2,0,0,2
15430,1,1,0,0,2
15431,0,2,0,0,2
15432,0,2,0,0,2
15433,0,2,0,0,2
15434,1,1,0,0,2
15435,0,2,0,0,2
15436,0,2,0,0,2
15437,1,0,0,1,2
15438,0,2,0,0,2
15439,0,2,0,0,2
15440,0,2,0,0,2
15441,1,0,1,0,2
15442,0,2,0,0,2
15443,0,2,0,0,2
15444,2,0,0,0,2
15445,0,2,0,0,2
15446,0,2,0,0,2
15447,0,2,0,0,2
15448,0,2,0,0,2
15449,0,2,0,0,2
15450,0,1,1,0,2
15451,0,1,1,0,2
15452,0,2,0,0,2
15453,1,0,1,0,2
15454,2,0,0,0,2
15455,0,2,0,0,2
15456,0,2,0,0,2
15457,0,2,0,0,2
15458,0,2,0,0,2
15459,2,0,0,0,2
15460,1,1,0,0,2
15461,0,2,0,0,2
15462,0,2,0,0,2
15463,0,0,0,2,2
15464,0,2,0,0,2
15465,1,1,0,0,2
15466,0,2,0,0,2
15467,1,1,0,0,2
15468,0,2,0,0,2
15469,0,2,0,0,2
15470,0,2,0,0,2
15471,0,2,0,0,2
15472,2,0,0,0,2
15473,0,2,0,0,2
15474,0,2,0,0,2
15475,0,1,1,0,2
15476,0,2,0,0,2
15477,0,2,0,0,2
15478,1,1,0,0,2
15479,0,2,0,0,2
15480,0,2,0,0,2
15481,0,2,0,0,2
15482,0,2,0,0,2
15483,0,2,0,0,2
15484,2,0,0,0,2
15485,1,1,0,0,2
15486,0,2,0,0,2
15487,0,2,0,0,2
15488,0,2,0,0,2
15489,0,2,0,0,2
15490,0,2,0,0,2
15491,0,2,0,0,2
15492,2,0,0,0,2
15493,0,2,0,0,2
15494,0,2,0,0,2
15495,0,2,0,0,2
15496,0,2,0,0,2
15497,0,2,0,0,2
15498,0,2,0,0,2
15499,0,2,0,0,2
15500,0,1,1,0,2
15501,0,2,0,0,2
15502,0,2,0,0,2
15503,0,2,0,0,2
15504,0,2,0,0,2
15505,1,0,1,0,2
15506,0,2,0,0,2
15507,1,1,0,0,2
15508,0,2,0,0,2
15509,0,2,0,0,2
15510,0,0,0,2,2
15511,0,2,0,0,2
15512,0,2,0,0,2
15513,0,2,0,0,2
15514,0,2,0,0,2
15515,2,0,0,0,2
15516,0,2,0,0,2
15517,0,2,0,0,2
15518,0,2,0,0,2
15519,0,2,0,0,2
15520,1,1,0,0,2
15521,0,2,0,0,2
15522,0,0,2,0,2
15523,2,0,0,0,2
15524,0,2,0,0,2
15525,0,2,0,0,2
15526,1,1,0,0,2
15527,0,0,1,1,2
15528,1,0,0,1,2
15529,0,2,0,0,2
15530,0,2,0,0,2
15531,2,0,0,0,2
15532,2,0,0,0,2
15533,1,0,0,1,2
15534,0,2,0,0,2
15535,0,2,0,0,2
15536,1,1,0,0,2
15537,0,2,0,0,2
15538,1,0,0,1,2
15539,0,2,0,0,2
15540,1,0,0,1,2
15541,0,2,0,0,2
15542,1,1,0,0,2
15543,1,0,0,1,2
15544,0,2,0,0,2
15545,0,2,0,0,2
15546,0,2,0,0,2
15547,0,2,0,0,2
15548,1,0,1,0,2
15549,0,2,0,0,2
15550,0,2,0,0,2
15551,0,1,1,0,2
15552,2,0,0,0,2
15553,0,2,0,0,2
15554,1,1,0,0,2
15555,0,2,0,0,2
15556,0,2,0,0,2
15557,0,1,1,0,2
15558,0,2,0,0,2
15559,0,2,0,0,2
15560,1,1,0,0,2
15561,0,2,0,0,2
15562,0,1,0,1,2
15563,0,2,0,0,2
15564,1,1,0,0,2
15565,0,2,0,0,2
15566,1,1,0,0,2
15567,0,2,0,0,2
15568,0,2,0,0,2
15569,0,2,0,0,2
15570,0,2,0,0,2
15571,0,2,0,0,2
15572,0,1,0,1,2
15573,0,0,0,2,2
15574,0,2,0,0,2
15575,1,1,0,0,2
15576,0,2,0,0,2
15577,0,2,0,0,2
15578,0,2,0,0,2
15579,0,2,0,0,2
15580,0,2,0,0,2
15581,0,2,0,0,2
15582,0,2,0,0,2
15583,0,2,0,0,2
15584,0,2,0,0,2
15585,0,2,0,0,2
15586,1,1,0,0,2
15587,0,2,0,0,2
15588,2,0,0,0,2
15589,0,2,0,0,2
15590,0,2,0,0,2
15591,0,2,0,0,2
15592,0,2,0,0,2
15593,0,2,0,0,2
15594,0,2,0,0,2
15595,0,2,0,0,2
15596,0,2,0,0,2
15597,0,0,0,2,2
15598,0,2,0,0,2
15599,0,2,0,0,2
15600,0,2,0,0,2
15601,0,2,0,0,2
15602,0,2,0,0,2
15603,0,2,0,0,2
15604,0,2,0,0,2
15605,0,2,0,0,2
15606,1,1,0,0,2
15607,0,2,0,0,2
15608,0,2,0,0,2
15609,0,2,0,0,2
15610,0,2,0,0,2
15611,0,2,0,0,2
15612,0,2,0,0,2
15613,0,2,0,0,2
15614,0,2,0,0,2
15615,0,2,0,0,2
15616,0,2,0,0,2
15617,0,1,0,1,2
15618,0,2,0,0,2
15619,0,2,0,0,2
15620,0,2,0,0,2
15621,0,2,0,0,2
15622,2,0,0,0,2
15623,2,0,0,0,2
15624,0,2,0,0,2
15625,0,2,0,0,2
15626,0,1,0,1,2
15627,0,2,0,0,2
15628,1,1,0,0,2
15629,0,2,0,0,2
15630,0,2,0,0,2
15631,0,2,0,0,2
15632,1,1,0,0,2
15633,0,2,0,0,2
15634,2,0,0,0,2
15635,2,0,0,0,2
15636,1,1,0,0,2
15637,0,2,0,0,2
15638,0,2,0,0,2
15639,0,2,0,0,2
15640,1,1,0,0,2
15641,1,1,0,0,2
15642,0,2,0,0,2
15643,0,2,0,0,2
15644,0,2,0,0,2
15645,1,1,0,0,2
15646,0,2,0,0,2
15647,0,2,0,0,2
15648,0,1,0,1,2
15649,0,2,0,0,2
15650,0,2,0,0,2
15651,0,0,0,2,2
15652,2,0,0,0,2
15653,0,2,0,0,2
15654,0,2,0,0,2
15655,0,0,1,1,2
15656,2,0,0,0,2
15657,0,2,0,0,2
15658,0,2,0,0,2
15659,1,0,0,1,2
15660,0,2,0,0,2
15661,0,2,0,0,2
15662,0,2,0,0,2
15663,0,2,0,0,2
15664,1,1,0,0,2
15665,0,2,0,0,2
15666,0,2,0,0,2
15667,0,2,0,0,2
15668,0,2,0,0,2
15669,0,1,1,0,2
15670,0,2,0,0,2
15671,0,2,0,0,2
15672,0,2,0,0,2
15673,0,2,0,0,2
15674,0,1,1,0,2
15675,0,2,0,0,2
15676,0,2,0,0,2
15677,0,2,0,0,2
15678,0,2,0,0,2
15679,0,2,0,0,2
15680,0,2,0,0,2
15681,1,1,0,0,2
15682,0,2,0,0,2
15683,0,2,0,0,2
15684,0,2,0,0,2
15685,0,2,0,0,2
15686,0,2,0,0,2
15687,0,2,0,0,2
15688,2,0,0,0,2
15689,0,2,0,0,2
15690,0,2,0,0,2
15691,0,2,0,0,2
15692,2,0,0,0,2
15693,0,2,0,0,2
15694,0,1,1,0,2
15695,1,0,0,1,2
15696,2,0,0,0,2
15697,0,2,0,0,2
15698,2,0,0,0,2
15699,0,2,0,0,2
15700,1,1,0,0,2
15701,1,0,0,1,2
15702,2,0,0,0,2
15703,2,0,0,0,2
15704,0,2,0,0,2
15705,1,1,0,0,2
15706,0,2,0,0,2
15707,0,2,0,0,2
15708,0,0,1,1,2
15709,0,2,0,0,2
15710,0,2,0,0,2
15711,1,0,1,0,2
15712,0,0,0,2,2
15713,0,2,0,0,2
15714,2,0,0,0,2
15715,0,2,0,0,2
15716,1,1,0,0,2
15717,0,2,0,0,2
15718,0,2,0,0,2
15719,1,1,0,0,2
15720,0,2,0,0,2
15721,0,2,0,0,2
15722,1,0,0,1,2
15723,0,2,0,0,2
15724,0,2,0,0,2
15725,0,2,0,0,2
15726,0,2,0,0,2
15727,1,1,0,0,2
15728,0,2,0,0,2
15729,0,0,0,2,2
15730,0,2,0,0,2
15731,0,2,0,0,2
15732,1,0,0,1,2
15733,1,1,0,0,2
15734,0,2,0,0,2
15735,0,2,0,0,2
15736,1,1,0,0,2
15737,0,2,0,0,2
15738,2,0,0,0,2
15739,1,1,0,0,2
15740,0,2,0,0,2
15741,0,2,0,0,2
15742,0,2,0,0,2
15743,0,2,0,0,2
15744,1,0,0,1,2
15745,0,2,0,0,2
15746,0,2,0,0,2
15747,0,2,0,0,2
15748,0,2,0,0,2
15749,0,2,0,0,2
15750,0,2,0,0,2
15751,1,0,0,1,2
15752,0,2,0,0,2
15753,2,0,0,0,2
15754,1,0,1,0,2
15755,0,2,0,0,2
15756,0,2,0,0,2
15757,0,2,0,0,2
15758,0,2,0,0,2
15759,0,2,0,0,2
15760,0,2,0,0,2
15761,0,2,0,0,2
15762,0,2,0,0,2
15763,0,2,0,0,2
15764,1,1,0,0,2
15765,2,0,0,0,2
15766,0,2,0,0,2
15767,0,2,0,0,2
15768,0,2,0,0,2
15769,0,2,0,0,2
15770,0,2,0,0,2
15771,0,2,0,0,2
15772,0,0,0,2,2
15773,0,2,0,0,2
15774,0,2,0,0,2
15775,0,2,0,0,2
15776,0,2,0,0,2
15777,0,2,0,0,2
15778,0,2,0,0,2
15779,0,2,0,0,2
15780,0,2,0,0,2
15781,0,2,0,0,2
15782,0,2,0,0,2
15783,0,2,0,0,2
15784,0,2,0,0,2
15785,1,0,0,1,2
15786,0,0,0,2,2
15787,0,2,0,0,2
15788,0,2,0,0,2
15789,1,0,0,1,2
15790,0,2,0,0,2
15791,0,2,0,0,2
15792,1,0,1,0,2
15793,2,0,0,0,2
15794,2,0,0,0,2
15795,1,1,0,0,2
15796,0,0,0,2,2
15797,0,2,0,0,2
15798,0,2,0,0,2
15799,0,1,0,1,2
15800,0,2,0,0,2
15801,0,2,0,0,2
15802,0,2,0,0,2
15803,2,0,0,0,2
15804,0,2,0,0,2
15805,2,0,0,0,2
15806,0,2,0,0,2
15807,2,0,0,0,2
15808,0,2,0,0,2
15809,0,2,0,0,2
15810,0,2,0,0,2
15811,0,2,0,0,2
15812,0,2,0,0,2
15813,0,2,0,0,2
15814,2,0,0,0,2
15815,0,2,0,0,2
15816,0,2,0,0,2
15817,1,0,0,1,2
15818,0,2,0,0,2
15819,0,2,0,0,2
15820,0,2,0,0,2
15821,0,2,0,0,2
15822,0,2,0,0,2
15823,1,1,0,0,2
15824,0,2,0,0,2
15825,0,2,0,0,2
15826,0,2,0,0,2
15827,0,2,0,0,2
15828,1,1,0,0,2
15829,2,0,0,0,2
15830,0,2,0,0,2
15831,0,2,0,0,2
15832,0,2,0,0,2
15833,0,2,0,0,2
15834,0,2,0,0,2
15835,0,2,0,0,2
15836,0,0,0,2,2
15837,0,2,0,0,2
15838,0,2,0,0,2
15839,0,2,0,0,2
15840,0,2,0,0,2
15841,0,2,0,0,2
15842,1,0,0,1,2
15843,1,1,0,0,2
15844,0,2,0,0,2
15845,0,2,0,0,2
15846,0,2,0,0,2
15847,2,0,0,0,2
15848,0,2,0,0,2
15849,1,0,0,1,2
15850,0,2,0,0,2
15851,1,1,0,0,2
15852,1,0,1,0,2
15853,0,2,0,0,2
15854,2,0,0,0,2
15855,0,2,0,0,2
15856,0,2,0,0,2
15857,2,0,0,0,2
15858,1,1,0,0,2
15859,0,2,0,0,2
15860,0,2,0,0,2
15861,0,2,0,0,2
15862,0,2,0,0,2
15863,0,2,0,0,2
15864,0,2,0,0,2
15865,0,2,0,0,2
15866,0,2,0,0,2
15867,0,2,0,0,2
15868,0,2,0,0,2
15869,0,2,0,0,2
15870,0,2,0,0,2
15871,0,2,0,0,2
15872,0,1,0,1,2
15873,0,2,0,0,2
15874,1,1,0,0,2
15875,0,2,0,0,2
15876,0,2,0,0,2
15877,0,2,0,0,2
15878,0,2,0,0,2
15879,1,1,0,0,2
15880,0,2,0,0,2
15881,0,2,0,0,2
15882,0,2,0,0,2
15883,0,2,0,0,2
15884,0,2,0,0,2
15885,0,2,0,0,2
15886,1,1,0,0,2
15887,0,2,0,0,2
15888,0,2,0,0,2
15889,1,1,0,0,2
15890,0,2,0,0,2
15891,2,0,0,0,2
15892,0,2,0,0,2
15893,0,2,0,0,2
15894,0,2,0,0,2
15895,0,2,0,0,2
15896,0,2,0,0,2
15897,2,0,0,0,2
15898,0,2,0,0,2
15899,0,2,0,0,2
15900,0,2,0,0,2
15901,0,2,0,0,2
15902,0,2,0,0,2
15903,0,2,0,0,2
15904,0,2,0,0,2
15905,0,2,0,0,2
15906,0,2,0,0,2
15907,2,0,0,0,2
15908,0,2,0,0,2
15909,0,2,0,0,2
15910,0,2,0,0,2
15911,0,2,0,0,2
15912,0,2,0,0,2
15913,0,2,0,0,2
15914,0,2,0,0,2
15915,0,2,0,0,2
15916,0,2,0,0,2
15917,1,1,0,0,2
15918,1,0,0,1,2
15919,0,2,0,0,2
15920,0,2,0,0,2
15921,0,2,0,0,2
15922,2,0,0,0,2
15923,0,2,0,0,2
15924,2,0,0,0,2
15925,0,2,0,0,2
15926,0,2,0,0,2
15927,0,2,0,0,2
15928,0,2,0,0,2
15929,0,2,0,0,2
15930,1,1,0,0,2
15931,0,2,0,0,2
15932,0,2,0,0,2
15933,0,2,0,0,2
15934,2,0,0,0,2
15935,0,2,0,0,2
15936,0,0,0,2,2
15937,0,2,0,0,2
15938,1,1,0,0,2
15939,0,2,0,0,2
15940,0,2,0,0,2
15941,0,2,0,0,2
15942,0,2,0,0,2
15943,1,0,0,1,2
15944,1,1,0,0,2
15945,0,2,0,0,2
15946,0,2,0,0,2
15947,0,0,0,2,2
15948,0,2,0,0,2
15949,2,0,0,0,2
15950,0,2,0,0,2
15951,0,2,0,0,2
15952,0,2,0,0,2
15953,0,2,0,0,2
15954,0,2,0,0,2
15955,0,2,0,0,2
15956,1,0,0,1,2
15957,0,2,0,0,2
15958,0,2,0,0,2
15959,1,1,0,0,2
15960,2,0,0,0,2
15961,0,2,0,0,2
15962,1,1,0,0,2
15963,0,1,0,1,2
15964,1,1,0,0,2
15965,0,2,0,0,2
15966,0,2,0,0,2
15967,0,2,0,0,2
15968,0,2,0,0,2
15969,2,0,0,0,2
15970,0,2,0,0,2
15971,0,2,0,0,2
15972,1,1,0,0,2
15973,0,2,0,0,2
15974,0,2,0,0,2
15975,0,2,0,0,2
15976,1,1,0,0,2
15977,2,0,0,0,2
15978,0,2,0,0,2
15979,0,2,0,0,2
15980,0,2,0,0,2
15981,0,0,0,2,2
15982,1,1,0,0,2
15983,0,2,0,0,2
15984,0,2,0,0,2
15985,0,2,0,0,2
15986,0,2,0,0,2
15987,0,2,0,0,2
15988,0,2,0,0,2
15989,0,2,0,0,2
15990,0,2,0,0,2
15991,0,0,1,1,2
15992,0,2,0,0,2
15993,1,1,0,0,2
15994,0,2,0,0,2
15995,0,2,0,0,2
15996,0,2,0,0,2
15997,0,2,0,0,2
15998,1,1,0,0,2
15999,2,0,0,0,2
16000,1,0,1,0,2
16001,2,0,0,0,2
16002,0,2,0,0,2
16003,2,0,0,0,2
16004,1,1,0,0,2
16005,0,2,0,0,2
16006,2,0,0,0,2
16007,0,1,0,1,2
16008,2,0,0,0,2
16009,0,2,0,0,2
16010,0,2,0,0,2
16011,0,2,0,0,2
16012,0,2,0,0,2
16013,0,2,0,0,2
16014,0,1,0,1,2
16015,0,2,0,0,2
16016,1,1,0,0,2
16017,0,2,0,0,2
16018,0,2,0,0,2
16019,0,2,0,0,2
16020,0,2,0,0,2
16021,0,2,0,0,2
16022,1,1,0,0,2
16023,0,2,0,0,2
16024,0,2,0,0,2
16025,0,2,0,0,2
16026,0,2,0,0,2
16027,0,2,0,0,2
16028,0,2,0,0,2
16029,0,2,0,0,2
16030,0,2,0,0,2
16031,1,1,0,0,2
16032,1,0,0,1,2
16033,2,0,0,0,2
16034,0,2,0,0,2
16035,0,2,0,0,2
16036,0,2,0,0,2
16037,0,2,0,0,2
16038,0,2,0,0,2
16039,2,0,0,0,2
16040,0,2,0,0,2
16041,0,2,0,0,2
16042,0,2,0,0,2
16043,1,1,0,0,2
16044,2,0,0,0,2
16045,0,2,0,0,2
16046,0,2,0,0,2
16047,1,1,0,0,2
16048,0,2,0,0,2
16049,0,2,0,0,2
16050,0,2,0,0,2
16051,0,2,0,0,2
16052,0,2,0,0,2
16053,0,2,0,0,2
16054,2,0,0,0,2
16055,1,1,0,0,2
16056,0,2,0,0,2
16057,0,2,0,0,2
16058,0,0,2,0,2
16059,0,0,2,0,2
16060,0,2,0,0,2
16061,0,2,0,0,2
16062,0,2,0,0,2
16063,0,2,0,0,2
16064,0,2,0,0,2
16065,0,2,0,0,2
16066,0,2,0,0,2
16067,0,2,0,0,2
16068,0,2,0,0,2
16069,0,2,0,0,2
16070,0,2,0,0,2
16071,1,1,0,0,2
16072,0,2,0,0,2
16073,0,2,0,0,2
16074,0,2,0,0,2
16075,0,2,0,0,2
16076,0,2,0,0,2
16077,0,2,0,0,2
16078,1,1,0,0,2
16079,0,2,0,0,2
16080,0,0,2,0,2
16081,1,1,0,0,2
16082,0,2,0,0,2
16083,0,2,0,0,2
16084,0,2,0,0,2
16085,0,0,0,2,2
16086,2,0,0,0,2
16087,1,1,0,0,2
16088,0,2,0,0,2
16089,0,2,0,0,2
16090,0,2,0,0,2
16091,0,2,0,0,2
16092,0,2,0,0,2
16093,2,0,0,0,2
16094,0,2,0,0,2
16095,0,2,0,0,2
16096,0,2,0,0,2
16097,0,2,0,0,2
16098,0,2,0,0,2
16099,0,2,0,0,2
16100,0,2,0,0,2
16101,0,0,0,2,2
16102,0,2,0,0,2
16103,0,2,0,0,2
16104,0,2,0,0,2
16105,0,2,0,0,2
16106,1,1,0,0,2
16107,0,2,0,0,2
16108,0,2,0,0,2
16109,0,2,0,0,2
16110,0,2,0,0,2
16111,2,0,0,0,2
16112,1,0,0,1,2
16113,0,2,0,0,2
16114,0,2,0,0,2
16115,0,2,0,0,2
16116,1,1,0,0,2
16117,0,2,0,0,2
16118,1,0,1,0,2
16119,0,2,0,0,2
16120,0,2,0,0,2
16121,0,2,0,0,2
16122,0,2,0,0,2
16123,0,2,0,0,2
16124,0,2,0,0,2
16125,0,2,0,0,2
16126,0,2,0,0,2
16127,0,2,0,0,2
16128,1,1,0,0,2
16129,0,2,0,0,2
16130,2,0,0,0,2
16131,1,1,0,0,2
16132,2,0,0,0,2
16133,0,2,0,0,2
16134,1,1,0,0,2
16135,1,1,0,0,2
16136,0,2,0,0,2
16137,0,2,0,0,2
16138,0,2,0,0,2
16139,2,0,0,0,2
16140,0,2,0,0,2
16141,2,0,0,0,2
16142,0,2,0,0,2
16143,0,2,0,0,2
16144,0,0,1,1,2
16145,0,2,0,0,2
16146,1,1,0,0,2
16147,0,2,0,0,2
16148,0,2,0,0,2
16149,0,2,0,0,2
16150,0,2,0,0,2
16151,0,2,0,0,2
16152,1,1,0,0,2
16153,0,1,1,0,2
16154,0,2,0,0,2
16155,1,1,0,0,2
16156,0,2,0,0,2
16157,0,2,0,0,2
16158,2,0,0,0,2
16159,2,0,0,0,2
16160,0,2,0,0,2
16161,0,2,0,0,2
16162,0,1,0,1,2
16163,0,2,0,0,2
16164,0,2,0,0,2
16165,2,0,0,0,2
16166,0,2,0,0,2
16167,0,2,0,0,2
16168,0,2,0,0,2
16169,0,2,0,0,2
16170,1,0,1,0,2
16171,0,2,0,0,2
16172,2,0,0,0,2
16173,0,1,0,1,2
16174,0,2,0,0,2
16175,0,2,0,0,2
16176,0,2,0,0,2
16177,0,2,0,0,2
16178,0,0,2,0,2
16179,0,2,0,0,2
16180,0,2,0,0,2
16181,0,2,0,0,2
16182,1,0,1,0,2
16183,2,0,0,0,2
16184,0,2,0,0,2
16185,0,2,0,0,2
16186,0,2,0,0,2
16187,0,2,0,0,2
16188,1,0,1,0,2
16189,0,2,0,0,2
16190,0,2,0,0,2
16191,2,0,0,0,2
16192,1,1,0,0,2
16193,1,1,0,0,2
16194,0,2,0,0,2
16195,0,0,0,2,2
16196,0,2,0,0,2
16197,0,2,0,0,2
16198,0,0,0,2,2
16199,0,2,0,0,2
16200,0,0,0,2,2
16201,1,1,0,0,2
16202,1,1,0,0,2
16203,0,2,0,0,2
16204,0,2,0,0,2
16205,0,2,0,0,2
16206,0,2,0,0,2
16207,0,2,0,0,2
16208,1,0,0,1,2
16209,0,2,0,0,2
16210,0,2,0,0,2
16211,0,2,0,0,2
16212,0,2,0,0,2
16213,0,2,0,0,2
16214,0,2,0,0,2
16215,0,2,0,0,2
16216,0,2,0,0,2
16217,0,0,0,2,2
16218,2,0,0,0,2
16219,0,2,0,0,2
16220,0,2,0,0,2
16221,0,2,0,0,2
16222,0,2,0,0,2
16223,0,2,0,0,2
16224,0,2,0,0,2
16225,0,2,0,0,2
16226,0,2,0,0,2
16227,0,2,0,0,2
16228,0,1,1,0,2
16229,0,2,0,0,2
16230,0,2,0,0,2
16231,0,2,0,0,2
16232,0,2,0,0,2
16233,1,1,0,0,2
16234,0,2,0,0,2
16235,0,2,0,0,2
16236,0,2,0,0,2
16237,0,1,1,0,2
16238,0,2,0,0,2
16239,0,2,0,0,2
16240,1,0,1,0,2
16241,0,2,0,0,2
16242,0,2,0,0,2
16243,0,2,0,0,2
16244,0,2,0,0,2
16245,1,1,0,0,2
16246,0,2,0,0,2
16247,0,2,0,0,2
16248,0,2,0,0,2
16249,0,2,0,0,2
16250,0,2,0,0,2
16251,1,1,0,0,2
16252,1,1,0,0,2
16253,0,2,0,0,2
16254,0,2,0,0,2
16255,0,2,0,0,2
16256,1,0,0,1,2
16257,0,2,0,0,2
16258,0,2,0,0,2
16259,0,2,0,0,2
16260,0,2,0,0,2
16261,0,2,0,0,2
16262,2,0,0,0,2
16263,0,2,0,0,2
16264,0,2,0,0,2
16265,1,0,1,0,2
16266,0,2,0,0,2
16267,1,0,0,1,2
16268,0,2,0,0,2
16269,0,2,0,0,2
16270,0,2,0,0,2
16271,0,2,0,0,2
16272,0,2,0,0,2
16273,0,2,0,0,2
16274,0,2,0,0,2
16275,0,2,0,0,2
16276,0,2,0,0,2
16277,0,2,0,0,2
16278,0,0,0,2,2
16279,0,2,0,0,2
16280,2,0,0,0,2
16281,0,2,0,0,2
16282,0,2,0,0,2
16283,0,2,0,0,2
16284,0,2,0,0,2
16285,0,2,0,0,2
16286,0,2,0,0,2
16287,0,2,0,0,2
16288,0,2,0,0,2
16289,1,1,0,0,2
16290,2,0,0,0,2
16291,0,2,0,0,2
16292,0,1,0,1,2
16293,0,2,0,0,2
16294,0,2,0,0,2
16295,0,2,0,0,2
16296,0,2,0,0,2
16297,1,1,0,0,2
16298,0,2,0,0,2
16299,0,2,0,0,2
16300,0,2,0,0,2
16301,0,1,1,0,2
16302,0,2,0,0,2
16303,0,0,2,0,2
16304,1,1,0,0,2
16305,1,1,0,0,2
16306,2,0,0,0,2
16307,0,2,0,0,2
16308,0,1,0,1,2
16309,0,2,0,0,2
16310,0,2,0,0,2
16311,2,0,0,0,2
16312,0,2,0,0,2
16313,0,2,0,0,2
16314,0,2,0,0,2
16315,0,2,0,0,2
16316,0,2,0,0,2
16317,0,2,0,0,2
16318,0,2,0,0,2
16319,0,2,0,0,2
16320,0,2,0,0,2
16321,0,1,1,0,2
16322,0,2,0,0,2
16323,2,0,0,0,2
16324,0,0,1,1,2
16325,0,2,0,0,2
16326,0,2,0,0,2
16327,0,2,0,0,2
16328,0,2,0,0,2
16329,0,2,0,0,2
16330,0,2,0,0,2
16331,2,0,0,0,2
16332,0,2,0,0,2
16333,1,1,0,0,2
16334,0,2,0,0,2
16335,0,2,0,0,2
16336,0,2,0,0,2
16337,1,0,0,1,2
16338,0,2,0,0,2
16339,0,2,0,0,2
16340,1,0,1,0,2
16341,0,2,0,0,2
16342,0,2,0,0,2
16343,0,2,0,0,2
16344,1,1,0,0,2
16345,0,2,0,0,2
16346,0,2,0,0,2
16347,0,2,0,0,2
16348,0,1,1,0,2
16349,0,2,0,0,2
16350,0,2,0,0,2
16351,0,2,0,0,2
16352,0,2,0,0,2
16353,0,2,0,0,2
16354,0,1,0,1,2
16355,0,2,0,0,2
16356,0,2,0,0,2
16357,0,1,1,0,2
16358,0,2,0,0,2
16359,1,0,1,0,2
16360,1,1,0,0,2
16361,2,0,0,0,2
16362,2,0,0,0,2
16363,0,0,2,0,2
16364,1,1,0,0,2
16365,0,2,0,0,2
16366,0,2,0,0,2
16367,2,0,0,0,2
16368,0,2,0,0,2
16369,2,0,0,0,2
16370,0,2,0,0,2
16371,1,1,0,0,2
16372,0,2,0,0,2
16373,2,0,0,0,2
16374,0,2,0,0,2
16375,0,2,0,0,2
16376,0,2,0,0,2
16377,0,2,0,0,2
16378,0,2,0,0,2
16379,0,2,0,0,2
16380,2,0,0,0,2
16381,0,2,0,0,2
16382,0,2,0,0,2
16383,0,2,0,0,2
16384,0,2,0,0,2
16385,0,0,0,2,2
16386,0,2,0,0,2
16387,0,2,0,0,2
16388,0,2,0,0,2
16389,0,2,0,0,2
16390,1,1,0,0,2
16391,0,1,0,1,2
16392,0,2,0,0,2
16393,0,2,0,0,2
16394,1,0,0,1,2
16395,0,2,0,0,2
16396,0,2,0,0,2
16397,0,2,0,0,2
16398,0,1,1,0,2
16399,2,0,0,0,2
16400,0,2,0,0,2
16401,0,2,0,0,2
16402,0,2,0,0,2
16403,0,2,0,0,2
16404,1,1,0,0,2
16405,0,2,0,0,2
16406,1,0,1,0,2
16407,0,2,0,0,2
16408,0,2,0,0,2
16409,0,2,0,0,2
16410,0,2,0,0,2
16411,2,0,0,0,2
16412,2,0,0,0,2
16413,2,0,0,0,2
16414,0,1,1,0,2
16415,1,1,0,0,2
16416,0,2,0,0,2
16417,0,2,0,0,2
16418,0,2,0,0,2
16419,0,2,0,0,2
16420,0,2,0,0,2
16421,1,1,0,0,2
16422,1,1,0,0,2
16423,0,2,0,0,2
16424,0,2,0,0,2
16425,0,2,0,0,2
16426,1,1,0,0,2
16427,0,2,0,0,2
16428,0,2,0,0,2
16429,2,0,0,0,2
16430,0,2,0,0,2
16431,2,0,0,0,2
16432,0,2,0,0,2
16433,0,2,0,0,2
16434,1,0,0,1,2
16435,2,0,0,0,2
16436,1,1,0,0,2
16437,0,2,0,0,2
16438,0,1,1,0,2
16439,0,0,0,2,2
16440,1,1,0,0,2
16441,0,2,0,0,2
16442,0,2,0,0,2
16443,0,2,0,0,2
16444,2,0,0,0,2
16445,0,2,0,0,2
16446,0,2,0,0,2
16447,0,2,0,0,2
16448,1,0,1,0,2
16449,2,0,0,0,2
16450,0,1,0,1,2
16451,0,2,0,0,2
16452,1,1,0,0,2
16453,0,2,0,0,2
16454,0,2,0,0,2
16455,0,0,0,2,2
16456,0,2,0,0,2
16457,1,0,1,0,2
16458,0,0,1,1,2
16459,0,2,0,0,2
16460,0,2,0,0,2
16461,2,0,0,0,2
16462,0,2,0,0,2
16463,0,2,0,0,2
16464,2,0,0,0,2
16465,0,2,0,0,2
16466,0,2,0,0,2
16467,0,2,0,0,2
16468,0,2,0,0,2
16469,0,2,0,0,2
16470,0,0,0,2,2
16471,0,2,0,0,2
16472,0,0,0,2,2
16473,1,0,0,1,2
16474,0,2,0,0,2
16475,0,2,0,0,2
16476,0,2,0,0,2
16477,1,1,0,0,2
16478,0,2,0,0,2
16479,0,2,0,0,2
16480,0,2,0,0,2
16481,0,2,0,0,2
16482,0,2,0,0,2
16483,0,2,0,0,2
16484,0,2,0,0,2
16485,0,1,0,1,2
16486,0,2,0,0,2
16487,0,2,0,0,2
16488,2,0,0,0,2
16489,0,2,0,0,2
16490,2,0,0,0,2
16491,0,2,0,0,2
16492,0,2,0,0,2
16493,0,2,0,0,2
16494,1,1,0,0,2
16495,1,1,0,0,2
16496,0,2,0,0,2
16497,0,2,0,0,2
16498,2,0,0,0,2
16499,0,2,0,0,2
16500,0,0,2,0,2
16501,1,1,0,0,2
16502,1,0,1,0,2
16503,2,0,0,0,2
16504,1,1,0,0,2
16505,0,0,0,2,2
16506,1,0,0,1,2
16507,0,2,0,0,2
16508,1,1,0,0,2
16509,0,2,0,0,2
16510,0,2,0,0,2
16511,2,0,0,0,2
16512,0,2,0,0,2
16513,1,0,1,0,2
16514,0,2,0,0,2
16515,2,0,0,0,2
16516,1,0,1,0,2
16517,0,2,0,0,2
16518,1,0,1,0,2
16519,0,2,0,0,2
16520,0,2,0,0,2
16521,0,2,0,0,2
16522,2,0,0,0,2
16523,0,2,0,0,2
16524,1,1,0,0,2
16525,0,2,0,0,2
16526,0,2,0,0,2
16527,2,0,0,0,2
16528,0,2,0,0,2
16529,0,2,0,0,2
16530,0,2,0,0,2
16531,0,2,0,0,2
16532,0,2,0,0,2
16533,0,2,0,0,2
16534,0,2,0,0,2
16535,2,0,0,0,2
16536,0,2,0,0,2
16537,0,2,0,0,2
16538,1,0,0,1,2
16539,0,2,0,0,2
16540,0,2,0,0,2
16541,0,2,0,0,2
16542,0,2,0,0,2
16543,1,0,1,0,2
16544,0,2,0,0,2
16545,0,2,0,0,2
16546,2,0,0,0,2
16547,0,2,0,0,2
16548,0,2,0,0,2
16549,1,0,0,1,2
16550,0,2,0,0,2
16551,0,2,0,0,2
16552,0,2,0,0,2
16553,0,2,0,0,2
16554,0,2,0,0,2
16555,0,2,0,0,2
16556,1,0,1,0,2
16557,0,2,0,0,2
16558,0,2,0,0,2
16559,2,0,0,0,2
16560,0,2,0,0,2
16561,0,2,0,0,2
16562,0,2,0,0,2
16563,0,2,0,0,2
16564,0,2,0,0,2
16565,2,0,0,0,2
16566,2,0,0,0,2
16567,0,2,0,0,2
16568,0,2,0,0,2
16569,0,2,0,0,2
16570,0,2,0,0,2
16571,1,1,0,0,2
16572,0,2,0,0,2
16573,0,2,0,0,2
16574,0,2,0,0,2
16575,1,1,0,0,2
16576,0,2,0,0,2
16577,0,2,0,0,2
16578,1,1,0,0,2
16579,0,2,0,0,2
16580,0,2,0,0,2
16581,0,2,0,0,2
16582,0,2,0,0,2
16583,0,2,0,0,2
16584,2,0,0,0,2
16585,0,2,0,0,2
16586,0,2,0,0,2
16587,0,2,0,0,2
16588,0,2,0,0,2
16589,0,2,0,0,2
16590,0,2,0,0,2
16591,0,2,0,0,2
16592,0,2,0,0,2
16593,2,0,0,0,2
16594,1,1,0,0,2
16595,0,1,0,1,2
16596,2,0,0,0,2
16597,0,2,0,0,2
16598,0,2,0,0,2
16599,0,2,0,0,2
16600,0,2,0,0,2
16601,0,2,0,0,2
16602,0,2,0,0,2
16603,0,2,0,0,2
16604,2,0,0,0,2
16605,0,2,0,0,2
16606,2,0,0,0,2
16607,0,2,0,0,2
16608,2,0,0,0,2
16609,1,1,0,0,2
16610,0,2,0,0,2
16611,2,0,0,0,2
16612,2,0,0,0,2
16613,0,2,0,0,2
16614,0,1,0,1,2
16615,0,2,0,0,2
16616,0,2,0,0,2
16617,1,1,0,0,2
16618,1,0,1,0,2
16619,2,0,0,0,2
16620,0,2,0,0,2
16621,0,2,0,0,2
16622,0,2,0,0,2
16623,0,2,0,0,2
16624,0,2,0,0,2
16625,2,0,0,0,2
16626,0,2,0,0,2
16627,0,2,0,0,2
16628,0,2,0,0,2
16629,0,2,0,0,2
16630,0,0,0,2,2
16631,0,2,0,0,2
16632,2,0,0,0,2
16633,2,0,0,0,2
16634,1,1,0,0,2
16635,0,2,0,0,2
16636,2,0,0,0,2
16637,2,0,0,0,2
16638,1,0,1,0,2
16639,0,2,0,0,2
16640,0,2,0,0,2
16641,0,2,0,0,2
16642,0,2,0,0,2
16643,1,1,0,0,2
16644,0,2,0,0,2
16645,1,1,0,0,2
16646,0,2,0,0,2
16647,0,2,0,0,2
16648,1,0,1,0,2
16649,0,2,0,0,2
16650,0,2,0,0,2
16651,0,2,0,0,2
16652,0,2,0,0,2
16653,0,2,0,0,2
16654,0,2,0,0,2
16655,2,0,0,0,2
16656,0,2,0,0,2
16657,0,2,0,0,2
16658,0,2,0,0,2
16659,0,2,0,0,2
16660,0,2,0,0,2
16661,0,2,0,0,2
16662,0,2,0,0,2
16663,0,2,0,0,2
16664,0,2,0,0,2
16665,0,2,0,0,2
16666,0,2,0,0,2
16667,0,1,0,1,2
16668,0,2,0,0,2
16669,0,2,0,0,2
16670,0,2,0,0,2
16671,0,2,0,0,2
16672,0,1,1,0,2
16673,0,2,0,0,2
16674,2,0,0,0,2
16675,0,2,0,0,2
16676,0,2,0,0,2
16677,1,1,0,0,2
16678,0,2,0,0,2
16679,0,2,0,0,2
16680,0,2,0,0,2
16681,0,2,0,0,2
16682,0,2,0,0,2
16683,1,0,1,0,2
16684,0,2,0,0,2
16685,0,2,0,0,2
16686,0,2,0,0,2
16687,0,2,0,0,2
16688,0,2,0,0,2
16689,2,0,0,0,2
16690,0,2,0,0,2
16691,0,2,0,0,2
16692,0,2,0,0,2
16693,0,2,0,0,2
16694,0,2,0,0,2
16695,0,2,0,0,2
16696,0,2,0,0,2
16697,0,2,0,0,2
16698,0,2,0,0,2
16699,0,2,0,0,2
16700,0,2,0,0,2
16701,0,2,0,0,2
16702,0,2,0,0,2
16703,0,2,0,0,2
16704,0,2,0,0,2
16705,0,2,0,0,2
16706,0,2,0,0,2
16707,1,1,0,0,2
16708,0,2,0,0,2
16709,0,2,0,0,2
16710,0,2,0,0,2
16711,0,2,0,0,2
16712,0,2,0,0,2
16713,0,2,0,0,2
16714,0,2,0,0,2
16715,0,2,0,0,2
16716,2,0,0,0,2
16717,0,2,0,0,2
16718,1,1,0,0,2
16719,2,0,0,0,2
16720,0,2,0,0,2
16721,2,0,0,0,2
16722,0,2,0,0,2
16723,0,2,0,0,2
16724,1,0,1,0,2
16725,0,2,0,0,2
16726,1,1,0,0,2
16727,0,2,0,0,2
16728,0,2,0,0,2
16729,0,2,0,0,2
16730,1,1,0,0,2
16731,0,2,0,0,2
16732,0,2,0,0,2
16733,1,0,1,0,2
16734,0,2,0,0,2
16735,0,2,0,0,2
16736,2,0,0,0,2
16737,2,0,0,0,2
16738,0,2,0,0,2
16739,0,2,0,0,2
16740,0,2,0,0,2
16741,0,2,0,0,2
16742,0,2,0,0,2
16743,0,2,0,0,2
16744,0,2,0,0,2
16745,0,2,0,0,2
16746,0,2,0,0,2
16747,0,2,0,0,2
16748,0,2,0,0,2
16749,0,2,0,0,2
16750,2,0,0,0,2
16751,0,2,0,0,2
16752,0,2,0,0,2
16753,0,2,0,0,2
16754,0,2,0,0,2
16755,0,2,0,0,2
16756,0,2,0,0,2
16757,0,2,0,0,2
16758,0,2,0,0,2
16759,0,2,0,0,2
16760,0,2,0,0,2
16761,0,2,0,0,2
16762,0,2,0,0,2
16763,0,2,0,0,2
16764,0,2,0,0,2
16765,0,2,0,0,2
16766,0,2,0,0,2
16767,0,2,0,0,2
16768,0,2,0,0,2
16769,0,2,0,0,2
16770,0,2,0,0,2
16771,0,2,0,0,2
16772,0,2,0,0,2
16773,0,2,0,0,2
16774,0,2,0,0,2
16775,0,2,0,0,2
16776,1,1,0,0,2
16777,1,0,1,0,2
16778,0,2,0,0,2
16779,2,0,0,0,2
16780,1,1,0,0,2
16781,1,1,0,0,2
16782,0,2,0,0,2
16783,0,2,0,0,2
16784,0,2,0,0,2
16785,0,2,0,0,2
16786,0,2,0,0,2
16787,1,0,0,1,2
16788,0,0,0,2,2
16789,0,1,1,0,2
16790,0,0,0,2,2
16791,0,2,0,0,2
16792,0,1,1,0,2
16793,0,2,0,0,2
16794,0,2,0,0,2
16795,0,0,0,2,2
16796,0,2,0,0,2
16797,2,0,0,0,2
16798,0,0,0,2,2
16799,1,1,0,0,2
16800,0,2,0,0,2
16801,0,2,0,0,2
16802,0,2,0,0,2
16803,0,2,0,0,2
16804,0,2,0,0,2
16805,2,0,0,0,2
16806,0,2,0,0,2
16807,0,2,0,0,2
16808,0,0,0,2,2
16809,0,2,0,0,2
16810,0,0,0,2,2
16811,0,2,0,0,2
16812,0,2,0,0,2
16813,0,2,0,0,2
16814,0,2,0,0,2
16815,2,0,0,0,2
16816,0,2,0,0,2
16817,0,2,0,0,2
16818,0,2,0,0,2
16819,1,1,0,0,2
16820,0,2,0,0,2
16821,0,2,0,0,2
16822,2,0,0,0,2
16823,0,2,0,0,2
16824,0,2,0,0,2
16825,0,2,0,0,2
16826,0,0,2,0,2
16827,0,2,0,0,2
16828,0,2,0,0,2
16829,0,2,0,0,2
16830,0,1,0,1,2
16831,0,2,0,0,2
16832,1,1,0,0,2
16833,1,1,0,0,2
16834,0,2,0,0,2
16835,0,2,0,0,2
16836,1,1,0,0,2
16837,0,2,0,0,2
16838,0,2,0,0,2
16839,2,0,0,0,2
16840,0,2,0,0,2
16841,0,2,0,0,2
16842,0,2,0,0,2
16843,1,1,0,0,2
16844,1,1,0,0,2
16845,0,0,0,2,2
16846,0,1,0,1,2
16847,0,2,0,0,2
16848,0,2,0,0,2
16849,0,2,0,0,2
16850,0,2,0,0,2
16851,0,2,0,0,2
16852,1,1,0,0,2
16853,0,2,0,0,2
16854,0,2,0,0,2
16855,0,2,0,0,2
16856,1,0,1,0,2
16857,0,2,0,0,2
16858,0,2,0,0,2
16859,0,2,0,0,2
16860,0,2,0,0,2
16861,0,2,0,0,2
16862,0,2,0,0,2
16863,0,2,0,0,2
16864,0,2,0,0,2
16865,0,0,2,0,2
16866,0,2,0,0,2
16867,0,2,0,0,2
16868,0,2,0,0,2
16869,0,0,0,2,2
16870,0,2,0,0,2
16871,1,1,0,0,2
16872,0,2,0,0,2
16873,0,2,0,0,2
16874,0,2,0,0,2
16875,2,0,0,0,2
16876,1,0,0,1,2
16877,0,2,0,0,2
16878,0,2,0,0,2
16879,1,1,0,0,2
16880,2,0,0,0,2
16881,0,2,0,0,2
16882,0,2,0,0,2
16883,0,2,0,0,2
16884,0,2,0,0,2
16885,0,0,1,1,2
16886,1,0,1,0,2
16887,0,2,0,0,2
16888,0,1,0,1,2
16889,0,2,0,0,2
16890,0,2,0,0,2
16891,0,2,0,0,2
16892,0,2,0,0,2
16893,0,2,0,0,2
16894,1,1,0,0,2
16895,0,2,0,0,2
16896,0,2,0,0,2
16897,1,0,0,1,2
16898,0,2,0,0,2
16899,0,2,0,0,2
16900,0,0,0,2,2
16901,0,2,0,0,2
16902,0,2,0,0,2
16903,0,2,0,0,2
16904,0,2,0,0,2
16905,1,1,0,0,2
16906,0,2,0,0,2
16907,0,2,0,0,2
16908,0,2,0,0,2
16909,0,2,0,0,2
16910,0,2,0,0,2
16911,0,2,0,0,2
16912,0,2,0,0,2
16913,0,2,0,0,2
16914,1,0,0,1,2
16915,0,2,0,0,2
16916,0,2,0,0,2
16917,0,2,0,0,2
16918,0,2,0,0,2
16919,0,2,0,0,2
16920,0,2,0,0,2
16921,0,2,0,0,2
16922,0,2,0,0,2
16923,0,2,0,0,2
16924,0,2,0,0,2
16925,1,0,0,1,2
16926,0,2,0,0,2
16927,1,1,0,0,2
16928,1,0,1,0,2
16929,0,2,0,0,2
16930,1,0,0,1,2
16931,1,0,0,1,2
16932,0,2,0,0,2
16933,1,1,0,0,2
16934,0,2,0,0,2
16935,0,2,0,0,2
16936,0,2,0,0,2
16937,0,2,0,0,2
16938,2,0,0,0,2
16939,0,2,0,0,2
16940,0,2,0,0,2
16941,0,2,0,0,2
16942,0,1,0,1,2
16943,0,2,0,0,2
16944,1,0,0,1,2
16945,0,2,0,0,2
16946,0,2,0,0,2
16947,0,2,0,0,2
16948,0,2,0,0,2
16949,0,2,0,0,2
16950,0,0,0,2,2
16951,1,0,0,1,2
16952,0,2,0,0,2
16953,2,0,0,0,2
16954,1,0,0,1,2
16955,0,2,0,0,2
16956,0,2,0,0,2
16957,2,0,0,0,2
16958,1,0,0,1,2
16959,0,2,0,0,2
16960,1,1,0,0,2
16961,0,2,0,0,2
16962,0,2,0,0,2
16963,0,2,0,0,2
16964,0,2,0,0,2
16965,1,0,0,1,2
16966,0,2,0,0,2
16967,2,0,0,0,2
16968,0,2,0,0,2
16969,0,1,0,1,2
16970,1,1,0,0,2
16971,0,2,0,0,2
16972,1,0,0,1,2
16973,0,2,0,0,2
16974,0,2,0,0,2
16975,0,2,0,0,2
16976,0,2,0,0,2
16977,0,2,0,0,2
16978,0,2,0,0,2
16979,1,1,0,0,2
16980,0,2,0,0,2
16981,0,2,0,0,2
16982,0,2,0,0,2
16983,0,2,0,0,2
16984,0,1,1,0,2
16985,0,2,0,0,2
16986,0,2,0,0,2
16987,0,2,0,0,2
16988,0,2,0,0,2
16989,1,1,0,0,2
16990,0,2,0,0,2
16991,1,0,0,1,2
16992,0,2,0,0,2
16993,0,2,0,0,2
16994,0,2,0,0,2
16995,1,0,1,0,2
16996,0,1,0,1,2
16997,0,0,0,2,2
16998,0,2,0,0,2
16999,0,2,0,0,2
17000,0,2,0,0,2
17001,0,2,0,0,2
17002,0,2,0,0,2
17003,0,2,0,0,2
17004,0,2,0,0,2
17005,1,0,0,1,2
17006,2,0,0,0,2
17007,0,2,0,0,2
17008,0,2,0,0,2
17009,2,0,0,0,2
17010,1,1,0,0,2
17011,0,2,0,0,2
17012,0,0,0,2,2
17013,0,2,0,0,2
17014,0,2,0,0,2
17015,1,1,0,0,2
17016,0,2,0,0,2
17017,1,0,0,1,2
17018,0,2,0,0,2
17019,0,2,0,0,2
17020,0,2,0,0,2
17021,2,0,0,0,2
17022,0,2,0,0,2
17023,0,2,0,0,2
17024,0,2,0,0,2
17025,0,2,0,0,2
17026,0,2,0,0,2
17027,0,2,0,0,2
17028,2,0,0,0,2
17029,0,2,0,0,2
17030,0,2,0,0,2
17031,0,2,0,0,2
17032,0,0,0,2,2
17033,0,2,0,0,2
17034,0,2,0,0,2
17035,2,0,0,0,2
17036,1,1,0,0,2
17037,0,1,0,1,2
17038,2,0,0,0,2
17039,0,2,0,0,2
17040,0,2,0,0,2
17041,0,2,0,0,2
17042,0,2,0,0,2
17043,0,2,0,0,2
17044,0,2,0,0,2
17045,1,1,0,0,2
17046,0,2,0,0,2
17047,0,2,0,0,2
17048,0,2,0,0,2
17049,0,2,0,0,2
17050,0,2,0,0,2
17051,1,1,0,0,2
17052,0,1,0,1,2
17053,2,0,0,0,2
17054,0,2,0,0,2
17055,0,2,0,0,2
17056,0,2,0,0,2
17057,1,1,0,0,2
17058,0,2,0,0,2
17059,0,2,0,0,2
17060,0,2,0,0,2
17061,0,2,0,0,2
17062,0,2,0,0,2
17063,0,2,0,0,2
17064,0,2,0,0,2
17065,0,2,0,0,2
17066,0,2,0,0,2
17067,0,2,0,0,2
17068,0,2,0,0,2
17069,1,1,0,0,2
17070,0,2,0,0,2
17071,0,2,0,0,2
17072,0,2,0,0,2
17073,1,1,0,0,2
17074,1,0,0,1,2
17075,1,1,0,0,2
17076,1,0,1,0,2
17077,0,2,0,0,2
17078,0,2,0,0,2
17079,0,0,2,0,2
17080,0,2,0,0,2
17081,0,2,0,0,2
17082,2,0,0,0,2
17083,1,1,0,0,2
17084,0,2,0,0,2
17085,0,2,0,0,2
17086,2,0,0,0,2
17087,0,2,0,0,2
17088,0,2,0,0,2
17089,0,2,0,0,2
17090,0,2,0,0,2
17091,0,2,0,0,2
17092,0,2,0,0,2
17093,1,1,0,0,2
17094,0,2,0,0,2
17095,0,2,0,0,2
17096,0,2,0,0,2
17097,2,0,0,0,2
17098,0,2,0,0,2
17099,2,0,0,0,2
17100,0,2,0,0,2
17101,0,2,0,0,2
17102,0,2,0,0,2
17103,1,1,0,0,2
17104,0,2,0,0,2
17105,1,1,0,0,2
17106,0,2,0,0,2
17107,0,1,1,0,2
17108,0,2,0,0,2
17109,0,2,0,0,2
17110,0,2,0,0,2
17111,1,0,0,1,2
17112,0,1,0,1,2
17113,2,0,0,0,2
17114,0,2,0,0,2
17115,0,2,0,0,2
17116,0,0,0,2,2
17117,1,1,0,0,2
17118,0,2,0,0,2
17119,0,2,0,0,2
17120,2,0,0,0,2
17121,0,2,0,0,2
17122,0,2,0,0,2
17123,2,0,0,0,2
17124,0,2,0,0,2
17125,0,2,0,0,2
17126,0,2,0,0,2
17127,2,0,0,0,2
17128,2,0,0,0,2
17129,0,2,0,0,2
17130,0,2,0,0,2
17131,1,1,0,0,2
17132,0,0,1,1,2
17133,0,2,0,0,2
17134,0,2,0,0,2
17135,0,2,0,0,2
17136,0,1,0,1,2
17137,0,2,0,0,2
17138,1,1,0,0,2
17139,0,2,0,0,2
17140,0,2,0,0,2
17141,0,2,0,0,2
17142,0,2,0,0,2
17143,0,2,0,0,2
17144,0,2,0,0,2
17145,0,2,0,0,2
17146,0,2,0,0,2
17147,0,2,0,0,2
17148,0,2,0,0,2
17149,0,2,0,0,2
17150,0,2,0,0,2
17151,0,2,0,0,2
17152,0,2,0,0,2
17153,0,2,0,0,2
17154,0,0,2,0,2
17155,0,2,0,0,2
17156,0,1,0,1,2
17157,1,1,0,0,2
17158,0,2,0,0,2
17159,1,1,0,0,2
17160,0,2,0,0,2
17161,0,2,0,0,2
17162,1,1,0,0,2
17163,1,1,0,0,2
17164,2,0,0,0,2
17165,0,2,0,0,2
17166,2,0,0,0,2
17167,0,2,0,0,2
17168,0,2,0,0,2
17169,0,2,0,0,2
17170,0,2,0,0,2
17171,0,2,0,0,2
17172,0,2,0,0,2
17173,0,2,0,0,2
17174,0,2,0,0,2
17175,0,0,0,2,2
17176,0,1,0,1,2
17177,0,2,0,0,2
17178,0,2,0,0,2
17179,0,2,0,0,2
17180,1,0,0,1,2
17181,0,2,0,0,2
17182,0,2,0,0,2
17183,0,2,0,0,2
17184,0,2,0,0,2
17185,0,2,0,0,2
17186,1,0,0,1,2
17187,0,2,0,0,2
17188,0,2,0,0,2
17189,1,1,0,0,2
17190,1,0,0,1,2
17191,2,0,0,0,2
17192,0,2,0,0,2
17193,0,2,0,0,2
17194,1,1,0,0,2
17195,0,1,1,0,2
17196,2,0,0,0,2
17197,0,2,0,0,2
17198,0,2,0,0,2
17199,0,2,0,0,2
17200,2,0,0,0,2
17201,0,2,0,0,2
17202,2,0,0,0,2
17203,0,2,0,0,2
17204,0,2,0,0,2
17205,0,2,0,0,2
17206,0,2,0,0,2
17207,0,2,0,0,2
17208,0,2,0,0,2
17209,0,2,0,0,2
17210,1,1,0,0,2
17211,0,2,0,0,2
17212,0,2,0,0,2
17213,0,0,1,1,2
17214,0,2,0,0,2
17215,0,2,0,0,2
17216,0,2,0,0,2
17217,0,2,0,0,2
17218,0,2,0,0,2
17219,0,2,0,0,2
17220,0,2,0,0,2
17221,0,2,0,0,2
17222,0,2,0,0,2
17223,0,2,0,0,2
17224,0,2,0,0,2
17225,0,2,0,0,2
17226,0,2,0,0,2
17227,0,2,0,0,2
17228,0,2,0,0,2
17229,0,2,0,0,2
17230,0,2,0,0,2
17231,0,2,0,0,2
17232,0,2,0,0,2
17233,0,2,0,0,2
17234,2,0,0,0,2
17235,0,1,0,1,2
17236,0,2,0,0,2
17237,0,2,0,0,2
17238,0,2,0,0,2
17239,2,0,0,0,2
17240,0,2,0,0,2
17241,0,2,0,0,2
17242,0,2,0,0,2
17243,2,0,0,0,2
17244,0,2,0,0,2
17245,2,0,0,0,2
17246,0,2,0,0,2
17247,0,1,1,0,2
17248,0,2,0,0,2
17249,0,2,0,0,2
17250,0,2,0,0,2
17251,2,0,0,0,2
17252,0,2,0,0,2
17253,0,2,0,0,2
17254,0,2,0,0,2
17255,0,2,0,0,2
17256,0,2,0,0,2
17257,0,2,0,0,2
17258,0,2,0,0,2
17259,0,2,0,0,2
17260,0,2,0,0,2
17261,0,1,1,0,2
17262,0,2,0,0,2
17263,0,2,0,0,2
17264,1,1,0,0,2
17265,0,2,0,0,2
17266,0,2,0,0,2
17267,0,0,0,2,2
17268,0,2,0,0,2
17269,0,2,0,0,2
17270,1,0,0,1,2
17271,0,2,0,0,2
17272,0,2,0,0,2
17273,2,0,0,0,2
17274,0,2,0,0,2
17275,1,1,0,0,2
17276,0,2,0,0,2
17277,0,2,0,0,2
17278,1,1,0,0,2
17279,0,2,0,0,2
17280,1,1,0,0,2
17281,0,2,0,0,2
17282,0,2,0,0,2
17283,0,0,1,1,2
17284,0,2,0,0,2
17285,0,2,0,0,2
17286,0,2,0,0,2
17287,2,0,0,0,2
17288,0,2,0,0,2
17289,0,2,0,0,2
17290,0,2,0,0,2
17291,0,1,1,0,2
17292,0,2,0,0,2
17293,0,2,0,0,2
17294,1,1,0,0,2
17295,0,2,0,0,2
17296,0,2,0,0,2
17297,1,1,0,0,2
17298,0,2,0,0,2
17299,1,1,0,0,2
17300,1,1,0,0,2
17301,1,1,0,0,2
17302,0,2,0,0,2
17303,2,0,0,0,2
17304,2,0,0,0,2
17305,0,2,0,0,2
17306,0,2,0,0,2
17307,0,2,0,0,2
17308,0,2,0,0,2
17309,1,1,0,0,2
17310,0,2,0,0,2
17311,0,2,0,0,2
17312,0,1,1,0,2
17313,0,2,0,0,2
17314,0,2,0,0,2
17315,0,2,0,0,2
17316,0,2,0,0,2
17317,0,0,1,1,2
17318,0,1,0,1,2
17319,1,0,1,0,2
17320,0,2,0,0,2
17321,0,2,0,0,2
17322,1,1,0,0,2
17323,0,2,0,0,2
17324,1,1,0,0,2
17325,0,2,0,0,2
17326,0,2,0,0,2
17327,0,2,0,0,2
17328,0,2,0,0,2
17329,1,0,0,1,2
17330,0,2,0,0,2
17331,0,2,0,0,2
17332,1,1,0,0,2
17333,0,2,0,0,2
17334,0,2,0,0,2
17335,0,2,0,0,2
17336,0,2,0,0,2
17337,2,0,0,0,2
17338,0,2,0,0,2
17339,0,2,0,0,2
17340,0,2,0,0,2
17341,1,0,1,0,2
17342,0,2,0,0,2
17343,0,2,0,0,2
17344,1,0,1,0,2
17345,0,2,0,0,2
17346,2,0,0,0,2
17347,0,2,0,0,2
17348,0,2,0,0,2
17349,0,2,0,0,2
17350,1,1,0,0,2
17351,0,2,0,0,2
17352,1,1,0,0,2
17353,0,2,0,0,2
17354,0,2,0,0,2
17355,0,2,0,0,2
17356,1,0,0,1,2
17357,1,1,0,0,2
17358,0,2,0,0,2
17359,0,2,0,0,2
17360,0,2,0,0,2
17361,2,0,0,0,2
17362,0,2,0,0,2
17363,0,1,0,1,2
17364,0,2,0,0,2
17365,0,2,0,0,2
17366,0,2,0,0,2
17367,2,0,0,0,2
17368,0,2,0,0,2
17369,2,0,0,0,2
17370,0,2,0,0,2
17371,0,2,0,0,2
17372,0,2,0,0,2
17373,0,2,0,0,2
17374,0,2,0,0,2
17375,0,2,0,0,2
17376,0,2,0,0,2
17377,0,2,0,0,2
17378,0,2,0,0,2
17379,0,0,2,0,2
17380,0,2,0,0,2
17381,0,2,0,0,2
17382,1,0,1,0,2
17383,1,0,0,1,2
17384,0,2,0,0,2
17385,1,1,0,0,2
17386,0,2,0,0,2
17387,0,2,0,0,2
17388,0,2,0,0,2
17389,0,2,0,0,2
17390,0,2,0,0,2
17391,0,2,0,0,2
17392,0,2,0,0,2
17393,0,1,0,1,2
17394,1,0,0,1,2
17395,0,2,0,0,2
17396,0,2,0,0,2
17397,0,2,0,0,2
17398,1,1,0,0,2
17399,0,2,0,0,2
17400,0,2,0,0,2
17401,0,2,0,0,2
17402,0,2,0,0,2
17403,0,2,0,0,2
17404,0,2,0,0,2
17405,0,2,0,0,2
17406,1,1,0,0,2
17407,0,2,0,0,2
17408,0,2,0,0,2
17409,2,0,0,0,2
17410,0,2,0,0,2
17411,2,0,0,0,2
17412,0,2,0,0,2
17413,0,2,0,0,2
17414,0,2,0,0,2
17415,0,2,0,0,2
17416,1,1,0,0,2
17417,0,2,0,0,2
17418,0,2,0,0,2
17419,0,2,0,0,2
17420,1,1,0,0,2
17421,0,2,0,0,2
17422,0,2,0,0,2
17423,0,2,0,0,2
17424,0,2,0,0,2
17425,0,2,0,0,2
17426,0,2,0,0,2
17427,0,2,0,0,2
17428,0,2,0,0,2
17429,1,0,0,1,2
17430,0,2,0,0,2
17431,0,2,0,0,2
17432,0,2,0,0,2
17433,1,1,0,0,2
17434,1,1,0,0,2
17435,0,2,0,0,2
17436,0,2,0,0,2
17437,1,1,0,0,2
17438,0,2,0,0,2
17439,0,2,0,0,2
17440,1,1,0,0,2
17441,0,2,0,0,2
17442,1,0,0,1,2
17443,0,2,0,0,2
17444,2,0,0,0,2
17445,1,1,0,0,2
17446,0,2,0,0,2
17447,0,2,0,0,2
17448,2,0,0,0,2
17449,0,2,0,0,2
17450,0,2,0,0,2
17451,0,2,0,0,2
17452,0,0,0,2,2
17453,0,2,0,0,2
17454,0,2,0,0,2
17455,0,2,0,0,2
17456,0,2,0,0,2
17457,0,2,0,0,2
17458,0,2,0,0,2
17459,0,2,0,0,2
17460,0,2,0,0,2
17461,2,0,0,0,2
17462,0,2,0,0,2
17463,1,0,0,1,2
17464,0,2,0,0,2
17465,0,2,0,0,2
17466,0,2,0,0,2
17467,2,0,0,0,2
17468,2,0,0,0,2
17469,1,1,0,0,2
17470,0,2,0,0,2
17471,0,2,0,0,2
17472,0,2,0,0,2
17473,0,2,0,0,2
17474,0,0,1,1,2
17475,2,0,0,0,2
17476,0,0,1,1,2
17477,0,2,0,0,2
17478,0,2,0,0,2
17479,2,0,0,0,2
17480,0,2,0,0,2
17481,0,2,0,0,2
17482,0,2,0,0,2
17483,0,2,0,0,2
17484,0,2,0,0,2
17485,0,2,0,0,2
17486,0,2,0,0,2
17487,0,2,0,0,2
17488,1,0,0,1,2
17489,0,2,0,0,2
17490,0,2,0,0,2
17491,0,2,0,0,2
17492,0,2,0,0,2
17493,1,0,0,1,2
17494,1,1,0,0,2
17495,0,2,0,0,2
17496,2,0,0,0,2
17497,0,2,0,0,2
17498,1,1,0,0,2
17499,0,2,0,0,2
17500,2,0,0,0,2
17501,2,0,0,0,2
17502,0,2,0,0,2
17503,0,2,0,0,2
17504,0,2,0,0,2
17505,0,1,0,1,2
17506,0,2,0,0,2
17507,0,2,0,0,2
17508,0,2,0,0,2
17509,0,2,0,0,2
17510,0,2,0,0,2
17511,0,2,0,0,2
17512,0,2,0,0,2
17513,0,1,0,1,2
17514,0,2,0,0,2
17515,1,0,1,0,2
17516,0,1,0,1,2
17517,0,2,0,0,2
17518,0,2,0,0,2
17519,0,2,0,0,2
17520,0,2,0,0,2
17521,2,0,0,0,2
17522,0,2,0,0,2
17523,1,0,1,0,2
17524,0,2,0,0,2
17525,0,1,0,1,2
17526,0,2,0,0,2
17527,0,2,0,0,2
17528,0,0,0,2,2
17529,2,0,0,0,2
17530,0,2,0,0,2
17531,2,0,0,0,2
17532,2,0,0,0,2
17533,1,0,1,0,2
17534,2,0,0,0,2
17535,2,0,0,0,2
17536,0,1,0,1,2
17537,0,2,0,0,2
17538,0,2,0,0,2
17539,0,2,0,0,2
17540,0,2,0,0,2
17541,0,2,0,0,2
17542,0,2,0,0,2
17543,0,2,0,0,2
17544,0,2,0,0,2
17545,0,2,0,0,2
17546,0,2,0,0,2
17547,0,2,0,0,2
17548,0,2,0,0,2
17549,0,2,0,0,2
17550,0,2,0,0,2
17551,0,2,0,0,2
17552,0,2,0,0,2
17553,0,2,0,0,2
17554,0,2,0,0,2
17555,0,2,0,0,2
17556,1,0,0,1,2
17557,0,2,0,0,2
17558,0,1,0,1,2
17559,0,2,0,0,2
17560,0,2,0,0,2
17561,2,0,0,0,2
17562,0,2,0,0,2
17563,0,2,0,0,2
17564,1,1,0,0,2
17565,0,2,0,0,2
17566,2,0,0,0,2
17567,0,2,0,0,2
17568,1,0,1,0,2
17569,0,2,0,0,2
17570,0,2,0,0,2
17571,1,1,0,0,2
17572,0,2,0,0,2
17573,0,2,0,0,2
17574,0,2,0,0,2
17575,0,2,0,0,2
17576,1,1,0,0,2
17577,2,0,0,0,2
17578,0,0,1,1,2
17579,0,2,0,0,2
17580,1,1,0,0,2
17581,1,1,0,0,2
17582,0,2,0,0,2
17583,0,2,0,0,2
17584,0,2,0,0,2
17585,0,1,0,1,2
17586,0,2,0,0,2
17587,0,2,0,0,2
17588,0,2,0,0,2
17589,2,0,0,0,2
17590,0,2,0,0,2
17591,0,2,0,0,2
17592,0,2,0,0,2
17593,0,0,2,0,2
17594,1,0,0,1,2
17595,0,2,0,0,2
17596,0,2,0,0,2
17597,0,2,0,0,2
17598,0,2,0,0,2
17599,0,2,0,0,2
17600,0,2,0,0,2
17601,0,2,0,0,2
17602,0,2,0,0,2
17603,2,0,0,0,2
17604,1,0,0,1,2
17605,0,1,1,0,2
17606,1,1,0,0,2
17607,0,2,0,0,2
17608,0,1,1,0,2
17609,0,1,0,1,2
17610,0,2,0,0,2
17611,0,2,0,0,2
17612,1,1,0,0,2
17613,0,2,0,0,2
17614,0,2,0,0,2
17615,1,1,0,0,2
17616,0,2,0,0,2
17617,0,0,2,0,2
17618,0,2,0,0,2
17619,1,1,0,0,2
17620,0,2,0,0,2
17621,0,2,0,0,2
17622,0,2,0,0,2
17623,0,2,0,0,2
17624,0,2,0,0,2
17625,0,2,0,0,2
17626,1,1,0,0,2
17627,0,2,0,0,2
17628,1,1,0,0,2
17629,0,2,0,0,2
17630,0,2,0,0,2
17631,1,0,1,0,2
17632,0,2,0,0,2
17633,1,1,0,0,2
17634,0,2,0,0,2
17635,0,2,0,0,2
17636,0,2,0,0,2
17637,0,2,0,0,2
17638,0,2,0,0,2
17639,0,2,0,0,2
17640,0,2,0,0,2
17641,0,2,0,0,2
17642,0,2,0,0,2
17643,0,2,0,0,2
17644,2,0,0,0,2
17645,0,2,0,0,2
17646,0,0,0,2,2
17647,0,2,0,0,2
17648,0,2,0,0,2
17649,1,0,0,1,2
17650,1,1,0,0,2
17651,1,1,0,0,2
17652,0,2,0,0,2
17653,0,0,0,2,2
17654,0,2,0,0,2
17655,1,0,0,1,2
17656,1,1,0,0,2
17657,2,0,0,0,2
17658,0,2,0,0,2
17659,0,2,0,0,2
17660,0,2,0,0,2
17661,0,2,0,0,2
17662,0,0,2,0,2
17663,1,1,0,0,2
17664,0,2,0,0,2
17665,0,2,0,0,2
17666,0,2,0,0,2
17667,0,2,0,0,2
17668,0,2,0,0,2
17669,0,0,0,2,2
17670,0,2,0,0,2
17671,2,0,0,0,2
17672,0,2,0,0,2
17673,0,2,0,0,2
17674,0,2,0,0,2
17675,0,1,1,0,2
17676,0,2,0,0,2
17677,0,2,0,0,2
17678,0,2,0,0,2
17679,0,2,0,0,2
17680,0,2,0,0,2
17681,0,2,0,0,2
17682,1,1,0,0,2
17683,1,0,0,1,2
17684,0,2,0,0,2
17685,0,2,0,0,2
17686,0,2,0,0,2
17687,0,2,0,0,2
17688,0,2,0,0,2
17689,0,2,0,0,2
17690,0,2,0,0,2
17691,0,2,0,0,2
17692,0,2,0,0,2
17693,1,1,0,0,2
17694,0,2,0,0,2
17695,0,2,0,0,2
17696,0,2,0,0,2
17697,0,2,0,0,2
17698,0,2,0,0,2
17699,0,2,0,0,2
17700,2,0,0,0,2
17701,0,2,0,0,2
17702,0,2,0,0,2
17703,0,2,0,0,2
17704,0,0,2,0,2
17705,0,1,1,0,2
17706,0,2,0,0,2
17707,1,1,0,0,2
17708,1,1,0,0,2
17709,0,0,0,2,2
17710,0,2,0,0,2
17711,0,2,0,0,2
17712,2,0,0,0,2
17713,0,2,0,0,2
17714,0,2,0,0,2
17715,2,0,0,0,2
17716,0,2,0,0,2
17717,0,2,0,0,2
17718,2,0,0,0,2
17719,0,0,0,2,2
17720,1,1,0,0,2
17721,0,2,0,0,2
17722,0,2,0,0,2
17723,0,0,2,0,2
17724,0,2,0,0,2
17725,0,2,0,0,2
17726,0,2,0,0,2
17727,1,0,0,1,2
17728,0,2,0,0,2
17729,0,2,0,0,2
17730,0,2,0,0,2
17731,0,0,1,1,2
17732,0,2,0,0,2
17733,2,0,0,0,2
17734,1,1,0,0,2
17735,1,0,0,1,2
17736,0,2,0,0,2
17737,0,2,0,0,2
17738,0,2,0,0,2
17739,0,2,0,0,2
17740,2,0,0,0,2
17741,0,2,0,0,2
17742,1,1,0,0,2
17743,0,2,0,0,2
17744,0,1,1,0,2
17745,0,2,0,0,2
17746,0,2,0,0,2
17747,0,2,0,0,2
17748,0,2,0,0,2
17749,1,1,0,0,2
17750,0,2,0,0,2
17751,2,0,0,0,2
17752,0,2,0,0,2
17753,0,2,0,0,2
17754,0,2,0,0,2
17755,0,2,0,0,2
17756,0,1,0,1,2
17757,0,0,2,0,2
17758,0,2,0,0,2
17759,2,0,0,0,2
17760,1,0,0,1,2
17761,0,2,0,0,2
17762,0,0,2,0,2
17763,0,2,0,0,2
17764,1,1,0,0,2
17765,0,0,0,2,2
17766,0,1,1,0,2
17767,0,2,0,0,2
17768,0,2,0,0,2
17769,0,2,0,0,2
17770,1,1,0,0,2
17771,1,0,0,1,2
17772,1,1,0,0,2
17773,0,2,0,0,2
17774,0,2,0,0,2
17775,0,2,0,0,2
17776,0,2,0,0,2
17777,0,2,0,0,2
17778,0,2,0,0,2
17779,2,0,0,0,2
17780,0,2,0,0,2
17781,0,2,0,0,2
17782,0,2,0,0,2
17783,1,1,0,0,2
17784,0,2,0,0,2
17785,2,0,0,0,2
17786,0,2,0,0,2
17787,2,0,0,0,2
17788,0,2,0,0,2
17789,0,2,0,0,2
17790,0,2,0,0,2
17791,1,0,0,1,2
17792,1,0,1,0,2
17793,1,1,0,0,2
17794,0,2,0,0,2
17795,0,2,0,0,2
17796,0,2,0,0,2
17797,0,2,0,0,2
17798,2,0,0,0,2
17799,0,0,0,2,2
17800,0,2,0,0,2
17801,0,2,0,0,2
17802,0,2,0,0,2
17803,0,2,0,0,2
17804,0,0,2,0,2
17805,0,0,0,2,2
17806,0,2,0,0,2
17807,0,2,0,0,2
17808,2,0,0,0,2
17809,1,1,0,0,2
17810,0,2,0,0,2
17811,0,2,0,0,2
17812,0,2,0,0,2
17813,2,0,0,0,2
17814,0,2,0,0,2
17815,0,2,0,0,2
17816,0,1,0,1,2
17817,0,2,0,0,2
17818,0,2,0,0,2
17819,1,1,0,0,2
17820,0,2,0,0,2
17821,0,2,0,0,2
17822,2,0,0,0,2
17823,0,2,0,0,2
17824,0,2,0,0,2
17825,0,2,0,0,2
17826,0,2,0,0,2
17827,0,2,0,0,2
17828,1,1,0,0,2
17829,0,2,0,0,2
17830,0,0,0,2,2
17831,0,2,0,0,2
17832,2,0,0,0,2
17833,0,0,0,2,2
17834,0,2,0,0,2
17835,0,2,0,0,2
17836,0,2,0,0,2
17837,0,0,2,0,2
17838,1,1,0,0,2
17839,0,2,0,0,2
17840,0,2,0,0,2
17841,0,2,0,0,2
17842,1,1,0,0,2
17843,1,1,0,0,2
17844,0,2,0,0,2
17845,1,1,0,0,2
17846,2,0,0,0,2
17847,0,2,0,0,2
17848,0,2,0,0,2
17849,0,0,0,2,2
17850,0,2,0,0,2
17851,1,1,0,0,2
17852,0,2,0,0,2
17853,0,2,0,0,2
17854,0,2,0,0,2
17855,0,2,0,0,2
17856,2,0,0,0,2
17857,0,2,0,0,2
17858,0,2,0,0,2
17859,2,0,0,0,2
17860,1,0,1,0,2
17861,0,2,0,0,2
17862,0,2,0,0,2
17863,0,2,0,0,2
17864,0,1,0,1,2
17865,0,2,0,0,2
17866,0,2,0,0,2
17867,0,2,0,0,2
17868,1,1,0,0,2
17869,0,2,0,0,2
17870,0,2,0,0,2
17871,0,2,0,0,2
17872,0,2,0,0,2
17873,0,2,0,0,2
17874,1,0,0,1,2
17875,0,2,0,0,2
17876,1,1,0,0,2
17877,0,2,0,0,2
17878,0,1,0,1,2
17879,0,2,0,0,2
17880,0,2,0,0,2
17881,0,2,0,0,2
17882,2,0,0,0,2
17883,1,1,0,0,2
17884,1,1,0,0,2
17885,1,1,0,0,2
17886,2,0,0,0,2
17887,2,0,0,0,2
17888,0,0,0,2,2
17889,0,2,0,0,2
17890,0,2,0,0,2
17891,0,2,0,0,2
17892,0,2,0,0,2
17893,0,2,0,0,2
17894,0,2,0,0,2
17895,0,2,0,0,2
17896,1,1,0,0,2
17897,0,2,0,0,2
17898,2,0,0,0,2
17899,0,2,0,0,2
17900,0,2,0,0,2
17901,0,2,0,0,2
17902,0,2,0,0,2
17903,2,0,0,0,2
17904,0,2,0,0,2
17905,0,2,0,0,2
17906,0,2,0,0,2
17907,0,2,0,0,2
17908,0,2,0,0,2
17909,0,2,0,0,2
17910,0,2,0,0,2
17911,0,2,0,0,2
17912,0,2,0,0,2
17913,0,2,0,0,2
17914,0,2,0,0,2
17915,0,2,0,0,2
17916,0,2,0,0,2
17917,0,2,0,0,2
17918,2,0,0,0,2
17919,0,2,0,0,2
17920,0,2,0,0,2
17921,0,2,0,0,2
17922,0,2,0,0,2
17923,0,1,0,1,2
17924,0,2,0,0,2
17925,1,1,0,0,2
17926,0,2,0,0,2
17927,0,2,0,0,2
17928,0,2,0,0,2
17929,0,2,0,0,2
17930,2,0,0,0,2
17931,0,2,0,0,2
17932,0,2,0,0,2
17933,0,2,0,0,2
17934,0,2,0,0,2
17935,0,2,0,0,2
17936,0,2,0,0,2
17937,0,0,0,2,2
17938,0,1,0,1,2
17939,0,2,0,0,2
17940,0,2,0,0,2
17941,0,2,0,0,2
17942,0,2,0,0,2
17943,0,2,0,0,2
17944,0,2,0,0,2
17945,0,2,0,0,2
17946,0,2,0,0,2
17947,0,2,0,0,2
17948,0,2,0,0,2
17949,0,2,0,0,2
17950,0,1,1,0,2
17951,0,2,0,0,2
17952,0,2,0,0,2
17953,0,2,0,0,2
17954,0,2,0,0,2
17955,0,2,0,0,2
17956,0,2,0,0,2
17957,0,2,0,0,2
17958,0,2,0,0,2
17959,0,2,0,0,2
17960,0,1,1,0,2
17961,2,0,0,0,2
17962,0,2,0,0,2
17963,0,2,0,0,2
17964,0,2,0,0,2
17965,2,0,0,0,2
17966,0,2,0,0,2
17967,0,2,0,0,2
17968,0,2,0,0,2
17969,0,2,0,0,2
17970,1,1,0,0,2
17971,0,2,0,0,2
17972,0,2,0,0,2
17973,0,2,0,0,2
17974,0,2,0,0,2
17975,0,2,0,0,2
17976,0,2,0,0,2
17977,0,2,0,0,2
17978,0,2,0,0,2
17979,0,2,0,0,2
17980,0,2,0,0,2
17981,0,2,0,0,2
17982,0,2,0,0,2
17983,0,0,2,0,2
17984,0,2,0,0,2
17985,0,2,0,0,2
17986,0,0,1,1,2
17987,0,2,0,0,2
17988,0,2,0,0,2
17989,0,2,0,0,2
17990,1,1,0,0,2
17991,0,2,0,0,2
17992,2,0,0,0,2
17993,0,2,0,0,2
17994,0,2,0,0,2
17995,0,2,0,0,2
17996,0,2,0,0,2
17997,0,2,0,0,2
17998,0,1,1,0,2
17999,0,1,1,0,2
18000,0,2,0,0,2
18001,0,2,0,0,2
18002,0,1,1,0,2
18003,0,2,0,0,2
18004,0,2,0,0,2
18005,0,2,0,0,2
18006,0,2,0,0,2
18007,0,2,0,0,2
18008,2,0,0,0,2
18009,0,2,0,0,2
18010,0,2,0,0,2
18011,0,2,0,0,2
18012,0,2,0,0,2
18013,0,2,0,0,2
18014,1,0,0,1,2
18015,0,2,0,0,2
18016,0,2,0,0,2
18017,0,2,0,0,2
18018,0,2,0,0,2
18019,0,2,0,0,2
18020,0,2,0,0,2
18021,0,2,0,0,2
18022,0,2,0,0,2
18023,0,2,0,0,2
18024,0,2,0,0,2
18025,2,0,0,0,2
18026,2,0,0,0,2
18027,0,2,0,0,2
18028,1,1,0,0,2
18029,0,1,0,1,2
18030,0,2,0,0,2
18031,0,2,0,0,2
18032,1,1,0,0,2
18033,0,2,0,0,2
18034,0,2,0,0,2
18035,0,2,0,0,2
18036,0,2,0,0,2
18037,1,1,0,0,2
18038,0,2,0,0,2
18039,0,2,0,0,2
18040,1,1,0,0,2
18041,0,2,0,0,2
18042,2,0,0,0,2
18043,0,2,0,0,2
18044,0,2,0,0,2
18045,0,2,0,0,2
18046,0,2,0,0,2
18047,0,1,0,1,2
18048,0,2,0,0,2
18049,0,2,0,0,2
18050,0,0,0,2,2
18051,0,2,0,0,2
18052,0,2,0,0,2
18053,1,1,0,0,2
18054,0,2,0,0,2
18055,1,0,0,1,2
18056,0,2,0,0,2
18057,0,2,0,0,2
18058,0,2,0,0,2
18059,0,2,0,0,2
18060,0,2,0,0,2
18061,0,2,0,0,2
18062,2,0,0,0,2
18063,0,2,0,0,2
18064,1,1,0,0,2
18065,0,2,0,0,2
18066,0,2,0,0,2
18067,2,0,0,0,2
18068,0,2,0,0,2
18069,0,2,0,0,2
18070,0,2,0,0,2
18071,0,2,0,0,2
18072,0,2,0,0,2
18073,0,1,1,0,2
18074,2,0,0,0,2
18075,0,2,0,0,2
18076,0,2,0,0,2
18077,0,2,0,0,2
18078,2,0,0,0,2
18079,0,2,0,0,2
18080,0,2,0,0,2
18081,0,2,0,0,2
18082,0,2,0,0,2
18083,0,2,0,0,2
18084,0,2,0,0,2
18085,1,1,0,0,2
18086,0,0,0,2,2
18087,0,2,0,0,2
18088,1,0,0,1,2
18089,0,2,0,0,2
18090,0,2,0,0,2
18091,0,2,0,0,2
18092,0,2,0,0,2
18093,0,2,0,0,2
18094,0,2,0,0,2
18095,1,0,1,0,2
18096,0,2,0,0,2
18097,0,2,0,0,2
18098,0,2,0,0,2
18099,1,1,0,0,2
18100,0,2,0,0,2
18101,1,0,0,1,2
18102,2,0,0,0,2
18103,0,0,0,2,2
18104,0,2,0,0,2
18105,0,2,0,0,2
18106,0,2,0,0,2
18107,1,0,0,1,2
18108,1,1,0,0,2
18109,0,2,0,0,2
18110,0,2,0,0,2
18111,0,2,0,0,2
18112,0,2,0,0,2
18113,0,2,0,0,2
18114,0,2,0,0,2
18115,2,0,0,0,2
18116,1,0,1,0,2
18117,0,2,0,0,2
18118,2,0,0,0,2
18119,0,2,0,0,2
18120,0,2,0,0,2
18121,0,2,0,0,2
18122,0,2,0,0,2
18123,0,2,0,0,2
18124,0,2,0,0,2
18125,0,1,1,0,2
18126,0,2,0,0,2
18127,0,2,0,0,2
18128,0,2,0,0,2
18129,0,2,0,0,2
18130,0,2,0,0,2
18131,0,2,0,0,2
18132,0,2,0,0,2
18133,0,2,0,0,2
18134,1,1,0,0,2
18135,0,2,0,0,2
18136,2,0,0,0,2
18137,0,2,0,0,2
18138,1,1,0,0,2
18139,0,2,0,0,2
18140,0,2,0,0,2
18141,0,2,0,0,2
18142,0,2,0,0,2
18143,0,2,0,0,2
18144,1,1,0,0,2
18145,0,2,0,0,2
18146,0,2,0,0,2
18147,0,2,0,0,2
18148,0,2,0,0,2
18149,0,2,0,0,2
18150,0,2,0,0,2
18151,2,0,0,0,2
18152,0,2,0,0,2
18153,0,2,0,0,2
18154,1,1,0,0,2
18155,0,2,0,0,2
18156,1,1,0,0,2
18157,0,2,0,0,2
18158,0,2,0,0,2
18159,0,1,1,0,2
18160,0,2,0,0,2
18161,0,2,0,0,2
18162,0,2,0,0,2
18163,1,0,0,1,2
18164,0,2,0,0,2
18165,1,0,0,1,2
18166,2,0,0,0,2
18167,0,2,0,0,2
18168,0,2,0,0,2
18169,0,2,0,0,2
18170,0,0,2,0,2
18171,0,2,0,0,2
18172,0,2,0,0,2
18173,0,2,0,0,2
18174,0,2,0,0,2
18175,0,2,0,0,2
18176,2,0,0,0,2
18177,0,2,0,0,2
18178,0,2,0,0,2
18179,0,2,0,0,2
18180,2,0,0,0,2
18181,0,2,0,0,2
18182,0,1,0,1,2
18183,0,2,0,0,2
18184,0,0,2,0,2
18185,0,2,0,0,2
18186,0,2,0,0,2
18187,0,2,0,0,2
18188,0,2,0,0,2
18189,0,2,0,0,2
18190,0,2,0,0,2
18191,0,2,0,0,2
18192,0,2,0,0,2
18193,0,2,0,0,2
18194,0,2,0,0,2
18195,0,2,0,0,2
18196,0,2,0,0,2
18197,0,2,0,0,2
18198,0,2,0,0,2
18199,1,1,0,0,2
18200,2,0,0,0,2
18201,1,1,0,0,2
18202,0,2,0,0,2
18203,0,2,0,0,2
18204,0,2,0,0,2
18205,0,2,0,0,2
18206,0,2,0,0,2
18207,0,2,0,0,2
18208,1,1,0,0,2
18209,0,2,0,0,2
18210,0,2,0,0,2
18211,0,2,0,0,2
18212,0,2,0,0,2
18213,2,0,0,0,2
18214,0,2,0,0,2
18215,0,2,0,0,2
18216,1,1,0,0,2
18217,0,2,0,0,2
18218,0,2,0,0,2
18219,0,1,0,1,2
18220,0,0,0,2,2
18221,0,2,0,0,2
18222,2,0,0,0,2
18223,0,2,0,0,2
18224,0,2,0,0,2
18225,0,2,0,0,2
18226,1,1,0,0,2
18227,0,2,0,0,2
18228,0,2,0,0,2
18229,0,0,2,0,2
18230,0,2,0,0,2
18231,0,2,0,0,2
18232,0,2,0,0,2
18233,0,2,0,0,2
18234,0,2,0,0,2
18235,0,2,0,0,2
18236,0,2,0,0,2
18237,2,0,0,0,2
18238,2,0,0,0,2
18239,1,1,0,0,2
18240,0,2,0,0,2
18241,0,2,0,0,2
18242,0,2,0,0,2
18243,0,2,0,0,2
18244,0,2,0,0,2
18245,1,0,0,1,2
18246,1,1,0,0,2
18247,0,2,0,0,2
18248,0,2,0,0,2
18249,0,2,0,0,2
18250,0,0,2,0,2
18251,1,1,0,0,2
18252,0,2,0,0,2
18253,0,2,0,0,2
18254,1,1,0,0,2
18255,0,2,0,0,2
18256,0,2,0,0,2
18257,0,2,0,0,2
18258,1,0,1,0,2
18259,0,2,0,0,2
18260,0,1,1,0,2
18261,0,2,0,0,2
18262,0,2,0,0,2
18263,0,2,0,0,2
18264,0,2,0,0,2
18265,0,2,0,0,2
18266,0,1,1,0,2
18267,0,2,0,0,2
18268,0,2,0,0,2
18269,0,2,0,0,2
18270,0,2,0,0,2
18271,1,1,0,0,2
18272,0,2,0,0,2
18273,0,2,0,0,2
18274,0,2,0,0,2
18275,0,0,2,0,2
18276,2,0,0,0,2
18277,0,2,0,0,2
18278,0,2,0,0,2
18279,0,2,0,0,2
18280,0,2,0,0,2
18281,2,0,0,0,2
18282,0,2,0,0,2
18283,0,2,0,0,2
18284,2,0,0,0,2
18285,0,2,0,0,2
18286,1,0,1,0,2
18287,0,2,0,0,2
18288,0,2,0,0,2
18289,2,0,0,0,2
18290,0,2,0,0,2
18291,2,0,0,0,2
18292,1,0,0,1,2
18293,0,2,0,0,2
18294,0,2,0,0,2
18295,0,2,0,0,2
18296,0,2,0,0,2
18297,0,2,0,0,2
18298,0,2,0,0,2
18299,0,0,0,2,2
18300,0,2,0,0,2
18301,0,2,0,0,2
18302,0,0,2,0,2
18303,0,2,0,0,2
18304,0,2,0,0,2
18305,0,2,0,0,2
18306,0,0,1,1,2
18307,0,2,0,0,2
18308,0,2,0,0,2
18309,0,2,0,0,2
18310,0,2,0,0,2
18311,1,0,0,1,2
18312,0,2,0,0,2
18313,0,2,0,0,2
18314,0,1,0,1,2
18315,0,2,0,0,2
18316,0,2,0,0,2
18317,0,2,0,0,2
18318,0,2,0,0,2
18319,0,2,0,0,2
18320,1,0,0,1,2
18321,0,2,0,0,2
18322,0,2,0,0,2
18323,0,2,0,0,2
18324,0,2,0,0,2
18325,2,0,0,0,2
18326,0,2,0,0,2
18327,0,0,0,2,2
18328,0,2,0,0,2
18329,1,1,0,0,2
18330,0,2,0,0,2
18331,0,2,0,0,2
18332,0,2,0,0,2
18333,0,2,0,0,2
18334,0,2,0,0,2
18335,2,0,0,0,2
18336,0,2,0,0,2
18337,0,2,0,0,2
18338,0,2,0,0,2
18339,0,2,0,0,2
18340,2,0,0,0,2
18341,1,1,0,0,2
18342,2,0,0,0,2
18343,2,0,0,0,2
18344,1,1,0,0,2
18345,0,2,0,0,2
18346,2,0,0,0,2
18347,0,1,0,1,2
18348,0,2,0,0,2
18349,0,2,0,0,2
18350,0,2,0,0,2
18351,0,2,0,0,2
18352,0,2,0,0,2
18353,0,2,0,0,2
18354,0,2,0,0,2
18355,0,2,0,0,2
18356,0,2,0,0,2
18357,0,2,0,0,2
18358,0,2,0,0,2
18359,1,1,0,0,2
18360,0,2,0,0,2
18361,2,0,0,0,2
18362,0,2,0,0,2
18363,0,2,0,0,2
18364,0,2,0,0,2
18365,2,0,0,0,2
18366,0,2,0,0,2
18367,0,2,0,0,2
18368,0,2,0,0,2
18369,0,2,0,0,2
18370,0,2,0,0,2
18371,0,2,0,0,2
18372,1,1,0,0,2
18373,0,2,0,0,2
18374,0,2,0,0,2
18375,0,2,0,0,2
18376,0,0,0,2,2
18377,0,2,0,0,2
18378,1,1,0,0,2
18379,0,2,0,0,2
18380,0,2,0,0,2
18381,0,2,0,0,2
18382,0,2,0,0,2
18383,0,2,0,0,2
18384,0,2,0,0,2
18385,1,0,1,0,2
18386,0,2,0,0,2
18387,2,0,0,0,2
18388,0,2,0,0,2
18389,1,1,0,0,2
18390,0,2,0,0,2
18391,0,2,0,0,2
18392,0,0,0,2,2
18393,0,2,0,0,2
18394,0,2,0,0,2
18395,0,2,0,0,2
18396,0,2,0,0,2
18397,0,2,0,0,2
18398,0,2,0,0,2
18399,0,2,0,0,2
18400,0,2,0,0,2
18401,0,2,0,0,2
18402,1,1,0,0,2
18403,1,1,0,0,2
18404,0,2,0,0,2
18405,0,2,0,0,2
18406,1,1,0,0,2
18407,1,1,0,0,2
18408,0,2,0,0,2
18409,0,2,0,0,2
18410,0,2,0,0,2
18411,0,2,0,0,2
18412,0,2,0,0,2
18413,1,1,0,0,2
18414,0,2,0,0,2
18415,0,2,0,0,2
18416,0,2,0,0,2
18417,0,2,0,0,2
18418,0,2,0,0,2
18419,0,1,1,0,2
18420,0,2,0,0,2
18421,0,2,0,0,2
18422,0,2,0,0,2
18423,0,2,0,0,2
18424,0,2,0,0,2
18425,0,2,0,0,2
18426,0,2,0,0,2
18427,1,1,0,0,2
18428,0,2,0,0,2
18429,0,2,0,0,2
18430,0,2,0,0,2
18431,0,2,0,0,2
18432,0,2,0,0,2
18433,0,2,0,0,2
18434,0,2,0,0,2
18435,0,2,0,0,2
18436,0,2,0,0,2
18437,0,2,0,0,2
18438,0,2,0,0,2
18439,1,1,0,0,2
18440,0,2,0,0,2
18441,0,2,0,0,2
18442,2,0,0,0,2
18443,0,2,0,0,2
18444,0,2,0,0,2
18445,0,2,0,0,2
18446,2,0,0,0,2
18447,0,2,0,0,2
18448,1,1,0,0,2
18449,0,2,0,0,2
18450,0,0,1,1,2
18451,0,2,0,0,2
18452,0,2,0,0,2
18453,0,2,0,0,2
18454,0,1,0,1,2
18455,0,2,0,0,2
18456,0,2,0,0,2
18457,0,2,0,0,2
18458,0,0,0,2,2
18459,0,1,0,1,2
18460,0,2,0,0,2
18461,2,0,0,0,2
18462,1,1,0,0,2
18463,1,1,0,0,2
18464,0,2,0,0,2
18465,0,2,0,0,2
18466,1,0,0,1,2
18467,0,2,0,0,2
18468,0,2,0,0,2
18469,1,1,0,0,2
18470,0,2,0,0,2
18471,0,2,0,0,2
18472,0,2,0,0,2
18473,1,1,0,0,2
18474,0,2,0,0,2
18475,0,2,0,0,2
18476,0,2,0,0,2
18477,1,1,0,0,2
18478,0,2,0,0,2
18479,0,1,0,1,2
18480,0,2,0,0,2
18481,0,2,0,0,2
18482,0,0,2,0,2
18483,1,1,0,0,2
18484,0,2,0,0,2
18485,0,2,0,0,2
18486,0,2,0,0,2
18487,0,2,0,0,2
18488,1,1,0,0,2
18489,0,2,0,0,2
18490,0,2,0,0,2
18491,0,2,0,0,2
18492,0,2,0,0,2
18493,1,1,0,0,2
18494,0,2,0,0,2
18495,0,2,0,0,2
18496,1,1,0,0,2
18497,1,1,0,0,2
18498,0,2,0,0,2
18499,0,2,0,0,2
18500,0,2,0,0,2
18501,0,2,0,0,2
18502,0,2,0,0,2
18503,2,0,0,0,2
18504,1,0,0,1,2
18505,0,2,0,0,2
18506,1,1,0,0,2
18507,0,2,0,0,2
18508,0,2,0,0,2
18509,0,2,0,0,2
18510,1,0,0,1,2
18511,0,2,0,0,2
18512,1,1,0,0,2
18513,0,2,0,0,2
18514,0,2,0,0,2
18515,0,2,0,0,2
18516,0,2,0,0,2
18517,0,2,0,0,2
18518,0,2,0,0,2
18519,0,0,0,2,2
18520,0,2,0,0,2
18521,0,2,0,0,2
18522,0,2,0,0,2
18523,0,2,0,0,2
18524,0,2,0,0,2
18525,0,2,0,0,2
18526,0,2,0,0,2
18527,0,2,0,0,2
18528,0,2,0,0,2
18529,0,2,0,0,2
18530,1,1,0,0,2
18531,1,1,0,0,2
18532,0,1,0,1,2
18533,0,2,0,0,2
18534,0,2,0,0,2
18535,0,2,0,0,2
18536,0,0,2,0,2
18537,0,2,0,0,2
18538,0,2,0,0,2
18539,0,2,0,0,2
18540,0,1,1,0,2
18541,0,2,0,0,2
18542,0,2,0,0,2
18543,1,1,0,0,2
18544,0,2,0,0,2
18545,0,2,0,0,2
18546,0,2,0,0,2
18547,0,2,0,0,2
18548,1,1,0,0,2
18549,0,2,0,0,2
18550,0,2,0,0,2
18551,1,1,0,0,2
18552,0,2,0,0,2
18553,0,2,0,0,2
18554,0,1,1,0,2
18555,1,0,0,1,2
18556,0,2,0,0,2
18557,0,2,0,0,2
18558,1,0,1,0,2
18559,0,2,0,0,2
18560,0,2,0,0,2
18561,1,1,0,0,2
18562,0,0,2,0,2
18563,0,2,0,0,2
18564,1,1,0,0,2
18565,1,0,1,0,2
18566,2,0,0,0,2
18567,0,2,0,0,2
18568,0,2,0,0,2
18569,0,2,0,0,2
18570,0,2,0,0,2
18571,0,2,0,0,2
18572,0,2,0,0,2
18573,0,2,0,0,2
18574,0,2,0,0,2
18575,0,2,0,0,2
18576,0,2,0,0,2
18577,2,0,0,0,2
18578,2,0,0,0,2
18579,0,2,0,0,2
18580,0,2,0,0,2
18581,1,1,0,0,2
18582,1,1,0,0,2
18583,0,2,0,0,2
18584,1,0,1,0,2
18585,0,2,0,0,2
18586,0,2,0,0,2
18587,0,2,0,0,2
18588,0,0,1,1,2
18589,0,2,0,0,2
18590,0,2,0,0,2
18591,2,0,0,0,2
18592,0,2,0,0,2
18593,1,1,0,0,2
18594,0,2,0,0,2
18595,0,2,0,0,2
18596,1,0,1,0,2
18597,0,2,0,0,2
18598,0,2,0,0,2
18599,0,0,0,2,2
18600,0,2,0,0,2
18601,0,2,0,0,2
18602,0,2,0,0,2
18603,0,2,0,0,2
18604,0,2,0,0,2
18605,0,2,0,0,2
18606,0,2,0,0,2
18607,1,1,0,0,2
18608,0,2,0,0,2
18609,0,2,0,0,2
18610,1,1,0,0,2
18611,0,2,0,0,2
18612,0,2,0,0,2
18613,0,2,0,0,2
18614,0,2,0,0,2
18615,0,2,0,0,2
18616,0,2,0,0,2
18617,2,0,0,0,2
18618,0,2,0,0,2
18619,0,2,0,0,2
18620,0,2,0,0,2
18621,1,1,0,0,2
18622,1,0,0,1,2
18623,2,0,0,0,2
18624,0,2,0,0,2
18625,0,2,0,0,2
18626,0,2,0,0,2
18627,0,2,0,0,2
18628,0,2,0,0,2
18629,0,2,0,0,2
18630,1,0,1,0,2
18631,0,2,0,0,2
18632,1,1,0,0,2
18633,0,2,0,0,2
18634,0,2,0,0,2
18635,0,2,0,0,2
18636,1,1,0,0,2
18637,0,2,0,0,2
18638,0,2,0,0,2
18639,0,2,0,0,2
18640,0,2,0,0,2
18641,2,0,0,0,2
18642,1,1,0,0,2
18643,0,2,0,0,2
18644,0,2,0,0,2
18645,0,2,0,0,2
18646,1,1,0,0,2
18647,0,2,0,0,2
18648,0,2,0,0,2
18649,0,2,0,0,2
18650,0,2,0,0,2
18651,1,1,0,0,2
18652,0,2,0,0,2
18653,0,2,0,0,2
18654,0,2,0,0,2
18655,0,2,0,0,2
18656,0,2,0,0,2
18657,0,2,0,0,2
18658,1,1,0,0,2
18659,0,2,0,0,2
18660,0,2,0,0,2
18661,1,0,1,0,2
18662,0,2,0,0,2
18663,0,2,0,0,2
18664,0,2,0,0,2
18665,1,0,0,1,2
18666,0,2,0,0,2
18667,0,2,0,0,2
18668,0,2,0,0,2
18669,0,2,0,0,2
18670,2,0,0,0,2
18671,0,2,0,0,2
18672,2,0,0,0,2
18673,0,2,0,0,2
18674,0,2,0,0,2
18675,1,1,0,0,2
18676,2,0,0,0,2
18677,0,2,0,0,2
18678,0,2,0,0,2
18679,0,2,0,0,2
18680,0,2,0,0,2
18681,0,0,2,0,2
18682,0,2,0,0,2
18683,2,0,0,0,2
18684,0,2,0,0,2
18685,0,2,0,0,2
18686,0,2,0,0,2
18687,1,1,0,0,2
18688,0,2,0,0,2
18689,0,2,0,0,2
18690,0,2,0,0,2
18691,0,2,0,0,2
18692,0,2,0,0,2
18693,0,2,0,0,2
18694,1,1,0,0,2
18695,1,1,0,0,2
18696,0,1,0,1,2
18697,0,2,0,0,2
18698,2,0,0,0,2
18699,0,2,0,0,2
18700,1,1,0,0,2
18701,0,2,0,0,2
18702,1,0,1,0,2
18703,0,2,0,0,2
18704,0,2,0,0,2
18705,1,1,0,0,2
18706,0,2,0,0,2
18707,0,2,0,0,2
18708,0,2,0,0,2
18709,0,2,0,0,2
18710,2,0,0,0,2
18711,1,1,0,0,2
18712,2,0,0,0,2
18713,0,0,0,2,2
18714,0,2,0,0,2
18715,0,2,0,0,2
18716,0,2,0,0,2
18717,2,0,0,0,2
18718,1,1,0,0,2
18719,0,2,0,0,2
18720,1,1,0,0,2
18721,2,0,0,0,2
18722,0,2,0,0,2
18723,0,2,0,0,2
18724,0,2,0,0,2
18725,0,2,0,0,2
18726,0,2,0,0,2
18727,0,2,0,0,2
18728,1,1,0,0,2
18729,0,2,0,0,2
18730,1,1,0,0,2
18731,1,0,0,1,2
18732,0,2,0,0,2
18733,0,2,0,0,2
18734,0,2,0,0,2
18735,1,0,1,0,2
18736,0,2,0,0,2
18737,0,2,0,0,2
18738,2,0,0,0,2
18739,0,2,0,0,2
18740,0,2,0,0,2
18741,0,2,0,0,2
18742,0,2,0,0,2
18743,0,0,0,2,2
18744,0,2,0,0,2
18745,0,2,0,0,2
18746,0,2,0,0,2
18747,0,2,0,0,2
18748,2,0,0,0,2
18749,0,2,0,0,2
18750,0,2,0,0,2
18751,0,2,0,0,2
18752,0,2,0,0,2
18753,0,2,0,0,2
18754,0,2,0,0,2
18755,0,2,0,0,2
18756,0,2,0,0,2
18757,0,2,0,0,2
18758,0,2,0,0,2
18759,0,2,0,0,2
18760,0,2,0,0,2
18761,0,2,0,0,2
18762,0,2,0,0,2
18763,0,2,0,0,2
18764,1,0,0,1,2
18765,0,2,0,0,2
18766,1,1,0,0,2
18767,0,2,0,0,2
18768,0,2,0,0,2
18769,0,2,0,0,2
18770,0,2,0,0,2
18771,0,0,1,1,2
18772,0,2,0,0,2
18773,0,2,0,0,2
18774,2,0,0,0,2
18775,0,2,0,0,2
18776,0,2,0,0,2
18777,0,2,0,0,2
18778,0,2,0,0,2
18779,0,2,0,0,2
18780,0,2,0,0,2
18781,0,2,0,0,2
18782,1,0,0,1,2
18783,0,2,0,0,2
18784,1,0,1,0,2
18785,0,2,0,0,2
18786,0,0,0,2,2
18787,0,2,0,0,2
18788,0,2,0,0,2
18789,0,2,0,0,2
18790,0,2,0,0,2
18791,0,2,0,0,2
18792,0,2,0,0,2
18793,1,0,1,0,2
18794,0,1,0,1,2
18795,0,2,0,0,2
18796,0,2,0,0,2
18797,0,2,0,0,2
18798,2,0,0,0,2
18799,0,2,0,0,2
18800,0,2,0,0,2
18801,0,2,0,0,2
18802,1,1,0,0,2
18803,0,2,0,0,2
18804,0,2,0,0,2
18805,0,2,0,0,2
18806,1,0,0,1,2
18807,1,0,0,1,2
18808,1,1,0,0,2
18809,0,2,0,0,2
18810,0,2,0,0,2
18811,2,0,0,0,2
18812,0,2,0,0,2
18813,2,0,0,0,2
18814,1,1,0,0,2
18815,0,2,0,0,2
18816,0,2,0,0,2
18817,0,2,0,0,2
18818,2,0,0,0,2
18819,1,0,0,1,2
18820,2,0,0,0,2
18821,0,2,0,0,2
18822,0,2,0,0,2
18823,0,2,0,0,2
18824,0,2,0,0,2
18825,0,2,0,0,2
18826,2,0,0,0,2
18827,0,2,0,0,2
18828,0,2,0,0,2
18829,0,2,0,0,2
18830,0,2,0,0,2
18831,0,2,0,0,2
18832,0,2,0,0,2
18833,0,2,0,0,2
18834,0,2,0,0,2
18835,0,2,0,0,2
18836,0,2,0,0,2
18837,1,0,1,0,2
18838,0,2,0,0,2
18839,0,2,0,0,2
18840,0,2,0,0,2
18841,0,1,0,1,2
18842,2,0,0,0,2
18843,0,2,0,0,2
18844,0,2,0,0,2
18845,0,2,0,0,2
18846,2,0,0,0,2
18847,0,0,0,2,2
18848,0,2,0,0,2
18849,0,2,0,0,2
18850,0,2,0,0,2
18851,0,2,0,0,2
18852,0,2,0,0,2
18853,0,2,0,0,2
18854,0,2,0,0,2
18855,2,0,0,0,2
18856,0,2,0,0,2
18857,0,2,0,0,2
18858,0,2,0,0,2
18859,0,2,0,0,2
18860,0,2,0,0,2
18861,1,0,0,1,2
18862,2,0,0,0,2
18863,0,2,0,0,2
18864,0,2,0,0,2
18865,0,2,0,0,2
18866,0,2,0,0,2
18867,1,1,0,0,2
18868,0,2,0,0,2
18869,0,2,0,0,2
18870,0,2,0,0,2
18871,0,2,0,0,2
18872,0,2,0,0,2
18873,0,2,0,0,2
18874,0,2,0,0,2
18875,0,2,0,0,2
18876,0,2,0,0,2
18877,0,2,0,0,2
18878,0,2,0,0,2
18879,0,2,0,0,2
18880,0,0,0,2,2
18881,0,2,0,0,2
18882,0,2,0,0,2
18883,0,2,0,0,2
18884,1,1,0,0,2
18885,2,0,0,0,2
18886,0,2,0,0,2
18887,0,2,0,0,2
18888,0,2,0,0,2
18889,0,1,0,1,2
18890,2,0,0,0,2
18891,0,2,0,0,2
18892,0,2,0,0,2
18893,0,2,0,0,2
18894,1,1,0,0,2
18895,0,0,0,2,2
18896,1,0,1,0,2
18897,0,2,0,0,2
18898,0,2,0,0,2
18899,1,1,0,0,2
18900,0,2,0,0,2
18901,0,2,0,0,2
18902,0,0,0,2,2
18903,1,1,0,0,2
18904,0,2,0,0,2
18905,0,2,0,0,2
18906,0,2,0,0,2
18907,0,2,0,0,2
18908,0,2,0,0,2
18909,2,0,0,0,2
18910,1,1,0,0,2
18911,1,1,0,0,2
18912,0,2,0,0,2
18913,0,2,0,0,2
18914,0,2,0,0,2
18915,0,2,0,0,2
18916,0,2,0,0,2
18917,0,2,0,0,2
18918,2,0,0,0,2
18919,0,2,0,0,2
18920,0,2,0,0,2
18921,1,1,0,0,2
18922,2,0,0,0,2
18923,1,1,0,0,2
18924,1,1,0,0,2
18925,0,1,0,1,2
18926,0,2,0,0,2
18927,0,2,0,0,2
18928,0,2,0,0,2
18929,0,2,0,0,2
18930,2,0,0,0,2
18931,0,2,0,0,2
18932,0,0,0,2,2
18933,1,1,0,0,2
18934,1,1,0,0,2
18935,0,2,0,0,2
18936,0,2,0,0,2
18937,0,2,0,0,2
18938,1,0,0,1,2
18939,0,2,0,0,2
18940,0,2,0,0,2
18941,0,2,0,0,2
18942,0,2,0,0,2
18943,0,2,0,0,2
18944,1,1,0,0,2
18945,0,2,0,0,2
18946,0,2,0,0,2
18947,1,1,0,0,2
18948,0,2,0,0,2
18949,0,2,0,0,2
18950,1,0,0,1,2
18951,0,2,0,0,2
18952,0,2,0,0,2
18953,0,2,0,0,2
18954,0,2,0,0,2
18955,0,2,0,0,2
18956,0,2,0,0,2
18957,0,2,0,0,2
18958,0,2,0,0,2
18959,0,2,0,0,2
18960,0,2,0,0,2
18961,0,2,0,0,2
18962,0,2,0,0,2
18963,0,2,0,0,2
18964,1,0,1,0,2
18965,0,2,0,0,2
18966,0,2,0,0,2
18967,0,2,0,0,2
18968,0,2,0,0,2
18969,2,0,0,0,2
18970,1,1,0,0,2
18971,0,2,0,0,2
18972,2,0,0,0,2
18973,0,2,0,0,2
18974,1,1,0,0,2
18975,0,2,0,0,2
18976,0,2,0,0,2
18977,0,2,0,0,2
18978,0,2,0,0,2
18979,0,2,0,0,2
18980,0,2,0,0,2
18981,0,2,0,0,2
18982,0,2,0,0,2
18983,0,2,0,0,2
18984,0,2,0,0,2
18985,0,2,0,0,2
18986,0,2,0,0,2
18987,2,0,0,0,2
18988,0,2,0,0,2
18989,0,2,0,0,2
18990,0,2,0,0,2
18991,0,2,0,0,2
18992,0,2,0,0,2
18993,2,0,0,0,2
18994,1,1,0,0,2
18995,0,2,0,0,2
18996,0,2,0,0,2
18997,1,1,0,0,2
18998,0,2,0,0,2
18999,1,1,0,0,2
19000,0,2,0,0,2
19001,0,2,0,0,2
19002,0,2,0,0,2
19003,0,2,0,0,2
19004,0,2,0,0,2
19005,2,0,0,0,2
19006,0,2,0,0,2
19007,2,0,0,0,2
19008,0,2,0,0,2
19009,0,2,0,0,2
19010,1,1,0,0,2
19011,0,2,0,0,2
19012,1,0,0,1,2
19013,2,0,0,0,2
19014,1,1,0,0,2
19015,0,2,0,0,2
19016,1,1,0,0,2
19017,1,0,0,1,2
19018,1,1,0,0,2
19019,0,2,0,0,2
19020,1,1,0,0,2
19021,0,2,0,0,2
19022,0,2,0,0,2
19023,1,1,0,0,2
19024,1,0,0,1,2
19025,0,2,0,0,2
19026,0,2,0,0,2
19027,0,2,0,0,2
19028,0,2,0,0,2
19029,0,2,0,0,2
19030,0,2,0,0,2
19031,0,2,0,0,2
19032,0,0,0,2,2
19033,0,2,0,0,2
19034,2,0,0,0,2
19035,0,2,0,0,2
19036,0,2,0,0,2
19037,0,2,0,0,2
19038,2,0,0,0,2
19039,0,2,0,0,2
19040,0,2,0,0,2
19041,0,2,0,0,2
19042,0,2,0,0,2
19043,1,1,0,0,2
19044,0,2,0,0,2
19045,0,2,0,0,2
19046,0,2,0,0,2
19047,0,2,0,0,2
19048,2,0,0,0,2
19049,0,1,0,1,2
19050,0,2,0,0,2
19051,2,0,0,0,2
19052,0,2,0,0,2
19053,0,2,0,0,2
19054,0,2,0,0,2
19055,0,2,0,0,2
19056,0,2,0,0,2
19057,0,2,0,0,2
19058,0,2,0,0,2
19059,0,2,0,0,2
19060,0,2,0,0,2
19061,0,2,0,0,2
19062,1,1,0,0,2
19063,1,1,0,0,2
19064,0,2,0,0,2
19065,0,2,0,0,2
19066,0,2,0,0,2
19067,0,2,0,0,2
19068,0,2,0,0,2
19069,0,2,0,0,2
19070,0,2,0,0,2
19071,0,2,0,0,2
19072,0,2,0,0,2
19073,0,2,0,0,2
19074,0,2,0,0,2
19075,0,2,0,0,2
19076,0,2,0,0,2
19077,1,1,0,0,2
19078,2,0,0,0,2
19079,0,2,0,0,2
19080,0,2,0,0,2
19081,0,2,0,0,2
19082,1,0,1,0,2
19083,0,2,0,0,2
19084,0,2,0,0,2
19085,0,2,0,0,2
19086,0,2,0,0,2
19087,0,2,0,0,2
19088,1,1,0,0,2
19089,0,2,0,0,2
19090,0,2,0,0,2
19091,1,0,1,0,2
19092,0,2,0,0,2
19093,0,2,0,0,2
19094,0,2,0,0,2
19095,0,2,0,0,2
19096,0,2,0,0,2
19097,0,2,0,0,2
19098,0,2,0,0,2
19099,0,2,0,0,2
19100,0,2,0,0,2
19101,0,2,0,0,2
19102,0,2,0,0,2
19103,1,1,0,0,2
19104,0,2,0,0,2
19105,2,0,0,0,2
19106,0,2,0,0,2
19107,0,2,0,0,2
19108,0,2,0,0,2
19109,0,2,0,0,2
19110,0,2,0,0,2
19111,0,2,0,0,2
19112,0,2,0,0,2
19113,0,2,0,0,2
19114,1,0,1,0,2
19115,0,1,0,1,2
19116,0,2,0,0,2
19117,1,1,0,0,2
19118,0,2,0,0,2
19119,0,2,0,0,2
19120,0,2,0,0,2
19121,0,2,0,0,2
19122,0,2,0,0,2
19123,2,0,0,0,2
19124,0,2,0,0,2
19125,0,2,0,0,2
19126,0,2,0,0,2
19127,0,2,0,0,2
19128,0,2,0,0,2
19129,1,1,0,0,2
19130,0,2,0,0,2
19131,0,2,0,0,2
19132,0,2,0,0,2
19133,0,2,0,0,2
19134,0,2,0,0,2
19135,0,2,0,0,2
19136,1,1,0,0,2
19137,0,2,0,0,2
19138,0,2,0,0,2
19139,0,2,0,0,2
19140,0,0,1,1,2
19141,0,2,0,0,2
19142,0,2,0,0,2
19143,1,1,0,0,2
19144,0,2,0,0,2
19145,0,2,0,0,2
19146,0,2,0,0,2
19147,0,2,0,0,2
19148,0,2,0,0,2
19149,0,2,0,0,2
19150,1,1,0,0,2
19151,0,2,0,0,2
19152,0,2,0,0,2
19153,0,2,0,0,2
19154,1,1,0,0,2
19155,1,1,0,0,2
19156,0,2,0,0,2
19157,1,0,0,1,2
19158,0,2,0,0,2
19159,0,2,0,0,2
19160,0,2,0,0,2
19161,0,2,0,0,2
19162,0,2,0,0,2
19163,2,0,0,0,2
19164,0,2,0,0,2
19165,0,2,0,0,2
19166,0,2,0,0,2
19167,0,2,0,0,2
19168,0,2,0,0,2
19169,1,1,0,0,2
19170,1,1,0,0,2
19171,0,2,0,0,2
19172,0,2,0,0,2
19173,0,2,0,0,2
19174,2,0,0,0,2
19175,0,2,0,0,2
19176,0,2,0,0,2
19177,0,2,0,0,2
19178,0,2,0,0,2
19179,0,2,0,0,2
19180,0,0,2,0,2
19181,0,2,0,0,2
19182,0,2,0,0,2
19183,0,0,0,2,2
19184,1,1,0,0,2
19185,2,0,0,0,2
19186,0,2,0,0,2
19187,0,2,0,0,2
19188,0,2,0,0,2
19189,0,2,0,0,2
19190,0,2,0,0,2
19191,0,2,0,0,2
19192,0,2,0,0,2
19193,1,1,0,0,2
19194,2,0,0,0,2
19195,2,0,0,0,2
19196,0,2,0,0,2
19197,0,2,0,0,2
19198,0,2,0,0,2
19199,0,2,0,0,2
19200,2,0,0,0,2
19201,0,2,0,0,2
19202,0,2,0,0,2
19203,0,2,0,0,2
19204,0,2,0,0,2
19205,0,2,0,0,2
19206,0,2,0,0,2
19207,0,2,0,0,2
19208,1,0,0,1,2
19209,0,2,0,0,2
19210,0,2,0,0,2
19211,0,2,0,0,2
19212,2,0,0,0,2
19213,0,2,0,0,2
19214,2,0,0,0,2
19215,1,1,0,0,2
19216,0,2,0,0,2
19217,0,2,0,0,2
19218,0,2,0,0,2
19219,0,2,0,0,2
19220,2,0,0,0,2
19221,2,0,0,0,2
19222,0,2,0,0,2
19223,0,2,0,0,2
19224,0,2,0,0,2
19225,0,2,0,0,2
19226,0,2,0,0,2
19227,0,2,0,0,2
19228,0,2,0,0,2
19229,0,2,0,0,2
19230,0,2,0,0,2
19231,1,1,0,0,2
19232,0,2,0,0,2
19233,0,2,0,0,2
19234,0,2,0,0,2
19235,0,2,0,0,2
19236,0,2,0,0,2
19237,0,1,1,0,2
19238,0,2,0,0,2
19239,1,1,0,0,2
19240,0,2,0,0,2
19241,0,2,0,0,2
19242,2,0,0,0,2
19243,0,2,0,0,2
19244,0,2,0,0,2
19245,0,2,0,0,2
19246,0,0,0,2,2
19247,0,2,0,0,2
19248,0,2,0,0,2
19249,0,2,0,0,2
19250,0,2,0,0,2
19251,0,2,0,0,2
19252,0,2,0,0,2
19253,0,2,0,0,2
19254,0,2,0,0,2
19255,0,2,0,0,2
19256,0,2,0,0,2
19257,0,2,0,0,2
19258,0,2,0,0,2
19259,0,2,0,0,2
19260,0,2,0,0,2
19261,0,2,0,0,2
19262,1,1,0,0,2
19263,0,2,0,0,2
19264,0,2,0,0,2
19265,0,2,0,0,2
19266,0,2,0,0,2
19267,0,2,0,0,2
19268,0,2,0,0,2
19269,0,2,0,0,2
19270,0,2,0,0,2
19271,0,2,0,0,2
19272,1,0,0,1,2
19273,0,2,0,0,2
19274,0,2,0,0,2
19275,0,2,0,0,2
19276,1,1,0,0,2
19277,0,2,0,0,2
19278,0,2,0,0,2
19279,1,0,0,1,2
19280,2,0,0,0,2
19281,0,2,0,0,2
19282,0,2,0,0,2
19283,0,2,0,0,2
19284,2,0,0,0,2
19285,0,2,0,0,2
19286,1,0,0,1,2
19287,2,0,0,0,2
19288,1,1,0,0,2
19289,0,2,0,0,2
19290,0,2,0,0,2
19291,0,2,0,0,2
19292,0,2,0,0,2
19293,1,1,0,0,2
19294,0,2,0,0,2
19295,2,0,0,0,2
19296,0,2,0,0,2
19297,0,2,0,0,2
19298,0,2,0,0,2
19299,0,2,0,0,2
19300,0,1,1,0,2
19301,0,1,0,1,2
19302,2,0,0,0,2
19303,1,0,1,0,2
19304,0,2,0,0,2
19305,0,2,0,0,2
19306,0,2,0,0,2
19307,0,2,0,0,2
19308,0,2,0,0,2
19309,0,2,0,0,2
19310,0,2,0,0,2
19311,1,0,0,1,2
19312,0,2,0,0,2
19313,0,2,0,0,2
19314,0,2,0,0,2
19315,0,2,0,0,2
19316,0,2,0,0,2
19317,0,2,0,0,2
19318,0,2,0,0,2
19319,0,2,0,0,2
19320,0,2,0,0,2
19321,0,2,0,0,2
19322,0,2,0,0,2
19323,1,1,0,0,2
19324,0,2,0,0,2
19325,0,2,0,0,2
19326,0,2,0,0,2
19327,0,2,0,0,2
19328,0,2,0,0,2
19329,2,0,0,0,2
19330,0,2,0,0,2
19331,0,2,0,0,2
19332,0,0,2,0,2
19333,0,2,0,0,2
19334,0,2,0,0,2
19335,0,2,0,0,2
19336,1,0,1,0,2
19337,0,2,0,0,2
19338,0,2,0,0,2
19339,0,2,0,0,2
19340,0,2,0,0,2
19341,0,0,1,1,2
19342,0,2,0,0,2
19343,0,2,0,0,2
19344,0,2,0,0,2
19345,1,1,0,0,2
19346,0,2,0,0,2
19347,0,0,0,2,2
19348,0,2,0,0,2
19349,0,2,0,0,2
19350,0,2,0,0,2
19351,0,2,0,0,2
19352,1,1,0,0,2
19353,0,1,0,1,2
19354,1,1,0,0,2
19355,0,2,0,0,2
19356,0,1,1,0,2
19357,0,2,0,0,2
19358,2,0,0,0,2
19359,1,1,0,0,2
19360,0,2,0,0,2
19361,0,2,0,0,2
19362,0,2,0,0,2
19363,1,1,0,0,2
19364,0,2,0,0,2
19365,0,2,0,0,2
19366,0,2,0,0,2
19367,0,2,0,0,2
19368,2,0,0,0,2
19369,0,2,0,0,2
19370,0,2,0,0,2
19371,0,2,0,0,2
19372,2,0,0,0,2
19373,1,1,0,0,2
19374,0,2,0,0,2
19375,0,2,0,0,2
19376,0,2,0,0,2
19377,1,1,0,0,2
19378,1,1,0,0,2
19379,0,2,0,0,2
19380,2,0,0,0,2
19381,1,1,0,0,2
19382,1,1,0,0,2
19383,0,2,0,0,2
19384,0,2,0,0,2
19385,0,2,0,0,2
19386,0,2,0,0,2
19387,0,2,0,0,2
19388,0,2,0,0,2
19389,0,2,0,0,2
19390,0,2,0,0,2
19391,0,2,0,0,2
19392,0,2,0,0,2
19393,0,2,0,0,2
19394,0,2,0,0,2
19395,0,2,0,0,2
19396,0,2,0,0,2
19397,0,2,0,0,2
19398,2,0,0,0,2
19399,0,2,0,0,2
19400,0,2,0,0,2
19401,0,2,0,0,2
19402,0,2,0,0,2
19403,2,0,0,0,2
19404,0,2,0,0,2
19405,0,2,0,0,2
19406,0,2,0,0,2
19407,0,1,0,1,2
19408,0,2,0,0,2
19409,1,0,0,1,2
19410,1,1,0,0,2
19411,0,2,0,0,2
19412,1,0,0,1,2
19413,0,2,0,0,2
19414,0,2,0,0,2
19415,0,2,0,0,2
19416,0,2,0,0,2
19417,2,0,0,0,2
19418,2,0,0,0,2
19419,1,1,0,0,2
19420,0,2,0,0,2
19421,0,2,0,0,2
19422,0,2,0,0,2
19423,1,1,0,0,2
19424,2,0,0,0,2
19425,0,2,0,0,2
19426,0,0,0,2,2
19427,1,0,1,0,2
19428,0,1,1,0,2
19429,0,2,0,0,2
19430,0,2,0,0,2
19431,0,2,0,0,2
19432,0,1,0,1,2
19433,0,2,0,0,2
19434,0,2,0,0,2
19435,0,2,0,0,2
19436,0,0,2,0,2
19437,0,2,0,0,2
19438,1,1,0,0,2
19439,0,2,0,0,2
19440,0,1,0,1,2
19441,2,0,0,0,2
19442,0,2,0,0,2
19443,0,2,0,0,2
19444,0,2,0,0,2
19445,0,2,0,0,2
19446,0,2,0,0,2
19447,2,0,0,0,2
19448,2,0,0,0,2
19449,0,2,0,0,2
19450,1,1,0,0,2
19451,0,2,0,0,2
19452,1,0,0,1,2
19453,0,2,0,0,2
19454,0,2,0,0,2
19455,0,2,0,0,2
19456,0,2,0,0,2
19457,1,1,0,0,2
19458,0,0,1,1,2
19459,1,1,0,0,2
19460,0,2,0,0,2
19461,0,2,0,0,2
19462,0,2,0,0,2
19463,0,2,0,0,2
19464,0,2,0,0,2
19465,0,2,0,0,2
19466,0,2,0,0,2
19467,0,2,0,0,2
19468,0,2,0,0,2
19469,1,1,0,0,2
19470,0,2,0,0,2
19471,1,1,0,0,2
19472,0,2,0,0,2
19473,0,1,1,0,2
19474,0,0,0,2,2
19475,0,2,0,0,2
19476,0,0,1,1,2
19477,0,2,0,0,2
19478,0,2,0,0,2
19479,0,2,0,0,2
19480,0,2,0,0,2
19481,0,2,0,0,2
19482,0,2,0,0,2
19483,0,2,0,0,2
19484,0,2,0,0,2
19485,0,2,0,0,2
19486,1,0,1,0,2
19487,1,1,0,0,2
19488,0,2,0,0,2
19489,0,2,0,0,2
19490,0,2,0,0,2
19491,0,1,1,0,2
19492,0,2,0,0,2
19493,0,2,0,0,2
19494,1,1,0,0,2
19495,0,2,0,0,2
19496,1,0,1,0,2
19497,1,1,0,0,2
19498,0,2,0,0,2
19499,0,2,0,0,2
19500,0,2,0,0,2
19501,0,2,0,0,2
19502,0,2,0,0,2
19503,0,2,0,0,2
19504,1,0,0,1,2
19505,0,2,0,0,2
19506,1,1,0,0,2
19507,0,2,0,0,2
19508,0,2,0,0,2
19509,0,2,0,0,2
19510,1,1,0,0,2
19511,0,1,0,1,2
19512,0,2,0,0,2
19513,0,2,0,0,2
19514,0,2,0,0,2
19515,1,0,0,1,2
19516,0,2,0,0,2
19517,1,1,0,0,2
19518,0,2,0,0,2
19519,0,2,0,0,2
19520,0,2,0,0,2
19521,0,2,0,0,2
19522,0,2,0,0,2
19523,0,2,0,0,2
19524,0,2,0,0,2
19525,0,2,0,0,2
19526,0,2,0,0,2
19527,1,1,0,0,2
19528,0,2,0,0,2
19529,0,2,0,0,2
19530,1,0,0,1,2
19531,0,2,0,0,2
19532,2,0,0,0,2
19533,0,2,0,0,2
19534,1,0,1,0,2
19535,1,1,0,0,2
19536,0,2,0,0,2
19537,0,2,0,0,2
19538,1,1,0,0,2
19539,1,1,0,0,2
19540,0,2,0,0,2
19541,0,2,0,0,2
19542,0,2,0,0,2
19543,2,0,0,0,2
19544,0,1,0,1,2
19545,0,2,0,0,2
19546,0,0,1,1,2
19547,0,2,0,0,2
19548,0,2,0,0,2
19549,1,1,0,0,2
19550,0,2,0,0,2
19551,0,2,0,0,2
19552,2,0,0,0,2
19553,0,2,0,0,2
19554,1,0,0,1,2
19555,0,2,0,0,2
19556,0,2,0,0,2
19557,0,2,0,0,2
19558,2,0,0,0,2
19559,0,2,0,0,2
19560,2,0,0,0,2
19561,0,2,0,0,2
19562,2,0,0,0,2
19563,0,2,0,0,2
19564,0,2,0,0,2
19565,0,2,0,0,2
19566,0,2,0,0,2
19567,0,2,0,0,2
19568,0,2,0,0,2
19569,0,2,0,0,2
19570,0,2,0,0,2
19571,0,2,0,0,2
19572,0,2,0,0,2
19573,0,2,0,0,2
19574,0,2,0,0,2
19575,0,2,0,0,2
19576,0,2,0,0,2
19577,0,2,0,0,2
19578,0,2,0,0,2
19579,1,1,0,0,2
19580,0,2,0,0,2
19581,0,2,0,0,2
19582,0,2,0,0,2
19583,1,0,1,0,2
19584,0,2,0,0,2
19585,0,2,0,0,2
19586,0,2,0,0,2
19587,0,2,0,0,2
19588,0,2,0,0,2
19589,0,2,0,0,2
19590,0,2,0,0,2
19591,0,2,0,0,2
19592,0,2,0,0,2
19593,0,2,0,0,2
19594,0,2,0,0,2
19595,0,2,0,0,2
19596,1,0,1,0,2
19597,2,0,0,0,2
19598,1,1,0,0,2
19599,0,2,0,0,2
19600,0,2,0,0,2
19601,0,2,0,0,2
19602,0,2,0,0,2
19603,0,2,0,0,2
19604,0,2,0,0,2
19605,0,2,0,0,2
19606,0,2,0,0,2
19607,2,0,0,0,2
19608,0,2,0,0,2
19609,1,1,0,0,2
19610,0,2,0,0,2
19611,0,2,0,0,2
19612,0,0,0,2,2
19613,2,0,0,0,2
19614,0,2,0,0,2
19615,0,2,0,0,2
19616,2,0,0,0,2
19617,0,2,0,0,2
19618,0,2,0,0,2
19619,0,2,0,0,2
19620,0,2,0,0,2
19621,0,2,0,0,2
19622,0,2,0,0,2
19623,0,2,0,0,2
19624,0,2,0,0,2
19625,0,2,0,0,2
19626,0,2,0,0,2
19627,0,2,0,0,2
19628,0,2,0,0,2
19629,0,2,0,0,2
19630,0,2,0,0,2
19631,0,2,0,0,2
19632,2,0,0,0,2
19633,0,1,1,0,2
19634,0,2,0,0,2
19635,1,1,0,0,2
19636,0,1,0,1,2
19637,0,2,0,0,2
19638,0,2,0,0,2
19639,0,2,0,0,2
19640,1,0,0,1,2
19641,1,0,0,1,2
19642,0,2,0,0,2
19643,0,0,0,2,2
19644,0,2,0,0,2
19645,0,2,0,0,2
19646,2,0,0,0,2
19647,0,2,0,0,2
19648,0,2,0,0,2
19649,0,2,0,0,2
19650,0,2,0,0,2
19651,0,2,0,0,2
19652,0,2,0,0,2
19653,0,2,0,0,2
19654,0,2,0,0,2
19655,2,0,0,0,2
19656,0,2,0,0,2
19657,0,1,1,0,2
19658,0,0,0,2,2
19659,0,2,0,0,2
19660,2,0,0,0,2
19661,1,1,0,0,2
19662,1,0,1,0,2
19663,0,2,0,0,2
19664,0,2,0,0,2
19665,0,2,0,0,2
19666,0,2,0,0,2
19667,0,2,0,0,2
19668,2,0,0,0,2
19669,2,0,0,0,2
19670,1,0,0,1,2
19671,1,0,0,1,2
19672,0,2,0,0,2
19673,1,1,0,0,2
19674,1,1,0,0,2
19675,0,2,0,0,2
19676,2,0,0,0,2
19677,0,2,0,0,2
19678,1,1,0,0,2
19679,0,2,0,0,2
19680,2,0,0,0,2
19681,0,2,0,0,2
19682,0,2,0,0,2
19683,0,2,0,0,2
19684,0,2,0,0,2
19685,0,2,0,0,2
19686,2,0,0,0,2
19687,1,0,0,1,2
19688,0,2,0,0,2
19689,0,2,0,0,2
19690,2,0,0,0,2
19691,0,2,0,0,2
19692,1,0,0,1,2
19693,0,1,0,1,2
19694,0,2,0,0,2
19695,1,1,0,0,2
19696,0,1,0,1,2
19697,0,2,0,0,2
19698,0,0,0,2,2
19699,0,2,0,0,2
19700,0,2,0,0,2
19701,0,2,0,0,2
19702,0,2,0,0,2
19703,0,2,0,0,2
19704,0,2,0,0,2
19705,0,2,0,0,2
19706,0,2,0,0,2
19707,0,2,0,0,2
19708,0,2,0,0,2
19709,0,2,0,0,2
19710,0,2,0,0,2
19711,0,2,0,0,2
19712,0,2,0,0,2
19713,0,2,0,0,2
19714,1,1,0,0,2
19715,0,2,0,0,2
19716,0,2,0,0,2
19717,0,2,0,0,2
19718,0,2,0,0,2
19719,0,2,0,0,2
19720,2,0,0,0,2
19721,0,2,0,0,2
19722,0,2,0,0,2
19723,0,2,0,0,2
19724,2,0,0,0,2
19725,0,2,0,0,2
19726,0,2,0,0,2
19727,1,1,0,0,2
19728,0,2,0,0,2
19729,0,2,0,0,2
19730,2,0,0,0,2
19731,1,0,0,1,2
19732,0,0,0,2,2
19733,0,2,0,0,2
19734,0,2,0,0,2
19735,1,1,0,0,2
19736,0,2,0,0,2
19737,2,0,0,0,2
19738,1,1,0,0,2
19739,0,2,0,0,2
19740,0,2,0,0,2
19741,0,2,0,0,2
19742,0,2,0,0,2
19743,0,2,0,0,2
19744,0,2,0,0,2
19745,1,1,0,0,2
19746,0,2,0,0,2
19747,1,1,0,0,2
19748,0,2,0,0,2
19749,1,0,0,1,2
19750,0,2,0,0,2
19751,0,2,0,0,2
19752,0,2,0,0,2
19753,1,1,0,0,2
19754,0,0,2,0,2
19755,2,0,0,0,2
19756,1,1,0,0,2
19757,0,0,1,1,2
19758,0,2,0,0,2
19759,0,0,0,2,2
19760,0,2,0,0,2
19761,0,1,0,1,2
19762,0,2,0,0,2
19763,0,2,0,0,2
19764,0,2,0,0,2
19765,0,2,0,0,2
19766,1,1,0,0,2
19767,0,2,0,0,2
19768,0,2,0,0,2
19769,0,2,0,0,2
19770,0,2,0,0,2
19771,0,2,0,0,2
19772,0,2,0,0,2
19773,0,2,0,0,2
19774,0,2,0,0,2
19775,0,2,0,0,2
19776,0,2,0,0,2
19777,0,2,0,0,2
19778,0,2,0,0,2
19779,0,2,0,0,2
19780,0,2,0,0,2
19781,2,0,0,0,2
19782,0,2,0,0,2
19783,0,2,0,0,2
19784,0,2,0,0,2
19785,2,0,0,0,2
19786,0,2,0,0,2
19787,1,1,0,0,2
19788,0,2,0,0,2
19789,0,2,0,0,2
19790,0,2,0,0,2
19791,0,2,0,0,2
19792,0,2,0,0,2
19793,0,2,0,0,2
19794,1,1,0,0,2
19795,0,2,0,0,2
19796,0,2,0,0,2
19797,0,2,0,0,2
19798,0,2,0,0,2
19799,0,2,0,0,2
19800,0,2,0,0,2
19801,0,2,0,0,2
19802,0,2,0,0,2
19803,0,2,0,0,2
19804,0,2,0,0,2
19805,2,0,0,0,2
19806,0,2,0,0,2
19807,0,2,0,0,2
19808,2,0,0,0,2
19809,0,2,0,0,2
19810,2,0,0,0,2
19811,0,2,0,0,2
19812,0,2,0,0,2
19813,2,0,0,0,2
19814,0,2,0,0,2
19815,2,0,0,0,2
19816,0,2,0,0,2
19817,1,1,0,0,2
19818,2,0,0,0,2
19819,0,2,0,0,2
19820,0,2,0,0,2
19821,1,0,0,1,2
19822,0,1,0,1,2
19823,1,0,0,1,2
19824,1,1,0,0,2
19825,0,2,0,0,2
19826,0,2,0,0,2
19827,0,2,0,0,2
19828,0,2,0,0,2
19829,0,0,0,2,2
19830,0,2,0,0,2
19831,1,1,0,0,2
19832,2,0,0,0,2
19833,0,2,0,0,2
19834,1,1,0,0,2
19835,0,2,0,0,2
19836,0,2,0,0,2
19837,0,0,0,2,2
19838,0,2,0,0,2
19839,1,1,0,0,2
19840,0,1,1,0,2
19841,0,2,0,0,2
19842,0,2,0,0,2
19843,0,2,0,0,2
19844,0,2,0,0,2
19845,0,2,0,0,2
19846,0,2,0,0,2
19847,0,2,0,0,2
19848,0,2,0,0,2
19849,0,2,0,0,2
19850,0,2,0,0,2
19851,0,2,0,0,2
19852,0,2,0,0,2
19853,0,2,0,0,2
19854,0,2,0,0,2
19855,0,2,0,0,2
19856,2,0,0,0,2
19857,1,0,1,0,2
19858,0,2,0,0,2
19859,0,2,0,0,2
19860,2,0,0,0,2
19861,0,2,0,0,2
19862,1,0,0,1,2
19863,0,2,0,0,2
19864,0,2,0,0,2
19865,0,2,0,0,2
19866,1,1,0,0,2
19867,0,2,0,0,2
19868,0,2,0,0,2
19869,2,0,0,0,2
19870,0,0,1,1,2
19871,0,2,0,0,2
19872,0,2,0,0,2
19873,0,1,1,0,2
19874,0,2,0,0,2
19875,2,0,0,0,2
19876,0,2,0,0,2
19877,2,0,0,0,2
19878,2,0,0,0,2
19879,1,1,0,0,2
19880,0,2,0,0,2
19881,0,2,0,0,2
19882,0,2,0,0,2
19883,0,2,0,0,2
19884,0,2,0,0,2
19885,0,1,1,0,2
19886,0,2,0,0,2
19887,0,2,0,0,2
19888,0,2,0,0,2
19889,0,2,0,0,2
19890,0,2,0,0,2
19891,0,2,0,0,2
19892,2,0,0,0,2
19893,2,0,0,0,2
19894,0,2,0,0,2
19895,0,2,0,0,2
19896,0,2,0,0,2
19897,2,0,0,0,2
19898,0,2,0,0,2
19899,1,0,1,0,2
19900,0,0,1,1,2
19901,0,2,0,0,2
19902,0,0,2,0,2
19903,0,2,0,0,2
19904,0,1,1,0,2
19905,0,2,0,0,2
19906,0,2,0,0,2
19907,2,0,0,0,2
19908,0,2,0,0,2
19909,0,2,0,0,2
19910,0,2,0,0,2
19911,0,2,0,0,2
19912,0,2,0,0,2
19913,0,2,0,0,2
19914,0,2,0,0,2
19915,0,2,0,0,2
19916,0,2,0,0,2
19917,0,2,0,0,2
19918,1,1,0,0,2
19919,0,2,0,0,2
19920,1,1,0,0,2
19921,0,2,0,0,2
19922,0,2,0,0,2
19923,0,2,0,0,2
19924,2,0,0,0,2
19925,0,2,0,0,2
19926,2,0,0,0,2
19927,0,2,0,0,2
19928,2,0,0,0,2
19929,0,2,0,0,2
19930,1,1,0,0,2
19931,0,2,0,0,2
19932,1,1,0,0,2
19933,2,0,0,0,2
19934,0,2,0,0,2
19935,1,1,0,0,2
19936,0,2,0,0,2
19937,1,1,0,0,2
19938,0,2,0,0,2
19939,0,2,0,0,2
19940,0,2,0,0,2
19941,0,2,0,0,2
19942,0,2,0,0,2
19943,0,2,0,0,2
19944,0,2,0,0,2
19945,0,2,0,0,2
19946,1,1,0,0,2
19947,0,2,0,0,2
19948,1,1,0,0,2
19949,0,0,0,2,2
19950,0,2,0,0,2
19951,2,0,0,0,2
19952,2,0,0,0,2
19953,0,2,0,0,2
19954,1,1,0,0,2
19955,0,2,0,0,2
19956,0,2,0,0,2
19957,1,1,0,0,2
19958,1,1,0,0,2
19959,0,2,0,0,2
19960,1,0,0,1,2
19961,1,1,0,0,2
19962,0,2,0,0,2
19963,0,1,1,0,2
19964,0,2,0,0,2
19965,0,1,1,0,2
19966,0,2,0,0,2
19967,0,1,0,1,2
19968,0,2,0,0,2
19969,0,2,0,0,2
19970,0,2,0,0,2
19971,0,2,0,0,2
19972,0,2,0,0,2
19973,0,2,0,0,2
19974,0,0,2,0,2
19975,0,2,0,0,2
19976,2,0,0,0,2
19977,2,0,0,0,2
19978,0,0,0,2,2
19979,0,2,0,0,2
19980,0,2,0,0,2
19981,0,2,0,0,2
19982,2,0,0,0,2
19983,0,2,0,0,2
19984,0,2,0,0,2
19985,0,2,0,0,2
19986,2,0,0,0,2
19987,1,1,0,0,2
19988,0,2,0,0,2
19989,0,2,0,0,2
19990,0,2,0,0,2
19991,0,2,0,0,2
19992,0,2,0,0,2
19993,0,2,0,0,2
19994,0,2,0,0,2
19995,0,2,0,0,2
19996,1,1,0,0,2
19997,0,2,0,0,2
19998,0,2,0,0,2
19999,0,0,1,1,2
20000,0,2,0,0,2
20001,0,1,0,1,2
20002,0,2,0,0,2
20003,1,1,0,0,2
20004,2,0,0,0,2
20005,1,1,0,0,2
20006,0,2,0,0,2
20007,0,2,0,0,2
20008,0,2,0,0,2
20009,1,1,0,0,2
20010,0,1,0,1,2
20011,0,2,0,0,2
20012,1,1,0,0,2
20013,0,2,0,0,2
20014,0,2,0,0,2
20015,0,0,0,2,2
20016,1,1,0,0,2
20017,0,2,0,0,2
20018,0,2,0,0,2
20019,2,0,0,0,2
20020,0,2,0,0,2
20021,0,2,0,0,2
20022,0,2,0,0,2
20023,0,2,0,0,2
20024,0,2,0,0,2
20025,1,1,0,0,2
20026,0,2,0,0,2
20027,0,2,0,0,2
20028,0,2,0,0,2
20029,0,2,0,0,2
20030,0,2,0,0,2
20031,0,2,0,0,2
20032,0,1,1,0,2
20033,1,0,1,0,2
20034,0,1,0,1,2
20035,1,0,1,0,2
20036,0,1,0,1,2
20037,0,0,1,1,2
20038,0,2,0,0,2
20039,0,2,0,0,2
20040,0,2,0,0,2
20041,0,0,0,2,2
20042,0,2,0,0,2
20043,1,1,0,0,2
20044,0,2,0,0,2
20045,1,1,0,0,2
20046,0,2,0,0,2
20047,0,2,0,0,2
20048,0,2,0,0,2
20049,0,2,0,0,2
20050,0,2,0,0,2
20051,0,2,0,0,2
20052,2,0,0,0,2
20053,0,2,0,0,2
20054,0,0,1,1,2
20055,0,2,0,0,2
20056,2,0,0,0,2
20057,0,1,0,1,2
20058,0,1,0,1,2
20059,0,2,0,0,2
20060,0,2,0,0,2
20061,0,2,0,0,2
20062,0,2,0,0,2
20063,0,2,0,0,2
20064,0,2,0,0,2
20065,0,2,0,0,2
20066,0,2,0,0,2
20067,0,2,0,0,2
20068,0,2,0,0,2
20069,0,2,0,0,2
20070,0,2,0,0,2
20071,1,1,0,0,2
20072,0,2,0,0,2
20073,1,1,0,0,2
20074,0,2,0,0,2
20075,2,0,0,0,2
20076,1,1,0,0,2
20077,0,2,0,0,2
20078,0,2,0,0,2
20079,0,2,0,0,2
20080,1,1,0,0,2
20081,0,2,0,0,2
20082,1,1,0,0,2
20083,0,2,0,0,2
20084,0,2,0,0,2
20085,1,1,0,0,2
20086,0,2,0,0,2
20087,0,2,0,0,2
20088,0,2,0,0,2
20089,0,2,0,0,2
20090,1,1,0,0,2
20091,0,2,0,0,2
20092,0,1,1,0,2
20093,0,2,0,0,2
20094,0,2,0,0,2
20095,0,0,0,2,2
20096,0,2,0,0,2
20097,1,0,0,1,2
20098,0,0,2,0,2
20099,0,2,0,0,2
20100,0,1,0,1,2
20101,1,1,0,0,2
20102,0,2,0,0,2
20103,0,2,0,0,2
20104,0,2,0,0,2
20105,0,2,0,0,2
20106,0,2,0,0,2
20107,0,2,0,0,2
20108,0,2,0,0,2
20109,2,0,0,0,2
20110,0,2,0,0,2
20111,1,1,0,0,2
20112,1,0,1,0,2
20113,0,2,0,0,2
20114,0,2,0,0,2
20115,0,0,0,2,2
20116,2,0,0,0,2
20117,2,0,0,0,2
20118,0,2,0,0,2
20119,0,1,0,1,2
20120,0,2,0,0,2
20121,0,2,0,0,2
20122,0,2,0,0,2
20123,2,0,0,0,2
20124,0,2,0,0,2
20125,0,2,0,0,2
20126,0,2,0,0,2
20127,0,2,0,0,2
20128,1,1,0,0,2
20129,0,2,0,0,2
20130,0,2,0,0,2
20131,0,2,0,0,2
20132,2,0,0,0,2
20133,1,1,0,0,2
20134,0,2,0,0,2
20135,0,2,0,0,2
20136,1,1,0,0,2
20137,0,2,0,0,2
20138,0,2,0,0,2
20139,2,0,0,0,2
20140,0,2,0,0,2
20141,0,2,0,0,2
20142,0,2,0,0,2
20143,0,0,0,2,2
20144,2,0,0,0,2
20145,1,0,0,1,2
20146,0,2,0,0,2
20147,2,0,0,0,2
20148,2,0,0,0,2
20149,0,2,0,0,2
20150,2,0,0,0,2
20151,0,2,0,0,2
20152,0,2,0,0,2
20153,1,1,0,0,2
20154,0,2,0,0,2
20155,0,2,0,0,2
20156,0,2,0,0,2
20157,0,2,0,0,2
20158,2,0,0,0,2
20159,0,2,0,0,2
20160,0,2,0,0,2
20161,0,2,0,0,2
20162,0,2,0,0,2
20163,0,0,0,2,2
20164,2,0,0,0,2
20165,1,1,0,0,2
20166,1,0,0,1,2
20167,1,1,0,0,2
20168,0,2,0,0,2
20169,0,2,0,0,2
20170,0,2,0,0,2
20171,0,2,0,0,2
20172,0,0,0,2,2
20173,2,0,0,0,2
20174,0,2,0,0,2
20175,1,0,0,1,2
20176,0,2,0,0,2
20177,0,2,0,0,2
20178,1,0,0,1,2
20179,0,2,0,0,2
20180,2,0,0,0,2
20181,0,2,0,0,2
20182,0,2,0,0,2
20183,1,0,1,0,2
20184,0,2,0,0,2
20185,1,1,0,0,2
20186,0,2,0,0,2
20187,0,2,0,0,2
20188,0,0,0,2,2
20189,2,0,0,0,2
20190,0,2,0,0,2
20191,0,2,0,0,2
20192,0,0,0,2,2
20193,0,2,0,0,2
20194,0,2,0,0,2
20195,0,2,0,0,2
20196,0,2,0,0,2
20197,1,0,0,1,2
20198,0,1,0,1,2
20199,0,2,0,0,2
20200,0,2,0,0,2
20201,0,2,0,0,2
20202,2,0,0,0,2
20203,0,2,0,0,2
20204,0,2,0,0,2
20205,1,1,0,0,2
20206,0,2,0,0,2
20207,1,1,0,0,2
20208,0,2,0,0,2
20209,0,2,0,0,2
20210,0,2,0,0,2
20211,0,2,0,0,2
20212,0,2,0,0,2
20213,0,2,0,0,2
20214,0,2,0,0,2
20215,0,2,0,0,2
20216,0,2,0,0,2
20217,0,2,0,0,2
20218,0,2,0,0,2
20219,2,0,0,0,2
20220,0,2,0,0,2
20221,0,0,2,0,2
20222,0,2,0,0,2
20223,0,2,0,0,2
20224,0,2,0,0,2
20225,0,2,0,0,2
20226,0,2,0,0,2
20227,0,2,0,0,2
20228,0,2,0,0,2
20229,0,2,0,0,2
20230,0,2,0,0,2
20231,1,1,0,0,2
20232,0,2,0,0,2
20233,0,0,0,2,2
20234,2,0,0,0,2
20235,0,2,0,0,2
20236,0,2,0,0,2
20237,2,0,0,0,2
20238,0,2,0,0,2
20239,0,2,0,0,2
20240,0,2,0,0,2
20241,0,2,0,0,2
20242,0,2,0,0,2
20243,0,2,0,0,2
20244,0,2,0,0,2
20245,0,2,0,0,2
20246,0,2,0,0,2
20247,0,1,1,0,2
20248,2,0,0,0,2
20249,0,2,0,0,2
20250,2,0,0,0,2
20251,0,2,0,0,2
20252,0,2,0,0,2
20253,0,2,0,0,2
20254,1,1,0,0,2
20255,0,2,0,0,2
20256,0,2,0,0,2
20257,1,1,0,0,2
20258,0,2,0,0,2
20259,0,2,0,0,2
20260,1,1,0,0,2
20261,0,1,1,0,2
20262,0,2,0,0,2
20263,0,2,0,0,2
20264,0,2,0,0,2
20265,0,2,0,0,2
20266,0,2,0,0,2
20267,0,2,0,0,2
20268,0,2,0,0,2
20269,0,2,0,0,2
20270,0,2,0,0,2
20271,2,0,0,0,2
20272,0,2,0,0,2
20273,0,2,0,0,2
20274,1,1,0,0,2
20275,0,2,0,0,2
20276,2,0,0,0,2
20277,0,2,0,0,2
20278,0,2,0,0,2
20279,1,0,0,1,2
20280,0,2,0,0,2
20281,0,2,0,0,2
20282,2,0,0,0,2
20283,0,2,0,0,2
20284,0,2,0,0,2
20285,0,1,1,0,2
20286,0,1,0,1,2
20287,0,2,0,0,2
20288,0,2,0,0,2
20289,0,2,0,0,2
20290,0,2,0,0,2
20291,0,2,0,0,2
20292,1,1,0,0,2
20293,2,0,0,0,2
20294,0,2,0,0,2
20295,0,2,0,0,2
20296,0,2,0,0,2
20297,0,2,0,0,2
20298,0,2,0,0,2
20299,0,2,0,0,2
20300,0,2,0,0,2
20301,0,2,0,0,2
20302,0,2,0,0,2
20303,0,2,0,0,2
20304,1,0,1,0,2
20305,0,2,0,0,2
20306,0,2,0,0,2
20307,2,0,0,0,2
20308,0,2,0,0,2
20309,0,2,0,0,2
20310,0,2,0,0,2
20311,0,1,1,0,2
20312,0,2,0,0,2
20313,0,2,0,0,2
20314,0,2,0,0,2
20315,0,2,0,0,2
20316,0,1,1,0,2
20317,1,1,0,0,2
20318,0,2,0,0,2
20319,0,2,0,0,2
20320,0,2,0,0,2
20321,0,2,0,0,2
20322,0,2,0,0,2
20323,1,1,0,0,2
20324,1,1,0,0,2
20325,0,2,0,0,2
20326,2,0,0,0,2
20327,0,2,0,0,2
20328,0,2,0,0,2
20329,1,0,1,0,2
20330,1,0,0,1,2
20331,1,1,0,0,2
20332,2,0,0,0,2
20333,0,2,0,0,2
20334,0,2,0,0,2
20335,0,2,0,0,2
20336,2,0,0,0,2
20337,0,2,0,0,2
20338,0,2,0,0,2
20339,0,2,0,0,2
20340,0,2,0,0,2
20341,0,2,0,0,2
20342,0,2,0,0,2
20343,0,1,0,1,2
20344,0,2,0,0,2
20345,0,2,0,0,2
20346,1,1,0,0,2
20347,2,0,0,0,2
20348,0,0,1,1,2
20349,0,2,0,0,2
20350,0,2,0,0,2
20351,0,2,0,0,2
20352,0,2,0,0,2
20353,0,2,0,0,2
20354,0,2,0,0,2
20355,0,2,0,0,2
20356,0,2,0,0,2
20357,0,2,0,0,2
20358,0,2,0,0,2
20359,0,2,0,0,2
20360,0,2,0,0,2
20361,0,2,0,0,2
20362,0,2,0,0,2
20363,0,2,0,0,2
20364,0,2,0,0,2
20365,0,2,0,0,2
20366,0,2,0,0,2
20367,2,0,0,0,2
20368,0,2,0,0,2
20369,1,1,0,0,2
20370,0,2,0,0,2
20371,1,1,0,0,2
20372,0,2,0,0,2
20373,0,2,0,0,2
20374,1,1,0,0,2
20375,2,0,0,0,2
20376,0,2,0,0,2
20377,0,2,0,0,2
20378,0,2,0,0,2
20379,0,2,0,0,2
20380,0,2,0,0,2
20381,0,2,0,0,2
20382,1,0,0,0,1
20383,1,0,0,0,1
20384,0,0,1,0,1
20385,0,1,0,0,1
20386,0,1,0,0,1
20387,0,1,0,0,1
20388,0,1,0,0,1
20389,0,1,0,0,1
20390,0,1,0,0,1
20391,0,1,0,0,1
20392,0,1,0,0,1
20393,0,1,0,0,1
20394,0,1,0,0,1
20395,0,1,0,0,1
20396,0,1,0,0,1
20397,0,1,0,0,1
20398,0,1,0,0,1
20399,0,1,0,0,1
20400,1,0,0,0,1
20401,1,0,0,0,1
20402,0,1,0,0,1
20403,0,1,0,0,1
20404,0,1,0,0,1
20405,0,0,0,1,1
20406,1,0,0,0,1
20407,0,1,0,0,1
20408,1,0,0,0,1
20409,1,0,0,0,1
20410,0,1,0,0,1
20411,0,0,0,1,1
20412,0,1,0,0,1
20413,0,1,0,0,1
20414,0,1,0,0,1
20415,0,1,0,0,1
20416,0,1,0,0,1
20417,0,1,0,0,1
20418,0,1,0,0,1
20419,0,1,0,0,1
20420,0,1,0,0,1
20421,0,1,0,0,1
20422,1,0,0,0,1
20423,0,1,0,0,1
20424,0,1,0,0,1
20425,0,1,0,0,1
20426,1,0,0,0,1
20427,0,1,0,0,1
20428,0,1,0,0,1
20429,0,1,0,0,1
20430,0,1,0,0,1
20431,0,1,0,0,1
20432,0,1,0,0,1
20433,0,1,0,0,1
20434,0,1,0,0,1
20435,0,0,1,0,1
20436,0,1,0,0,1
20437,1,0,0,0,1
20438,0,1,0,0,1
20439,1,0,0,0,1
20440,0,1,0,0,1
20441,0,1,0,0,1
20442,0,1,0,0,1
20443,0,1,0,0,1
20444,0,1,0,0,1
20445,1,0,0,0,1
20446,0,1,0,0,1
20447,0,1,0,0,1
20448,0,0,0,1,1
20449,1,0,0,0,1
20450,0,1,0,0,1
20451,0,1,0,0,1
20452,0,1,0,0,1
20453,1,0,0,0,1
20454,0,1,0,0,1
20455,0,1,0,0,1
20456,0,1,0,0,1
20457,0,1,0,0,1
20458,0,1,0,0,1
20459,0,1,0,0,1
20460,0,1,0,0,1
20461,1,0,0,0,1
20462,0,1,0,0,1
20463,0,1,0,0,1
20464,0,1,0,0,1
20465,0,1,0,0,1
20466,0,1,0,0,1
20467,1,0,0,0,1
20468,0,1,0,0,1
20469,0,1,0,0,1
20470,0,1,0,0,1
20471,0,1,0,0,1
20472,0,1,0,0,1
20473,0,1,0,0,1
20474,1,0,0,0,1
20475,0,0,1,0,1
20476,0,1,0,0,1
20477,0,1,0,0,1
20478,0,1,0,0,1
20479,0,1,0,0,1
20480,0,0,0,1,1
20481,0,1,0,0,1
20482,0,1,0,0,1
20483,0,0,1,0,1
20484,0,1,0,0,1
20485,0,1,0,0,1
20486,0,0,1,0,1
20487,0,1,0,0,1
20488,0,1,0,0,1
20489,0,1,0,0,1
20490,0,1,0,0,1
20491,0,1,0,0,1
20492,1,0,0,0,1
20493,0,1,0,0,1
20494,0,1,0,0,1
20495,0,1,0,0,1
20496,0,1,0,0,1
20497,0,1,0,0,1
20498,0,1,0,0,1
20499,0,0,1,0,1
20500,0,1,0,0,1
20501,0,1,0,0,1
20502,0,1,0,0,1
20503,0,1,0,0,1
20504,0,1,0,0,1
20505,1,0,0,0,1
20506,0,1,0,0,1
20507,0,1,0,0,1
20508,0,1,0,0,1
20509,0,1,0,0,1
20510,0,1,0,0,1
20511,0,1,0,0,1
20512,0,1,0,0,1
20513,0,1,0,0,1
20514,0,1,0,0,1
20515,0,1,0,0,1
20516,0,1,0,0,1
20517,0,0,0,1,1
20518,0,1,0,0,1
20519,0,1,0,0,1
20520,0,1,0,0,1
20521,0,1,0,0,1
20522,1,0,0,0,1
20523,1,0,0,0,1
20524,0,1,0,0,1
20525,1,0,0,0,1
20526,0,1,0,0,1
20527,0,1,0,0,1
20528,0,1,0,0,1
20529,0,1,0,0,1
20530,0,1,0,0,1
20531,0,1,0,0,1
20532,0,1,0,0,1
20533,0,0,1,0,1
20534,0,1,0,0,1
20535,0,1,0,0,1
20536,0,1,0,0,1
20537,0,1,0,0,1
20538,0,1,0,0,1
20539,0,1,0,0,1
20540,0,1,0,0,1
20541,0,1,0,0,1
20542,0,1,0,0,1
20543,0,1,0,0,1
20544,0,1,0,0,1
20545,0,1,0,0,1
20546,0,1,0,0,1
20547,0,1,0,0,1
20548,0,1,0,0,1
20549,0,1,0,0,1
20550,0,0,1,0,1
20551,0,1,0,0,1
20552,1,0,0,0,1
20553,0,1,0,0,1
20554,0,1,0,0,1
20555,0,1,0,0,1
20556,0,1,0,0,1
20557,0,1,0,0,1
20558,0,1,0,0,1
20559,0,1,0,0,1
20560,0,1,0,0,1
20561,0,1,0,0,1
20562,0,1,0,0,1
20563,0,1,0,0,1
20564,0,1,0,0,1
20565,0,1,0,0,1
20566,0,1,0,0,1
20567,0,1,0,0,1
20568,0,1,0,0,1
20569,0,1,0,0,1
20570,0,1,0,0,1
20571,1,0,0,0,1
20572,0,1,0,0,1
20573,0,1,0,0,1
20574,0,1,0,0,1
20575,0,1,0,0,1
20576,0,1,0,0,1
20577,0,1,0,0,1
20578,0,1,0,0,1
20579,0,1,0,0,1
20580,1,0,0,0,1
20581,0,1,0,0,1
20582,0,1,0,0,1
20583,0,1,0,0,1
20584,0,1,0,0,1
20585,0,1,0,0,1
20586,0,1,0,0,1
20587,0,1,0,0,1
20588,1,0,0,0,1
20589,0,1,0,0,1
20590,1,0,0,0,1
20591,0,1,0,0,1
20592,0,1,0,0,1
20593,0,0,0,1,1
20594,0,1,0,0,1
20595,0,1,0,0,1
20596,0,1,0,0,1
20597,0,1,0,0,1
20598,1,0,0,0,1
20599,1,0,0,0,1
20600,0,1,0,0,1
20601,1,0,0,0,1
20602,0,1,0,0,1
20603,0,1,0,0,1
20604,0,1,0,0,1
20605,0,1,0,0,1
20606,0,1,0,0,1
20607,0,1,0,0,1
20608,0,1,0,0,1
20609,1,0,0,0,1
20610,1,0,0,0,1
20611,0,1,0,0,1
20612,1,0,0,0,1
20613,0,1,0,0,1
20614,0,1,0,0,1
20615,0,1,0,0,1
20616,0,1,0,0,1
20617,0,1,0,0,1
20618,1,0,0,0,1
20619,0,0,1,0,1
20620,0,0,1,0,1
20621,0,1,0,0,1
20622,0,1,0,0,1
20623,0,1,0,0,1
20624,0,1,0,0,1
20625,0,1,0,0,1
20626,0,1,0,0,1
20627,0,1,0,0,1
20628,0,1,0,0,1
20629,0,1,0,0,1
20630,0,1,0,0,1
20631,0,1,0,0,1
20632,0,1,0,0,1
20633,0,1,0,0,1
20634,0,1,0,0,1
20635,0,1,0,0,1
20636,1,0,0,0,1
20637,0,1,0,0,1
20638,0,1,0,0,1
20639,0,1,0,0,1
20640,0,1,0,0,1
20641,0,1,0,0,1
20642,0,1,0,0,1
20643,0,1,0,0,1
20644,0,1,0,0,1
20645,1,0,0,0,1
20646,0,1,0,0,1
20647,0,1,0,0,1
20648,0,1,0,0,1
20649,0,1,0,0,1
20650,0,1,0,0,1
20651,0,1,0,0,1
20652,0,0,0,1,1
20653,0,1,0,0,1
20654,0,1,0,0,1
20655,0,1,0,0,1
20656,0,1,0,0,1
20657,1,0,0,0,1
20658,0,1,0,0,1
20659,0,1,0,0,1
20660,0,1,0,0,1
20661,0,1,0,0,1
20662,1,0,0,0,1
20663,0,1,0,0,1
20664,0,1,0,0,1
20665,0,1,0,0,1
20666,0,1,0,0,1
20667,0,0,1,0,1
20668,0,1,0,0,1
20669,0,1,0,0,1
20670,0,1,0,0,1
20671,1,0,0,0,1
20672,0,1,0,0,1
20673,0,1,0,0,1
20674,0,1,0,0,1
20675,0,1,0,0,1
20676,0,1,0,0,1
20677,1,0,0,0,1
20678,0,1,0,0,1
20679,0,1,0,0,1
20680,0,1,0,0,1
20681,0,1,0,0,1
20682,0,1,0,0,1
20683,0,1,0,0,1
20684,0,1,0,0,1
20685,0,1,0,0,1
20686,1,0,0,0,1
20687,0,1,0,0,1
20688,1,0,0,0,1
20689,1,0,0,0,1
20690,0,1,0,0,1
20691,0,1,0,0,1
20692,1,0,0,0,1
20693,0,1,0,0,1
20694,0,0,0,1,1
20695,0,1,0,0,1
20696,0,1,0,0,1
20697,1,0,0,0,1
20698,0,1,0,0,1
20699,0,1,0,0,1
20700,0,1,0,0,1
20701,0,1,0,0,1
20702,0,1,0,0,1
20703,0,1,0,0,1
20704,0,1,0,0,1
20705,0,1,0,0,1
20706,0,1,0,0,1
20707,0,1,0,0,1
20708,0,1,0,0,1
20709,1,0,0,0,1
20710,0,1,0,0,1
20711,0,1,0,0,1
20712,0,1,0,0,1
20713,0,0,0,1,1
20714,0,1,0,0,1
20715,1,0,0,0,1
20716,0,1,0,0,1
20717,0,1,0,0,1
20718,0,1,0,0,1
20719,0,0,1,0,1
20720,0,1,0,0,1
20721,0,1,0,0,1
20722,0,1,0,0,1
20723,0,1,0,0,1
20724,0,1,0,0,1
20725,0,1,0,0,1
20726,0,0,0,1,1
20727,0,1,0,0,1
20728,0,1,0,0,1
20729,0,1,0,0,1
20730,0,1,0,0,1
20731,0,1,0,0,1
20732,0,1,0,0,1
20733,0,1,0,0,1
20734,0,1,0,0,1
20735,0,1,0,0,1
20736,0,1,0,0,1
20737,1,0,0,0,1
20738,0,1,0,0,1
20739,0,1,0,0,1
20740,0,1,0,0,1
20741,0,0,0,1,1
20742,0,1,0,0,1
20743,0,1,0,0,1
20744,0,1,0,0,1
20745,0,1,0,0,1
20746,0,1,0,0,1
20747,0,1,0,0,1
20748,0,1,0,0,1
20749,0,1,0,0,1
20750,1,0,0,0,1
20751,0,1,0,0,1
20752,1,0,0,0,1
20753,1,0,0,0,1
20754,0,1,0,0,1
20755,0,1,0,0,1
20756,0,1,0,0,1
20757,0,1,0,0,1
20758,0,1,0,0,1
20759,0,1,0,0,1
20760,0,1,0,0,1
20761,0,1,0,0,1
20762,0,1,0,0,1
20763,0,1,0,0,1
20764,0,1,0,0,1
20765,0,1,0,0,1
20766,0,1,0,0,1
20767,0,0,0,1,1
20768,0,1,0,0,1
20769,0,1,0,0,1
20770,1,0,0,0,1
20771,0,1,0,0,1
20772,0,1,0,0,1
20773,0,1,0,0,1
20774,0,1,0,0,1
20775,1,0,0,0,1
20776,0,1,0,0,1
20777,1,0,0,0,1
20778,1,0,0,0,1
20779,0,1,0,0,1
20780,0,1,0,0,1
20781,0,0,1,0,1
20782,0,1,0,0,1
20783,0,1,0,0,1
20784,0,1,0,0,1
20785,0,1,0,0,1
20786,0,1,0,0,1
20787,0,0,1,0,1
20788,0,1,0,0,1
20789,0,1,0,0,1
20790,1,0,0,0,1
20791,0,1,0,0,1
20792,0,1,0,0,1
20793,0,1,0,0,1
20794,1,0,0,0,1
20795,0,1,0,0,1
20796,0,1,0,0,1
20797,0,1,0,0,1
20798,0,1,0,0,1
20799,0,1,0,0,1
20800,0,1,0,0,1
20801,0,0,0,1,1
20802,0,1,0,0,1
20803,0,1,0,0,1
20804,0,1,0,0,1
20805,0,1,0,0,1
20806,0,1,0,0,1
20807,0,0,0,1,1
20808,0,1,0,0,1
20809,0,1,0,0,1
20810,0,1,0,0,1
20811,0,1,0,0,1
20812,0,1,0,0,1
20813,1,0,0,0,1
20814,0,1,0,0,1
20815,1,0,0,0,1
20816,0,1,0,0,1
20817,0,1,0,0,1
20818,0,1,0,0,1
20819,0,1,0,0,1
20820,0,1,0,0,1
20821,0,1,0,0,1
20822,0,1,0,0,1
20823,0,1,0,0,1
20824,0,0,0,1,1
20825,1,0,0,0,1
20826,1,0,0,0,1
20827,0,0,0,1,1
20828,1,0,0,0,1
20829,0,1,0,0,1
20830,1,0,0,0,1
20831,0,1,0,0,1
20832,1,0,0,0,1
20833,0,0,0,1,1
20834,0,1,0,0,1
20835,0,1,0,0,1
20836,1,0,0,0,1
20837,0,1,0,0,1
20838,0,1,0,0,1
20839,0,1,0,0,1
20840,0,1,0,0,1
20841,0,1,0,0,1
20842,1,0,0,0,1
20843,0,1,0,0,1
20844,1,0,0,0,1
20845,0,0,0,1,1
20846,0,1,0,0,1
20847,1,0,0,0,1
20848,0,0,0,1,1
20849,0,1,0,0,1
20850,0,1,0,0,1
20851,0,1,0,0,1
20852,0,1,0,0,1
20853,0,1,0,0,1
20854,0,1,0,0,1
20855,1,0,0,0,1
20856,1,0,0,0,1
20857,0,1,0,0,1
20858,0,1,0,0,1
20859,0,1,0,0,1
20860,0,1,0,0,1
20861,0,1,0,0,1
20862,0,0,1,0,1
20863,0,1,0,0,1
20864,0,1,0,0,1
20865,0,1,0,0,1
20866,0,1,0,0,1
20867,0,1,0,0,1
20868,0,1,0,0,1
20869,0,1,0,0,1
20870,0,0,1,0,1
20871,0,1,0,0,1
20872,0,1,0,0,1
20873,0,1,0,0,1
20874,0,0,0,1,1
20875,0,1,0,0,1
20876,0,1,0,0,1
20877,0,1,0,0,1
20878,0,1,0,0,1
20879,0,1,0,0,1
20880,0,1,0,0,1
20881,0,1,0,0,1
20882,0,1,0,0,1
20883,1,0,0,0,1
20884,0,1,0,0,1
20885,1,0,0,0,1
20886,0,1,0,0,1
20887,0,1,0,0,1
20888,0,1,0,0,1
20889,0,0,0,1,1
20890,0,0,0,1,1
20891,0,1,0,0,1
20892,0,1,0,0,1
20893,0,1,0,0,1
20894,1,0,0,0,1
20895,1,0,0,0,1
20896,0,1,0,0,1
20897,0,1,0,0,1
20898,1,0,0,0,1
20899,0,1,0,0,1
20900,1,0,0,0,1
20901,0,1,0,0,1
20902,1,0,0,0,1
20903,0,1,0,0,1
20904,0,0,0,1,1
20905,0,1,0,0,1
20906,1,0,0,0,1
20907,0,1,0,0,1
20908,0,1,0,0,1
20909,0,1,0,0,1
20910,0,1,0,0,1
20911,0,1,0,0,1
20912,0,1,0,0,1
20913,0,1,0,0,1
20914,0,1,0,0,1
20915,1,0,0,0,1
20916,0,1,0,0,1
20917,0,0,0,1,1
20918,0,1,0,0,1
20919,0,1,0,0,1
20920,0,1,0,0,1
20921,0,1,0,0,1
20922,0,1,0,0,1
20923,0,1,0,0,1
20924,0,1,0,0,1
20925,0,1,0,0,1
20926,0,1,0,0,1
20927,0,1,0,0,1
20928,0,1,0,0,1
20929,0,1,0,0,1
20930,0,1,0,0,1
20931,1,0,0,0,1
20932,0,0,0,1,1
20933,1,0,0,0,1
20934,0,1,0,0,1
20935,0,0,0,1,1
20936,0,1,0,0,1
20937,0,1,0,0,1
20938,0,1,0,0,1
20939,0,1,0,0,1
20940,0,1,0,0,1
20941,0,1,0,0,1
20942,0,1,0,0,1
20943,0,1,0,0,1
20944,0,1,0,0,1
20945,0,1,0,0,1
20946,0,1,0,0,1
20947,0,0,1,0,1
20948,1,0,0,0,1
20949,0,1,0,0,1
20950,0,1,0,0,1
20951,0,1,0,0,1
20952,0,1,0,0,1
20953,0,0,1,0,1
20954,1,0,0,0,1
20955,0,0,0,1,1
20956,0,1,0,0,1
20957,0,1,0,0,1
20958,0,1,0,0,1
20959,0,1,0,0,1
20960,0,1,0,0,1
20961,0,1,0,0,1
20962,0,1,0,0,1
20963,0,1,0,0,1
20964,0,1,0,0,1
20965,1,0,0,0,1
20966,0,1,0,0,1
20967,0,1,0,0,1
20968,1,0,0,0,1
20969,0,1,0,0,1
20970,0,1,0,0,1
20971,0,1,0,0,1
20972,0,1,0,0,1
20973,0,1,0,0,1
20974,1,0,0,0,1
20975,0,1,0,0,1
20976,0,1,0,0,1
20977,0,1,0,0,1
20978,0,1,0,0,1
20979,1,0,0,0,1
20980,0,1,0,0,1
20981,1,0,0,0,1
20982,0,1,0,0,1
20983,1,0,0,0,1
20984,0,1,0,0,1
20985,0,1,0,0,1
20986,0,1,0,0,1
20987,0,1,0,0,1
20988,1,0,0,0,1
20989,0,1,0,0,1
20990,0,1,0,0,1
20991,0,1,0,0,1
20992,0,1,0,0,1
20993,0,1,0,0,1
20994,0,1,0,0,1
20995,0,1,0,0,1
20996,0,1,0,0,1
20997,0,1,0,0,1
20998,0,1,0,0,1
20999,0,1,0,0,1
21000,0,1,0,0,1
21001,0,1,0,0,1
21002,0,1,0,0,1
21003,0,1,0,0,1
21004,0,1,0,0,1
21005,0,1,0,0,1
21006,0,1,0,0,1
21007,0,1,0,0,1
21008,0,1,0,0,1
21009,0,1,0,0,1
21010,0,1,0,0,1
21011,0,1,0,0,1
21012,0,1,0,0,1
21013,1,0,0,0,1
21014,0,1,0,0,1
21015,0,1,0,0,1
21016,0,1,0,0,1
21017,0,1,0,0,1
21018,0,1,0,0,1
21019,0,1,0,0,1
21020,1,0,0,0,1
21021,0,1,0,0,1
21022,0,1,0,0,1
21023,0,0,0,1,1
21024,0,1,0,0,1
21025,0,1,0,0,1
21026,0,1,0,0,1
21027,0,1,0,0,1
21028,0,1,0,0,1
21029,0,1,0,0,1
21030,0,1,0,0,1
21031,0,1,0,0,1
21032,0,1,0,0,1
21033,0,1,0,0,1
21034,0,1,0,0,1
21035,0,1,0,0,1
21036,0,0,1,0,1
21037,0,1,0,0,1
21038,0,1,0,0,1
21039,0,1,0,0,1
21040,0,1,0,0,1
21041,0,1,0,0,1
21042,0,1,0,0,1
21043,0,1,0,0,1
21044,0,1,0,0,1
21045,0,1,0,0,1
21046,0,1,0,0,1
21047,0,1,0,0,1
21048,0,1,0,0,1
21049,0,1,0,0,1
21050,0,1,0,0,1
21051,0,1,0,0,1
21052,1,0,0,0,1
21053,0,1,0,0,1
21054,0,1,0,0,1
21055,0,1,0,0,1
21056,0,1,0,0,1
21057,1,0,0,0,1
21058,0,1,0,0,1
21059,0,1,0,0,1
21060,0,1,0,0,1
21061,0,1,0,0,1
21062,0,1,0,0,1
21063,1,0,0,0,1
21064,0,1,0,0,1
21065,0,1,0,0,1
21066,0,1,0,0,1
21067,0,1,0,0,1
21068,0,1,0,0,1
21069,0,1,0,0,1
21070,0,1,0,0,1
21071,0,1,0,0,1
21072,0,1,0,0,1
21073,0,1,0,0,1
21074,1,0,0,0,1
21075,0,1,0,0,1
21076,0,1,0,0,1
21077,0,1,0,0,1
21078,0,1,0,0,1
21079,0,1,0,0,1
21080,0,1,0,0,1
21081,0,1,0,0,1
21082,1,0,0,0,1
21083,0,1,0,0,1
21084,0,1,0,0,1
21085,0,1,0,0,1
21086,1,0,0,0,1
21087,0,1,0,0,1
21088,1,0,0,0,1
21089,0,1,0,0,1
21090,0,1,0,0,1
21091,0,1,0,0,1
21092,0,1,0,0,1
21093,0,1,0,0,1
21094,0,1,0,0,1
21095,0,1,0,0,1
21096,0,1,0,0,1
21097,0,1,0,0,1
21098,0,1,0,0,1
21099,0,1,0,0,1
21100,1,0,0,0,1
21101,0,1,0,0,1
21102,1,0,0,0,1
21103,1,0,0,0,1
21104,1,0,0,0,1
21105,0,1,0,0,1
21106,0,1,0,0,1
21107,1,0,0,0,1
21108,0,1,0,0,1
21109,0,1,0,0,1
21110,0,1,0,0,1
21111,0,1,0,0,1
21112,0,1,0,0,1
21113,0,1,0,0,1
21114,0,1,0,0,1
21115,0,1,0,0,1
21116,0,1,0,0,1
21117,0,1,0,0,1
21118,0,1,0,0,1
21119,0,1,0,0,1
21120,0,1,0,0,1
21121,0,1,0,0,1
21122,0,1,0,0,1
21123,0,1,0,0,1
21124,0,1,0,0,1
21125,0,1,0,0,1
21126,0,1,0,0,1
21127,0,1,0,0,1
21128,0,1,0,0,1
21129,0,1,0,0,1
21130,0,1,0,0,1
21131,0,1,0,0,1
21132,1,0,0,0,1
21133,0,1,0,0,1
21134,0,1,0,0,1
21135,0,1,0,0,1
21136,0,1,0,0,1
21137,0,1,0,0,1
21138,0,1,0,0,1
21139,0,1,0,0,1
21140,0,1,0,0,1
21141,0,1,0,0,1
21142,0,1,0,0,1
21143,1,0,0,0,1
21144,0,1,0,0,1
21145,1,0,0,0,1
21146,1,0,0,0,1
21147,0,1,0,0,1
21148,0,1,0,0,1
21149,0,1,0,0,1
21150,0,1,0,0,1
21151,0,1,0,0,1
21152,1,0,0,0,1
21153,0,1,0,0,1
21154,0,1,0,0,1
21155,0,1,0,0,1
21156,0,1,0,0,1
21157,0,0,0,1,1
21158,0,1,0,0,1
21159,0,1,0,0,1
21160,0,1,0,0,1
21161,0,1,0,0,1
21162,0,1,0,0,1
21163,0,1,0,0,1
21164,0,1,0,0,1
21165,0,1,0,0,1
21166,0,1,0,0,1
21167,0,1,0,0,1
21168,0,1,0,0,1
21169,1,0,0,0,1
21170,0,1,0,0,1
21171,0,1,0,0,1
21172,1,0,0,0,1
21173,0,1,0,0,1
21174,0,1,0,0,1
21175,0,1,0,0,1
21176,0,0,0,1,1
21177,0,1,0,0,1
21178,0,1,0,0,1
21179,1,0,0,0,1
21180,0,1,0,0,1
21181,0,1,0,0,1
21182,0,1,0,0,1
21183,0,1,0,0,1
21184,1,0,0,0,1
21185,0,1,0,0,1
21186,0,1,0,0,1
21187,0,1,0,0,1
21188,0,1,0,0,1
21189,0,1,0,0,1
21190,0,1,0,0,1
21191,1,0,0,0,1
21192,1,0,0,0,1
21193,1,0,0,0,1
21194,0,1,0,0,1
21195,0,1,0,0,1
21196,0,1,0,0,1
21197,0,1,0,0,1
21198,0,1,0,0,1
21199,0,0,1,0,1
21200,1,0,0,0,1
21201,0,1,0,0,1
21202,0,1,0,0,1
21203,0,1,0,0,1
21204,0,1,0,0,1
21205,0,1,0,0,1
21206,0,0,0,1,1
21207,0,1,0,0,1
21208,0,1,0,0,1
21209,1,0,0,0,1
21210,0,1,0,0,1
21211,0,1,0,0,1
21212,0,1,0,0,1
21213,0,1,0,0,1
21214,0,1,0,0,1
21215,1,0,0,0,1
21216,0,1,0,0,1
21217,0,1,0,0,1
21218,0,1,0,0,1
21219,0,1,0,0,1
21220,0,1,0,0,1
21221,0,1,0,0,1
21222,0,1,0,0,1
21223,0,1,0,0,1
21224,0,1,0,0,1
21225,0,0,0,1,1
21226,0,1,0,0,1
21227,0,1,0,0,1
21228,0,1,0,0,1
21229,0,1,0,0,1
21230,0,1,0,0,1
21231,0,1,0,0,1
21232,0,1,0,0,1
21233,0,1,0,0,1
21234,0,1,0,0,1
21235,0,1,0,0,1
21236,0,1,0,0,1
21237,0,1,0,0,1
21238,0,1,0,0,1
21239,0,1,0,0,1
21240,0,1,0,0,1
21241,0,1,0,0,1
21242,1,0,0,0,1
21243,0,0,0,1,1
21244,0,1,0,0,1
21245,0,1,0,0,1
21246,0,1,0,0,1
21247,0,1,0,0,1
21248,0,1,0,0,1
21249,0,1,0,0,1
21250,0,1,0,0,1
21251,0,1,0,0,1
21252,0,1,0,0,1
21253,0,1,0,0,1
21254,0,1,0,0,1
21255,0,1,0,0,1
21256,0,1,0,0,1
21257,0,1,0,0,1
21258,0,1,0,0,1
21259,0,1,0,0,1
21260,0,1,0,0,1
21261,1,0,0,0,1
21262,0,1,0,0,1
21263,0,1,0,0,1
21264,0,1,0,0,1
21265,0,1,0,0,1
21266,0,1,0,0,1
21267,0,1,0,0,1
21268,0,1,0,0,1
21269,0,1,0,0,1
21270,0,1,0,0,1
21271,0,1,0,0,1
21272,0,1,0,0,1
21273,1,0,0,0,1
21274,0,1,0,0,1
21275,0,1,0,0,1
21276,0,0,0,1,1
21277,1,0,0,0,1
21278,0,0,1,0,1
21279,0,1,0,0,1
21280,0,1,0,0,1
21281,1,0,0,0,1
21282,0,1,0,0,1
21283,0,1,0,0,1
21284,0,0,0,1,1
21285,0,1,0,0,1
21286,1,0,0,0,1
21287,0,1,0,0,1
21288,0,1,0,0,1
21289,0,1,0,0,1
21290,0,1,0,0,1
21291,0,1,0,0,1
21292,1,0,0,0,1
21293,1,0,0,0,1
21294,0,1,0,0,1
21295,0,1,0,0,1
21296,0,1,0,0,1
21297,0,1,0,0,1
21298,0,1,0,0,1
21299,1,0,0,0,1
21300,0,1,0,0,1
21301,0,1,0,0,1
21302,0,1,0,0,1
21303,0,1,0,0,1
21304,0,1,0,0,1
21305,0,1,0,0,1
21306,0,1,0,0,1
21307,0,1,0,0,1
21308,0,0,1,0,1
21309,0,1,0,0,1
21310,0,1,0,0,1
21311,1,0,0,0,1
21312,0,1,0,0,1
21313,0,1,0,0,1
21314,0,1,0,0,1
21315,0,1,0,0,1
21316,0,1,0,0,1
21317,0,0,1,0,1
21318,0,1,0,0,1
21319,0,1,0,0,1
21320,1,0,0,0,1
21321,0,1,0,0,1
21322,0,1,0,0,1
21323,0,1,0,0,1
21324,0,1,0,0,1
21325,0,0,0,1,1
21326,0,1,0,0,1
21327,0,1,0,0,1
21328,0,1,0,0,1
21329,1,0,0,0,1
21330,0,1,0,0,1
21331,0,1,0,0,1
21332,0,1,0,0,1
21333,0,1,0,0,1
21334,0,0,1,0,1
21335,0,1,0,0,1
21336,0,1,0,0,1
21337,0,0,0,1,1
21338,0,1,0,0,1
21339,0,1,0,0,1
21340,0,1,0,0,1
21341,1,0,0,0,1
21342,0,1,0,0,1
21343,0,1,0,0,1
21344,1,0,0,0,1
21345,0,1,0,0,1
21346,0,1,0,0,1
21347,0,1,0,0,1
21348,0,1,0,0,1
21349,0,1,0,0,1
21350,0,1,0,0,1
21351,0,0,1,0,1
21352,1,0,0,0,1
21353,0,1,0,0,1
21354,0,1,0,0,1
21355,0,1,0,0,1
21356,0,1,0,0,1
21357,1,0,0,0,1
21358,0,1,0,0,1
21359,0,1,0,0,1
21360,1,0,0,0,1
21361,0,1,0,0,1
21362,0,1,0,0,1
21363,0,1,0,0,1
21364,0,1,0,0,1
21365,0,1,0,0,1
21366,0,1,0,0,1
21367,0,1,0,0,1
21368,0,1,0,0,1
21369,0,0,0,1,1
21370,0,0,0,1,1
21371,0,1,0,0,1
21372,0,1,0,0,1
21373,0,1,0,0,1
21374,0,1,0,0,1
21375,0,1,0,0,1
21376,0,1,0,0,1
21377,0,1,0,0,1
21378,0,1,0,0,1
21379,0,1,0,0,1
21380,1,0,0,0,1
21381,0,1,0,0,1
21382,0,1,0,0,1
21383,1,0,0,0,1
21384,0,1,0,0,1
21385,0,1,0,0,1
21386,0,1,0,0,1
21387,1,0,0,0,1
21388,0,1,0,0,1
21389,0,1,0,0,1
21390,0,1,0,0,1
21391,0,1,0,0,1
21392,0,1,0,0,1
21393,0,1,0,0,1
21394,0,1,0,0,1
21395,0,1,0,0,1
21396,0,1,0,0,1
21397,0,1,0,0,1
21398,0,1,0,0,1
21399,0,1,0,0,1
21400,0,1,0,0,1
21401,0,1,0,0,1
21402,0,1,0,0,1
21403,0,1,0,0,1
21404,0,1,0,0,1
21405,0,1,0,0,1
21406,0,1,0,0,1
21407,0,0,0,1,1
21408,0,1,0,0,1
21409,0,1,0,0,1
21410,0,1,0,0,1
21411,0,1,0,0,1
21412,0,1,0,0,1
21413,0,1,0,0,1
21414,0,1,0,0,1
21415,1,0,0,0,1
21416,1,0,0,0,1
21417,0,1,0,0,1
21418,0,1,0,0,1
21419,1,0,0,0,1
21420,0,1,0,0,1
21421,0,1,0,0,1
21422,1,0,0,0,1
21423,0,1,0,0,1
21424,1,0,0,0,1
21425,0,1,0,0,1
21426,0,1,0,0,1
21427,0,1,0,0,1
21428,0,1,0,0,1
21429,0,1,0,0,1
21430,0,0,0,1,1
21431,0,1,0,0,1
21432,0,1,0,0,1
21433,0,1,0,0,1
21434,1,0,0,0,1
21435,1,0,0,0,1
21436,0,1,0,0,1
21437,1,0,0,0,1
21438,0,1,0,0,1
21439,0,1,0,0,1
21440,0,1,0,0,1
21441,0,1,0,0,1
21442,0,1,0,0,1
21443,0,1,0,0,1
21444,0,1,0,0,1
21445,0,1,0,0,1
21446,0,1,0,0,1
21447,0,1,0,0,1
21448,0,1,0,0,1
21449,0,1,0,0,1
21450,0,1,0,0,1
21451,0,1,0,0,1
21452,0,1,0,0,1
21453,0,1,0,0,1
21454,1,0,0,0,1
21455,0,1,0,0,1
21456,0,1,0,0,1
21457,0,1,0,0,1
21458,0,1,0,0,1
21459,0,1,0,0,1
21460,0,1,0,0,1
21461,0,1,0,0,1
21462,0,1,0,0,1
21463,0,1,0,0,1
21464,1,0,0,0,1
21465,0,1,0,0,1
21466,0,1,0,0,1
21467,1,0,0,0,1
21468,0,1,0,0,1
21469,0,1,0,0,1
21470,1,0,0,0,1
21471,0,1,0,0,1
21472,0,1,0,0,1
21473,0,1,0,0,1
21474,0,1,0,0,1
21475,1,0,0,0,1
21476,0,1,0,0,1
21477,1,0,0,0,1
21478,0,1,0,0,1
21479,0,1,0,0,1
21480,0,1,0,0,1
21481,0,1,0,0,1
21482,0,1,0,0,1
21483,0,1,0,0,1
21484,1,0,0,0,1
21485,0,1,0,0,1
21486,0,1,0,0,1
21487,1,0,0,0,1
21488,0,1,0,0,1
21489,0,1,0,0,1
21490,0,1,0,0,1
21491,0,1,0,0,1
21492,0,1,0,0,1
21493,0,1,0,0,1
21494,0,1,0,0,1
21495,0,1,0,0,1
21496,1,0,0,0,1
21497,0,1,0,0,1
21498,0,1,0,0,1
21499,0,1,0,0,1
21500,0,1,0,0,1
21501,0,1,0,0,1
21502,0,1,0,0,1
21503,1,0,0,0,1
21504,1,0,0,0,1
21505,0,1,0,0,1
21506,0,1,0,0,1
21507,0,1,0,0,1
21508,0,1,0,0,1
21509,0,1,0,0,1
21510,0,1,0,0,1
21511,0,1,0,0,1
21512,0,1,0,0,1
21513,0,1,0,0,1
21514,0,1,0,0,1
21515,0,1,0,0,1
21516,1,0,0,0,1
21517,0,1,0,0,1
21518,0,0,1,0,1
21519,0,1,0,0,1
21520,0,1,0,0,1
21521,0,1,0,0,1
21522,0,1,0,0,1
21523,0,1,0,0,1
21524,0,1,0,0,1
21525,0,1,0,0,1
21526,1,0,0,0,1
21527,1,0,0,0,1
21528,0,1,0,0,1
21529,0,1,0,0,1
21530,0,1,0,0,1
21531,0,1,0,0,1
21532,0,1,0,0,1
21533,0,1,0,0,1
21534,0,1,0,0,1
21535,0,1,0,0,1
21536,0,1,0,0,1
21537,1,0,0,0,1
21538,1,0,0,0,1
21539,1,0,0,0,1
21540,0,0,0,1,1
21541,1,0,0,0,1
21542,0,1,0,0,1
21543,0,1,0,0,1
21544,0,1,0,0,1
21545,1,0,0,0,1
21546,0,1,0,0,1
21547,0,1,0,0,1
21548,0,1,0,0,1
21549,1,0,0,0,1
21550,0,1,0,0,1
21551,1,0,0,0,1
21552,0,1,0,0,1
21553,0,1,0,0,1
21554,1,0,0,0,1
21555,0,1,0,0,1
21556,0,1,0,0,1
21557,0,1,0,0,1
21558,0,1,0,0,1
21559,0,1,0,0,1
21560,0,1,0,0,1
21561,0,1,0,0,1
21562,0,1,0,0,1
21563,0,1,0,0,1
21564,0,1,0,0,1
21565,0,1,0,0,1
21566,0,1,0,0,1
21567,0,1,0,0,1
21568,0,1,0,0,1
21569,0,1,0,0,1
21570,0,1,0,0,1
21571,0,1,0,0,1
21572,0,1,0,0,1
21573,0,1,0,0,1
21574,0,1,0,0,1
21575,1,0,0,0,1
21576,0,1,0,0,1
21577,0,1,0,0,1
21578,0,1,0,0,1
21579,0,1,0,0,1
21580,0,1,0,0,1
21581,0,1,0,0,1
21582,0,1,0,0,1
21583,0,1,0,0,1
21584,0,1,0,0,1
21585,1,0,0,0,1
21586,0,1,0,0,1
21587,0,1,0,0,1
21588,0,1,0,0,1
21589,0,1,0,0,1
21590,0,1,0,0,1
21591,0,1,0,0,1
21592,0,1,0,0,1
21593,0,0,1,0,1
21594,0,1,0,0,1
21595,0,1,0,0,1
21596,0,1,0,0,1
21597,0,1,0,0,1
21598,0,1,0,0,1
21599,0,1,0,0,1
21600,0,0,1,0,1
21601,0,1,0,0,1
21602,0,1,0,0,1
21603,0,1,0,0,1
21604,1,0,0,0,1
21605,0,1,0,0,1
21606,1,0,0,0,1
21607,1,0,0,0,1
21608,0,1,0,0,1
21609,0,1,0,0,1
21610,0,1,0,0,1
21611,0,1,0,0,1
21612,0,1,0,0,1
21613,0,1,0,0,1
21614,0,1,0,0,1
21615,0,1,0,0,1
21616,0,1,0,0,1
21617,1,0,0,0,1
21618,0,1,0,0,1
21619,0,1,0,0,1
21620,0,1,0,0,1
21621,0,0,0,1,1
21622,0,1,0,0,1
21623,0,1,0,0,1
21624,1,0,0,0,1
21625,0,0,1,0,1
21626,1,0,0,0,1
21627,0,1,0,0,1
21628,0,1,0,0,1
21629,0,1,0,0,1
21630,0,1,0,0,1
21631,0,1,0,0,1
21632,0,1,0,0,1
21633,0,1,0,0,1
21634,0,1,0,0,1
21635,0,1,0,0,1
21636,0,1,0,0,1
21637,0,1,0,0,1
21638,0,1,0,0,1
21639,0,1,0,0,1
21640,0,1,0,0,1
21641,0,1,0,0,1
21642,0,1,0,0,1
21643,0,1,0,0,1
21644,0,1,0,0,1
21645,0,1,0,0,1
21646,0,0,1,0,1
21647,0,1,0,0,1
21648,0,1,0,0,1
21649,0,1,0,0,1
21650,0,1,0,0,1
21651,1,0,0,0,1
21652,0,1,0,0,1
21653,0,1,0,0,1
21654,0,1,0,0,1
21655,0,1,0,0,1
21656,0,1,0,0,1
21657,1,0,0,0,1
21658,0,1,0,0,1
21659,0,1,0,0,1
21660,0,1,0,0,1
21661,0,1,0,0,1
21662,0,1,0,0,1
21663,1,0,0,0,1
21664,1,0,0,0,1
21665,0,1,0,0,1
21666,0,1,0,0,1
21667,0,1,0,0,1
21668,0,1,0,0,1
21669,0,1,0,0,1
21670,0,1,0,0,1
21671,0,1,0,0,1
21672,1,0,0,0,1
21673,1,0,0,0,1
21674,1,0,0,0,1
21675,0,1,0,0,1
21676,0,1,0,0,1
21677,0,1,0,0,1
21678,0,1,0,0,1
21679,0,1,0,0,1
21680,0,1,0,0,1
21681,0,1,0,0,1
21682,0,1,0,0,1
21683,0,1,0,0,1
21684,1,0,0,0,1
21685,0,1,0,0,1
21686,0,1,0,0,1
21687,0,0,0,1,1
21688,1,0,0,0,1
21689,0,1,0,0,1
21690,0,1,0,0,1
21691,0,1,0,0,1
21692,1,0,0,0,1
21693,1,0,0,0,1
21694,0,1,0,0,1
21695,0,1,0,0,1
21696,0,1,0,0,1
21697,0,1,0,0,1
21698,1,0,0,0,1
21699,0,1,0,0,1
21700,0,1,0,0,1
21701,0,1,0,0,1
21702,0,1,0,0,1
21703,1,0,0,0,1
21704,0,1,0,0,1
21705,0,1,0,0,1
21706,0,1,0,0,1
21707,0,1,0,0,1
21708,0,1,0,0,1
21709,1,0,0,0,1
21710,0,1,0,0,1
21711,0,1,0,0,1
21712,0,1,0,0,1
21713,0,1,0,0,1
21714,0,0,1,0,1
21715,0,1,0,0,1
21716,1,0,0,0,1
21717,0,0,1,0,1
21718,0,1,0,0,1
21719,1,0,0,0,1
21720,0,1,0,0,1
21721,0,1,0,0,1
21722,0,1,0,0,1
21723,0,1,0,0,1
21724,0,1,0,0,1
21725,0,1,0,0,1
21726,0,1,0,0,1
21727,1,0,0,0,1
21728,0,1,0,0,1
21729,0,1,0,0,1
21730,0,0,1,0,1
21731,1,0,0,0,1
21732,0,1,0,0,1
21733,1,0,0,0,1
21734,0,1,0,0,1
21735,0,0,1,0,1
21736,0,1,0,0,1
21737,0,0,0,1,1
21738,0,1,0,0,1
21739,0,1,0,0,1
21740,0,1,0,0,1
21741,0,1,0,0,1
21742,0,1,0,0,1
21743,0,1,0,0,1
21744,0,1,0,0,1
21745,1,0,0,0,1
21746,0,1,0,0,1
21747,0,1,0,0,1
21748,0,1,0,0,1
21749,0,0,0,1,1
21750,0,1,0,0,1
21751,0,1,0,0,1
21752,0,1,0,0,1
21753,0,1,0,0,1
21754,0,0,1,0,1
21755,0,1,0,0,1
21756,0,1,0,0,1
21757,1,0,0,0,1
21758,0,1,0,0,1
21759,0,1,0,0,1
21760,0,1,0,0,1
21761,0,1,0,0,1
21762,0,1,0,0,1
21763,0,1,0,0,1
21764,0,1,0,0,1
21765,0,1,0,0,1
21766,0,1,0,0,1
21767,0,1,0,0,1
21768,0,1,0,0,1
21769,0,1,0,0,1
21770,0,1,0,0,1
21771,0,0,0,1,1
21772,1,0,0,0,1
21773,0,1,0,0,1
21774,1,0,0,0,1
21775,0,1,0,0,1
21776,0,1,0,0,1
21777,0,1,0,0,1
21778,0,1,0,0,1
21779,0,1,0,0,1
21780,0,1,0,0,1
21781,0,0,1,0,1
21782,0,1,0,0,1
21783,0,1,0,0,1
21784,0,1,0,0,1
21785,0,1,0,0,1
21786,0,1,0,0,1
21787,0,1,0,0,1
21788,1,0,0,0,1
21789,0,0,1,0,1
21790,1,0,0,0,1
21791,0,1,0,0,1
21792,0,1,0,0,1
21793,0,1,0,0,1
21794,0,1,0,0,1
21795,0,1,0,0,1
21796,1,0,0,0,1
21797,1,0,0,0,1
21798,0,1,0,0,1
21799,0,1,0,0,1
21800,0,1,0,0,1
21801,0,1,0,0,1
21802,0,1,0,0,1
21803,0,0,0,1,1
21804,0,1,0,0,1
21805,0,1,0,0,1
21806,0,1,0,0,1
21807,0,0,0,1,1
21808,0,1,0,0,1
21809,0,1,0,0,1
21810,1,0,0,0,1
21811,0,1,0,0,1
21812,1,0,0,0,1
21813,0,1,0,0,1
21814,0,1,0,0,1
21815,0,1,0,0,1
21816,0,1,0,0,1
21817,0,1,0,0,1
21818,0,1,0,0,1
21819,0,1,0,0,1
21820,1,0,0,0,1
21821,0,1,0,0,1
21822,0,1,0,0,1
21823,0,1,0,0,1
21824,0,1,0,0,1
21825,0,1,0,0,1
21826,0,1,0,0,1
21827,0,1,0,0,1
21828,0,1,0,0,1
21829,1,0,0,0,1
21830,0,1,0,0,1
21831,0,1,0,0,1
21832,1,0,0,0,1
21833,0,1,0,0,1
21834,0,1,0,0,1
21835,0,1,0,0,1
21836,0,1,0,0,1
21837,1,0,0,0,1
21838,1,0,0,0,1
21839,0,1,0,0,1
21840,0,1,0,0,1
21841,0,1,0,0,1
21842,1,0,0,0,1
21843,0,1,0,0,1
21844,0,0,0,1,1
21845,0,0,1,0,1
21846,0,1,0,0,1
21847,0,1,0,0,1
21848,0,1,0,0,1
21849,0,1,0,0,1
21850,0,1,0,0,1
21851,0,1,0,0,1
21852,0,1,0,0,1
21853,1,0,0,0,1
21854,0,1,0,0,1
21855,0,1,0,0,1
21856,0,1,0,0,1
21857,1,0,0,0,1
21858,0,1,0,0,1
21859,0,0,0,1,1
21860,0,1,0,0,1
21861,0,1,0,0,1
21862,0,1,0,0,1
21863,0,1,0,0,1
21864,0,1,0,0,1
21865,0,0,0,1,1
21866,1,0,0,0,1
21867,0,1,0,0,1
21868,0,1,0,0,1
21869,0,1,0,0,1
21870,0,1,0,0,1
21871,0,1,0,0,1
21872,0,1,0,0,1
21873,0,1,0,0,1
21874,1,0,0,0,1
21875,0,1,0,0,1
21876,0,1,0,0,1
21877,0,1,0,0,1
21878,0,1,0,0,1
21879,0,1,0,0,1
21880,0,1,0,0,1
21881,0,1,0,0,1
21882,0,1,0,0,1
21883,1,0,0,0,1
21884,0,1,0,0,1
21885,0,0,0,1,1
21886,0,1,0,0,1
21887,0,1,0,0,1
21888,0,1,0,0,1
21889,0,1,0,0,1
21890,0,1,0,0,1
21891,0,1,0,0,1
21892,0,1,0,0,1
21893,0,1,0,0,1
21894,0,1,0,0,1
21895,0,1,0,0,1
21896,0,1,0,0,1
21897,0,0,0,1,1
21898,0,1,0,0,1
21899,0,1,0,0,1
21900,0,1,0,0,1
21901,0,1,0,0,1
21902,0,0,1,0,1
21903,0,1,0,0,1
21904,0,1,0,0,1
21905,0,1,0,0,1
21906,0,1,0,0,1
21907,0,1,0,0,1
21908,0,1,0,0,1
21909,1,0,0,0,1
21910,0,0,0,1,1
21911,0,1,0,0,1
21912,0,1,0,0,1
21913,0,1,0,0,1
21914,0,1,0,0,1
21915,0,1,0,0,1
21916,0,1,0,0,1
21917,0,1,0,0,1
21918,0,1,0,0,1
21919,0,1,0,0,1
21920,0,1,0,0,1
21921,0,1,0,0,1
21922,0,1,0,0,1
21923,0,1,0,0,1
21924,0,1,0,0,1
21925,0,0,1,0,1
21926,0,1,0,0,1
21927,0,1,0,0,1
21928,0,1,0,0,1
21929,0,1,0,0,1
21930,0,0,0,1,1
21931,0,0,0,1,1
21932,0,1,0,0,1
21933,1,0,0,0,1
21934,0,1,0,0,1
21935,0,1,0,0,1
21936,0,1,0,0,1
21937,0,1,0,0,1
21938,0,1,0,0,1
21939,1,0,0,0,1
21940,0,1,0,0,1
21941,0,1,0,0,1
21942,0,0,0,1,1
21943,0,1,0,0,1
21944,0,1,0,0,1
21945,1,0,0,0,1
21946,1,0,0,0,1
21947,1,0,0,0,1
21948,0,1,0,0,1
21949,1,0,0,0,1
21950,0,1,0,0,1
21951,0,1,0,0,1
21952,0,1,0,0,1
21953,1,0,0,0,1
21954,0,1,0,0,1
21955,0,1,0,0,1
21956,1,0,0,0,1
21957,0,1,0,0,1
21958,0,1,0,0,1
21959,0,1,0,0,1
21960,1,0,0,0,1
21961,0,1,0,0,1
21962,1,0,0,0,1
21963,0,1,0,0,1
21964,0,1,0,0,1
21965,0,1,0,0,1
21966,0,1,0,0,1
21967,0,1,0,0,1
21968,0,1,0,0,1
21969,0,1,0,0,1
21970,1,0,0,0,1
21971,0,1,0,0,1
21972,0,1,0,0,1
21973,0,1,0,0,1
21974,0,1,0,0,1
21975,0,1,0,0,1
21976,1,0,0,0,1
21977,0,1,0,0,1
21978,0,1,0,0,1
21979,0,1,0,0,1
21980,0,1,0,0,1
21981,0,1,0,0,1
21982,0,1,0,0,1
21983,0,0,1,0,1
21984,0,1,0,0,1
21985,0,1,0,0,1
21986,0,1,0,0,1
21987,1,0,0,0,1
21988,0,1,0,0,1
21989,0,1,0,0,1
21990,1,0,0,0,1
21991,1,0,0,0,1
21992,0,1,0,0,1
21993,0,1,0,0,1
21994,1,0,0,0,1
21995,0,1,0,0,1
21996,0,1,0,0,1
21997,0,1,0,0,1
21998,0,1,0,0,1
21999,0,1,0,0,1
22000,0,1,0,0,1
22001,0,1,0,0,1
22002,0,1,0,0,1
22003,0,1,0,0,1
22004,0,1,0,0,1
22005,0,0,0,1,1
22006,0,1,0,0,1
22007,0,1,0,0,1
22008,0,1,0,0,1
22009,0,1,0,0,1
22010,1,0,0,0,1
22011,0,0,0,1,1
22012,0,1,0,0,1
22013,1,0,0,0,1
22014,1,0,0,0,1
22015,0,1,0,0,1
22016,0,1,0,0,1
22017,0,0,1,0,1
22018,0,1,0,0,1
22019,0,1,0,0,1
22020,0,1,0,0,1
22021,1,0,0,0,1
22022,0,1,0,0,1
22023,0,1,0,0,1
22024,0,1,0,0,1
22025,0,1,0,0,1
22026,0,1,0,0,1
22027,0,1,0,0,1
22028,1,0,0,0,1
22029,0,1,0,0,1
22030,1,0,0,0,1
22031,0,1,0,0,1
22032,0,1,0,0,1
22033,1,0,0,0,1
22034,1,0,0,0,1
22035,0,1,0,0,1
22036,0,1,0,0,1
22037,0,1,0,0,1
22038,1,0,0,0,1
22039,0,1,0,0,1
22040,0,1,0,0,1
22041,0,1,0,0,1
22042,0,0,0,1,1
22043,0,1,0,0,1
22044,0,1,0,0,1
22045,1,0,0,0,1
22046,0,1,0,0,1
22047,0,1,0,0,1
22048,0,1,0,0,1
22049,0,1,0,0,1
22050,0,1,0,0,1
22051,1,0,0,0,1
22052,0,1,0,0,1
22053,0,1,0,0,1
22054,0,1,0,0,1
22055,0,1,0,0,1
22056,0,1,0,0,1
22057,1,0,0,0,1
22058,0,1,0,0,1
22059,0,1,0,0,1
22060,0,1,0,0,1
22061,0,1,0,0,1
22062,0,1,0,0,1
22063,1,0,0,0,1
22064,0,1,0,0,1
22065,1,0,0,0,1
22066,1,0,0,0,1
22067,0,1,0,0,1
22068,0,1,0,0,1
22069,0,1,0,0,1
22070,0,0,1,0,1
22071,0,0,0,1,1
22072,0,1,0,0,1
22073,0,1,0,0,1
22074,0,1,0,0,1
22075,0,1,0,0,1
22076,1,0,0,0,1
22077,0,1,0,0,1
22078,0,1,0,0,1
22079,0,1,0,0,1
22080,0,1,0,0,1
22081,0,1,0,0,1
22082,0,0,0,1,1
22083,1,0,0,0,1
22084,0,1,0,0,1
22085,0,1,0,0,1
22086,0,1,0,0,1
22087,1,0,0,0,1
22088,0,1,0,0,1
22089,0,1,0,0,1
22090,0,1,0,0,1
22091,0,1,0,0,1
22092,0,1,0,0,1
22093,0,1,0,0,1
22094,0,1,0,0,1
22095,0,1,0,0,1
22096,0,1,0,0,1
22097,0,1,0,0,1
22098,1,0,0,0,1
22099,0,1,0,0,1
22100,0,1,0,0,1
22101,1,0,0,0,1
22102,0,1,0,0,1
22103,0,1,0,0,1
22104,1,0,0,0,1
22105,0,1,0,0,1
22106,1,0,0,0,1
22107,0,0,0,1,1
22108,0,1,0,0,1
22109,0,0,1,0,1
22110,0,1,0,0,1
22111,0,1,0,0,1
22112,1,0,0,0,1
22113,0,1,0,0,1
22114,1,0,0,0,1
22115,0,1,0,0,1
22116,1,0,0,0,1
22117,0,1,0,0,1
22118,1,0,0,0,1
22119,0,1,0,0,1
22120,0,1,0,0,1
22121,0,1,0,0,1
22122,0,1,0,0,1
22123,0,1,0,0,1
22124,1,0,0,0,1
22125,0,1,0,0,1
22126,1,0,0,0,1
22127,1,0,0,0,1
22128,1,0,0,0,1
22129,0,1,0,0,1
22130,0,1,0,0,1
22131,0,1,0,0,1
22132,0,1,0,0,1
22133,0,1,0,0,1
22134,0,1,0,0,1
22135,0,1,0,0,1
22136,0,1,0,0,1
22137,0,1,0,0,1
22138,1,0,0,0,1
22139,0,1,0,0,1
22140,0,1,0,0,1
22141,0,1,0,0,1
22142,0,1,0,0,1
22143,0,1,0,0,1
22144,0,1,0,0,1
22145,1,0,0,0,1
22146,0,1,0,0,1
22147,0,1,0,0,1
22148,0,0,0,1,1
22149,1,0,0,0,1
22150,0,1,0,0,1
22151,0,1,0,0,1
22152,0,1,0,0,1
22153,0,1,0,0,1
22154,1,0,0,0,1
22155,0,1,0,0,1
22156,0,1,0,0,1
22157,1,0,0,0,1
22158,0,1,0,0,1
22159,0,1,0,0,1
22160,0,1,0,0,1
22161,0,1,0,0,1
22162,0,1,0,0,1
22163,1,0,0,0,1
22164,0,1,0,0,1
22165,0,1,0,0,1
22166,0,1,0,0,1
22167,0,1,0,0,1
22168,1,0,0,0,1
22169,0,1,0,0,1
22170,0,1,0,0,1
22171,0,1,0,0,1
22172,0,1,0,0,1
22173,0,1,0,0,1
22174,1,0,0,0,1
22175,0,1,0,0,1
22176,0,1,0,0,1
22177,0,1,0,0,1
22178,0,1,0,0,1
22179,0,1,0,0,1
22180,1,0,0,0,1
22181,0,1,0,0,1
22182,0,1,0,0,1
22183,1,0,0,0,1
22184,0,1,0,0,1
22185,0,1,0,0,1
22186,0,1,0,0,1
22187,0,1,0,0,1
22188,1,0,0,0,1
22189,0,1,0,0,1
22190,0,1,0,0,1
22191,1,0,0,0,1
22192,0,1,0,0,1
22193,0,1,0,0,1
22194,0,1,0,0,1
22195,0,1,0,0,1
22196,1,0,0,0,1
22197,0,1,0,0,1
22198,0,1,0,0,1
22199,0,1,0,0,1
22200,0,1,0,0,1
22201,0,1,0,0,1
22202,0,1,0,0,1
22203,0,1,0,0,1
22204,0,1,0,0,1
22205,0,1,0,0,1
22206,0,1,0,0,1
22207,0,0,0,1,1
22208,0,1,0,0,1
22209,0,1,0,0,1
22210,0,1,0,0,1
22211,0,1,0,0,1
22212,1,0,0,0,1
22213,0,1,0,0,1
22214,0,1,0,0,1
22215,0,1,0,0,1
22216,1,0,0,0,1
22217,1,0,0,0,1
22218,1,0,0,0,1
22219,1,0,0,0,1
22220,0,1,0,0,1
22221,0,1,0,0,1
22222,0,1,0,0,1
22223,0,1,0,0,1
22224,0,1,0,0,1
22225,0,1,0,0,1
22226,0,1,0,0,1
22227,1,0,0,0,1
22228,0,1,0,0,1
22229,0,1,0,0,1
22230,0,1,0,0,1
22231,1,0,0,0,1
22232,0,1,0,0,1
22233,0,1,0,0,1
22234,1,0,0,0,1
22235,1,0,0,0,1
22236,0,1,0,0,1
22237,0,1,0,0,1
22238,0,1,0,0,1
22239,0,1,0,0,1
22240,0,1,0,0,1
22241,1,0,0,0,1
22242,0,1,0,0,1
22243,0,1,0,0,1
22244,0,1,0,0,1
22245,0,1,0,0,1
22246,1,0,0,0,1
22247,0,1,0,0,1
22248,0,1,0,0,1
22249,0,1,0,0,1
22250,0,1,0,0,1
22251,0,1,0,0,1
22252,0,1,0,0,1
22253,0,1,0,0,1
22254,0,1,0,0,1
22255,0,1,0,0,1
22256,0,1,0,0,1
22257,0,1,0,0,1
22258,1,0,0,0,1
22259,1,0,0,0,1
22260,0,1,0,0,1
22261,0,1,0,0,1
22262,1,0,0,0,1
22263,0,0,0,1,1
22264,0,1,0,0,1
22265,1,0,0,0,1
22266,0,1,0,0,1
22267,0,1,0,0,1
22268,0,1,0,0,1
22269,0,1,0,0,1
22270,0,1,0,0,1
22271,0,1,0,0,1
22272,0,1,0,0,1
22273,0,1,0,0,1
22274,0,1,0,0,1
22275,0,1,0,0,1
22276,0,1,0,0,1
22277,0,1,0,0,1
22278,0,1,0,0,1
22279,0,1,0,0,1
22280,0,1,0,0,1
22281,0,0,1,0,1
22282,0,0,0,1,1
22283,1,0,0,0,1
22284,1,0,0,0,1
22285,1,0,0,0,1
22286,0,1,0,0,1
22287,0,1,0,0,1
22288,1,0,0,0,1
22289,0,1,0,0,1
22290,0,1,0,0,1
22291,0,1,0,0,1
22292,0,1,0,0,1
22293,0,1,0,0,1
22294,0,1,0,0,1
22295,0,1,0,0,1
22296,0,0,1,0,1
22297,0,1,0,0,1
22298,0,1,0,0,1
22299,0,1,0,0,1
22300,1,0,0,0,1
22301,1,0,0,0,1
22302,0,1,0,0,1
22303,0,1,0,0,1
22304,0,1,0,0,1
22305,0,1,0,0,1
22306,0,1,0,0,1
22307,1,0,0,0,1
22308,0,0,1,0,1
22309,0,1,0,0,1
22310,0,1,0,0,1
22311,0,1,0,0,1
22312,0,1,0,0,1
22313,0,1,0,0,1
22314,0,1,0,0,1
22315,0,1,0,0,1
22316,0,1,0,0,1
22317,0,1,0,0,1
22318,0,1,0,0,1
22319,0,1,0,0,1
22320,0,1,0,0,1
22321,0,1,0,0,1
22322,0,1,0,0,1
22323,0,1,0,0,1
22324,0,1,0,0,1
22325,0,1,0,0,1
22326,0,1,0,0,1
22327,0,1,0,0,1
22328,0,1,0,0,1
22329,0,1,0,0,1
22330,0,1,0,0,1
22331,1,0,0,0,1
22332,0,1,0,0,1
22333,0,0,0,1,1
22334,0,1,0,0,1
22335,0,1,0,0,1
22336,0,1,0,0,1
22337,0,1,0,0,1
22338,0,1,0,0,1
22339,0,1,0,0,1
22340,0,1,0,0,1
22341,0,1,0,0,1
22342,0,1,0,0,1
22343,1,0,0,0,1
22344,0,1,0,0,1
22345,0,1,0,0,1
22346,0,1,0,0,1
22347,0,1,0,0,1
22348,0,1,0,0,1
22349,0,1,0,0,1
22350,0,1,0,0,1
22351,0,1,0,0,1
22352,0,1,0,0,1
22353,0,1,0,0,1
22354,0,1,0,0,1
22355,0,1,0,0,1
22356,1,0,0,0,1
22357,1,0,0,0,1
22358,0,1,0,0,1
22359,0,1,0,0,1
22360,1,0,0,0,1
22361,0,1,0,0,1
22362,0,1,0,0,1
22363,1,0,0,0,1
22364,0,0,1,0,1
22365,0,1,0,0,1
22366,0,1,0,0,1
22367,0,1,0,0,1
22368,0,1,0,0,1
22369,0,1,0,0,1
22370,0,1,0,0,1
22371,0,1,0,0,1
22372,0,1,0,0,1
22373,0,1,0,0,1
22374,0,0,0,1,1
22375,0,1,0,0,1
22376,0,1,0,0,1
22377,0,1,0,0,1
22378,0,1,0,0,1
22379,0,1,0,0,1
22380,0,1,0,0,1
22381,0,1,0,0,1
22382,0,1,0,0,1
22383,0,1,0,0,1
22384,1,0,0,0,1
22385,0,1,0,0,1
22386,1,0,0,0,1
22387,1,0,0,0,1
22388,0,1,0,0,1
22389,0,1,0,0,1
22390,0,1,0,0,1
22391,0,1,0,0,1
22392,0,1,0,0,1
22393,0,1,0,0,1
22394,0,1,0,0,1
22395,1,0,0,0,1
22396,0,1,0,0,1
22397,0,1,0,0,1
22398,0,1,0,0,1
22399,0,1,0,0,1
22400,0,1,0,0,1
22401,1,0,0,0,1
22402,0,1,0,0,1
22403,0,1,0,0,1
22404,0,1,0,0,1
22405,0,1,0,0,1
22406,0,1,0,0,1
22407,0,0,1,0,1
22408,0,1,0,0,1
22409,0,1,0,0,1
22410,0,1,0,0,1
22411,0,1,0,0,1
22412,0,1,0,0,1
22413,1,0,0,0,1
22414,0,1,0,0,1
22415,0,1,0,0,1
22416,0,1,0,0,1
22417,0,1,0,0,1
22418,1,0,0,0,1
22419,0,0,0,1,1
22420,0,1,0,0,1
22421,0,1,0,0,1
22422,0,1,0,0,1
22423,0,1,0,0,1
22424,0,1,0,0,1
22425,0,1,0,0,1
22426,0,1,0,0,1
22427,0,1,0,0,1
22428,0,1,0,0,1
22429,0,1,0,0,1
22430,1,0,0,0,1
22431,0,1,0,0,1
22432,1,0,0,0,1
22433,0,1,0,0,1
22434,0,1,0,0,1
22435,1,0,0,0,1
22436,0,1,0,0,1
22437,0,1,0,0,1
22438,0,1,0,0,1
22439,0,1,0,0,1
22440,0,1,0,0,1
22441,0,1,0,0,1
22442,0,1,0,0,1
22443,0,1,0,0,1
22444,0,1,0,0,1
22445,0,1,0,0,1
22446,0,1,0,0,1
22447,0,1,0,0,1
22448,0,1,0,0,1
22449,0,1,0,0,1
22450,0,1,0,0,1
22451,0,1,0,0,1
22452,0,1,0,0,1
22453,0,1,0,0,1
22454,0,1,0,0,1
22455,0,1,0,0,1
22456,1,0,0,0,1
22457,0,1,0,0,1
22458,0,1,0,0,1
22459,0,0,0,1,1
22460,0,1,0,0,1
22461,0,1,0,0,1
22462,1,0,0,0,1
22463,0,1,0,0,1
22464,0,1,0,0,1
22465,0,1,0,0,1
22466,0,1,0,0,1
22467,0,1,0,0,1
22468,0,1,0,0,1
22469,0,1,0,0,1
22470,0,1,0,0,1
22471,0,1,0,0,1
22472,0,1,0,0,1
22473,0,1,0,0,1
22474,0,1,0,0,1
22475,0,1,0,0,1
22476,0,1,0,0,1
22477,0,1,0,0,1
22478,1,0,0,0,1
22479,0,1,0,0,1
22480,0,1,0,0,1
22481,0,1,0,0,1
22482,0,1,0,0,1
22483,1,0,0,0,1
22484,0,1,0,0,1
22485,0,1,0,0,1
22486,0,1,0,0,1
22487,0,1,0,0,1
22488,0,1,0,0,1
22489,0,1,0,0,1
22490,0,1,0,0,1
22491,0,1,0,0,1
22492,0,1,0,0,1
22493,0,1,0,0,1
22494,0,1,0,0,1
22495,0,1,0,0,1
22496,0,1,0,0,1
22497,1,0,0,0,1
22498,1,0,0,0,1
22499,0,1,0,0,1
22500,0,1,0,0,1
22501,0,1,0,0,1
22502,0,1,0,0,1
22503,0,1,0,0,1
22504,0,1,0,0,1
22505,0,1,0,0,1
22506,0,1,0,0,1
22507,0,1,0,0,1
22508,0,1,0,0,1
22509,0,1,0,0,1
22510,0,1,0,0,1
22511,0,1,0,0,1
22512,0,1,0,0,1
22513,0,1,0,0,1
22514,0,1,0,0,1
22515,1,0,0,0,1
22516,0,1,0,0,1
22517,0,1,0,0,1
22518,0,1,0,0,1
22519,0,1,0,0,1
22520,0,1,0,0,1
22521,0,1,0,0,1
22522,0,1,0,0,1
22523,0,1,0,0,1
22524,0,1,0,0,1
22525,0,1,0,0,1
22526,0,1,0,0,1
22527,0,1,0,0,1
22528,0,1,0,0,1
22529,0,1,0,0,1
22530,0,0,0,1,1
22531,0,1,0,0,1
22532,0,1,0,0,1
22533,0,1,0,0,1
22534,1,0,0,0,1
22535,0,1,0,0,1
22536,0,1,0,0,1
22537,0,1,0,0,1
22538,0,0,1,0,1
22539,0,1,0,0,1
22540,0,1,0,0,1
22541,0,1,0,0,1
22542,1,0,0,0,1
22543,0,1,0,0,1
22544,0,1,0,0,1
22545,0,1,0,0,1
22546,0,1,0,0,1
22547,0,1,0,0,1
22548,0,1,0,0,1
22549,0,1,0,0,1
22550,0,1,0,0,1
22551,0,1,0,0,1
22552,0,1,0,0,1
22553,0,1,0,0,1
22554,0,1,0,0,1
22555,0,1,0,0,1
22556,1,0,0,0,1
22557,0,1,0,0,1
22558,0,1,0,0,1
22559,0,1,0,0,1
22560,0,1,0,0,1
22561,0,1,0,0,1
22562,1,0,0,0,1
22563,0,1,0,0,1
22564,0,1,0,0,1
22565,0,1,0,0,1
22566,0,1,0,0,1
22567,1,0,0,0,1
22568,1,0,0,0,1
22569,0,1,0,0,1
22570,0,1,0,0,1
22571,0,1,0,0,1
22572,0,1,0,0,1
22573,1,0,0,0,1
22574,0,1,0,0,1
22575,0,1,0,0,1
22576,1,0,0,0,1
22577,0,0,0,1,1
22578,0,1,0,0,1
22579,0,1,0,0,1
22580,0,1,0,0,1
22581,1,0,0,0,1
22582,0,1,0,0,1
22583,0,1,0,0,1
22584,0,1,0,0,1
22585,0,1,0,0,1
22586,0,0,0,1,1
22587,0,1,0,0,1
22588,1,0,0,0,1
22589,0,1,0,0,1
22590,0,1,0,0,1
22591,0,1,0,0,1
22592,0,1,0,0,1
22593,0,1,0,0,1
22594,0,1,0,0,1
22595,0,1,0,0,1
22596,0,1,0,0,1
22597,0,1,0,0,1
22598,0,1,0,0,1
22599,0,1,0,0,1
22600,0,1,0,0,1
22601,1,0,0,0,1
22602,0,1,0,0,1
22603,0,1,0,0,1
22604,1,0,0,0,1
22605,0,1,0,0,1
22606,0,0,1,0,1
22607,0,1,0,0,1
22608,0,1,0,0,1
22609,0,1,0,0,1
22610,0,1,0,0,1
22611,0,1,0,0,1
22612,1,0,0,0,1
22613,0,1,0,0,1
22614,0,1,0,0,1
22615,0,1,0,0,1
22616,0,1,0,0,1
22617,0,0,0,1,1
22618,0,1,0,0,1
22619,0,1,0,0,1
22620,0,1,0,0,1
22621,0,1,0,0,1
22622,0,1,0,0,1
22623,0,1,0,0,1
22624,0,1,0,0,1
22625,0,1,0,0,1
22626,0,1,0,0,1
22627,0,1,0,0,1
22628,0,1,0,0,1
22629,0,1,0,0,1
22630,0,1,0,0,1
22631,0,1,0,0,1
22632,1,0,0,0,1
22633,0,1,0,0,1
22634,0,1,0,0,1
22635,0,1,0,0,1
22636,1,0,0,0,1
22637,0,1,0,0,1
22638,0,1,0,0,1
22639,0,1,0,0,1
22640,0,1,0,0,1
22641,0,1,0,0,1
22642,0,1,0,0,1
22643,0,0,1,0,1
22644,0,0,1,0,1
22645,0,1,0,0,1
22646,0,1,0,0,1
22647,0,1,0,0,1
22648,1,0,0,0,1
22649,0,1,0,0,1
22650,0,1,0,0,1
22651,0,1,0,0,1
22652,0,1,0,0,1
22653,0,1,0,0,1
22654,0,1,0,0,1
22655,0,1,0,0,1
22656,0,1,0,0,1
22657,0,1,0,0,1
22658,0,1,0,0,1
22659,1,0,0,0,1
22660,0,1,0,0,1
22661,1,0,0,0,1
22662,0,1,0,0,1
22663,1,0,0,0,1
22664,0,1,0,0,1
22665,1,0,0,0,1
22666,0,1,0,0,1
22667,0,1,0,0,1
22668,0,1,0,0,1
22669,0,1,0,0,1
22670,1,0,0,0,1
22671,1,0,0,0,1
22672,0,1,0,0,1
22673,1,0,0,0,1
22674,0,1,0,0,1
22675,0,1,0,0,1
22676,1,0,0,0,1
22677,0,1,0,0,1
22678,0,1,0,0,1
22679,0,1,0,0,1
22680,0,1,0,0,1
22681,0,1,0,0,1
22682,0,1,0,0,1
22683,1,0,0,0,1
22684,0,1,0,0,1
22685,0,0,0,1,1
22686,0,1,0,0,1
22687,0,1,0,0,1
22688,0,1,0,0,1
22689,1,0,0,0,1
22690,0,1,0,0,1
22691,0,1,0,0,1
22692,0,1,0,0,1
22693,1,0,0,0,1
22694,0,1,0,0,1
22695,1,0,0,0,1
22696,0,1,0,0,1
22697,0,1,0,0,1
22698,0,1,0,0,1
22699,0,1,0,0,1
22700,0,1,0,0,1
22701,0,1,0,0,1
22702,0,1,0,0,1
22703,0,1,0,0,1
22704,1,0,0,0,1
22705,0,1,0,0,1
22706,0,1,0,0,1
22707,0,1,0,0,1
22708,0,1,0,0,1
22709,0,1,0,0,1
22710,0,1,0,0,1
22711,0,1,0,0,1
22712,0,0,1,0,1
22713,0,1,0,0,1
22714,1,0,0,0,1
22715,0,1,0,0,1
22716,0,1,0,0,1
22717,0,1,0,0,1
22718,0,1,0,0,1
22719,0,1,0,0,1
22720,0,0,0,1,1
22721,1,0,0,0,1
22722,0,1,0,0,1
22723,0,1,0,0,1
22724,0,1,0,0,1
22725,0,1,0,0,1
22726,0,1,0,0,1
22727,0,1,0,0,1
22728,1,0,0,0,1
22729,1,0,0,0,1
22730,0,1,0,0,1
22731,0,1,0,0,1
22732,0,1,0,0,1
22733,0,1,0,0,1
22734,0,1,0,0,1
22735,1,0,0,0,1
22736,0,1,0,0,1
22737,0,1,0,0,1
22738,0,1,0,0,1
22739,0,1,0,0,1
22740,0,1,0,0,1
22741,0,1,0,0,1
22742,0,1,0,0,1
22743,0,1,0,0,1
22744,0,1,0,0,1
22745,0,1,0,0,1
22746,0,1,0,0,1
22747,1,0,0,0,1
22748,1,0,0,0,1
22749,0,1,0,0,1
22750,0,1,0,0,1
22751,1,0,0,0,1
22752,0,1,0,0,1
22753,0,1,0,0,1
22754,0,1,0,0,1
22755,1,0,0,0,1
22756,0,1,0,0,1
22757,0,1,0,0,1
22758,0,1,0,0,1
22759,1,0,0,0,1
22760,0,1,0,0,1
22761,0,1,0,0,1
22762,0,1,0,0,1
22763,0,1,0,0,1
22764,0,1,0,0,1
22765,0,1,0,0,1
22766,0,1,0,0,1
22767,0,1,0,0,1
22768,0,1,0,0,1
22769,0,1,0,0,1
22770,0,1,0,0,1
22771,0,1,0,0,1
22772,0,1,0,0,1
22773,0,1,0,0,1
22774,0,1,0,0,1
22775,0,1,0,0,1
22776,0,1,0,0,1
22777,0,1,0,0,1
22778,0,1,0,0,1
22779,0,1,0,0,1
22780,0,1,0,0,1
22781,0,1,0,0,1
22782,0,1,0,0,1
22783,0,1,0,0,1
22784,0,1,0,0,1
22785,0,1,0,0,1
22786,0,1,0,0,1
22787,0,1,0,0,1
22788,0,1,0,0,1
22789,0,1,0,0,1
22790,1,0,0,0,1
22791,0,1,0,0,1
22792,0,1,0,0,1
22793,0,1,0,0,1
22794,0,1,0,0,1
22795,0,0,0,1,1
22796,1,0,0,0,1
22797,0,1,0,0,1
22798,0,1,0,0,1
22799,0,1,0,0,1
22800,0,1,0,0,1
22801,0,1,0,0,1
22802,0,1,0,0,1
22803,0,1,0,0,1
22804,1,0,0,0,1
22805,0,1,0,0,1
22806,0,1,0,0,1
22807,1,0,0,0,1
22808,0,1,0,0,1
22809,0,1,0,0,1
22810,0,1,0,0,1
22811,1,0,0,0,1
22812,0,1,0,0,1
22813,0,1,0,0,1
22814,0,1,0,0,1
22815,1,0,0,0,1
22816,0,1,0,0,1
22817,0,1,0,0,1
22818,0,1,0,0,1
22819,0,1,0,0,1
22820,0,1,0,0,1
22821,0,1,0,0,1
22822,0,1,0,0,1
22823,1,0,0,0,1
22824,1,0,0,0,1
22825,0,1,0,0,1
22826,0,1,0,0,1
22827,0,1,0,0,1
22828,0,1,0,0,1
22829,0,1,0,0,1
22830,0,1,0,0,1
22831,0,1,0,0,1
22832,0,1,0,0,1
22833,0,1,0,0,1
22834,0,1,0,0,1
22835,0,1,0,0,1
22836,1,0,0,0,1
22837,0,1,0,0,1
22838,0,1,0,0,1
22839,0,1,0,0,1
22840,0,1,0,0,1
22841,0,1,0,0,1
22842,1,0,0,0,1
22843,0,1,0,0,1
22844,0,1,0,0,1
22845,0,1,0,0,1
22846,1,0,0,0,1
22847,0,1,0,0,1
22848,1,0,0,0,1
22849,0,1,0,0,1
22850,0,1,0,0,1
22851,0,1,0,0,1
22852,0,1,0,0,1
22853,0,1,0,0,1
22854,0,1,0,0,1
22855,1,0,0,0,1
22856,0,0,0,1,1
22857,0,1,0,0,1
22858,0,1,0,0,1
22859,0,1,0,0,1
22860,0,1,0,0,1
22861,1,0,0,0,1
22862,1,0,0,0,1
22863,0,1,0,0,1
22864,0,1,0,0,1
22865,0,1,0,0,1
22866,0,1,0,0,1
22867,0,1,0,0,1
22868,0,1,0,0,1
22869,0,1,0,0,1
22870,1,0,0,0,1
22871,0,1,0,0,1
22872,0,1,0,0,1
22873,0,1,0,0,1
22874,1,0,0,0,1
22875,0,1,0,0,1
22876,0,1,0,0,1
22877,0,1,0,0,1
22878,0,1,0,0,1
22879,0,1,0,0,1
22880,1,0,0,0,1
22881,1,0,0,0,1
22882,0,1,0,0,1
22883,1,0,0,0,1
22884,0,1,0,0,1
22885,0,1,0,0,1
22886,1,0,0,0,1
22887,1,0,0,0,1
22888,0,1,0,0,1
22889,0,1,0,0,1
22890,0,1,0,0,1
22891,0,1,0,0,1
22892,0,0,0,1,1
22893,0,1,0,0,1
22894,0,0,1,0,1
22895,1,0,0,0,1
22896,0,1,0,0,1
22897,0,1,0,0,1
22898,0,1,0,0,1
22899,0,1,0,0,1
22900,0,1,0,0,1
22901,0,0,0,1,1
22902,0,1,0,0,1
22903,0,1,0,0,1
22904,0,1,0,0,1
22905,0,1,0,0,1
22906,0,1,0,0,1
22907,0,1,0,0,1
22908,1,0,0,0,1
22909,1,0,0,0,1
22910,0,1,0,0,1
22911,0,1,0,0,1
22912,0,1,0,0,1
22913,0,1,0,0,1
22914,0,1,0,0,1
22915,1,0,0,0,1
22916,0,1,0,0,1
22917,0,1,0,0,1
22918,0,0,1,0,1
22919,0,1,0,0,1
22920,0,1,0,0,1
22921,1,0,0,0,1
22922,0,1,0,0,1
22923,0,1,0,0,1
22924,0,1,0,0,1
22925,0,1,0,0,1
22926,0,1,0,0,1
22927,0,1,0,0,1
22928,0,1,0,0,1
22929,0,1,0,0,1
22930,1,0,0,0,1
22931,0,1,0,0,1
22932,0,1,0,0,1
22933,0,1,0,0,1
22934,0,1,0,0,1
22935,0,1,0,0,1
22936,0,1,0,0,1
22937,1,0,0,0,1
22938,0,1,0,0,1
22939,0,1,0,0,1
22940,0,1,0,0,1
22941,0,1,0,0,1
22942,1,0,0,0,1
22943,0,1,0,0,1
22944,0,0,0,1,1
22945,0,1,0,0,1
22946,0,1,0,0,1
22947,0,1,0,0,1
22948,0,1,0,0,1
22949,1,0,0,0,1
22950,0,1,0,0,1
22951,0,1,0,0,1
22952,0,1,0,0,1
22953,0,1,0,0,1
22954,0,1,0,0,1
22955,1,0,0,0,1
22956,0,1,0,0,1
22957,0,1,0,0,1
22958,0,1,0,0,1
22959,1,0,0,0,1
22960,0,1,0,0,1
22961,0,1,0,0,1
22962,0,1,0,0,1
22963,0,1,0,0,1
22964,0,1,0,0,1
22965,0,1,0,0,1
22966,0,1,0,0,1
22967,0,1,0,0,1
22968,1,0,0,0,1
22969,0,1,0,0,1
22970,0,0,0,1,1
22971,1,0,0,0,1
22972,0,1,0,0,1
22973,1,0,0,0,1
22974,0,1,0,0,1
22975,0,1,0,0,1
22976,1,0,0,0,1
22977,1,0,0,0,1
22978,0,1,0,0,1
22979,1,0,0,0,1
22980,0,1,0,0,1
22981,0,1,0,0,1
22982,0,1,0,0,1
22983,0,1,0,0,1
22984,0,1,0,0,1
22985,0,1,0,0,1
22986,0,1,0,0,1
22987,0,1,0,0,1
22988,1,0,0,0,1
22989,0,1,0,0,1
22990,0,1,0,0,1
22991,1,0,0,0,1
22992,0,1,0,0,1
22993,1,0,0,0,1
22994,0,1,0,0,1
22995,0,1,0,0,1
22996,0,1,0,0,1
22997,0,1,0,0,1
22998,0,1,0,0,1
22999,0,1,0,0,1
23000,0,1,0,0,1
23001,0,1,0,0,1
23002,0,1,0,0,1
23003,0,1,0,0,1
23004,0,1,0,0,1
23005,0,1,0,0,1
23006,0,1,0,0,1
23007,1,0,0,0,1
23008,0,1,0,0,1
23009,1,0,0,0,1
23010,0,0,0,1,1
23011,0,1,0,0,1
23012,1,0,0,0,1
23013,0,1,0,0,1
23014,0,1,0,0,1
23015,1,0,0,0,1
23016,0,1,0,0,1
23017,0,1,0,0,1
23018,0,1,0,0,1
23019,0,1,0,0,1
23020,0,1,0,0,1
23021,0,1,0,0,1
23022,0,1,0,0,1
23023,0,1,0,0,1
23024,0,1,0,0,1
23025,0,1,0,0,1
23026,0,1,0,0,1
23027,0,1,0,0,1
23028,0,1,0,0,1
23029,0,0,0,1,1
23030,0,1,0,0,1
23031,0,1,0,0,1
23032,0,1,0,0,1
23033,0,1,0,0,1
23034,1,0,0,0,1
23035,0,1,0,0,1
23036,0,1,0,0,1
23037,0,1,0,0,1
23038,0,1,0,0,1
23039,0,1,0,0,1
23040,0,1,0,0,1
23041,0,1,0,0,1
23042,0,1,0,0,1
23043,0,1,0,0,1
23044,0,1,0,0,1
23045,1,0,0,0,1
23046,0,1,0,0,1
23047,0,1,0,0,1
23048,0,1,0,0,1
23049,1,0,0,0,1
23050,0,1,0,0,1
23051,0,0,1,0,1
23052,0,1,0,0,1
23053,1,0,0,0,1
23054,0,1,0,0,1
23055,0,1,0,0,1
23056,0,1,0,0,1
23057,0,1,0,0,1
23058,0,1,0,0,1
23059,0,1,0,0,1
23060,0,1,0,0,1
23061,0,1,0,0,1
23062,0,1,0,0,1
23063,0,1,0,0,1
23064,0,1,0,0,1
23065,1,0,0,0,1
23066,0,1,0,0,1
23067,1,0,0,0,1
23068,0,1,0,0,1
23069,0,1,0,0,1
23070,0,1,0,0,1
23071,0,1,0,0,1
23072,0,1,0,0,1
23073,0,1,0,0,1
23074,0,1,0,0,1
23075,1,0,0,0,1
23076,0,1,0,0,1
23077,0,1,0,0,1
23078,0,1,0,0,1
23079,0,1,0,0,1
23080,0,1,0,0,1
23081,0,1,0,0,1
23082,0,1,0,0,1
23083,0,1,0,0,1
23084,0,1,0,0,1
23085,0,1,0,0,1
23086,0,1,0,0,1
23087,0,1,0,0,1
23088,1,0,0,0,1
23089,0,1,0,0,1
23090,0,1,0,0,1
23091,0,1,0,0,1
23092,0,1,0,0,1
23093,0,1,0,0,1
23094,1,0,0,0,1
23095,0,1,0,0,1
23096,0,1,0,0,1
23097,0,1,0,0,1
23098,0,1,0,0,1
23099,0,1,0,0,1
23100,0,1,0,0,1
23101,0,0,0,1,1
23102,0,1,0,0,1
23103,1,0,0,0,1
23104,0,1,0,0,1
23105,0,0,0,1,1
23106,0,1,0,0,1
23107,0,1,0,0,1
23108,0,1,0,0,1
23109,0,1,0,0,1
23110,0,1,0,0,1
23111,1,0,0,0,1
23112,0,1,0,0,1
23113,0,1,0,0,1
23114,0,1,0,0,1
23115,0,1,0,0,1
23116,0,1,0,0,1
23117,0,1,0,0,1
23118,1,0,0,0,1
23119,0,1,0,0,1
23120,0,1,0,0,1
23121,0,1,0,0,1
23122,0,1,0,0,1
23123,0,1,0,0,1
23124,0,1,0,0,1
23125,0,1,0,0,1
23126,0,1,0,0,1
23127,1,0,0,0,1
23128,0,1,0,0,1
23129,0,1,0,0,1
23130,0,1,0,0,1
23131,1,0,0,0,1
23132,0,1,0,0,1
23133,0,0,1,0,1
23134,1,0,0,0,1
23135,0,1,0,0,1
23136,0,1,0,0,1
23137,0,1,0,0,1
23138,0,1,0,0,1
23139,1,0,0,0,1
23140,0,1,0,0,1
23141,0,1,0,0,1
23142,0,1,0,0,1
23143,0,1,0,0,1
23144,1,0,0,0,1
23145,0,1,0,0,1
23146,0,1,0,0,1
23147,1,0,0,0,1
23148,1,0,0,0,1
23149,0,1,0,0,1
23150,0,1,0,0,1
23151,0,1,0,0,1
23152,0,1,0,0,1
23153,0,1,0,0,1
23154,0,1,0,0,1
23155,0,1,0,0,1
23156,0,1,0,0,1
23157,1,0,0,0,1
23158,1,0,0,0,1
23159,1,0,0,0,1
23160,0,1,0,0,1
23161,1,0,0,0,1
23162,0,1,0,0,1
23163,1,0,0,0,1
23164,0,1,0,0,1
23165,0,1,0,0,1
23166,0,1,0,0,1
23167,0,1,0,0,1
23168,0,1,0,0,1
23169,1,0,0,0,1
23170,1,0,0,0,1
23171,0,1,0,0,1
23172,0,1,0,0,1
23173,0,1,0,0,1
23174,0,1,0,0,1
23175,0,1,0,0,1
23176,0,1,0,0,1
23177,0,1,0,0,1
23178,0,1,0,0,1
23179,0,1,0,0,1
23180,1,0,0,0,1
23181,1,0,0,0,1
23182,0,1,0,0,1
23183,0,1,0,0,1
23184,1,0,0,0,1
23185,0,1,0,0,1
23186,1,0,0,0,1
23187,1,0,0,0,1
23188,0,1,0,0,1
23189,0,1,0,0,1
23190,0,1,0,0,1
23191,1,0,0,0,1
23192,0,1,0,0,1
23193,0,1,0,0,1
23194,0,1,0,0,1
23195,1,0,0,0,1
23196,0,1,0,0,1
23197,0,1,0,0,1
23198,0,1,0,0,1
23199,0,1,0,0,1
23200,0,0,1,0,1
23201,0,1,0,0,1
23202,0,1,0,0,1
23203,0,1,0,0,1
23204,0,1,0,0,1
23205,0,1,0,0,1
23206,0,1,0,0,1
23207,0,1,0,0,1
23208,0,1,0,0,1
23209,0,1,0,0,1
23210,0,1,0,0,1
23211,0,1,0,0,1
23212,0,1,0,0,1
23213,1,0,0,0,1
23214,0,1,0,0,1
23215,0,1,0,0,1
23216,0,1,0,0,1
23217,1,0,0,0,1
23218,1,0,0,0,1
23219,0,1,0,0,1
23220,0,1,0,0,1
23221,0,1,0,0,1
23222,0,1,0,0,1
23223,0,1,0,0,1
23224,1,0,0,0,1
23225,0,1,0,0,1
23226,0,1,0,0,1
23227,0,1,0,0,1
23228,0,1,0,0,1
23229,0,1,0,0,1
23230,0,1,0,0,1
23231,1,0,0,0,1
23232,0,1,0,0,1
23233,0,1,0,0,1
23234,0,1,0,0,1
23235,0,1,0,0,1
23236,1,0,0,0,1
23237,0,1,0,0,1
23238,0,1,0,0,1
23239,0,1,0,0,1
23240,0,1,0,0,1
23241,1,0,0,0,1
23242,0,1,0,0,1
23243,0,1,0,0,1
23244,0,1,0,0,1
23245,0,0,0,1,1
23246,0,1,0,0,1
23247,0,1,0,0,1
23248,0,1,0,0,1
23249,0,1,0,0,1
23250,0,1,0,0,1
23251,0,1,0,0,1
23252,0,1,0,0,1
23253,0,1,0,0,1
23254,0,0,1,0,1
23255,1,0,0,0,1
23256,0,1,0,0,1
23257,0,1,0,0,1
23258,1,0,0,0,1
23259,1,0,0,0,1
23260,1,0,0,0,1
23261,0,1,0,0,1
23262,1,0,0,0,1
23263,0,1,0,0,1
23264,0,1,0,0,1
23265,0,1,0,0,1
23266,0,1,0,0,1
23267,0,1,0,0,1
23268,0,0,1,0,1
23269,0,1,0,0,1
23270,0,1,0,0,1
23271,0,1,0,0,1
23272,0,1,0,0,1
23273,0,1,0,0,1
23274,0,1,0,0,1
23275,1,0,0,0,1
23276,0,1,0,0,1
23277,1,0,0,0,1
23278,1,0,0,0,1
23279,1,0,0,0,1
23280,0,0,0,1,1
23281,0,1,0,0,1
23282,1,0,0,0,1
23283,1,0,0,0,1
23284,0,1,0,0,1
23285,1,0,0,0,1
23286,0,1,0,0,1
23287,0,0,1,0,1
23288,0,1,0,0,1
23289,1,0,0,0,1
23290,0,1,0,0,1
23291,0,1,0,0,1
23292,1,0,0,0,1
23293,0,1,0,0,1
23294,0,0,1,0,1
23295,0,1,0,0,1
23296,0,1,0,0,1
23297,0,1,0,0,1
23298,0,1,0,0,1
23299,0,1,0,0,1
23300,0,1,0,0,1
23301,0,1,0,0,1
23302,0,1,0,0,1
23303,0,1,0,0,1
23304,0,1,0,0,1
23305,0,1,0,0,1
23306,0,0,0,1,1
23307,0,1,0,0,1
23308,0,1,0,0,1
23309,0,1,0,0,1
23310,0,1,0,0,1
23311,1,0,0,0,1
23312,0,1,0,0,1
23313,0,1,0,0,1
23314,0,1,0,0,1
23315,0,1,0,0,1
23316,0,1,0,0,1
23317,0,1,0,0,1
23318,0,1,0,0,1
23319,1,0,0,0,1
23320,1,0,0,0,1
23321,0,1,0,0,1
23322,0,1,0,0,1
23323,0,1,0,0,1
23324,1,0,0,0,1
23325,0,1,0,0,1
23326,0,1,0,0,1
23327,0,1,0,0,1
23328,0,1,0,0,1
23329,0,1,0,0,1
23330,0,1,0,0,1
23331,0,1,0,0,1
23332,0,1,0,0,1
23333,0,1,0,0,1
23334,0,1,0,0,1
23335,1,0,0,0,1
23336,1,0,0,0,1
23337,1,0,0,0,1
23338,0,1,0,0,1
23339,0,1,0,0,1
23340,0,1,0,0,1
23341,0,0,1,0,1
23342,0,1,0,0,1
23343,0,1,0,0,1
23344,0,1,0,0,1
23345,0,1,0,0,1
23346,0,1,0,0,1
23347,0,1,0,0,1
23348,0,1,0,0,1
23349,0,1,0,0,1
23350,0,1,0,0,1
23351,0,1,0,0,1
23352,0,1,0,0,1
23353,0,0,0,1,1
23354,0,1,0,0,1
23355,0,0,0,1,1
23356,1,0,0,0,1
23357,0,1,0,0,1
23358,0,1,0,0,1
23359,0,1,0,0,1
23360,0,1,0,0,1
23361,0,1,0,0,1
23362,0,1,0,0,1
23363,0,1,0,0,1
23364,0,1,0,0,1
23365,0,0,0,1,1
23366,0,1,0,0,1
23367,0,1,0,0,1
23368,0,1,0,0,1
23369,0,1,0,0,1
23370,0,1,0,0,1
23371,0,1,0,0,1
23372,1,0,0,0,1
23373,0,1,0,0,1
23374,1,0,0,0,1
23375,0,1,0,0,1
23376,0,1,0,0,1
23377,1,0,0,0,1
23378,0,1,0,0,1
23379,0,1,0,0,1
23380,0,1,0,0,1
23381,0,1,0,0,1
23382,0,1,0,0,1
23383,0,1,0,0,1
23384,1,0,0,0,1
23385,1,0,0,0,1
23386,0,1,0,0,1
23387,0,1,0,0,1
23388,0,1,0,0,1
23389,0,1,0,0,1
23390,0,1,0,0,1
23391,0,1,0,0,1
23392,0,1,0,0,1
23393,0,1,0,0,1
23394,0,1,0,0,1
23395,0,1,0,0,1
23396,0,1,0,0,1
23397,0,0,0,1,1
23398,0,1,0,0,1
23399,1,0,0,0,1
23400,0,1,0,0,1
23401,0,1,0,0,1
23402,0,1,0,0,1
23403,1,0,0,0,1
23404,0,1,0,0,1
23405,0,1,0,0,1
23406,0,0,0,1,1
23407,0,1,0,0,1
23408,0,1,0,0,1
23409,0,1,0,0,1
23410,0,1,0,0,1
23411,0,1,0,0,1
23412,0,1,0,0,1
23413,0,1,0,0,1
23414,1,0,0,0,1
23415,0,1,0,0,1
23416,0,1,0,0,1
23417,0,1,0,0,1
23418,0,0,0,1,1
23419,0,1,0,0,1
23420,0,1,0,0,1
23421,1,0,0,0,1
23422,0,1,0,0,1
23423,0,1,0,0,1
23424,0,1,0,0,1
23425,0,1,0,0,1
23426,1,0,0,0,1
23427,0,1,0,0,1
23428,0,1,0,0,1
23429,0,1,0,0,1
23430,0,1,0,0,1
23431,0,1,0,0,1
23432,0,1,0,0,1
23433,0,1,0,0,1
23434,0,1,0,0,1
23435,0,0,0,1,1
23436,1,0,0,0,1
23437,0,1,0,0,1
23438,0,1,0,0,1
23439,1,0,0,0,1
23440,1,0,0,0,1
23441,1,0,0,0,1
23442,1,0,0,0,1
23443,0,1,0,0,1
23444,1,0,0,0,1
23445,0,1,0,0,1
23446,1,0,0,0,1
23447,0,1,0,0,1
23448,0,1,0,0,1
23449,0,1,0,0,1
23450,0,1,0,0,1
23451,0,1,0,0,1
23452,0,1,0,0,1
23453,1,0,0,0,1
23454,0,1,0,0,1
23455,0,1,0,0,1
23456,0,1,0,0,1
23457,0,1,0,0,1
23458,0,1,0,0,1
23459,0,1,0,0,1
23460,0,1,0,0,1
23461,0,1,0,0,1
23462,0,1,0,0,1
23463,0,1,0,0,1
23464,0,1,0,0,1
23465,0,1,0,0,1
23466,0,1,0,0,1
23467,0,1,0,0,1
23468,0,0,0,1,1
23469,1,0,0,0,1
23470,0,0,1,0,1
23471,0,1,0,0,1
23472,0,1,0,0,1
23473,0,1,0,0,1
23474,0,1,0,0,1
23475,0,1,0,0,1
23476,0,1,0,0,1
23477,0,1,0,0,1
23478,0,0,0,1,1
23479,0,1,0,0,1
23480,1,0,0,0,1
23481,0,1,0,0,1
23482,0,1,0,0,1
23483,0,1,0,0,1
23484,0,1,0,0,1
23485,0,1,0,0,1
23486,0,1,0,0,1
23487,0,1,0,0,1
23488,0,1,0,0,1
23489,0,1,0,0,1
23490,0,1,0,0,1
23491,0,1,0,0,1
23492,0,1,0,0,1
23493,0,1,0,0,1
23494,0,1,0,0,1
23495,1,0,0,0,1
23496,0,1,0,0,1
23497,1,0,0,0,1
23498,0,1,0,0,1
23499,0,1,0,0,1
23500,0,1,0,0,1
23501,0,0,1,0,1
23502,0,1,0,0,1
23503,0,1,0,0,1
23504,0,1,0,0,1
23505,0,1,0,0,1
23506,0,1,0,0,1
23507,0,1,0,0,1
23508,0,1,0,0,1
23509,0,1,0,0,1
23510,0,1,0,0,1
23511,0,1,0,0,1
23512,0,1,0,0,1
23513,0,1,0,0,1
23514,0,1,0,0,1
23515,0,1,0,0,1
23516,0,1,0,0,1
23517,1,0,0,0,1
23518,0,1,0,0,1
23519,0,1,0,0,1
23520,0,1,0,0,1
23521,0,1,0,0,1
23522,0,1,0,0,1
23523,0,1,0,0,1
23524,1,0,0,0,1
23525,1,0,0,0,1
23526,0,1,0,0,1
23527,1,0,0,0,1
23528,1,0,0,0,1
23529,0,1,0,0,1
23530,0,1,0,0,1
23531,0,1,0,0,1
23532,0,1,0,0,1
23533,0,1,0,0,1
23534,0,0,0,1,1
23535,0,1,0,0,1
23536,0,1,0,0,1
23537,0,1,0,0,1
23538,0,0,0,1,1
23539,0,1,0,0,1
23540,1,0,0,0,1
23541,0,1,0,0,1
23542,0,1,0,0,1
23543,0,1,0,0,1
23544,0,1,0,0,1
23545,0,1,0,0,1
23546,0,1,0,0,1
23547,0,1,0,0,1
23548,0,1,0,0,1
23549,0,1,0,0,1
23550,0,1,0,0,1
23551,0,1,0,0,1
23552,0,1,0,0,1
23553,0,1,0,0,1
23554,1,0,0,0,1
23555,0,1,0,0,1
23556,1,0,0,0,1
23557,0,1,0,0,1
23558,0,1,0,0,1
23559,0,1,0,0,1
23560,0,1,0,0,1
23561,0,1,0,0,1
23562,0,1,0,0,1
23563,0,1,0,0,1
23564,0,1,0,0,1
23565,0,1,0,0,1
23566,0,1,0,0,1
23567,0,1,0,0,1
23568,0,1,0,0,1
23569,0,1,0,0,1
23570,0,1,0,0,1
23571,0,1,0,0,1
23572,0,0,0,1,1
23573,0,1,0,0,1
23574,0,1,0,0,1
23575,0,1,0,0,1
23576,1,0,0,0,1
23577,0,1,0,0,1
23578,0,1,0,0,1
23579,0,0,1,0,1
23580,1,0,0,0,1
23581,0,1,0,0,1
23582,0,1,0,0,1
23583,0,1,0,0,1
23584,1,0,0,0,1
23585,0,1,0,0,1
23586,0,1,0,0,1
23587,0,1,0,0,1
23588,1,0,0,0,1
23589,0,1,0,0,1
23590,0,1,0,0,1
23591,0,0,0,1,1
23592,0,1,0,0,1
23593,0,1,0,0,1
23594,0,0,1,0,1
23595,1,0,0,0,1
23596,0,1,0,0,1
23597,0,1,0,0,1
23598,0,1,0,0,1
23599,0,1,0,0,1
23600,0,1,0,0,1
23601,0,1,0,0,1
23602,1,0,0,0,1
23603,0,1,0,0,1
23604,1,0,0,0,1
23605,0,1,0,0,1
23606,0,0,0,1,1
23607,0,1,0,0,1
23608,0,1,0,0,1
23609,0,1,0,0,1
23610,0,1,0,0,1
23611,0,1,0,0,1
23612,0,1,0,0,1
23613,0,1,0,0,1
23614,0,1,0,0,1
23615,0,1,0,0,1
23616,0,1,0,0,1
23617,1,0,0,0,1
23618,0,1,0,0,1
23619,0,1,0,0,1
23620,1,0,0,0,1
23621,0,1,0,0,1
23622,0,1,0,0,1
23623,1,0,0,0,1
23624,0,1,0,0,1
23625,1,0,0,0,1
23626,0,1,0,0,1
23627,0,1,0,0,1
23628,0,1,0,0,1
23629,0,1,0,0,1
23630,0,1,0,0,1
23631,0,1,0,0,1
23632,0,1,0,0,1
23633,0,0,0,1,1
23634,0,0,0,1,1
23635,0,1,0,0,1
23636,0,1,0,0,1
23637,0,1,0,0,1
23638,1,0,0,0,1
23639,1,0,0,0,1
23640,0,0,0,1,1
23641,1,0,0,0,1
23642,1,0,0,0,1
23643,0,1,0,0,1
23644,0,1,0,0,1
23645,0,1,0,0,1
23646,0,1,0,0,1
23647,0,1,0,0,1
23648,0,1,0,0,1
23649,1,0,0,0,1
23650,0,1,0,0,1
23651,0,1,0,0,1
23652,0,1,0,0,1
23653,0,1,0,0,1
23654,0,1,0,0,1
23655,0,1,0,0,1
23656,0,1,0,0,1
23657,0,1,0,0,1
23658,0,1,0,0,1
23659,1,0,0,0,1
23660,0,1,0,0,1
23661,0,1,0,0,1
23662,0,1,0,0,1
23663,0,1,0,0,1
23664,0,1,0,0,1
23665,0,1,0,0,1
23666,1,0,0,0,1
23667,1,0,0,0,1
23668,1,0,0,0,1
23669,0,1,0,0,1
23670,0,1,0,0,1
23671,0,1,0,0,1
23672,0,1,0,0,1
23673,1,0,0,0,1
23674,0,1,0,0,1
23675,0,1,0,0,1
23676,0,1,0,0,1
23677,0,1,0,0,1
23678,0,1,0,0,1
23679,1,0,0,0,1
23680,0,1,0,0,1
23681,0,1,0,0,1
23682,0,0,0,1,1
23683,0,0,1,0,1
23684,0,1,0,0,1
23685,0,1,0,0,1
23686,1,0,0,0,1
23687,1,0,0,0,1
23688,0,1,0,0,1
23689,0,1,0,0,1
23690,0,0,0,1,1
23691,0,1,0,0,1
23692,0,1,0,0,1
23693,1,0,0,0,1
23694,0,1,0,0,1
23695,0,1,0,0,1
23696,0,1,0,0,1
23697,0,1,0,0,1
23698,0,1,0,0,1
23699,0,1,0,0,1
23700,1,0,0,0,1
23701,0,1,0,0,1
23702,0,1,0,0,1
23703,0,0,0,1,1
23704,0,1,0,0,1
23705,0,1,0,0,1
23706,0,1,0,0,1
23707,0,1,0,0,1
23708,0,1,0,0,1
23709,1,0,0,0,1
23710,1,0,0,0,1
23711,0,1,0,0,1
23712,0,0,0,1,1
23713,0,1,0,0,1
23714,1,0,0,0,1
23715,0,0,0,1,1
23716,0,1,0,0,1
23717,0,1,0,0,1
23718,0,1,0,0,1
23719,1,0,0,0,1
23720,1,0,0,0,1
23721,0,1,0,0,1
23722,0,1,0,0,1
23723,0,1,0,0,1
23724,0,1,0,0,1
23725,0,1,0,0,1
23726,0,1,0,0,1
23727,0,1,0,0,1
23728,0,1,0,0,1
23729,0,1,0,0,1
23730,0,1,0,0,1
23731,0,0,1,0,1
23732,0,1,0,0,1
23733,0,1,0,0,1
23734,0,1,0,0,1
23735,0,1,0,0,1
23736,0,1,0,0,1
23737,0,1,0,0,1
23738,0,1,0,0,1
23739,0,1,0,0,1
23740,0,1,0,0,1
23741,0,1,0,0,1
23742,0,1,0,0,1
23743,0,1,0,0,1
23744,0,0,1,0,1
23745,1,0,0,0,1
23746,1,0,0,0,1
23747,0,0,1,0,1
23748,0,0,0,1,1
23749,0,1,0,0,1
23750,0,1,0,0,1
23751,0,1,0,0,1
23752,0,1,0,0,1
23753,0,0,0,1,1
23754,0,1,0,0,1
23755,0,1,0,0,1
23756,0,1,0,0,1
23757,0,1,0,0,1
23758,0,1,0,0,1
23759,0,1,0,0,1
23760,0,1,0,0,1
23761,0,1,0,0,1
23762,0,1,0,0,1
23763,1,0,0,0,1
23764,0,1,0,0,1
23765,0,1,0,0,1
23766,0,1,0,0,1
23767,0,1,0,0,1
23768,0,1,0,0,1
23769,0,1,0,0,1
23770,0,1,0,0,1
23771,0,1,0,0,1
23772,0,1,0,0,1
23773,0,1,0,0,1
23774,0,1,0,0,1
23775,0,1,0,0,1
23776,0,1,0,0,1
23777,1,0,0,0,1
23778,0,1,0,0,1
23779,0,1,0,0,1
23780,0,1,0,0,1
23781,0,0,0,1,1
23782,0,1,0,0,1
23783,0,1,0,0,1
23784,1,0,0,0,1
23785,0,1,0,0,1
23786,0,1,0,0,1
23787,0,1,0,0,1
23788,1,0,0,0,1
23789,0,1,0,0,1
23790,0,1,0,0,1
23791,0,1,0,0,1
23792,1,0,0,0,1
23793,0,1,0,0,1
23794,0,1,0,0,1
23795,0,1,0,0,1
23796,0,1,0,0,1
23797,0,1,0,0,1
23798,0,0,0,1,1
23799,0,1,0,0,1
23800,0,1,0,0,1
23801,0,1,0,0,1
23802,0,1,0,0,1
23803,1,0,0,0,1
23804,0,1,0,0,1
23805,0,1,0,0,1
23806,0,1,0,0,1
23807,0,1,0,0,1
23808,0,1,0,0,1
23809,0,1,0,0,1
23810,1,0,0,0,1
23811,0,1,0,0,1
23812,0,1,0,0,1
23813,0,0,1,0,1
23814,0,1,0,0,1
23815,0,1,0,0,1
23816,0,1,0,0,1
23817,0,0,1,0,1
23818,0,1,0,0,1
23819,1,0,0,0,1
23820,0,1,0,0,1
23821,0,1,0,0,1
23822,0,1,0,0,1
23823,0,1,0,0,1
23824,0,1,0,0,1
23825,0,1,0,0,1
23826,0,1,0,0,1
23827,0,0,0,1,1
23828,0,1,0,0,1
23829,0,1,0,0,1
23830,0,1,0,0,1
23831,0,1,0,0,1
23832,1,0,0,0,1
23833,0,1,0,0,1
23834,0,1,0,0,1
23835,0,0,1,0,1
23836,0,1,0,0,1
23837,0,1,0,0,1
23838,0,1,0,0,1
23839,0,1,0,0,1
23840,0,1,0,0,1
23841,0,1,0,0,1
23842,1,0,0,0,1
23843,0,1,0,0,1
23844,0,1,0,0,1
23845,0,0,1,0,1
23846,1,0,0,0,1
23847,0,1,0,0,1
23848,0,1,0,0,1
23849,0,1,0,0,1
23850,0,1,0,0,1
23851,0,1,0,0,1
23852,0,0,0,1,1
23853,0,1,0,0,1
23854,1,0,0,0,1
23855,0,1,0,0,1
23856,0,1,0,0,1
23857,0,1,0,0,1
23858,0,1,0,0,1
23859,0,1,0,0,1
23860,0,1,0,0,1
23861,0,0,0,1,1
23862,0,1,0,0,1
23863,0,1,0,0,1
23864,0,1,0,0,1
23865,0,1,0,0,1
23866,0,1,0,0,1
23867,0,1,0,0,1
23868,0,1,0,0,1
23869,0,1,0,0,1
23870,0,0,0,1,1
23871,0,1,0,0,1
23872,0,1,0,0,1
23873,0,1,0,0,1
23874,0,1,0,0,1
23875,0,1,0,0,1
23876,0,1,0,0,1
23877,0,1,0,0,1
23878,0,1,0,0,1
23879,1,0,0,0,1
23880,0,1,0,0,1
23881,1,0,0,0,1
23882,0,1,0,0,1
23883,0,1,0,0,1
23884,0,1,0,0,1
23885,0,1,0,0,1
23886,1,0,0,0,1
23887,1,0,0,0,1
23888,0,1,0,0,1
23889,0,1,0,0,1
23890,0,1,0,0,1
23891,1,0,0,0,1
23892,0,1,0,0,1
23893,0,1,0,0,1
23894,0,1,0,0,1
23895,0,1,0,0,1
23896,0,1,0,0,1
23897,0,1,0,0,1
23898,0,1,0,0,1
23899,0,1,0,0,1
23900,1,0,0,0,1
23901,0,1,0,0,1
23902,0,1,0,0,1
23903,0,1,0,0,1
23904,1,0,0,0,1
23905,0,1,0,0,1
23906,0,1,0,0,1
23907,0,1,0,0,1
23908,0,1,0,0,1
23909,0,1,0,0,1
23910,0,1,0,0,1
23911,1,0,0,0,1
23912,0,1,0,0,1
23913,0,0,0,1,1
23914,0,1,0,0,1
23915,0,1,0,0,1
23916,1,0,0,0,1
23917,0,1,0,0,1
23918,0,1,0,0,1
23919,0,1,0,0,1
23920,1,0,0,0,1
23921,0,1,0,0,1
23922,0,1,0,0,1
23923,0,1,0,0,1
23924,1,0,0,0,1
23925,0,1,0,0,1
23926,0,1,0,0,1
23927,0,1,0,0,1
23928,1,0,0,0,1
23929,0,1,0,0,1
23930,0,1,0,0,1
23931,0,1,0,0,1
23932,0,1,0,0,1
23933,1,0,0,0,1
23934,1,0,0,0,1
23935,0,1,0,0,1
23936,0,0,1,0,1
23937,0,1,0,0,1
23938,0,1,0,0,1
23939,0,1,0,0,1
23940,0,0,0,1,1
23941,0,1,0,0,1
23942,1,0,0,0,1
23943,0,1,0,0,1
23944,0,1,0,0,1
23945,1,0,0,0,1
23946,0,1,0,0,1
23947,0,1,0,0,1
23948,0,1,0,0,1
23949,0,1,0,0,1
23950,1,0,0,0,1
23951,1,0,0,0,1
23952,1,0,0,0,1
23953,0,0,1,0,1
23954,0,1,0,0,1
23955,1,0,0,0,1
23956,0,1,0,0,1
23957,0,1,0,0,1
23958,0,1,0,0,1
23959,0,1,0,0,1
23960,0,1,0,0,1
23961,0,1,0,0,1
23962,0,1,0,0,1
23963,0,1,0,0,1
23964,0,1,0,0,1
23965,0,1,0,0,1
23966,1,0,0,0,1
23967,1,0,0,0,1
23968,0,1,0,0,1
23969,0,1,0,0,1
23970,0,1,0,0,1
23971,0,1,0,0,1
23972,0,1,0,0,1
23973,0,1,0,0,1
23974,0,0,1,0,1
23975,0,1,0,0,1
23976,1,0,0,0,1
23977,0,1,0,0,1
23978,0,1,0,0,1
23979,0,1,0,0,1
23980,0,1,0,0,1
23981,0,1,0,0,1
23982,0,1,0,0,1
23983,0,1,0,0,1
23984,1,0,0,0,1
23985,0,1,0,0,1
23986,1,0,0,0,1
23987,0,1,0,0,1
23988,0,1,0,0,1
23989,0,1,0,0,1
23990,0,1,0,0,1
23991,0,1,0,0,1
23992,0,0,0,1,1
23993,1,0,0,0,1
23994,1,0,0,0,1
23995,0,1,0,0,1
23996,0,1,0,0,1
23997,0,1,0,0,1
23998,1,0,0,0,1
23999,0,1,0,0,1
24000,0,1,0,0,1
24001,0,1,0,0,1
24002,0,1,0,0,1
24003,0,1,0,0,1
24004,0,1,0,0,1
24005,1,0,0,0,1
24006,0,1,0,0,1
24007,1,0,0,0,1
24008,0,1,0,0,1
24009,1,0,0,0,1
24010,1,0,0,0,1
24011,0,1,0,0,1
24012,1,0,0,0,1
24013,0,1,0,0,1
24014,0,1,0,0,1
24015,0,1,0,0,1
24016,0,1,0,0,1
24017,0,0,1,0,1
24018,0,0,0,1,1
24019,0,1,0,0,1
24020,0,1,0,0,1
24021,1,0,0,0,1
24022,0,1,0,0,1
24023,0,0,0,1,1
24024,0,1,0,0,1
24025,1,0,0,0,1
24026,0,1,0,0,1
24027,0,1,0,0,1
24028,0,1,0,0,1
24029,0,1,0,0,1
24030,0,1,0,0,1
24031,0,0,0,1,1
24032,0,1,0,0,1
24033,1,0,0,0,1
24034,0,1,0,0,1
24035,0,0,0,1,1
24036,0,1,0,0,1
24037,0,1,0,0,1
24038,0,1,0,0,1
24039,0,0,0,1,1
24040,1,0,0,0,1
24041,0,1,0,0,1
24042,0,1,0,0,1
24043,0,1,0,0,1
24044,0,1,0,0,1
24045,0,0,1,0,1
24046,0,1,0,0,1
24047,0,1,0,0,1
24048,0,1,0,0,1
24049,0,1,0,0,1
24050,0,1,0,0,1
24051,0,0,1,0,1
24052,0,1,0,0,1
24053,0,1,0,0,1
24054,0,1,0,0,1
24055,0,1,0,0,1
24056,0,1,0,0,1
24057,0,1,0,0,1
24058,0,1,0,0,1
24059,0,1,0,0,1
24060,1,0,0,0,1
24061,0,1,0,0,1
24062,1,0,0,0,1
24063,0,1,0,0,1
24064,0,1,0,0,1
24065,0,1,0,0,1
24066,0,0,1,0,1
24067,0,1,0,0,1
24068,0,1,0,0,1
24069,0,1,0,0,1
24070,1,0,0,0,1
24071,0,1,0,0,1
24072,0,1,0,0,1
24073,0,1,0,0,1
24074,1,0,0,0,1
24075,0,1,0,0,1
24076,0,1,0,0,1
24077,0,1,0,0,1
24078,0,1,0,0,1
24079,1,0,0,0,1
24080,1,0,0,0,1
24081,1,0,0,0,1
24082,0,1,0,0,1
24083,0,0,0,1,1
24084,0,1,0,0,1
24085,0,0,0,1,1
24086,0,1,0,0,1
24087,0,0,0,1,1
24088,0,1,0,0,1
24089,0,1,0,0,1
24090,1,0,0,0,1
24091,0,1,0,0,1
24092,0,1,0,0,1
24093,0,1,0,0,1
24094,1,0,0,0,1
24095,1,0,0,0,1
24096,0,1,0,0,1
24097,0,1,0,0,1
24098,0,1,0,0,1
24099,0,1,0,0,1
24100,0,1,0,0,1
24101,0,1,0,0,1
24102,0,1,0,0,1
24103,0,1,0,0,1
24104,0,1,0,0,1
24105,1,0,0,0,1
24106,0,1,0,0,1
24107,0,1,0,0,1
24108,0,1,0,0,1
24109,0,1,0,0,1
24110,1,0,0,0,1
24111,0,1,0,0,1
24112,0,1,0,0,1
24113,0,1,0,0,1
24114,1,0,0,0,1
24115,0,1,0,0,1
24116,0,1,0,0,1
24117,0,1,0,0,1
24118,1,0,0,0,1
24119,0,1,0,0,1
24120,0,1,0,0,1
24121,1,0,0,0,1
24122,0,1,0,0,1
24123,0,1,0,0,1
24124,0,1,0,0,1
24125,0,1,0,0,1
24126,0,1,0,0,1
24127,1,0,0,0,1
24128,0,1,0,0,1
24129,0,1,0,0,1
24130,0,1,0,0,1
24131,0,1,0,0,1
24132,0,1,0,0,1
24133,0,1,0,0,1
24134,1,0,0,0,1
24135,1,0,0,0,1
24136,0,1,0,0,1
24137,0,1,0,0,1
24138,1,0,0,0,1
24139,0,1,0,0,1
24140,0,1,0,0,1
24141,0,1,0,0,1
24142,0,1,0,0,1
24143,1,0,0,0,1
24144,0,1,0,0,1
24145,0,1,0,0,1
24146,1,0,0,0,1
24147,0,1,0,0,1
24148,0,1,0,0,1
24149,0,0,1,0,1
24150,0,1,0,0,1
24151,1,0,0,0,1
24152,0,0,0,1,1
24153,0,1,0,0,1
24154,0,1,0,0,1
24155,0,1,0,0,1
24156,1,0,0,0,1
24157,0,1,0,0,1
24158,1,0,0,0,1
24159,0,1,0,0,1
24160,0,1,0,0,1
24161,0,1,0,0,1
24162,0,1,0,0,1
24163,0,1,0,0,1
24164,0,1,0,0,1
24165,0,1,0,0,1
24166,0,1,0,0,1
24167,0,1,0,0,1
24168,0,1,0,0,1
24169,1,0,0,0,1
24170,0,1,0,0,1
24171,0,1,0,0,1
24172,0,1,0,0,1
24173,0,1,0,0,1
24174,0,1,0,0,1
24175,0,1,0,0,1
24176,0,1,0,0,1
24177,1,0,0,0,1
24178,1,0,0,0,1
24179,0,1,0,0,1
24180,0,1,0,0,1
24181,0,1,0,0,1
24182,1,0,0,0,1
24183,0,1,0,0,1
24184,1,0,0,0,1
24185,1,0,0,0,1
24186,0,1,0,0,1
24187,0,0,1,0,1
24188,0,1,0,0,1
24189,0,1,0,0,1
24190,0,1,0,0,1
24191,0,1,0,0,1
24192,0,1,0,0,1
24193,1,0,0,0,1
24194,0,1,0,0,1
24195,1,0,0,0,1
24196,0,1,0,0,1
24197,0,1,0,0,1
24198,0,1,0,0,1
24199,0,1,0,0,1
24200,0,1,0,0,1
24201,1,0,0,0,1
24202,0,1,0,0,1
24203,0,1,0,0,1
24204,1,0,0,0,1
24205,0,1,0,0,1
24206,0,1,0,0,1
24207,0,1,0,0,1
24208,1,0,0,0,1
24209,0,1,0,0,1
24210,0,1,0,0,1
24211,1,0,0,0,1
24212,0,1,0,0,1
24213,0,1,0,0,1
24214,0,1,0,0,1
24215,0,0,0,1,1
24216,0,1,0,0,1
24217,0,1,0,0,1
24218,0,1,0,0,1
24219,0,1,0,0,1
24220,1,0,0,0,1
24221,0,1,0,0,1
24222,1,0,0,0,1
24223,0,1,0,0,1
24224,0,1,0,0,1
24225,1,0,0,0,1
24226,0,1,0,0,1
24227,0,1,0,0,1
24228,0,1,0,0,1
24229,0,1,0,0,1
24230,0,1,0,0,1
24231,0,1,0,0,1
24232,0,1,0,0,1
24233,0,0,1,0,1
24234,0,1,0,0,1
24235,0,1,0,0,1
24236,1,0,0,0,1
24237,0,1,0,0,1
24238,1,0,0,0,1
24239,1,0,0,0,1
24240,0,1,0,0,1
24241,1,0,0,0,1
24242,0,1,0,0,1
24243,0,1,0,0,1
24244,0,1,0,0,1
24245,1,0,0,0,1
24246,0,1,0,0,1
24247,0,1,0,0,1
24248,1,0,0,0,1
24249,0,1,0,0,1
24250,0,1,0,0,1
24251,0,1,0,0,1
24252,0,1,0,0,1
24253,0,1,0,0,1
24254,0,1,0,0,1
24255,0,1,0,0,1
24256,0,1,0,0,1
24257,0,1,0,0,1
24258,0,1,0,0,1
24259,0,1,0,0,1
24260,0,1,0,0,1
24261,0,1,0,0,1
24262,0,1,0,0,1
24263,0,1,0,0,1
24264,0,1,0,0,1
24265,0,1,0,0,1
24266,0,1,0,0,1
24267,0,1,0,0,1
24268,0,1,0,0,1
24269,0,1,0,0,1
24270,0,1,0,0,1
24271,0,1,0,0,1
24272,0,1,0,0,1
24273,0,1,0,0,1
24274,0,1,0,0,1
24275,0,1,0,0,1
24276,1,0,0,0,1
24277,0,1,0,0,1
24278,0,0,0,1,1
24279,0,1,0,0,1
24280,0,1,0,0,1
24281,0,1,0,0,1
24282,0,0,1,0,1
24283,0,1,0,0,1
24284,0,1,0,0,1
24285,0,1,0,0,1
24286,0,1,0,0,1
24287,0,1,0,0,1
24288,0,1,0,0,1
24289,1,0,0,0,1
24290,0,1,0,0,1
24291,0,1,0,0,1
24292,0,0,1,0,1
24293,1,0,0,0,1
24294,1,0,0,0,1
24295,0,1,0,0,1
24296,0,0,1,0,1
24297,1,0,0,0,1
24298,0,0,0,1,1
24299,0,1,0,0,1
24300,0,1,0,0,1
24301,0,1,0,0,1
24302,0,1,0,0,1
24303,1,0,0,0,1
24304,0,1,0,0,1
24305,0,1,0,0,1
24306,0,1,0,0,1
24307,0,1,0,0,1
24308,0,1,0,0,1
24309,0,1,0,0,1
24310,0,1,0,0,1
24311,0,1,0,0,1
24312,0,1,0,0,1
24313,0,1,0,0,1
24314,0,1,0,0,1
24315,0,1,0,0,1
24316,0,1,0,0,1
24317,0,0,0,1,1
24318,0,1,0,0,1
24319,0,1,0,0,1
24320,1,0,0,0,1
24321,0,1,0,0,1
24322,0,1,0,0,1
24323,0,1,0,0,1
24324,0,1,0,0,1
24325,0,1,0,0,1
24326,0,1,0,0,1
24327,0,1,0,0,1
24328,0,1,0,0,1
24329,0,1,0,0,1
24330,1,0,0,0,1
24331,0,1,0,0,1
24332,0,1,0,0,1
24333,0,1,0,0,1
24334,1,0,0,0,1
24335,0,1,0,0,1
24336,0,1,0,0,1
24337,0,1,0,0,1
24338,0,1,0,0,1
24339,0,1,0,0,1
24340,1,0,0,0,1
24341,0,1,0,0,1
24342,0,1,0,0,1
24343,0,1,0,0,1
24344,1,0,0,0,1
24345,0,1,0,0,1
24346,0,1,0,0,1
24347,0,0,0,1,1
24348,0,1,0,0,1
24349,0,1,0,0,1
24350,0,1,0,0,1
24351,0,1,0,0,1
24352,0,0,0,1,1
24353,1,0,0,0,1
24354,0,1,0,0,1
24355,1,0,0,0,1
24356,1,0,0,0,1
24357,0,1,0,0,1
24358,0,1,0,0,1
24359,0,1,0,0,1
24360,1,0,0,0,1
24361,0,1,0,0,1
24362,0,1,0,0,1
24363,0,1,0,0,1
24364,0,0,1,0,1
24365,0,0,1,0,1
24366,1,0,0,0,1
24367,1,0,0,0,1
24368,1,0,0,0,1
24369,0,1,0,0,1
24370,0,1,0,0,1
24371,0,1,0,0,1
24372,0,1,0,0,1
24373,0,1,0,0,1
24374,0,1,0,0,1
24375,0,1,0,0,1
24376,0,1,0,0,1
24377,0,1,0,0,1
24378,1,0,0,0,1
24379,1,0,0,0,1
24380,0,1,0,0,1
24381,0,1,0,0,1
24382,0,1,0,0,1
24383,0,1,0,0,1
24384,0,1,0,0,1
24385,0,1,0,0,1
24386,1,0,0,0,1
24387,0,1,0,0,1
24388,0,1,0,0,1
24389,0,1,0,0,1
24390,0,1,0,0,1
24391,0,1,0,0,1
24392,1,0,0,0,1
24393,0,1,0,0,1
24394,0,1,0,0,1
24395,0,1,0,0,1
24396,0,1,0,0,1
24397,0,0,0,1,1
24398,0,1,0,0,1
24399,0,1,0,0,1
24400,0,1,0,0,1
24401,0,1,0,0,1
24402,0,1,0,0,1
24403,0,1,0,0,1
24404,0,1,0,0,1
24405,0,1,0,0,1
24406,0,1,0,0,1
24407,0,1,0,0,1
24408,1,0,0,0,1
24409,0,1,0,0,1
24410,0,1,0,0,1
24411,0,1,0,0,1
24412,0,1,0,0,1
24413,0,1,0,0,1
24414,0,1,0,0,1
24415,0,1,0,0,1
24416,0,1,0,0,1
24417,0,1,0,0,1
24418,0,1,0,0,1
24419,1,0,0,0,1
24420,0,1,0,0,1
24421,1,0,0,0,1
24422,0,1,0,0,1
24423,0,1,0,0,1
24424,1,0,0,0,1
24425,0,1,0,0,1
24426,0,1,0,0,1
24427,0,1,0,0,1
24428,1,0,0,0,1
24429,0,1,0,0,1
24430,0,1,0,0,1
24431,0,1,0,0,1
24432,0,1,0,0,1
24433,1,0,0,0,1
24434,0,1,0,0,1
24435,0,1,0,0,1
24436,0,1,0,0,1
24437,1,0,0,0,1
24438,0,1,0,0,1
24439,1,0,0,0,1
24440,0,1,0,0,1
24441,0,1,0,0,1
24442,1,0,0,0,1
24443,0,1,0,0,1
24444,1,0,0,0,1
24445,0,1,0,0,1
24446,0,1,0,0,1
24447,0,0,0,1,1
24448,0,1,0,0,1
24449,0,1,0,0,1
24450,1,0,0,0,1
24451,0,1,0,0,1
24452,0,1,0,0,1
24453,0,1,0,0,1
24454,0,1,0,0,1
24455,0,1,0,0,1
24456,0,1,0,0,1
24457,0,1,0,0,1
24458,0,1,0,0,1
24459,0,1,0,0,1
24460,0,1,0,0,1
24461,0,1,0,0,1
24462,1,0,0,0,1
24463,0,1,0,0,1
24464,0,1,0,0,1
24465,0,1,0,0,1
24466,1,0,0,0,1
24467,1,0,0,0,1
24468,0,0,0,1,1
24469,0,1,0,0,1
24470,0,1,0,0,1
24471,0,1,0,0,1
24472,0,1,0,0,1
24473,0,0,1,0,1
24474,0,1,0,0,1
24475,0,1,0,0,1
24476,0,1,0,0,1
24477,0,1,0,0,1
24478,0,1,0,0,1
24479,1,0,0,0,1
24480,1,0,0,0,1
24481,0,1,0,0,1
24482,0,1,0,0,1
24483,0,0,0,1,1
24484,0,1,0,0,1
24485,1,0,0,0,1
24486,0,1,0,0,1
24487,0,1,0,0,1
24488,0,1,0,0,1
24489,1,0,0,0,1
24490,1,0,0,0,1
24491,0,1,0,0,1
24492,0,1,0,0,1
24493,0,1,0,0,1
24494,0,1,0,0,1
24495,0,1,0,0,1
24496,0,1,0,0,1
24497,0,1,0,0,1
24498,0,1,0,0,1
24499,0,1,0,0,1
24500,0,1,0,0,1
24501,0,1,0,0,1
24502,0,1,0,0,1
24503,0,1,0,0,1
24504,1,0,0,0,1
24505,1,0,0,0,1
24506,0,1,0,0,1
24507,0,0,0,1,1
24508,0,1,0,0,1
24509,0,1,0,0,1
24510,0,1,0,0,1
24511,0,1,0,0,1
24512,1,0,0,0,1
24513,0,1,0,0,1
24514,0,1,0,0,1
24515,0,1,0,0,1
24516,0,1,0,0,1
24517,0,1,0,0,1
24518,0,1,0,0,1
24519,1,0,0,0,1
24520,0,1,0,0,1
24521,1,0,0,0,1
24522,0,1,0,0,1
24523,0,1,0,0,1
24524,0,1,0,0,1
24525,0,1,0,0,1
24526,0,1,0,0,1
24527,0,1,0,0,1
24528,0,1,0,0,1
24529,0,1,0,0,1
24530,0,1,0,0,1
24531,0,1,0,0,1
24532,1,0,0,0,1
24533,0,1,0,0,1
24534,0,0,1,0,1
24535,0,1,0,0,1
24536,0,1,0,0,1
24537,0,1,0,0,1
24538,0,1,0,0,1
24539,0,1,0,0,1
24540,0,1,0,0,1
24541,0,1,0,0,1
24542,0,1,0,0,1
24543,0,1,0,0,1
24544,0,1,0,0,1
24545,0,1,0,0,1
24546,0,1,0,0,1
24547,0,1,0,0,1
24548,0,1,0,0,1
24549,1,0,0,0,1
24550,0,1,0,0,1
24551,0,1,0,0,1
24552,0,1,0,0,1
24553,1,0,0,0,1
24554,1,0,0,0,1
24555,0,1,0,0,1
24556,0,0,0,1,1
24557,1,0,0,0,1
24558,1,0,0,0,1
24559,0,1,0,0,1
24560,0,1,0,0,1
24561,0,1,0,0,1
24562,0,1,0,0,1
24563,0,0,0,1,1
24564,1,0,0,0,1
24565,0,1,0,0,1
24566,0,1,0,0,1
24567,1,0,0,0,1
24568,0,1,0,0,1
24569,1,0,0,0,1
24570,0,1,0,0,1
24571,0,1,0,0,1
24572,0,0,0,1,1
24573,0,1,0,0,1
24574,0,1,0,0,1
24575,0,1,0,0,1
24576,0,1,0,0,1
24577,0,1,0,0,1
24578,1,0,0,0,1
24579,0,1,0,0,1
24580,0,1,0,0,1
24581,0,1,0,0,1
24582,0,1,0,0,1
24583,0,1,0,0,1
24584,0,1,0,0,1
24585,0,1,0,0,1
24586,1,0,0,0,1
24587,1,0,0,0,1
24588,0,1,0,0,1
24589,0,1,0,0,1
24590,0,1,0,0,1
24591,0,1,0,0,1
24592,0,1,0,0,1
24593,0,1,0,0,1
24594,0,1,0,0,1
24595,0,1,0,0,1
24596,0,1,0,0,1
24597,0,1,0,0,1
24598,0,1,0,0,1
24599,0,1,0,0,1
24600,1,0,0,0,1
24601,0,1,0,0,1
24602,1,0,0,0,1
24603,1,0,0,0,1
24604,0,1,0,0,1
24605,0,1,0,0,1
24606,1,0,0,0,1
24607,0,1,0,0,1
24608,0,1,0,0,1
24609,1,0,0,0,1
24610,0,1,0,0,1
24611,0,1,0,0,1
24612,0,1,0,0,1
24613,1,0,0,0,1
24614,0,1,0,0,1
24615,0,1,0,0,1
24616,0,1,0,0,1
24617,0,0,0,1,1
24618,0,1,0,0,1
24619,1,0,0,0,1
24620,1,0,0,0,1
24621,0,1,0,0,1
24622,0,1,0,0,1
24623,0,1,0,0,1
24624,0,0,0,1,1
24625,0,1,0,0,1
24626,0,1,0,0,1
24627,0,1,0,0,1
24628,0,1,0,0,1
24629,0,1,0,0,1
24630,0,1,0,0,1
24631,0,1,0,0,1
24632,0,1,0,0,1
24633,1,0,0,0,1
24634,1,0,0,0,1
24635,0,1,0,0,1
24636,0,1,0,0,1
24637,0,1,0,0,1
24638,0,1,0,0,1
24639,0,1,0,0,1
24640,0,1,0,0,1
24641,0,1,0,0,1
24642,0,1,0,0,1
24643,0,1,0,0,1
24644,0,1,0,0,1
24645,0,1,0,0,1
24646,0,1,0,0,1
24647,0,1,0,0,1
24648,0,1,0,0,1
24649,0,1,0,0,1
24650,0,1,0,0,1
24651,0,1,0,0,1
24652,0,1,0,0,1
24653,0,1,0,0,1
24654,0,1,0,0,1
24655,0,1,0,0,1
24656,0,1,0,0,1
24657,0,1,0,0,1
24658,0,1,0,0,1
24659,0,1,0,0,1
24660,0,1,0,0,1
24661,0,1,0,0,1
24662,0,1,0,0,1
24663,0,1,0,0,1
24664,0,1,0,0,1
24665,0,1,0,0,1
24666,0,1,0,0,1
24667,1,0,0,0,1
24668,0,1,0,0,1
24669,0,1,0,0,1
24670,0,1,0,0,1
24671,0,1,0,0,1
24672,0,1,0,0,1
24673,0,1,0,0,1
24674,1,0,0,0,1
24675,0,1,0,0,1
24676,0,1,0,0,1
24677,0,1,0,0,1
24678,1,0,0,0,1
24679,0,1,0,0,1
24680,0,1,0,0,1
24681,0,1,0,0,1
24682,0,1,0,0,1
24683,1,0,0,0,1
24684,0,1,0,0,1
24685,0,1,0,0,1
24686,1,0,0,0,1
24687,0,1,0,0,1
24688,0,1,0,0,1
24689,0,1,0,0,1
24690,1,0,0,0,1
24691,0,1,0,0,1
24692,0,1,0,0,1
24693,0,1,0,0,1
24694,0,1,0,0,1
24695,1,0,0,0,1
24696,0,1,0,0,1
24697,1,0,0,0,1
24698,0,1,0,0,1
24699,0,1,0,0,1
24700,0,1,0,0,1
24701,0,1,0,0,1
24702,1,0,0,0,1
24703,0,1,0,0,1
24704,1,0,0,0,1
24705,0,1,0,0,1
24706,0,1,0,0,1
24707,1,0,0,0,1
24708,0,1,0,0,1
24709,0,1,0,0,1
24710,0,1,0,0,1
24711,1,0,0,0,1
24712,0,1,0,0,1
24713,0,1,0,0,1
24714,0,1,0,0,1
24715,0,1,0,0,1
24716,0,1,0,0,1
24717,0,1,0,0,1
24718,0,1,0,0,1
24719,0,1,0,0,1
24720,0,1,0,0,1
24721,0,1,0,0,1
24722,0,1,0,0,1
24723,0,1,0,0,1
24724,0,1,0,0,1
24725,0,1,0,0,1
24726,0,1,0,0,1
24727,0,1,0,0,1
24728,0,1,0,0,1
24729,0,1,0,0,1
24730,0,1,0,0,1
24731,0,1,0,0,1
24732,1,0,0,0,1
24733,0,0,0,1,1
24734,0,1,0,0,1
24735,0,1,0,0,1
24736,0,1,0,0,1
24737,0,1,0,0,1
24738,0,1,0,0,1
24739,0,1,0,0,1
24740,0,1,0,0,1
24741,0,1,0,0,1
24742,0,1,0,0,1
24743,1,0,0,0,1
24744,0,1,0,0,1
24745,0,1,0,0,1
24746,1,0,0,0,1
24747,0,0,1,0,1
24748,0,1,0,0,1
24749,0,1,0,0,1
24750,0,1,0,0,1
24751,0,1,0,0,1
24752,0,1,0,0,1
24753,0,1,0,0,1
24754,0,1,0,0,1
24755,0,1,0,0,1
24756,0,1,0,0,1
24757,0,1,0,0,1
24758,0,1,0,0,1
24759,0,1,0,0,1
24760,0,1,0,0,1
24761,0,1,0,0,1
24762,0,1,0,0,1
24763,1,0,0,0,1
24764,0,0,0,1,1
24765,0,1,0,0,1
24766,0,1,0,0,1
24767,0,1,0,0,1
24768,0,1,0,0,1
24769,0,1,0,0,1
24770,0,1,0,0,1
24771,1,0,0,0,1
24772,0,0,1,0,1
24773,0,1,0,0,1
24774,0,1,0,0,1
24775,0,0,0,1,1
24776,0,1,0,0,1
24777,0,1,0,0,1
24778,0,0,0,1,1
24779,0,1,0,0,1
24780,0,1,0,0,1
24781,0,1,0,0,1
24782,1,0,0,0,1
24783,0,1,0,0,1
24784,0,0,0,1,1
24785,0,1,0,0,1
24786,0,1,0,0,1
24787,0,1,0,0,1
24788,0,1,0,0,1
24789,0,1,0,0,1
24790,1,0,0,0,1
24791,1,0,0,0,1
24792,1,0,0,0,1
24793,0,1,0,0,1
24794,0,1,0,0,1
24795,0,1,0,0,1
24796,0,1,0,0,1
24797,0,1,0,0,1
24798,0,1,0,0,1
24799,0,1,0,0,1
24800,0,1,0,0,1
24801,0,1,0,0,1
24802,1,0,0,0,1
24803,0,1,0,0,1
24804,0,1,0,0,1
24805,0,1,0,0,1
24806,0,1,0,0,1
24807,1,0,0,0,1
24808,0,1,0,0,1
24809,0,1,0,0,1
24810,0,1,0,0,1
24811,1,0,0,0,1
24812,1,0,0,0,1
24813,0,1,0,0,1
24814,1,0,0,0,1
24815,0,1,0,0,1
24816,0,1,0,0,1
24817,1,0,0,0,1
24818,0,1,0,0,1
24819,0,1,0,0,1
24820,0,1,0,0,1
24821,0,1,0,0,1
24822,1,0,0,0,1
24823,1,0,0,0,1
24824,0,1,0,0,1
24825,1,0,0,0,1
24826,0,1,0,0,1
24827,0,1,0,0,1
24828,0,1,0,0,1
24829,0,1,0,0,1
24830,0,1,0,0,1
24831,0,1,0,0,1
24832,0,1,0,0,1
24833,0,1,0,0,1
24834,1,0,0,0,1
24835,1,0,0,0,1
24836,0,1,0,0,1
24837,0,1,0,0,1
24838,0,1,0,0,1
24839,0,1,0,0,1
24840,1,0,0,0,1
24841,0,1,0,0,1
24842,0,1,0,0,1
24843,0,1,0,0,1
24844,0,1,0,0,1
24845,0,1,0,0,1
24846,0,1,0,0,1
24847,0,1,0,0,1
24848,0,0,1,0,1
24849,0,1,0,0,1
24850,1,0,0,0,1
24851,0,1,0,0,1
24852,0,0,1,0,1
24853,0,1,0,0,1
24854,0,1,0,0,1
24855,1,0,0,0,1
24856,0,1,0,0,1
24857,1,0,0,0,1
24858,0,1,0,0,1
24859,0,1,0,0,1
24860,0,1,0,0,1
24861,0,1,0,0,1
24862,0,1,0,0,1
24863,1,0,0,0,1
24864,0,1,0,0,1
24865,0,1,0,0,1
24866,0,1,0,0,1
24867,0,0,1,0,1
24868,0,1,0,0,1
24869,0,1,0,0,1
24870,0,1,0,0,1
24871,0,1,0,0,1
24872,0,1,0,0,1
24873,0,1,0,0,1
24874,1,0,0,0,1
24875,0,1,0,0,1
24876,0,1,0,0,1
24877,1,0,0,0,1
24878,0,1,0,0,1
24879,0,1,0,0,1
24880,0,1,0,0,1
24881,0,1,0,0,1
24882,0,1,0,0,1
24883,0,1,0,0,1
24884,0,1,0,0,1
24885,1,0,0,0,1
24886,0,1,0,0,1
24887,0,0,1,0,1
24888,0,1,0,0,1
24889,0,1,0,0,1
24890,0,1,0,0,1
24891,0,1,0,0,1
24892,0,1,0,0,1
24893,1,0,0,0,1
24894,0,1,0,0,1
24895,0,1,0,0,1
24896,1,0,0,0,1
24897,0,1,0,0,1
24898,0,1,0,0,1
24899,0,1,0,0,1
24900,0,1,0,0,1
24901,0,1,0,0,1
24902,0,1,0,0,1
24903,0,1,0,0,1
24904,0,1,0,0,1
24905,0,0,0,1,1
24906,0,1,0,0,1
24907,1,0,0,0,1
24908,0,1,0,0,1
24909,0,1,0,0,1
24910,0,1,0,0,1
24911,0,1,0,0,1
24912,1,0,0,0,1
24913,1,0,0,0,1
24914,0,1,0,0,1
24915,0,1,0,0,1
24916,0,1,0,0,1
24917,0,1,0,0,1
24918,0,1,0,0,1
24919,0,1,0,0,1
24920,1,0,0,0,1
24921,0,1,0,0,1
24922,0,1,0,0,1
24923,0,1,0,0,1
24924,0,1,0,0,1
24925,0,0,1,0,1
24926,0,0,1,0,1
24927,0,1,0,0,1
24928,0,1,0,0,1
24929,0,1,0,0,1
24930,0,1,0,0,1
24931,0,1,0,0,1
24932,0,1,0,0,1
24933,0,0,1,0,1
24934,0,1,0,0,1
24935,1,0,0,0,1
24936,0,1,0,0,1
24937,0,1,0,0,1
24938,1,0,0,0,1
24939,0,1,0,0,1
24940,1,0,0,0,1
24941,0,1,0,0,1
24942,0,1,0,0,1
24943,0,1,0,0,1
24944,0,1,0,0,1
24945,0,1,0,0,1
24946,0,1,0,0,1
24947,0,1,0,0,1
24948,0,1,0,0,1
24949,1,0,0,0,1
24950,0,1,0,0,1
24951,1,0,0,0,1
24952,0,1,0,0,1
24953,1,0,0,0,1
24954,1,0,0,0,1
24955,1,0,0,0,1
24956,0,1,0,0,1
24957,0,1,0,0,1
24958,0,1,0,0,1
24959,1,0,0,0,1
24960,0,1,0,0,1
24961,0,1,0,0,1
24962,0,1,0,0,1
24963,1,0,0,0,1
24964,0,1,0,0,1
24965,0,1,0,0,1
24966,0,1,0,0,1
24967,0,1,0,0,1
24968,0,1,0,0,1
24969,0,1,0,0,1
24970,0,1,0,0,1
24971,0,1,0,0,1
24972,1,0,0,0,1
24973,0,1,0,0,1
24974,0,1,0,0,1
24975,0,1,0,0,1
24976,0,0,1,0,1
24977,1,0,0,0,1
24978,0,0,0,1,1
24979,0,1,0,0,1
24980,0,1,0,0,1
24981,0,1,0,0,1
24982,0,1,0,0,1
24983,0,1,0,0,1
24984,1,0,0,0,1
24985,0,1,0,0,1
24986,0,1,0,0,1
24987,0,1,0,0,1
24988,0,1,0,0,1
24989,0,1,0,0,1
24990,0,1,0,0,1
24991,0,0,0,1,1
24992,0,1,0,0,1
24993,0,1,0,0,1
24994,0,1,0,0,1
24995,0,1,0,0,1
24996,0,1,0,0,1
24997,0,1,0,0,1
24998,0,1,0,0,1
24999,0,1,0,0,1
25000,1,0,0,0,1
25001,0,1,0,0,1
25002,0,1,0,0,1
25003,0,1,0,0,1
25004,0,1,0,0,1
25005,0,1,0,0,1
25006,0,1,0,0,1
25007,0,1,0,0,1
25008,0,1,0,0,1
25009,0,1,0,0,1
25010,0,1,0,0,1
25011,1,0,0,0,1
25012,0,1,0,0,1
25013,0,1,0,0,1
25014,0,1,0,0,1
25015,0,1,0,0,1
25016,0,1,0,0,1
25017,0,1,0,0,1
25018,0,1,0,0,1
25019,1,0,0,0,1
25020,1,0,0,0,1
25021,0,1,0,0,1
25022,0,1,0,0,1
25023,1,0,0,0,1
25024,0,1,0,0,1
25025,0,1,0,0,1
25026,0,1,0,0,1
25027,0,1,0,0,1
25028,0,1,0,0,1
25029,0,1,0,0,1
25030,0,1,0,0,1
25031,1,0,0,0,1
25032,0,1,0,0,1
25033,0,1,0,0,1
25034,0,1,0,0,1
25035,0,1,0,0,1
25036,1,0,0,0,1
25037,0,1,0,0,1
25038,0,0,1,0,1
25039,0,1,0,0,1
25040,0,1,0,0,1
25041,0,1,0,0,1
25042,0,1,0,0,1
25043,1,0,0,0,1
25044,1,0,0,0,1
25045,1,0,0,0,1
25046,0,1,0,0,1
25047,0,1,0,0,1
25048,0,1,0,0,1
25049,0,1,0,0,1
25050,0,1,0,0,1
25051,0,1,0,0,1
25052,0,1,0,0,1
25053,0,1,0,0,1
25054,0,1,0,0,1
25055,0,1,0,0,1
25056,0,1,0,0,1
25057,0,1,0,0,1
25058,0,1,0,0,1
25059,0,1,0,0,1
25060,0,1,0,0,1
25061,1,0,0,0,1
25062,0,1,0,0,1
25063,0,1,0,0,1
25064,0,1,0,0,1
25065,0,1,0,0,1
25066,0,1,0,0,1
25067,0,1,0,0,1
25068,0,1,0,0,1
25069,0,1,0,0,1
25070,0,1,0,0,1
25071,0,1,0,0,1
25072,0,1,0,0,1
25073,0,1,0,0,1
25074,1,0,0,0,1
25075,0,1,0,0,1
25076,0,1,0,0,1
25077,0,1,0,0,1
25078,1,0,0,0,1
25079,0,1,0,0,1
25080,0,1,0,0,1
25081,1,0,0,0,1
25082,0,1,0,0,1
25083,0,1,0,0,1
25084,0,1,0,0,1
25085,0,1,0,0,1
25086,1,0,0,0,1
25087,0,1,0,0,1
25088,0,1,0,0,1
25089,0,1,0,0,1
25090,0,1,0,0,1
25091,0,0,0,1,1
25092,0,1,0,0,1
25093,1,0,0,0,1
25094,0,1,0,0,1
25095,1,0,0,0,1
25096,1,0,0,0,1
25097,0,1,0,0,1
25098,0,1,0,0,1
25099,0,1,0,0,1
25100,0,1,0,0,1
25101,1,0,0,0,1
25102,0,1,0,0,1
25103,0,1,0,0,1
25104,0,0,0,1,1
25105,0,1,0,0,1
25106,0,1,0,0,1
25107,0,1,0,0,1
25108,0,1,0,0,1
25109,0,1,0,0,1
25110,0,1,0,0,1
25111,1,0,0,0,1
25112,0,1,0,0,1
25113,1,0,0,0,1
25114,0,1,0,0,1
25115,0,1,0,0,1
25116,0,1,0,0,1
25117,0,1,0,0,1
25118,0,1,0,0,1
25119,0,1,0,0,1
25120,0,1,0,0,1
25121,0,1,0,0,1
25122,0,1,0,0,1
25123,0,1,0,0,1
25124,0,1,0,0,1
25125,0,1,0,0,1
25126,0,1,0,0,1
25127,0,1,0,0,1
25128,0,1,0,0,1
25129,1,0,0,0,1
25130,0,1,0,0,1
25131,1,0,0,0,1
25132,1,0,0,0,1
25133,0,1,0,0,1
25134,0,1,0,0,1
25135,0,1,0,0,1
25136,1,0,0,0,1
25137,0,1,0,0,1
25138,0,1,0,0,1
25139,0,1,0,0,1
25140,0,1,0,0,1
25141,0,1,0,0,1
25142,0,1,0,0,1
25143,0,1,0,0,1
25144,0,1,0,0,1
25145,0,1,0,0,1
25146,1,0,0,0,1
25147,1,0,0,0,1
25148,0,1,0,0,1
25149,0,1,0,0,1
25150,0,1,0,0,1
25151,0,1,0,0,1
25152,0,1,0,0,1
25153,1,0,0,0,1
25154,0,1,0,0,1
25155,0,1,0,0,1
25156,0,1,0,0,1
25157,0,1,0,0,1
25158,0,1,0,0,1
25159,0,1,0,0,1
25160,0,1,0,0,1
25161,0,1,0,0,1
25162,0,1,0,0,1
25163,0,1,0,0,1
25164,0,1,0,0,1
25165,0,1,0,0,1
25166,1,0,0,0,1
25167,0,1,0,0,1
25168,0,1,0,0,1
25169,0,1,0,0,1
25170,0,1,0,0,1
25171,0,1,0,0,1
25172,0,1,0,0,1
25173,0,1,0,0,1
25174,1,0,0,0,1
25175,0,1,0,0,1
25176,0,1,0,0,1
25177,0,1,0,0,1
25178,0,1,0,0,1
25179,0,1,0,0,1
25180,0,1,0,0,1
25181,0,1,0,0,1
25182,0,1,0,0,1
25183,0,1,0,0,1
25184,0,1,0,0,1
25185,0,1,0,0,1
25186,1,0,0,0,1
25187,0,1,0,0,1
25188,0,1,0,0,1
25189,0,1,0,0,1
25190,1,0,0,0,1
25191,1,0,0,0,1
25192,0,1,0,0,1
25193,1,0,0,0,1
25194,0,1,0,0,1
25195,0,1,0,0,1
25196,0,1,0,0,1
25197,0,1,0,0,1
25198,0,1,0,0,1
25199,0,1,0,0,1
25200,0,1,0,0,1
25201,0,1,0,0,1
25202,0,1,0,0,1
25203,1,0,0,0,1
25204,0,1,0,0,1
25205,0,1,0,0,1
25206,1,0,0,0,1
25207,0,1,0,0,1
25208,0,1,0,0,1
25209,0,1,0,0,1
25210,0,0,1,0,1
25211,0,1,0,0,1
25212,0,1,0,0,1
25213,0,1,0,0,1
25214,0,1,0,0,1
25215,1,0,0,0,1
25216,0,1,0,0,1
25217,0,1,0,0,1
25218,1,0,0,0,1
25219,0,1,0,0,1
25220,0,1,0,0,1
25221,0,1,0,0,1
25222,0,1,0,0,1
25223,0,1,0,0,1
25224,0,0,0,1,1
25225,0,1,0,0,1
25226,0,1,0,0,1
25227,1,0,0,0,1
25228,0,1,0,0,1
25229,0,1,0,0,1
25230,0,1,0,0,1
25231,0,1,0,0,1
25232,1,0,0,0,1
25233,0,1,0,0,1
25234,0,1,0,0,1
25235,0,1,0,0,1
25236,0,1,0,0,1
25237,0,1,0,0,1
25238,0,1,0,0,1
25239,0,1,0,0,1
25240,0,0,0,1,1
25241,0,1,0,0,1
25242,0,1,0,0,1
25243,1,0,0,0,1
25244,0,1,0,0,1
25245,1,0,0,0,1
25246,0,1,0,0,1
25247,0,1,0,0,1
25248,0,1,0,0,1
25249,0,1,0,0,1
25250,0,1,0,0,1
25251,0,0,0,1,1
25252,1,0,0,0,1
25253,0,1,0,0,1
25254,1,0,0,0,1
25255,0,1,0,0,1
25256,0,1,0,0,1
25257,0,1,0,0,1
25258,0,1,0,0,1
25259,0,1,0,0,1
25260,0,0,0,1,1
25261,0,1,0,0,1
25262,1,0,0,0,1
25263,0,1,0,0,1
25264,0,1,0,0,1
25265,0,1,0,0,1
25266,0,0,1,0,1
25267,1,0,0,0,1
25268,0,1,0,0,1
25269,0,1,0,0,1
25270,0,1,0,0,1
25271,0,1,0,0,1
25272,0,1,0,0,1
25273,0,1,0,0,1
25274,0,1,0,0,1
25275,0,1,0,0,1
25276,0,1,0,0,1
25277,0,1,0,0,1
25278,0,1,0,0,1
25279,0,1,0,0,1
25280,1,0,0,0,1
25281,0,1,0,0,1
25282,0,1,0,0,1
25283,0,1,0,0,1
25284,1,0,0,0,1
25285,0,1,0,0,1
25286,0,1,0,0,1
25287,0,1,0,0,1
25288,0,0,1,0,1
25289,0,1,0,0,1
25290,0,1,0,0,1
25291,0,1,0,0,1
25292,0,1,0,0,1
25293,0,1,0,0,1
25294,0,1,0,0,1
25295,0,1,0,0,1
25296,0,1,0,0,1
25297,1,0,0,0,1
25298,0,1,0,0,1
25299,0,1,0,0,1
25300,0,1,0,0,1
25301,0,1,0,0,1
25302,0,1,0,0,1
25303,0,1,0,0,1
25304,0,1,0,0,1
25305,0,1,0,0,1
25306,1,0,0,0,1
25307,0,1,0,0,1
25308,0,1,0,0,1
25309,1,0,0,0,1
25310,0,1,0,0,1
25311,0,1,0,0,1
25312,0,1,0,0,1
25313,0,1,0,0,1
25314,0,1,0,0,1
25315,0,1,0,0,1
25316,0,1,0,0,1
25317,1,0,0,0,1
25318,0,1,0,0,1
25319,0,1,0,0,1
25320,1,0,0,0,1
25321,0,1,0,0,1
25322,0,1,0,0,1
25323,0,1,0,0,1
25324,1,0,0,0,1
25325,1,0,0,0,1
25326,0,1,0,0,1
25327,0,1,0,0,1
25328,1,0,0,0,1
25329,0,1,0,0,1
25330,1,0,0,0,1
25331,0,1,0,0,1
25332,0,1,0,0,1
25333,0,1,0,0,1
25334,0,1,0,0,1
25335,0,0,1,0,1
25336,0,1,0,0,1
25337,0,1,0,0,1
25338,0,1,0,0,1
25339,0,1,0,0,1
25340,0,1,0,0,1
25341,0,1,0,0,1
25342,0,1,0,0,1
25343,0,1,0,0,1
25344,1,0,0,0,1
25345,0,1,0,0,1
25346,0,1,0,0,1
25347,0,1,0,0,1
25348,0,1,0,0,1
25349,0,1,0,0,1
25350,1,0,0,0,1
25351,1,0,0,0,1
25352,0,1,0,0,1
25353,1,0,0,0,1
25354,1,0,0,0,1
25355,0,1,0,0,1
25356,1,0,0,0,1
25357,0,1,0,0,1
25358,0,1,0,0,1
25359,0,1,0,0,1
25360,0,1,0,0,1
25361,0,1,0,0,1
25362,0,1,0,0,1
25363,0,1,0,0,1
25364,1,0,0,0,1
25365,0,1,0,0,1
25366,0,1,0,0,1
25367,0,1,0,0,1
25368,0,1,0,0,1
25369,1,0,0,0,1
25370,1,0,0,0,1
25371,0,1,0,0,1
25372,0,1,0,0,1
25373,0,1,0,0,1
25374,0,1,0,0,1
25375,0,1,0,0,1
25376,0,1,0,0,1
25377,0,1,0,0,1
25378,0,1,0,0,1
25379,0,1,0,0,1
25380,0,1,0,0,1
25381,1,0,0,0,1
25382,0,0,1,0,1
25383,0,1,0,0,1
25384,0,1,0,0,1
25385,1,0,0,0,1
25386,1,0,0,0,1
25387,0,1,0,0,1
25388,0,1,0,0,1
25389,0,0,0,1,1
25390,0,1,0,0,1
25391,0,1,0,0,1
25392,0,1,0,0,1
25393,1,0,0,0,1
25394,0,1,0,0,1
25395,1,0,0,0,1
25396,0,1,0,0,1
25397,0,1,0,0,1
25398,0,0,0,1,1
25399,1,0,0,0,1
25400,0,1,0,0,1
25401,0,1,0,0,1
25402,0,0,0,1,1
25403,0,1,0,0,1
25404,0,1,0,0,1
25405,0,1,0,0,1
25406,0,1,0,0,1
25407,0,1,0,0,1
25408,0,1,0,0,1
25409,0,1,0,0,1
25410,0,1,0,0,1
25411,0,1,0,0,1
25412,0,1,0,0,1
25413,0,1,0,0,1
25414,0,0,1,0,1
25415,0,1,0,0,1
25416,1,0,0,0,1
25417,1,0,0,0,1
25418,0,1,0,0,1
25419,0,1,0,0,1
25420,0,1,0,0,1
25421,0,1,0,0,1
25422,0,1,0,0,1
25423,1,0,0,0,1
25424,0,1,0,0,1
25425,0,1,0,0,1
25426,0,1,0,0,1
25427,0,1,0,0,1
25428,0,1,0,0,1
25429,0,1,0,0,1
25430,0,0,0,1,1
25431,0,1,0,0,1
25432,0,1,0,0,1
25433,0,1,0,0,1
25434,0,1,0,0,1
25435,1,0,0,0,1
25436,0,1,0,0,1
25437,0,1,0,0,1
25438,1,0,0,0,1
25439,0,1,0,0,1
25440,1,0,0,0,1
25441,0,1,0,0,1
25442,0,1,0,0,1
25443,0,1,0,0,1
25444,1,0,0,0,1
25445,0,1,0,0,1
25446,0,1,0,0,1
25447,0,1,0,0,1
25448,0,1,0,0,1
25449,0,1,0,0,1
25450,0,1,0,0,1
25451,1,0,0,0,1
25452,0,1,0,0,1
25453,1,0,0,0,1
25454,0,1,0,0,1
25455,0,1,0,0,1
25456,0,1,0,0,1
25457,0,1,0,0,1
25458,0,1,0,0,1
25459,0,1,0,0,1
25460,0,1,0,0,1
25461,0,1,0,0,1
25462,0,1,0,0,1
25463,0,1,0,0,1
25464,1,0,0,0,1
25465,0,1,0,0,1
25466,0,1,0,0,1
25467,1,0,0,0,1
25468,0,1,0,0,1
25469,0,1,0,0,1
25470,0,1,0,0,1
25471,0,1,0,0,1
25472,0,1,0,0,1
25473,0,1,0,0,1
25474,0,1,0,0,1
25475,0,1,0,0,1
25476,0,1,0,0,1
25477,0,1,0,0,1
25478,0,1,0,0,1
25479,0,1,0,0,1
25480,0,1,0,0,1
25481,0,1,0,0,1
25482,0,1,0,0,1
25483,0,1,0,0,1
25484,0,1,0,0,1
25485,0,1,0,0,1
25486,0,1,0,0,1
25487,0,1,0,0,1
25488,0,1,0,0,1
25489,0,1,0,0,1
25490,1,0,0,0,1
25491,0,1,0,0,1
25492,0,1,0,0,1
25493,0,1,0,0,1
25494,0,1,0,0,1
25495,0,1,0,0,1
25496,0,1,0,0,1
25497,0,1,0,0,1
25498,0,1,0,0,1
25499,0,1,0,0,1
25500,0,1,0,0,1
25501,0,1,0,0,1
25502,0,1,0,0,1
25503,0,1,0,0,1
25504,0,1,0,0,1
25505,1,0,0,0,1
25506,0,1,0,0,1
25507,0,1,0,0,1
25508,1,0,0,0,1
25509,0,1,0,0,1
25510,0,1,0,0,1
25511,0,1,0,0,1
25512,0,1,0,0,1
25513,0,1,0,0,1
25514,0,1,0,0,1
25515,0,1,0,0,1
25516,0,1,0,0,1
25517,0,1,0,0,1
25518,0,1,0,0,1
25519,1,0,0,0,1
25520,0,1,0,0,1
25521,0,1,0,0,1
25522,1,0,0,0,1
25523,0,1,0,0,1
25524,1,0,0,0,1
25525,0,1,0,0,1
25526,0,1,0,0,1
25527,0,1,0,0,1
25528,0,1,0,0,1
25529,0,1,0,0,1
25530,0,0,1,0,1
25531,0,1,0,0,1
25532,0,1,0,0,1
25533,0,1,0,0,1
25534,0,0,0,1,1
25535,0,1,0,0,1
25536,0,1,0,0,1
25537,0,1,0,0,1
25538,0,1,0,0,1
25539,0,1,0,0,1
25540,0,1,0,0,1
25541,1,0,0,0,1
25542,0,1,0,0,1
25543,0,1,0,0,1
25544,0,1,0,0,1
25545,0,1,0,0,1
25546,0,1,0,0,1
25547,0,0,0,1,1
25548,1,0,0,0,1
25549,0,1,0,0,1
25550,0,1,0,0,1
25551,0,1,0,0,1
25552,0,1,0,0,1
25553,0,1,0,0,1
25554,1,0,0,0,1
25555,0,1,0,0,1
25556,0,1,0,0,1
25557,0,0,1,0,1
25558,1,0,0,0,1
25559,0,1,0,0,1
25560,0,1,0,0,1
25561,0,1,0,0,1
25562,1,0,0,0,1
25563,0,1,0,0,1
25564,0,1,0,0,1
25565,0,1,0,0,1
25566,1,0,0,0,1
25567,0,1,0,0,1
25568,0,1,0,0,1
25569,0,1,0,0,1
25570,0,1,0,0,1
25571,0,1,0,0,1
25572,0,1,0,0,1
25573,0,1,0,0,1
25574,0,1,0,0,1
25575,0,1,0,0,1
25576,0,1,0,0,1
25577,0,1,0,0,1
25578,0,1,0,0,1
25579,1,0,0,0,1
25580,0,0,1,0,1
25581,0,1,0,0,1
25582,0,1,0,0,1
25583,0,1,0,0,1
25584,0,1,0,0,1
25585,0,1,0,0,1
25586,0,1,0,0,1
25587,0,1,0,0,1
25588,0,1,0,0,1
25589,0,1,0,0,1
25590,0,1,0,0,1
25591,0,1,0,0,1
25592,0,1,0,0,1
25593,0,1,0,0,1
25594,0,1,0,0,1
25595,0,1,0,0,1
25596,0,1,0,0,1
25597,1,0,0,0,1
25598,0,1,0,0,1
25599,0,1,0,0,1
25600,0,1,0,0,1
25601,0,1,0,0,1
25602,0,1,0,0,1
25603,0,1,0,0,1
25604,0,1,0,0,1
25605,0,1,0,0,1
25606,0,0,0,1,1
25607,0,1,0,0,1
25608,0,1,0,0,1
25609,1,0,0,0,1
25610,0,1,0,0,1
25611,0,1,0,0,1
25612,1,0,0,0,1
25613,0,1,0,0,1
25614,0,1,0,0,1
25615,0,1,0,0,1
25616,0,1,0,0,1
25617,1,0,0,0,1
25618,1,0,0,0,1
25619,0,1,0,0,1
25620,0,1,0,0,1
25621,1,0,0,0,1
25622,0,0,0,1,1
25623,0,1,0,0,1
25624,0,1,0,0,1
25625,0,1,0,0,1
25626,0,1,0,0,1
25627,0,1,0,0,1
25628,0,1,0,0,1
25629,1,0,0,0,1
25630,0,1,0,0,1
25631,0,1,0,0,1
25632,0,1,0,0,1
25633,0,1,0,0,1
25634,0,1,0,0,1
25635,0,1,0,0,1
25636,0,1,0,0,1
25637,0,1,0,0,1
25638,0,0,0,1,1
25639,0,0,0,1,1
25640,1,0,0,0,1
25641,0,1,0,0,1
25642,0,1,0,0,1
25643,0,1,0,0,1
25644,0,1,0,0,1
25645,1,0,0,0,1
25646,0,1,0,0,1
25647,1,0,0,0,1
25648,0,1,0,0,1
25649,0,1,0,0,1
25650,0,1,0,0,1
25651,0,1,0,0,1
25652,1,0,0,0,1
25653,0,1,0,0,1
25654,0,1,0,0,1
25655,0,0,0,1,1
25656,1,0,0,0,1
25657,1,0,0,0,1
25658,1,0,0,0,1
25659,0,1,0,0,1
25660,0,1,0,0,1
25661,1,0,0,0,1
25662,0,1,0,0,1
25663,0,1,0,0,1
25664,0,1,0,0,1
25665,0,1,0,0,1
25666,0,1,0,0,1
25667,0,1,0,0,1
25668,0,1,0,0,1
25669,0,1,0,0,1
25670,0,1,0,0,1
25671,0,1,0,0,1
25672,0,1,0,0,1
25673,0,1,0,0,1
25674,0,1,0,0,1
25675,0,1,0,0,1
25676,0,1,0,0,1
25677,0,1,0,0,1
25678,0,1,0,0,1
25679,0,1,0,0,1
25680,0,1,0,0,1
25681,0,1,0,0,1
25682,0,1,0,0,1
25683,0,1,0,0,1
25684,0,0,0,1,1
25685,0,1,0,0,1
25686,0,1,0,0,1
25687,0,1,0,0,1
25688,1,0,0,0,1
25689,0,1,0,0,1
25690,0,1,0,0,1
25691,0,1,0,0,1
25692,1,0,0,0,1
25693,0,1,0,0,1
25694,0,1,0,0,1
25695,0,1,0,0,1
25696,0,1,0,0,1
25697,0,1,0,0,1
25698,0,1,0,0,1
25699,1,0,0,0,1
25700,0,1,0,0,1
25701,0,1,0,0,1
25702,0,1,0,0,1
25703,1,0,0,0,1
25704,0,1,0,0,1
25705,0,1,0,0,1
25706,0,1,0,0,1
25707,1,0,0,0,1
25708,0,1,0,0,1
25709,0,1,0,0,1
25710,0,1,0,0,1
25711,0,1,0,0,1
25712,1,0,0,0,1
25713,0,1,0,0,1
25714,0,1,0,0,1
25715,0,0,0,1,1
25716,0,1,0,0,1
25717,0,1,0,0,1
25718,0,1,0,0,1
25719,0,1,0,0,1
25720,0,1,0,0,1
25721,0,1,0,0,1
25722,1,0,0,0,1
25723,0,1,0,0,1
25724,0,1,0,0,1
25725,0,1,0,0,1
25726,1,0,0,0,1
25727,0,0,0,1,1
25728,0,1,0,0,1
25729,0,1,0,0,1
25730,0,1,0,0,1
25731,0,1,0,0,1
25732,1,0,0,0,1
25733,0,1,0,0,1
25734,0,1,0,0,1
25735,0,1,0,0,1
25736,0,1,0,0,1
25737,0,1,0,0,1
25738,0,1,0,0,1
25739,0,0,1,0,1
25740,0,1,0,0,1
25741,1,0,0,0,1
25742,0,0,0,1,1
25743,0,1,0,0,1
25744,0,1,0,0,1
25745,0,1,0,0,1
25746,0,1,0,0,1
25747,0,1,0,0,1
25748,0,1,0,0,1
25749,0,1,0,0,1
25750,0,1,0,0,1
25751,0,1,0,0,1
25752,0,1,0,0,1
25753,1,0,0,0,1
25754,0,1,0,0,1
25755,0,1,0,0,1
25756,0,1,0,0,1
25757,0,1,0,0,1
25758,1,0,0,0,1
25759,1,0,0,0,1
25760,0,1,0,0,1
25761,0,1,0,0,1
25762,1,0,0,0,1
25763,0,1,0,0,1
25764,0,1,0,0,1
25765,0,1,0,0,1
25766,0,1,0,0,1
25767,0,1,0,0,1
25768,0,1,0,0,1
25769,1,0,0,0,1
25770,0,1,0,0,1
25771,0,1,0,0,1
25772,0,1,0,0,1
25773,0,1,0,0,1
25774,0,1,0,0,1
25775,0,1,0,0,1
25776,1,0,0,0,1
25777,0,0,0,1,1
25778,0,1,0,0,1
25779,0,1,0,0,1
25780,0,1,0,0,1
25781,0,1,0,0,1
25782,0,1,0,0,1
25783,0,0,0,1,1
25784,1,0,0,0,1
25785,1,0,0,0,1
25786,0,1,0,0,1
25787,0,1,0,0,1
25788,1,0,0,0,1
25789,0,1,0,0,1
25790,0,1,0,0,1
25791,0,1,0,0,1
25792,0,1,0,0,1
25793,0,1,0,0,1
25794,0,1,0,0,1
25795,0,1,0,0,1
25796,0,1,0,0,1
25797,0,1,0,0,1
25798,0,1,0,0,1
25799,0,1,0,0,1
25800,0,1,0,0,1
25801,0,1,0,0,1
25802,0,1,0,0,1
25803,0,1,0,0,1
25804,0,0,1,0,1
25805,0,1,0,0,1
25806,0,1,0,0,1
25807,0,1,0,0,1
25808,0,1,0,0,1
25809,0,1,0,0,1
25810,0,1,0,0,1
25811,0,1,0,0,1
25812,1,0,0,0,1
25813,1,0,0,0,1
25814,0,1,0,0,1
25815,0,1,0,0,1
25816,0,1,0,0,1
25817,0,1,0,0,1
25818,0,1,0,0,1
25819,0,1,0,0,1
25820,1,0,0,0,1
25821,0,1,0,0,1
25822,0,1,0,0,1
25823,1,0,0,0,1
25824,0,1,0,0,1
25825,0,1,0,0,1
25826,0,1,0,0,1
25827,0,1,0,0,1
25828,0,0,0,1,1
25829,0,1,0,0,1
25830,0,1,0,0,1
25831,0,1,0,0,1
25832,0,1,0,0,1
25833,1,0,0,0,1
25834,0,1,0,0,1
25835,0,1,0,0,1
25836,0,1,0,0,1
25837,0,1,0,0,1
25838,1,0,0,0,1
25839,0,1,0,0,1
25840,0,1,0,0,1
25841,0,1,0,0,1
25842,0,1,0,0,1
25843,1,0,0,0,1
25844,1,0,0,0,1
25845,0,1,0,0,1
25846,0,1,0,0,1
25847,0,1,0,0,1
25848,0,1,0,0,1
25849,0,1,0,0,1
25850,0,1,0,0,1
25851,1,0,0,0,1
25852,0,1,0,0,1
25853,1,0,0,0,1
25854,0,1,0,0,1
25855,0,1,0,0,1
25856,0,1,0,0,1
25857,0,1,0,0,1
25858,0,1,0,0,1
25859,0,1,0,0,1
25860,0,1,0,0,1
25861,0,1,0,0,1
25862,0,1,0,0,1
25863,1,0,0,0,1
25864,0,1,0,0,1
25865,0,1,0,0,1
25866,0,1,0,0,1
25867,1,0,0,0,1
25868,0,1,0,0,1
25869,0,1,0,0,1
25870,0,1,0,0,1
25871,0,1,0,0,1
25872,0,1,0,0,1
25873,0,1,0,0,1
25874,0,1,0,0,1
25875,0,1,0,0,1
25876,0,1,0,0,1
25877,1,0,0,0,1
25878,0,1,0,0,1
25879,1,0,0,0,1
25880,1,0,0,0,1
25881,0,1,0,0,1
25882,0,1,0,0,1
25883,0,1,0,0,1
25884,0,1,0,0,1
25885,0,1,0,0,1
25886,0,1,0,0,1
25887,0,1,0,0,1
25888,0,0,1,0,1
25889,0,1,0,0,1
25890,0,1,0,0,1
25891,0,1,0,0,1
25892,0,1,0,0,1
25893,0,1,0,0,1
25894,1,0,0,0,1
25895,0,1,0,0,1
25896,0,1,0,0,1
25897,1,0,0,0,1
25898,0,1,0,0,1
25899,0,1,0,0,1
25900,0,1,0,0,1
25901,1,0,0,0,1
25902,1,0,0,0,1
25903,0,1,0,0,1
25904,0,0,1,0,1
25905,0,1,0,0,1
25906,0,1,0,0,1
25907,0,1,0,0,1
25908,0,1,0,0,1
25909,0,1,0,0,1
25910,0,1,0,0,1
25911,0,1,0,0,1
25912,0,1,0,0,1
25913,0,1,0,0,1
25914,0,1,0,0,1
25915,0,1,0,0,1
25916,0,1,0,0,1
25917,0,1,0,0,1
25918,0,1,0,0,1
25919,0,1,0,0,1
25920,1,0,0,0,1
25921,0,1,0,0,1
25922,1,0,0,0,1
25923,0,1,0,0,1
25924,0,1,0,0,1
25925,0,1,0,0,1
25926,0,1,0,0,1
25927,0,1,0,0,1
25928,0,1,0,0,1
25929,0,1,0,0,1
25930,0,1,0,0,1
25931,1,0,0,0,1
25932,1,0,0,0,1
25933,0,1,0,0,1
25934,0,1,0,0,1
25935,0,1,0,0,1
25936,0,1,0,0,1
25937,0,1,0,0,1
25938,0,1,0,0,1
25939,1,0,0,0,1
25940,0,0,0,1,1
25941,1,0,0,0,1
25942,0,1,0,0,1
25943,0,1,0,0,1
25944,0,1,0,0,1
25945,1,0,0,0,1
25946,0,1,0,0,1
25947,0,1,0,0,1
25948,0,1,0,0,1
25949,0,1,0,0,1
25950,1,0,0,0,1
25951,0,1,0,0,1
25952,0,1,0,0,1
25953,0,1,0,0,1
25954,0,1,0,0,1
25955,1,0,0,0,1
25956,0,1,0,0,1
25957,0,1,0,0,1
25958,1,0,0,0,1
25959,0,1,0,0,1
25960,0,1,0,0,1
25961,0,1,0,0,1
25962,0,1,0,0,1
25963,0,1,0,0,1
25964,0,1,0,0,1
25965,0,1,0,0,1
25966,0,0,1,0,1
25967,0,1,0,0,1
25968,1,0,0,0,1
25969,0,1,0,0,1
25970,1,0,0,0,1
25971,0,1,0,0,1
25972,0,0,1,0,1
25973,0,1,0,0,1
25974,1,0,0,0,1
25975,0,1,0,0,1
25976,0,1,0,0,1
25977,0,1,0,0,1
25978,0,1,0,0,1
25979,0,1,0,0,1
25980,0,1,0,0,1
25981,0,1,0,0,1
25982,0,1,0,0,1
25983,1,0,0,0,1
25984,0,1,0,0,1
25985,0,1,0,0,1
25986,1,0,0,0,1
25987,0,1,0,0,1
25988,0,1,0,0,1
25989,0,1,0,0,1
25990,0,1,0,0,1
25991,0,1,0,0,1
25992,0,1,0,0,1
25993,0,1,0,0,1
25994,0,1,0,0,1
25995,0,1,0,0,1
25996,1,0,0,0,1
25997,0,1,0,0,1
25998,0,1,0,0,1
25999,0,1,0,0,1
26000,0,1,0,0,1
26001,0,1,0,0,1
26002,1,0,0,0,1
26003,0,1,0,0,1
26004,0,1,0,0,1
26005,0,1,0,0,1
26006,0,1,0,0,1
26007,1,0,0,0,1
26008,0,1,0,0,1
26009,0,1,0,0,1
26010,0,1,0,0,1
26011,0,1,0,0,1
26012,1,0,0,0,1
26013,0,1,0,0,1
26014,0,1,0,0,1
26015,1,0,0,0,1
26016,1,0,0,0,1
26017,0,1,0,0,1
26018,1,0,0,0,1
26019,0,1,0,0,1
26020,0,1,0,0,1
26021,0,1,0,0,1
26022,0,1,0,0,1
26023,0,1,0,0,1
26024,0,1,0,0,1
26025,1,0,0,0,1
26026,0,1,0,0,1
26027,1,0,0,0,1
26028,1,0,0,0,1
26029,1,0,0,0,1
26030,0,1,0,0,1
26031,0,1,0,0,1
26032,0,1,0,0,1
26033,0,1,0,0,1
26034,0,1,0,0,1
26035,0,1,0,0,1
26036,0,1,0,0,1
26037,0,1,0,0,1
26038,0,1,0,0,1
26039,0,1,0,0,1
26040,0,1,0,0,1
26041,0,1,0,0,1
26042,0,1,0,0,1
26043,0,1,0,0,1
26044,0,1,0,0,1
26045,0,1,0,0,1
26046,0,1,0,0,1
26047,0,1,0,0,1
26048,0,1,0,0,1
26049,0,1,0,0,1
26050,1,0,0,0,1
26051,1,0,0,0,1
26052,0,1,0,0,1
26053,0,1,0,0,1
26054,0,1,0,0,1
26055,0,1,0,0,1
26056,1,0,0,0,1
26057,1,0,0,0,1
26058,0,1,0,0,1
26059,0,1,0,0,1
26060,0,0,0,1,1
26061,0,1,0,0,1
26062,0,0,0,1,1
26063,1,0,0,0,1
26064,0,1,0,0,1
26065,0,1,0,0,1
26066,1,0,0,0,1
26067,0,1,0,0,1
26068,0,0,1,0,1
26069,0,1,0,0,1
26070,0,1,0,0,1
26071,0,1,0,0,1
26072,0,1,0,0,1
26073,0,1,0,0,1
26074,0,1,0,0,1
26075,0,1,0,0,1
26076,0,1,0,0,1
26077,0,1,0,0,1
26078,0,1,0,0,1
26079,0,1,0,0,1
26080,0,1,0,0,1
26081,0,1,0,0,1
26082,0,0,0,1,1
26083,1,0,0,0,1
26084,0,1,0,0,1
26085,0,1,0,0,1
26086,0,1,0,0,1
26087,1,0,0,0,1
26088,0,1,0,0,1
26089,0,1,0,0,1
26090,0,1,0,0,1
26091,0,1,0,0,1
26092,0,1,0,0,1
26093,0,1,0,0,1
26094,0,1,0,0,1
26095,0,1,0,0,1
26096,0,1,0,0,1
26097,0,0,1,0,1
26098,0,1,0,0,1
26099,0,1,0,0,1
26100,0,1,0,0,1
26101,0,1,0,0,1
26102,0,1,0,0,1
26103,0,1,0,0,1
26104,0,1,0,0,1
26105,0,1,0,0,1
26106,0,1,0,0,1
26107,0,1,0,0,1
26108,0,1,0,0,1
26109,0,0,0,1,1
26110,0,1,0,0,1
26111,0,1,0,0,1
26112,0,1,0,0,1
26113,0,1,0,0,1
26114,0,1,0,0,1
26115,0,1,0,0,1
26116,0,1,0,0,1
26117,0,1,0,0,1
26118,0,1,0,0,1
26119,0,1,0,0,1
26120,0,1,0,0,1
26121,0,1,0,0,1
26122,0,1,0,0,1
26123,0,1,0,0,1
26124,0,1,0,0,1
26125,0,1,0,0,1
26126,0,1,0,0,1
26127,0,1,0,0,1
26128,1,0,0,0,1
26129,0,1,0,0,1
26130,0,1,0,0,1
26131,0,1,0,0,1
26132,0,1,0,0,1
26133,0,1,0,0,1
26134,0,1,0,0,1
26135,0,1,0,0,1
26136,0,1,0,0,1
26137,0,1,0,0,1
26138,0,1,0,0,1
26139,0,1,0,0,1
26140,0,1,0,0,1
26141,0,1,0,0,1
26142,0,1,0,0,1
26143,0,0,1,0,1
26144,0,1,0,0,1
26145,0,1,0,0,1
26146,0,1,0,0,1
26147,0,1,0,0,1
26148,0,1,0,0,1
26149,0,1,0,0,1
26150,0,1,0,0,1
26151,0,1,0,0,1
26152,0,1,0,0,1
26153,0,1,0,0,1
26154,1,0,0,0,1
26155,0,1,0,0,1
26156,0,1,0,0,1
26157,1,0,0,0,1
26158,1,0,0,0,1
26159,0,1,0,0,1
26160,0,1,0,0,1
26161,0,1,0,0,1
26162,0,1,0,0,1
26163,0,1,0,0,1
26164,0,1,0,0,1
26165,0,1,0,0,1
26166,0,1,0,0,1
26167,0,0,0,1,1
26168,0,1,0,0,1
26169,1,0,0,0,1
26170,1,0,0,0,1
26171,0,1,0,0,1
26172,0,1,0,0,1
26173,0,1,0,0,1
26174,0,1,0,0,1
26175,0,1,0,0,1
26176,0,1,0,0,1
26177,0,1,0,0,1
26178,0,1,0,0,1
26179,0,1,0,0,1
26180,0,1,0,0,1
26181,0,1,0,0,1
26182,0,1,0,0,1
26183,0,1,0,0,1
26184,1,0,0,0,1
26185,1,0,0,0,1
26186,0,1,0,0,1
26187,0,1,0,0,1
26188,1,0,0,0,1
26189,0,1,0,0,1
26190,0,1,0,0,1
26191,0,1,0,0,1
26192,0,1,0,0,1
26193,0,0,0,1,1
26194,0,1,0,0,1
26195,0,1,0,0,1
26196,0,1,0,0,1
26197,0,1,0,0,1
26198,1,0,0,0,1
26199,0,0,1,0,1
26200,0,1,0,0,1
26201,0,1,0,0,1
26202,0,1,0,0,1
26203,0,1,0,0,1
26204,0,1,0,0,1
26205,1,0,0,0,1
26206,0,1,0,0,1
26207,0,1,0,0,1
26208,0,1,0,0,1
26209,0,1,0,0,1
26210,1,0,0,0,1
26211,0,1,0,0,1
26212,0,1,0,0,1
26213,0,1,0,0,1
26214,1,0,0,0,1
26215,0,1,0,0,1
26216,0,1,0,0,1
26217,0,1,0,0,1
26218,0,1,0,0,1
26219,0,1,0,0,1
26220,1,0,0,0,1
26221,0,1,0,0,1
26222,0,1,0,0,1
26223,0,1,0,0,1
26224,0,1,0,0,1
26225,0,1,0,0,1
26226,0,1,0,0,1
26227,0,1,0,0,1
26228,0,0,0,1,1
26229,0,1,0,0,1
26230,0,1,0,0,1
26231,0,1,0,0,1
26232,0,1,0,0,1
26233,0,1,0,0,1
26234,0,1,0,0,1
26235,0,1,0,0,1
26236,0,1,0,0,1
26237,0,0,1,0,1
26238,0,1,0,0,1
26239,1,0,0,0,1
26240,0,1,0,0,1
26241,0,1,0,0,1
26242,0,1,0,0,1
26243,0,1,0,0,1
26244,0,1,0,0,1
26245,0,1,0,0,1
26246,1,0,0,0,1
26247,0,1,0,0,1
26248,0,1,0,0,1
26249,0,1,0,0,1
26250,0,1,0,0,1
26251,0,1,0,0,1
26252,0,1,0,0,1
26253,0,1,0,0,1
26254,0,1,0,0,1
26255,0,1,0,0,1
26256,0,1,0,0,1
26257,0,1,0,0,1
26258,0,1,0,0,1
26259,0,1,0,0,1
26260,0,1,0,0,1
26261,0,1,0,0,1
26262,0,1,0,0,1
26263,0,1,0,0,1
26264,0,1,0,0,1
26265,0,0,0,1,1
26266,0,1,0,0,1
26267,0,1,0,0,1
26268,1,0,0,0,1
26269,0,1,0,0,1
26270,0,1,0,0,1
26271,0,1,0,0,1
26272,0,1,0,0,1
26273,0,1,0,0,1
26274,0,1,0,0,1
26275,0,1,0,0,1
26276,0,1,0,0,1
26277,0,1,0,0,1
26278,0,1,0,0,1
26279,1,0,0,0,1
26280,0,1,0,0,1
26281,0,1,0,0,1
26282,1,0,0,0,1
26283,0,1,0,0,1
26284,0,1,0,0,1
26285,1,0,0,0,1
26286,0,1,0,0,1
26287,0,1,0,0,1
26288,0,1,0,0,1
26289,0,1,0,0,1
26290,0,1,0,0,1
26291,0,1,0,0,1
26292,0,1,0,0,1
26293,1,0,0,0,1
26294,0,1,0,0,1
26295,0,1,0,0,1
26296,1,0,0,0,1
26297,0,1,0,0,1
26298,0,1,0,0,1
26299,0,1,0,0,1
26300,1,0,0,0,1
26301,0,1,0,0,1
26302,0,1,0,0,1
26303,1,0,0,0,1
26304,1,0,0,0,1
26305,0,1,0,0,1
26306,0,1,0,0,1
26307,0,1,0,0,1
26308,1,0,0,0,1
26309,0,1,0,0,1
26310,0,1,0,0,1
26311,0,1,0,0,1
26312,0,1,0,0,1
26313,0,1,0,0,1
26314,0,1,0,0,1
26315,0,1,0,0,1
26316,0,1,0,0,1
26317,0,1,0,0,1
26318,1,0,0,0,1
26319,0,1,0,0,1
26320,0,1,0,0,1
26321,0,1,0,0,1
26322,0,1,0,0,1
26323,1,0,0,0,1
26324,0,1,0,0,1
26325,0,1,0,0,1
26326,0,1,0,0,1
26327,0,1,0,0,1
26328,0,1,0,0,1
26329,0,1,0,0,1
26330,0,1,0,0,1
26331,0,1,0,0,1
26332,0,1,0,0,1
26333,0,1,0,0,1
26334,1,0,0,0,1
26335,0,1,0,0,1
26336,0,1,0,0,1
26337,1,0,0,0,1
26338,0,1,0,0,1
26339,0,1,0,0,1
26340,0,1,0,0,1
26341,0,1,0,0,1
26342,0,1,0,0,1
26343,1,0,0,0,1
26344,0,1,0,0,1
26345,0,1,0,0,1
26346,0,1,0,0,1
26347,1,0,0,0,1
26348,0,1,0,0,1
26349,0,1,0,0,1
26350,0,1,0,0,1
26351,0,0,0,1,1
26352,1,0,0,0,1
26353,1,0,0,0,1
26354,0,1,0,0,1
26355,0,1,0,0,1
26356,0,1,0,0,1
26357,0,1,0,0,1
26358,0,1,0,0,1
26359,0,1,0,0,1
26360,0,1,0,0,1
26361,0,1,0,0,1
26362,0,0,0,1,1
26363,1,0,0,0,1
26364,0,1,0,0,1
26365,1,0,0,0,1
26366,0,1,0,0,1
26367,1,0,0,0,1
26368,1,0,0,0,1
26369,0,1,0,0,1
26370,0,1,0,0,1
26371,0,1,0,0,1
26372,0,1,0,0,1
26373,0,1,0,0,1
26374,0,1,0,0,1
26375,0,1,0,0,1
26376,0,0,0,1,1
26377,1,0,0,0,1
26378,0,1,0,0,1
26379,1,0,0,0,1
26380,0,1,0,0,1
26381,0,1,0,0,1
26382,0,1,0,0,1
26383,0,1,0,0,1
26384,0,1,0,0,1
26385,0,1,0,0,1
26386,1,0,0,0,1
26387,0,1,0,0,1
26388,0,1,0,0,1
26389,1,0,0,0,1
26390,0,1,0,0,1
26391,0,1,0,0,1
26392,0,1,0,0,1
26393,0,1,0,0,1
26394,0,1,0,0,1
26395,0,1,0,0,1
26396,0,1,0,0,1
26397,0,1,0,0,1
26398,1,0,0,0,1
26399,0,1,0,0,1
26400,0,1,0,0,1
26401,0,1,0,0,1
26402,0,1,0,0,1
26403,0,1,0,0,1
26404,1,0,0,0,1
26405,0,1,0,0,1
26406,1,0,0,0,1
26407,0,0,1,0,1
26408,0,1,0,0,1
26409,0,1,0,0,1
26410,1,0,0,0,1
26411,0,1,0,0,1
26412,0,1,0,0,1
26413,1,0,0,0,1
26414,0,1,0,0,1
26415,0,1,0,0,1
26416,0,1,0,0,1
26417,0,1,0,0,1
26418,0,1,0,0,1
26419,1,0,0,0,1
26420,0,1,0,0,1
26421,1,0,0,0,1
26422,0,1,0,0,1
26423,1,0,0,0,1
26424,0,1,0,0,1
26425,0,1,0,0,1
26426,0,1,0,0,1
26427,0,1,0,0,1
26428,0,1,0,0,1
26429,0,1,0,0,1
26430,0,1,0,0,1
26431,0,1,0,0,1
26432,1,0,0,0,1
26433,0,1,0,0,1
26434,0,1,0,0,1
26435,1,0,0,0,1
26436,0,1,0,0,1
26437,0,1,0,0,1
26438,0,1,0,0,1
26439,0,1,0,0,1
26440,0,1,0,0,1
26441,0,1,0,0,1
26442,1,0,0,0,1
26443,0,0,0,1,1
26444,0,1,0,0,1
26445,1,0,0,0,1
26446,0,1,0,0,1
26447,0,1,0,0,1
26448,1,0,0,0,1
26449,0,0,0,1,1
26450,0,1,0,0,1
26451,1,0,0,0,1
26452,0,1,0,0,1
26453,0,1,0,0,1
26454,0,1,0,0,1
26455,0,1,0,0,1
26456,0,1,0,0,1
26457,0,1,0,0,1
26458,0,1,0,0,1
26459,0,1,0,0,1
26460,0,1,0,0,1
26461,0,1,0,0,1
26462,0,1,0,0,1
26463,0,1,0,0,1
26464,0,0,0,1,1
26465,0,1,0,0,1
26466,0,1,0,0,1
26467,0,1,0,0,1
26468,1,0,0,0,1
26469,0,1,0,0,1
26470,0,1,0,0,1
26471,0,1,0,0,1
26472,0,1,0,0,1
26473,1,0,0,0,1
26474,0,0,0,1,1
26475,0,1,0,0,1
26476,0,1,0,0,1
26477,0,1,0,0,1
26478,0,1,0,0,1
26479,1,0,0,0,1
26480,1,0,0,0,1
26481,1,0,0,0,1
26482,0,1,0,0,1
26483,0,1,0,0,1
26484,1,0,0,0,1
26485,0,1,0,0,1
26486,0,1,0,0,1
26487,0,1,0,0,1
26488,0,1,0,0,1
26489,0,1,0,0,1
26490,0,0,0,1,1
26491,1,0,0,0,1
26492,0,1,0,0,1
26493,0,1,0,0,1
26494,0,1,0,0,1
26495,0,1,0,0,1
26496,0,1,0,0,1
26497,0,1,0,0,1
26498,0,0,0,1,1
26499,1,0,0,0,1
26500,0,1,0,0,1
26501,1,0,0,0,1
26502,0,1,0,0,1
26503,0,1,0,0,1
26504,0,1,0,0,1
26505,1,0,0,0,1
26506,1,0,0,0,1
26507,0,1,0,0,1
26508,0,1,0,0,1
26509,1,0,0,0,1
26510,0,1,0,0,1
26511,0,0,1,0,1
26512,0,0,0,1,1
26513,0,1,0,0,1
26514,0,1,0,0,1
26515,0,1,0,0,1
26516,1,0,0,0,1
26517,1,0,0,0,1
26518,0,1,0,0,1
26519,1,0,0,0,1
26520,1,0,0,0,1
26521,0,1,0,0,1
26522,1,0,0,0,1
26523,1,0,0,0,1
26524,0,1,0,0,1
26525,0,1,0,0,1
26526,0,1,0,0,1
26527,0,1,0,0,1
26528,0,1,0,0,1
26529,0,0,1,0,1
26530,0,1,0,0,1
26531,0,1,0,0,1
26532,0,1,0,0,1
26533,0,1,0,0,1
26534,0,1,0,0,1
26535,0,1,0,0,1
26536,0,1,0,0,1
26537,0,1,0,0,1
26538,0,1,0,0,1
26539,0,1,0,0,1
26540,0,1,0,0,1
26541,0,0,0,1,1
26542,1,0,0,0,1
26543,0,0,0,1,1
26544,0,1,0,0,1
26545,1,0,0,0,1
26546,0,1,0,0,1
26547,1,0,0,0,1
26548,0,1,0,0,1
26549,0,1,0,0,1
26550,0,1,0,0,1
26551,0,1,0,0,1
26552,0,1,0,0,1
26553,1,0,0,0,1
26554,0,1,0,0,1
26555,0,1,0,0,1
26556,1,0,0,0,1
26557,1,0,0,0,1
26558,1,0,0,0,1
26559,0,1,0,0,1
26560,0,1,0,0,1
26561,0,1,0,0,1
26562,0,0,1,0,1
26563,0,1,0,0,1
26564,0,0,1,0,1
26565,0,1,0,0,1
26566,0,1,0,0,1
26567,0,1,0,0,1
26568,0,1,0,0,1
26569,0,1,0,0,1
26570,0,1,0,0,1
26571,0,1,0,0,1
26572,0,1,0,0,1
26573,0,1,0,0,1
26574,0,1,0,0,1
26575,0,1,0,0,1
26576,0,1,0,0,1
26577,0,1,0,0,1
26578,0,0,1,0,1
26579,1,0,0,0,1
26580,0,1,0,0,1
26581,0,1,0,0,1
26582,0,1,0,0,1
26583,0,1,0,0,1
26584,0,1,0,0,1
26585,0,1,0,0,1
26586,0,1,0,0,1
26587,0,1,0,0,1
26588,0,1,0,0,1
26589,1,0,0,0,1
26590,0,1,0,0,1
26591,0,1,0,0,1
26592,1,0,0,0,1
26593,0,1,0,0,1
26594,0,1,0,0,1
26595,0,1,0,0,1
26596,0,1,0,0,1
26597,1,0,0,0,1
26598,0,1,0,0,1
26599,0,1,0,0,1
26600,0,1,0,0,1
26601,0,1,0,0,1
26602,1,0,0,0,1
26603,1,0,0,0,1
26604,0,1,0,0,1
26605,1,0,0,0,1
26606,0,0,0,1,1
26607,0,1,0,0,1
26608,1,0,0,0,1
26609,0,1,0,0,1
26610,0,1,0,0,1
26611,0,1,0,0,1
26612,0,1,0,0,1
26613,0,1,0,0,1
26614,1,0,0,0,1
26615,1,0,0,0,1
26616,1,0,0,0,1
26617,0,1,0,0,1
26618,0,0,0,1,1
26619,0,1,0,0,1
26620,0,1,0,0,1
26621,0,1,0,0,1
26622,0,1,0,0,1
26623,0,1,0,0,1
26624,0,1,0,0,1
26625,1,0,0,0,1
26626,0,0,1,0,1
26627,0,1,0,0,1
26628,0,1,0,0,1
26629,0,1,0,0,1
26630,0,1,0,0,1
26631,0,1,0,0,1
26632,0,1,0,0,1
26633,0,1,0,0,1
26634,0,1,0,0,1
26635,0,1,0,0,1
26636,0,1,0,0,1
26637,0,1,0,0,1
26638,0,1,0,0,1
26639,0,1,0,0,1
26640,1,0,0,0,1
26641,0,1,0,0,1
26642,0,1,0,0,1
26643,0,1,0,0,1
26644,0,1,0,0,1
26645,0,0,0,1,1
26646,1,0,0,0,1
26647,0,1,0,0,1
26648,1,0,0,0,1
26649,0,1,0,0,1
26650,0,1,0,0,1
26651,0,1,0,0,1
26652,0,1,0,0,1
26653,0,1,0,0,1
26654,1,0,0,0,1
26655,0,1,0,0,1
26656,0,1,0,0,1
26657,0,1,0,0,1
26658,0,1,0,0,1
26659,0,0,0,1,1
26660,0,1,0,0,1
26661,0,1,0,0,1
26662,0,1,0,0,1
26663,0,1,0,0,1
26664,1,0,0,0,1
26665,1,0,0,0,1
26666,0,1,0,0,1
26667,0,1,0,0,1
26668,0,1,0,0,1
26669,0,1,0,0,1
26670,0,1,0,0,1
26671,0,1,0,0,1
26672,0,1,0,0,1
26673,0,1,0,0,1
26674,1,0,0,0,1
26675,0,1,0,0,1
26676,1,0,0,0,1
26677,1,0,0,0,1
26678,0,1,0,0,1
26679,1,0,0,0,1
26680,0,1,0,0,1
26681,0,1,0,0,1
26682,0,1,0,0,1
26683,1,0,0,0,1
26684,0,1,0,0,1
26685,0,1,0,0,1
26686,1,0,0,0,1
26687,0,1,0,0,1
26688,0,1,0,0,1
26689,0,1,0,0,1
26690,0,1,0,0,1
26691,1,0,0,0,1
26692,1,0,0,0,1
26693,0,1,0,0,1
26694,0,1,0,0,1
26695,0,1,0,0,1
26696,1,0,0,0,1
26697,1,0,0,0,1
26698,0,1,0,0,1
26699,0,1,0,0,1
26700,0,1,0,0,1
26701,0,1,0,0,1
26702,0,1,0,0,1
26703,1,0,0,0,1
26704,0,1,0,0,1
26705,0,1,0,0,1
26706,0,1,0,0,1
26707,0,0,0,1,1
26708,0,1,0,0,1
26709,1,0,0,0,1
26710,0,1,0,0,1
26711,1,0,0,0,1
26712,0,0,0,1,1
26713,0,1,0,0,1
26714,0,1,0,0,1
26715,0,1,0,0,1
26716,1,0,0,0,1
26717,0,1,0,0,1
26718,1,0,0,0,1
26719,1,0,0,0,1
26720,0,1,0,0,1
26721,1,0,0,0,1
26722,0,1,0,0,1
26723,0,1,0,0,1
26724,0,1,0,0,1
26725,0,1,0,0,1
26726,0,1,0,0,1
26727,0,1,0,0,1
26728,1,0,0,0,1
26729,1,0,0,0,1
26730,0,1,0,0,1
26731,1,0,0,0,1
26732,0,0,0,1,1
26733,1,0,0,0,1
26734,0,1,0,0,1
26735,0,1,0,0,1
26736,0,1,0,0,1
26737,0,1,0,0,1
26738,0,1,0,0,1
26739,0,1,0,0,1
26740,1,0,0,0,1
26741,0,1,0,0,1
26742,0,1,0,0,1
26743,0,1,0,0,1
26744,0,1,0,0,1
26745,0,1,0,0,1
26746,0,1,0,0,1
26747,0,1,0,0,1
26748,0,1,0,0,1
26749,0,1,0,0,1
26750,1,0,0,0,1
26751,1,0,0,0,1
26752,0,1,0,0,1
26753,0,1,0,0,1
26754,0,1,0,0,1
26755,0,1,0,0,1
26756,0,1,0,0,1
26757,0,1,0,0,1
26758,0,1,0,0,1
26759,0,1,0,0,1
26760,1,0,0,0,1
26761,0,1,0,0,1
26762,0,1,0,0,1
26763,0,1,0,0,1
26764,0,1,0,0,1
26765,0,1,0,0,1
26766,1,0,0,0,1
26767,1,0,0,0,1
26768,0,0,1,0,1
26769,0,1,0,0,1
26770,0,1,0,0,1
26771,0,1,0,0,1
26772,0,0,1,0,1
26773,0,1,0,0,1
26774,0,1,0,0,1
26775,0,1,0,0,1
26776,0,1,0,0,1
26777,1,0,0,0,1
26778,0,1,0,0,1
26779,0,1,0,0,1
26780,0,1,0,0,1
26781,1,0,0,0,1
26782,0,0,0,1,1
26783,0,1,0,0,1
26784,1,0,0,0,1
26785,0,1,0,0,1
26786,0,1,0,0,1
26787,0,1,0,0,1
26788,0,1,0,0,1
26789,0,1,0,0,1
26790,0,1,0,0,1
26791,0,1,0,0,1
26792,0,1,0,0,1
26793,0,1,0,0,1
26794,0,1,0,0,1
26795,0,1,0,0,1
26796,0,1,0,0,1
26797,1,0,0,0,1
26798,0,1,0,0,1
26799,0,1,0,0,1
26800,1,0,0,0,1
26801,0,1,0,0,1
26802,0,1,0,0,1
26803,0,1,0,0,1
26804,0,1,0,0,1
26805,0,1,0,0,1
26806,0,1,0,0,1
26807,0,1,0,0,1
26808,0,1,0,0,1
26809,0,0,0,1,1
26810,0,1,0,0,1
26811,0,1,0,0,1
26812,1,0,0,0,1
26813,1,0,0,0,1
26814,1,0,0,0,1
26815,0,1,0,0,1
26816,0,1,0,0,1
26817,0,1,0,0,1
26818,0,1,0,0,1
26819,0,1,0,0,1
26820,0,1,0,0,1
26821,0,0,1,0,1
26822,0,1,0,0,1
26823,0,1,0,0,1
26824,0,1,0,0,1
26825,0,1,0,0,1
26826,0,1,0,0,1
26827,0,1,0,0,1
26828,0,1,0,0,1
26829,1,0,0,0,1
26830,0,1,0,0,1
26831,0,1,0,0,1
26832,0,1,0,0,1
26833,0,1,0,0,1
26834,0,1,0,0,1
26835,0,1,0,0,1
26836,0,1,0,0,1
26837,1,0,0,0,1
26838,1,0,0,0,1
26839,0,1,0,0,1
26840,0,1,0,0,1
26841,0,0,0,1,1
26842,0,1,0,0,1
26843,0,1,0,0,1
26844,0,1,0,0,1
26845,0,0,1,0,1
26846,0,1,0,0,1
26847,0,1,0,0,1
26848,0,1,0,0,1
26849,1,0,0,0,1
26850,1,0,0,0,1
26851,0,1,0,0,1
26852,1,0,0,0,1
26853,1,0,0,0,1
26854,0,1,0,0,1
26855,0,1,0,0,1
26856,0,1,0,0,1
26857,0,1,0,0,1
26858,0,1,0,0,1
26859,1,0,0,0,1
26860,0,1,0,0,1
26861,0,1,0,0,1
26862,0,1,0,0,1
26863,1,0,0,0,1
26864,0,1,0,0,1
26865,1,0,0,0,1
26866,1,0,0,0,1
26867,0,1,0,0,1
26868,0,1,0,0,1
26869,0,0,0,1,1
26870,0,1,0,0,1
26871,0,1,0,0,1
26872,0,1,0,0,1
26873,1,0,0,0,1
26874,0,1,0,0,1
26875,0,1,0,0,1
26876,1,0,0,0,1
26877,0,1,0,0,1
26878,0,1,0,0,1
26879,0,1,0,0,1
26880,0,1,0,0,1
26881,1,0,0,0,1
26882,1,0,0,0,1
26883,0,1,0,0,1
26884,0,1,0,0,1
26885,0,1,0,0,1
26886,0,1,0,0,1
26887,0,1,0,0,1
26888,0,1,0,0,1
26889,0,1,0,0,1
26890,0,1,0,0,1
26891,0,1,0,0,1
26892,0,1,0,0,1
26893,0,1,0,0,1
26894,0,1,0,0,1
26895,0,1,0,0,1
26896,0,1,0,0,1
26897,1,0,0,0,1
26898,0,1,0,0,1
26899,0,1,0,0,1
26900,0,1,0,0,1
26901,1,0,0,0,1
26902,1,0,0,0,1
26903,0,1,0,0,1
26904,0,0,0,1,1
26905,0,0,0,1,1
26906,0,1,0,0,1
26907,0,1,0,0,1
26908,1,0,0,0,1
26909,0,1,0,0,1
26910,0,1,0,0,1
26911,1,0,0,0,1
26912,0,1,0,0,1
26913,0,1,0,0,1
26914,0,1,0,0,1
26915,0,1,0,0,1
26916,0,1,0,0,1
26917,0,1,0,0,1
26918,0,1,0,0,1
26919,0,1,0,0,1
26920,0,1,0,0,1
26921,0,1,0,0,1
26922,0,1,0,0,1
26923,0,1,0,0,1
26924,0,1,0,0,1
26925,0,1,0,0,1
26926,0,0,0,1,1
26927,0,1,0,0,1
26928,0,1,0,0,1
26929,0,1,0,0,1
26930,1,0,0,0,1
26931,0,1,0,0,1
26932,1,0,0,0,1
26933,0,1,0,0,1
26934,0,1,0,0,1
26935,0,1,0,0,1
26936,0,1,0,0,1
26937,0,1,0,0,1
26938,0,1,0,0,1
26939,0,0,1,0,1
26940,0,1,0,0,1
26941,1,0,0,0,1
26942,0,1,0,0,1
26943,0,1,0,0,1
26944,0,0,1,0,1
26945,0,1,0,0,1
26946,0,1,0,0,1
26947,0,1,0,0,1
26948,0,1,0,0,1
26949,0,1,0,0,1
26950,0,1,0,0,1
26951,0,1,0,0,1
26952,0,1,0,0,1
26953,1,0,0,0,1
26954,1,0,0,0,1
26955,0,1,0,0,1
26956,0,1,0,0,1
26957,0,1,0,0,1
26958,0,1,0,0,1
26959,0,1,0,0,1
26960,0,1,0,0,1
26961,0,1,0,0,1
26962,0,1,0,0,1
26963,0,1,0,0,1
26964,0,1,0,0,1
26965,0,1,0,0,1
26966,0,1,0,0,1
26967,0,1,0,0,1
26968,0,1,0,0,1
26969,0,1,0,0,1
26970,0,1,0,0,1
26971,0,1,0,0,1
26972,0,0,0,1,1
26973,0,0,0,1,1
26974,0,1,0,0,1
26975,0,1,0,0,1
26976,0,1,0,0,1
26977,1,0,0,0,1
26978,0,1,0,0,1
26979,0,0,0,1,1
26980,1,0,0,0,1
26981,0,1,0,0,1
26982,0,1,0,0,1
26983,0,1,0,0,1
26984,1,0,0,0,1
26985,1,0,0,0,1
26986,0,1,0,0,1
26987,0,0,0,1,1
26988,0,1,0,0,1
26989,0,1,0,0,1
26990,0,1,0,0,1
26991,0,1,0,0,1
26992,1,0,0,0,1
26993,0,1,0,0,1
26994,0,1,0,0,1
26995,0,1,0,0,1
26996,0,1,0,0,1
26997,0,1,0,0,1
26998,0,1,0,0,1
26999,0,1,0,0,1
27000,0,1,0,0,1
27001,0,0,1,0,1
27002,0,1,0,0,1
27003,0,0,1,0,1
27004,1,0,0,0,1
27005,1,0,0,0,1
27006,0,1,0,0,1
27007,0,1,0,0,1
27008,0,1,0,0,1
27009,0,1,0,0,1
27010,0,1,0,0,1
27011,1,0,0,0,1
27012,0,1,0,0,1
27013,0,1,0,0,1
27014,0,1,0,0,1
27015,0,1,0,0,1
27016,1,0,0,0,1
27017,0,1,0,0,1
27018,0,1,0,0,1
27019,0,1,0,0,1
27020,0,1,0,0,1
27021,0,0,1,0,1
27022,0,1,0,0,1
27023,0,1,0,0,1
27024,0,1,0,0,1
27025,0,1,0,0,1
27026,0,1,0,0,1
27027,0,1,0,0,1
27028,0,1,0,0,1
27029,0,1,0,0,1
27030,0,1,0,0,1
27031,1,0,0,0,1
27032,0,1,0,0,1
27033,0,1,0,0,1
27034,1,0,0,0,1
27035,1,0,0,0,1
27036,0,1,0,0,1
27037,0,1,0,0,1
27038,0,1,0,0,1
27039,0,1,0,0,1
27040,0,1,0,0,1
27041,0,1,0,0,1
27042,0,0,0,1,1
27043,1,0,0,0,1
27044,0,1,0,0,1
27045,1,0,0,0,1
27046,0,1,0,0,1
27047,0,1,0,0,1
27048,0,1,0,0,1
27049,1,0,0,0,1
27050,0,1,0,0,1
27051,0,1,0,0,1
27052,0,1,0,0,1
27053,0,1,0,0,1
27054,1,0,0,0,1
27055,0,1,0,0,1
27056,0,0,1,0,1
27057,0,1,0,0,1
27058,0,0,1,0,1
27059,0,1,0,0,1
27060,0,1,0,0,1
27061,0,1,0,0,1
27062,0,1,0,0,1
27063,0,1,0,0,1
27064,0,1,0,0,1
27065,0,1,0,0,1
27066,1,0,0,0,1
27067,0,1,0,0,1
27068,0,1,0,0,1
27069,0,1,0,0,1
27070,0,1,0,0,1
27071,0,1,0,0,1
27072,0,1,0,0,1
27073,0,0,0,1,1
27074,0,1,0,0,1
27075,0,1,0,0,1
27076,0,1,0,0,1
27077,0,1,0,0,1
27078,0,1,0,0,1
27079,0,1,0,0,1
27080,1,0,0,0,1
27081,0,1,0,0,1
27082,0,1,0,0,1
27083,0,1,0,0,1
27084,1,0,0,0,1
27085,0,1,0,0,1
27086,1,0,0,0,1
27087,1,0,0,0,1
27088,0,1,0,0,1
27089,0,1,0,0,1
27090,0,1,0,0,1
27091,0,1,0,0,1
27092,1,0,0,0,1
27093,0,1,0,0,1
27094,0,1,0,0,1
27095,0,1,0,0,1
27096,0,1,0,0,1
27097,0,1,0,0,1
27098,0,1,0,0,1
27099,0,1,0,0,1
27100,0,1,0,0,1
27101,0,1,0,0,1
27102,1,0,0,0,1
27103,0,1,0,0,1
27104,0,1,0,0,1
27105,0,1,0,0,1
27106,0,1,0,0,1
27107,0,1,0,0,1
27108,0,1,0,0,1
27109,0,1,0,0,1
27110,1,0,0,0,1
27111,0,1,0,0,1
27112,0,1,0,0,1
27113,0,0,1,0,1
27114,0,1,0,0,1
27115,0,1,0,0,1
27116,0,1,0,0,1
27117,0,1,0,0,1
27118,0,1,0,0,1
27119,0,1,0,0,1
27120,1,0,0,0,1
27121,0,1,0,0,1
27122,0,1,0,0,1
27123,0,1,0,0,1
27124,1,0,0,0,1
27125,0,1,0,0,1
27126,1,0,0,0,1
27127,0,1,0,0,1
27128,0,1,0,0,1
27129,0,1,0,0,1
27130,0,1,0,0,1
27131,0,0,0,1,1
27132,0,1,0,0,1
27133,0,1,0,0,1
27134,0,1,0,0,1
27135,0,1,0,0,1
27136,1,0,0,0,1
27137,0,1,0,0,1
27138,0,0,0,1,1
27139,1,0,0,0,1
27140,0,1,0,0,1
27141,0,1,0,0,1
27142,0,1,0,0,1
27143,0,1,0,0,1
27144,0,1,0,0,1
27145,0,1,0,0,1
27146,0,0,1,0,1
27147,0,1,0,0,1
27148,0,1,0,0,1
27149,0,1,0,0,1
27150,0,1,0,0,1
27151,0,1,0,0,1
27152,0,1,0,0,1
27153,1,0,0,0,1
27154,0,1,0,0,1
27155,1,0,0,0,1
27156,1,0,0,0,1
27157,1,0,0,0,1
27158,0,1,0,0,1
27159,0,1,0,0,1
27160,1,0,0,0,1
27161,0,0,0,1,1
27162,0,1,0,0,1
27163,0,1,0,0,1
27164,0,1,0,0,1
27165,0,1,0,0,1
27166,0,1,0,0,1
27167,0,1,0,0,1
27168,0,1,0,0,1
27169,0,0,1,0,1
27170,0,1,0,0,1
27171,0,1,0,0,1
27172,1,0,0,0,1
27173,1,0,0,0,1
27174,0,1,0,0,1
27175,0,1,0,0,1
27176,0,1,0,0,1
27177,0,1,0,0,1
27178,0,1,0,0,1
27179,0,1,0,0,1
27180,0,1,0,0,1
27181,0,1,0,0,1
27182,0,1,0,0,1
27183,0,0,0,1,1
27184,0,1,0,0,1
27185,0,1,0,0,1
27186,0,1,0,0,1
27187,0,1,0,0,1
27188,0,1,0,0,1
27189,0,1,0,0,1
27190,0,1,0,0,1
27191,0,1,0,0,1
27192,1,0,0,0,1
27193,0,1,0,0,1
27194,0,0,1,0,1
27195,0,1,0,0,1
27196,0,1,0,0,1
27197,0,1,0,0,1
27198,0,1,0,0,1
27199,1,0,0,0,1
27200,0,1,0,0,1
27201,0,1,0,0,1
27202,0,1,0,0,1
27203,1,0,0,0,1
27204,1,0,0,0,1
27205,0,0,1,0,1
27206,1,0,0,0,1
27207,0,1,0,0,1
27208,0,1,0,0,1
27209,0,1,0,0,1
27210,0,1,0,0,1
27211,0,1,0,0,1
27212,0,1,0,0,1
27213,0,1,0,0,1
27214,0,1,0,0,1
27215,1,0,0,0,1
27216,0,1,0,0,1
27217,0,1,0,0,1
27218,0,1,0,0,1
27219,0,1,0,0,1
27220,0,1,0,0,1
27221,0,1,0,0,1
27222,0,1,0,0,1
27223,1,0,0,0,1
27224,1,0,0,0,1
27225,0,1,0,0,1
27226,0,1,0,0,1
27227,1,0,0,0,1
27228,0,1,0,0,1
27229,1,0,0,0,1
27230,0,1,0,0,1
27231,0,1,0,0,1
27232,0,1,0,0,1
27233,0,0,0,1,1
27234,0,1,0,0,1
27235,0,1,0,0,1
27236,0,0,1,0,1
27237,0,1,0,0,1
27238,0,1,0,0,1
27239,0,0,0,1,1
27240,0,1,0,0,1
27241,0,1,0,0,1
27242,0,1,0,0,1
27243,0,1,0,0,1
27244,0,1,0,0,1
27245,0,0,1,0,1
27246,1,0,0,0,1
27247,1,0,0,0,1
27248,0,1,0,0,1
27249,0,1,0,0,1
27250,0,1,0,0,1
27251,0,1,0,0,1
27252,0,1,0,0,1
27253,0,1,0,0,1
27254,0,1,0,0,1
27255,0,1,0,0,1
27256,0,1,0,0,1
27257,1,0,0,0,1
27258,0,0,0,1,1
27259,0,1,0,0,1
27260,0,1,0,0,1
27261,0,1,0,0,1
27262,0,1,0,0,1
27263,0,1,0,0,1
27264,0,1,0,0,1
27265,1,0,0,0,1
27266,0,1,0,0,1
27267,0,1,0,0,1
27268,0,1,0,0,1
27269,0,1,0,0,1
27270,0,1,0,0,1
27271,0,1,0,0,1
27272,0,1,0,0,1
27273,0,1,0,0,1
27274,0,1,0,0,1
27275,0,1,0,0,1
27276,0,0,1,0,1
27277,0,1,0,0,1
27278,0,1,0,0,1
27279,0,1,0,0,1
27280,1,0,0,0,1
27281,1,0,0,0,1
27282,0,1,0,0,1
27283,0,1,0,0,1
27284,0,0,1,0,1
27285,0,1,0,0,1
27286,0,0,1,0,1
27287,0,1,0,0,1
27288,0,1,0,0,1
27289,1,0,0,0,1
27290,0,1,0,0,1
27291,0,1,0,0,1
27292,0,1,0,0,1
27293,0,1,0,0,1
27294,1,0,0,0,1
27295,0,0,0,1,1
27296,0,1,0,0,1
27297,1,0,0,0,1
27298,0,1,0,0,1
27299,0,1,0,0,1
27300,0,1,0,0,1
27301,0,1,0,0,1
27302,0,1,0,0,1
27303,1,0,0,0,1
27304,0,0,1,0,1
27305,1,0,0,0,1
27306,0,1,0,0,1
27307,0,1,0,0,1
27308,0,1,0,0,1
27309,0,1,0,0,1
27310,1,0,0,0,1
27311,0,1,0,0,1
27312,0,1,0,0,1
27313,0,1,0,0,1
27314,0,1,0,0,1
27315,0,1,0,0,1
27316,1,0,0,0,1
27317,0,1,0,0,1
27318,1,0,0,0,1
27319,0,0,0,1,1
27320,0,1,0,0,1
27321,0,1,0,0,1
27322,0,1,0,0,1
27323,0,1,0,0,1
27324,0,1,0,0,1
27325,0,1,0,0,1
27326,0,1,0,0,1
27327,0,1,0,0,1
27328,0,1,0,0,1
27329,0,0,1,0,1
27330,0,1,0,0,1
27331,0,0,1,0,1
27332,0,1,0,0,1
27333,0,1,0,0,1
27334,0,1,0,0,1
27335,1,0,0,0,1
27336,0,1,0,0,1
27337,0,1,0,0,1
27338,1,0,0,0,1
27339,0,1,0,0,1
27340,0,1,0,0,1
27341,0,1,0,0,1
27342,0,1,0,0,1
27343,0,1,0,0,1
27344,0,1,0,0,1
27345,0,1,0,0,1
27346,0,1,0,0,1
27347,0,1,0,0,1
27348,0,1,0,0,1
27349,0,1,0,0,1
27350,0,1,0,0,1
27351,0,1,0,0,1
27352,0,1,0,0,1
27353,0,1,0,0,1
27354,0,1,0,0,1
27355,0,1,0,0,1
27356,0,1,0,0,1
27357,0,1,0,0,1
27358,0,0,0,1,1
27359,1,0,0,0,1
27360,0,1,0,0,1
27361,0,1,0,0,1
27362,0,1,0,0,1
27363,1,0,0,0,1
27364,0,0,0,1,1
27365,0,1,0,0,1
27366,0,1,0,0,1
27367,0,1,0,0,1
27368,0,1,0,0,1
27369,0,1,0,0,1
27370,0,1,0,0,1
27371,0,1,0,0,1
27372,0,1,0,0,1
27373,0,1,0,0,1
27374,1,0,0,0,1
27375,0,1,0,0,1
27376,0,1,0,0,1
27377,0,1,0,0,1
27378,0,1,0,0,1
27379,0,1,0,0,1
27380,1,0,0,0,1
27381,0,1,0,0,1
27382,0,1,0,0,1
27383,1,0,0,0,1
27384,0,1,0,0,1
27385,0,1,0,0,1
27386,0,1,0,0,1
27387,0,1,0,0,1
27388,1,0,0,0,1
27389,0,1,0,0,1
27390,0,1,0,0,1
27391,0,1,0,0,1
27392,0,1,0,0,1
27393,1,0,0,0,1
27394,0,1,0,0,1
27395,0,1,0,0,1
27396,0,1,0,0,1
27397,0,1,0,0,1
27398,0,1,0,0,1
27399,0,1,0,0,1
27400,0,1,0,0,1
27401,1,0,0,0,1
27402,0,1,0,0,1
27403,0,1,0,0,1
27404,1,0,0,0,1
27405,1,0,0,0,1
27406,0,1,0,0,1
27407,1,0,0,0,1
27408,0,1,0,0,1
27409,0,1,0,0,1
27410,0,1,0,0,1
27411,0,1,0,0,1
27412,0,1,0,0,1
27413,0,0,1,0,1
27414,0,1,0,0,1
27415,0,1,0,0,1
27416,0,0,0,1,1
27417,0,1,0,0,1
27418,0,1,0,0,1
27419,1,0,0,0,1
27420,0,0,1,0,1
27421,1,0,0,0,1
27422,0,1,0,0,1
27423,1,0,0,0,1
27424,0,0,0,1,1
27425,0,1,0,0,1
27426,0,1,0,0,1
27427,0,1,0,0,1
27428,1,0,0,0,1
27429,1,0,0,0,1
27430,0,1,0,0,1
27431,0,1,0,0,1
27432,0,0,0,1,1
27433,1,0,0,0,1
27434,0,1,0,0,1
27435,0,1,0,0,1
27436,0,1,0,0,1
27437,0,1,0,0,1
27438,0,1,0,0,1
27439,1,0,0,0,1
27440,0,1,0,0,1
27441,0,1,0,0,1
27442,1,0,0,0,1
27443,1,0,0,0,1
27444,0,1,0,0,1
27445,0,1,0,0,1
27446,0,1,0,0,1
27447,1,0,0,0,1
27448,0,1,0,0,1
27449,0,1,0,0,1
27450,0,1,0,0,1
27451,0,0,0,1,1
27452,0,1,0,0,1
27453,0,1,0,0,1
27454,0,1,0,0,1
27455,1,0,0,0,1
27456,0,1,0,0,1
27457,0,1,0,0,1
27458,0,1,0,0,1
27459,0,1,0,0,1
27460,0,1,0,0,1
27461,1,0,0,0,1
27462,0,1,0,0,1
27463,0,1,0,0,1
27464,0,1,0,0,1
27465,0,1,0,0,1
27466,0,1,0,0,1
27467,0,0,0,1,1
27468,1,0,0,0,1
27469,0,1,0,0,1
27470,0,1,0,0,1
27471,0,1,0,0,1
27472,0,1,0,0,1
27473,1,0,0,0,1
27474,0,1,0,0,1
27475,0,1,0,0,1
27476,0,1,0,0,1
27477,0,1,0,0,1
27478,0,1,0,0,1
27479,0,1,0,0,1
27480,0,1,0,0,1
27481,0,1,0,0,1
27482,0,1,0,0,1
27483,0,1,0,0,1
27484,1,0,0,0,1
27485,0,1,0,0,1
27486,0,1,0,0,1
27487,0,1,0,0,1
27488,1,0,0,0,1
27489,1,0,0,0,1
27490,0,1,0,0,1
27491,0,1,0,0,1
27492,1,0,0,0,1
27493,0,1,0,0,1
27494,0,1,0,0,1
27495,0,1,0,0,1
27496,0,1,0,0,1
27497,0,1,0,0,1
27498,0,1,0,0,1
27499,0,1,0,0,1
27500,1,0,0,0,1
27501,0,1,0,0,1
27502,1,0,0,0,1
27503,0,1,0,0,1
27504,0,1,0,0,1
27505,0,1,0,0,1
27506,1,0,0,0,1
27507,0,1,0,0,1
27508,0,1,0,0,1
27509,0,1,0,0,1
27510,0,1,0,0,1
27511,1,0,0,0,1
27512,1,0,0,0,1
27513,0,1,0,0,1
27514,1,0,0,0,1
27515,1,0,0,0,1
27516,1,0,0,0,1
27517,0,1,0,0,1
27518,1,0,0,0,1
27519,0,1,0,0,1
27520,0,1,0,0,1
27521,0,1,0,0,1
27522,0,1,0,0,1
27523,0,1,0,0,1
27524,1,0,0,0,1
27525,1,0,0,0,1
27526,0,1,0,0,1
27527,0,1,0,0,1
27528,0,1,0,0,1
27529,0,1,0,0,1
27530,0,1,0,0,1
27531,0,1,0,0,1
27532,0,1,0,0,1
27533,0,1,0,0,1
27534,0,1,0,0,1
27535,0,1,0,0,1
27536,0,1,0,0,1
27537,0,1,0,0,1
27538,0,1,0,0,1
27539,0,1,0,0,1
27540,0,1,0,0,1
27541,0,1,0,0,1
27542,0,1,0,0,1
27543,0,1,0,0,1
27544,0,1,0,0,1
27545,0,1,0,0,1
27546,0,0,1,0,1
27547,0,1,0,0,1
27548,0,1,0,0,1
27549,0,1,0,0,1
27550,0,1,0,0,1
27551,0,1,0,0,1
27552,0,1,0,0,1
27553,0,1,0,0,1
27554,1,0,0,0,1
27555,0,1,0,0,1
27556,0,1,0,0,1
27557,0,1,0,0,1
27558,0,1,0,0,1
27559,0,1,0,0,1
27560,0,1,0,0,1
27561,0,1,0,0,1
27562,0,1,0,0,1
27563,1,0,0,0,1
27564,0,1,0,0,1
27565,0,1,0,0,1
27566,0,1,0,0,1
27567,1,0,0,0,1
27568,0,1,0,0,1
27569,0,1,0,0,1
27570,0,1,0,0,1
27571,0,1,0,0,1
27572,0,1,0,0,1
27573,1,0,0,0,1
27574,1,0,0,0,1
27575,0,1,0,0,1
27576,0,1,0,0,1
27577,0,1,0,0,1
27578,0,1,0,0,1
27579,0,1,0,0,1
27580,0,1,0,0,1
27581,0,1,0,0,1
27582,0,1,0,0,1
27583,0,1,0,0,1
27584,1,0,0,0,1
27585,0,1,0,0,1
27586,1,0,0,0,1
27587,0,1,0,0,1
27588,1,0,0,0,1
27589,0,1,0,0,1
27590,0,1,0,0,1
27591,0,1,0,0,1
27592,0,1,0,0,1
27593,0,1,0,0,1
27594,0,1,0,0,1
27595,0,1,0,0,1
27596,0,1,0,0,1
27597,0,1,0,0,1
27598,0,1,0,0,1
27599,1,0,0,0,1
27600,0,0,0,1,1
27601,1,0,0,0,1
27602,0,1,0,0,1
27603,0,1,0,0,1
27604,0,1,0,0,1
27605,0,1,0,0,1
27606,0,1,0,0,1
27607,0,1,0,0,1
27608,0,1,0,0,1
27609,0,1,0,0,1
27610,0,1,0,0,1
27611,0,1,0,0,1
27612,0,0,1,0,1
27613,0,1,0,0,1
27614,0,1,0,0,1
27615,0,1,0,0,1
27616,0,1,0,0,1
27617,0,1,0,0,1
27618,0,1,0,0,1
27619,0,1,0,0,1
27620,0,1,0,0,1
27621,0,1,0,0,1
27622,0,1,0,0,1
27623,0,1,0,0,1
27624,0,1,0,0,1
27625,0,1,0,0,1
27626,0,1,0,0,1
27627,0,1,0,0,1
27628,0,1,0,0,1
27629,0,0,0,1,1
27630,1,0,0,0,1
27631,0,1,0,0,1
27632,0,1,0,0,1
27633,0,1,0,0,1
27634,0,0,0,1,1
27635,0,1,0,0,1
27636,0,1,0,0,1
27637,0,1,0,0,1
27638,1,0,0,0,1
27639,0,1,0,0,1
27640,0,1,0,0,1
27641,0,1,0,0,1
27642,0,1,0,0,1
27643,0,1,0,0,1
27644,1,0,0,0,1
27645,0,1,0,0,1
27646,1,0,0,0,1
27647,0,1,0,0,1
27648,0,1,0,0,1
27649,0,1,0,0,1
27650,0,1,0,0,1
27651,0,0,0,1,1
27652,0,1,0,0,1
27653,0,1,0,0,1
27654,0,1,0,0,1
27655,1,0,0,0,1
27656,0,1,0,0,1
27657,0,1,0,0,1
27658,0,1,0,0,1
27659,0,1,0,0,1
27660,0,1,0,0,1
27661,0,1,0,0,1
27662,0,1,0,0,1
27663,0,1,0,0,1
27664,0,1,0,0,1
27665,0,1,0,0,1
27666,1,0,0,0,1
27667,0,1,0,0,1
27668,0,1,0,0,1
27669,0,1,0,0,1
27670,0,0,0,1,1
27671,0,1,0,0,1
27672,0,1,0,0,1
27673,0,1,0,0,1
27674,1,0,0,0,1
27675,1,0,0,0,1
27676,0,1,0,0,1
27677,0,1,0,0,1
27678,0,1,0,0,1
27679,1,0,0,0,1
27680,0,1,0,0,1
27681,0,1,0,0,1
27682,0,0,1,0,1
27683,0,1,0,0,1
27684,0,1,0,0,1
27685,1,0,0,0,1
27686,0,1,0,0,1
27687,0,1,0,0,1
27688,1,0,0,0,1
27689,0,1,0,0,1
27690,0,1,0,0,1
27691,0,1,0,0,1
27692,0,1,0,0,1
27693,0,1,0,0,1
27694,0,1,0,0,1
27695,1,0,0,0,1
27696,1,0,0,0,1
27697,0,1,0,0,1
27698,0,1,0,0,1
27699,0,1,0,0,1
27700,0,1,0,0,1
27701,0,1,0,0,1
27702,1,0,0,0,1
27703,0,1,0,0,1
27704,1,0,0,0,1
27705,0,1,0,0,1
27706,0,1,0,0,1
27707,1,0,0,0,1
27708,0,1,0,0,1
27709,0,1,0,0,1
27710,1,0,0,0,1
27711,0,0,1,0,1
27712,0,1,0,0,1
27713,0,1,0,0,1
27714,1,0,0,0,1
27715,0,1,0,0,1
27716,1,0,0,0,1
27717,0,1,0,0,1
27718,1,0,0,0,1
27719,1,0,0,0,1
27720,0,1,0,0,1
27721,1,0,0,0,1
27722,1,0,0,0,1
27723,1,0,0,0,1
27724,0,1,0,0,1
27725,0,1,0,0,1
27726,0,1,0,0,1
27727,0,1,0,0,1
27728,0,1,0,0,1
27729,0,1,0,0,1
27730,0,1,0,0,1
27731,0,1,0,0,1
27732,0,1,0,0,1
27733,0,1,0,0,1
27734,0,1,0,0,1
27735,1,0,0,0,1
27736,0,1,0,0,1
27737,0,1,0,0,1
27738,1,0,0,0,1
27739,1,0,0,0,1
27740,0,1,0,0,1
27741,0,1,0,0,1
27742,1,0,0,0,1
27743,0,1,0,0,1
27744,0,1,0,0,1
27745,0,1,0,0,1
27746,0,1,0,0,1
27747,0,1,0,0,1
27748,0,1,0,0,1
27749,0,1,0,0,1
27750,1,0,0,0,1
27751,0,1,0,0,1
27752,0,1,0,0,1
27753,1,0,0,0,1
27754,0,1,0,0,1
27755,1,0,0,0,1
27756,1,0,0,0,1
27757,0,1,0,0,1
27758,0,1,0,0,1
27759,0,1,0,0,1
27760,0,1,0,0,1
27761,0,1,0,0,1
27762,0,1,0,0,1
27763,1,0,0,0,1
27764,0,1,0,0,1
27765,0,1,0,0,1
27766,1,0,0,0,1
27767,0,1,0,0,1
27768,0,1,0,0,1
27769,1,0,0,0,1
27770,0,1,0,0,1
27771,0,1,0,0,1
27772,0,0,0,1,1
27773,1,0,0,0,1
27774,1,0,0,0,1
27775,0,1,0,0,1
27776,1,0,0,0,1
27777,0,1,0,0,1
27778,0,1,0,0,1
27779,0,1,0,0,1
27780,0,1,0,0,1
27781,1,0,0,0,1
27782,1,0,0,0,1
27783,0,1,0,0,1
27784,1,0,0,0,1
27785,0,0,0,1,1
27786,0,1,0,0,1
27787,1,0,0,0,1
27788,0,0,0,1,1
27789,0,1,0,0,1
27790,0,1,0,0,1
27791,0,1,0,0,1
27792,1,0,0,0,1
27793,0,1,0,0,1
27794,0,1,0,0,1
27795,1,0,0,0,1
27796,1,0,0,0,1
27797,0,1,0,0,1
27798,0,1,0,0,1
27799,0,1,0,0,1
27800,1,0,0,0,1
27801,0,1,0,0,1
27802,0,1,0,0,1
27803,0,1,0,0,1
27804,1,0,0,0,1
27805,0,1,0,0,1
27806,1,0,0,0,1
27807,0,1,0,0,1
27808,0,1,0,0,1
27809,0,0,0,1,1
27810,0,1,0,0,1
27811,0,1,0,0,1
27812,0,1,0,0,1
27813,0,1,0,0,1
27814,1,0,0,0,1
27815,0,1,0,0,1
27816,0,1,0,0,1
27817,0,1,0,0,1
27818,0,1,0,0,1
27819,0,1,0,0,1
27820,0,1,0,0,1
27821,1,0,0,0,1
27822,1,0,0,0,1
27823,0,0,1,0,1
27824,0,1,0,0,1
27825,0,1,0,0,1
27826,0,1,0,0,1
27827,0,1,0,0,1
27828,1,0,0,0,1
27829,0,1,0,0,1
27830,0,1,0,0,1
27831,0,1,0,0,1
27832,1,0,0,0,1
27833,0,1,0,0,1
27834,0,1,0,0,1
27835,1,0,0,0,1
27836,0,1,0,0,1
27837,1,0,0,0,1
27838,0,1,0,0,1
27839,0,1,0,0,1
27840,0,1,0,0,1
27841,0,1,0,0,1
27842,1,0,0,0,1
27843,0,1,0,0,1
27844,0,1,0,0,1
27845,0,1,0,0,1
27846,0,1,0,0,1
27847,1,0,0,0,1
27848,0,1,0,0,1
27849,0,1,0,0,1
27850,0,1,0,0,1
27851,0,1,0,0,1
27852,0,1,0,0,1
27853,0,1,0,0,1
27854,1,0,0,0,1
27855,0,1,0,0,1
27856,1,0,0,0,1
27857,1,0,0,0,1
27858,0,0,0,1,1
27859,0,1,0,0,1
27860,0,1,0,0,1
27861,0,1,0,0,1
27862,0,1,0,0,1
27863,0,1,0,0,1
27864,0,1,0,0,1
27865,0,1,0,0,1
27866,0,1,0,0,1
27867,0,1,0,0,1
27868,0,1,0,0,1
27869,0,0,0,1,1
27870,0,1,0,0,1
27871,0,1,0,0,1
27872,0,1,0,0,1
27873,0,1,0,0,1
27874,0,1,0,0,1
27875,1,0,0,0,1
27876,0,1,0,0,1
27877,0,1,0,0,1
27878,0,1,0,0,1
27879,0,1,0,0,1
27880,0,1,0,0,1
27881,0,1,0,0,1
27882,0,1,0,0,1
27883,0,1,0,0,1
27884,0,1,0,0,1
27885,0,1,0,0,1
27886,1,0,0,0,1
27887,0,1,0,0,1
27888,0,1,0,0,1
27889,0,1,0,0,1
27890,0,1,0,0,1
27891,1,0,0,0,1
27892,0,1,0,0,1
27893,0,0,1,0,1
27894,0,1,0,0,1
27895,0,0,1,0,1
27896,0,1,0,0,1
27897,1,0,0,0,1
27898,0,1,0,0,1
27899,0,1,0,0,1
27900,0,1,0,0,1
27901,0,1,0,0,1
27902,1,0,0,0,1
27903,1,0,0,0,1
27904,0,1,0,0,1
27905,0,1,0,0,1
27906,0,0,1,0,1
27907,0,1,0,0,1
27908,1,0,0,0,1
27909,0,0,0,1,1
27910,0,1,0,0,1
27911,0,0,0,1,1
27912,0,1,0,0,1
27913,1,0,0,0,1
27914,0,1,0,0,1
27915,1,0,0,0,1
27916,0,1,0,0,1
27917,0,1,0,0,1
27918,0,1,0,0,1
27919,0,1,0,0,1
27920,0,1,0,0,1
27921,0,1,0,0,1
27922,1,0,0,0,1
27923,1,0,0,0,1
27924,0,1,0,0,1
27925,0,1,0,0,1
27926,0,1,0,0,1
27927,0,1,0,0,1
27928,0,1,0,0,1
27929,0,1,0,0,1
27930,0,1,0,0,1
27931,0,1,0,0,1
27932,0,1,0,0,1
27933,1,0,0,0,1
27934,0,1,0,0,1
27935,0,1,0,0,1
27936,0,1,0,0,1
27937,0,1,0,0,1
27938,0,1,0,0,1
27939,0,1,0,0,1
27940,1,0,0,0,1
27941,1,0,0,0,1
27942,0,1,0,0,1
27943,0,1,0,0,1
27944,0,1,0,0,1
27945,0,1,0,0,1
27946,0,1,0,0,1
27947,0,1,0,0,1
27948,0,1,0,0,1
27949,1,0,0,0,1
27950,1,0,0,0,1
27951,0,1,0,0,1
27952,0,1,0,0,1
27953,1,0,0,0,1
27954,0,1,0,0,1
27955,0,1,0,0,1
27956,0,1,0,0,1
27957,0,1,0,0,1
27958,1,0,0,0,1
27959,0,1,0,0,1
27960,0,1,0,0,1
27961,1,0,0,0,1
27962,1,0,0,0,1
27963,0,1,0,0,1
27964,0,1,0,0,1
27965,0,1,0,0,1
27966,0,1,0,0,1
27967,0,1,0,0,1
27968,1,0,0,0,1
27969,0,1,0,0,1
27970,0,1,0,0,1
27971,0,1,0,0,1
27972,0,1,0,0,1
27973,1,0,0,0,1
27974,0,1,0,0,1
27975,0,1,0,0,1
27976,0,1,0,0,1
27977,0,1,0,0,1
27978,0,1,0,0,1
27979,0,0,0,1,1
27980,0,1,0,0,1
27981,0,1,0,0,1
27982,0,1,0,0,1
27983,0,1,0,0,1
27984,1,0,0,0,1
27985,0,1,0,0,1
27986,0,1,0,0,1
27987,1,0,0,0,1
27988,0,1,0,0,1
27989,0,1,0,0,1
27990,0,1,0,0,1
27991,0,1,0,0,1
27992,0,1,0,0,1
27993,0,1,0,0,1
27994,0,0,0,1,1
27995,0,1,0,0,1
27996,0,1,0,0,1
27997,0,1,0,0,1
27998,0,1,0,0,1
27999,0,1,0,0,1
28000,0,1,0,0,1
28001,0,0,1,0,1
28002,0,1,0,0,1
28003,0,1,0,0,1
28004,0,1,0,0,1
28005,0,1,0,0,1
28006,1,0,0,0,1
28007,0,1,0,0,1
28008,0,1,0,0,1
28009,0,1,0,0,1
28010,1,0,0,0,1
28011,0,1,0,0,1
28012,0,1,0,0,1
28013,1,0,0,0,1
28014,0,1,0,0,1
28015,0,1,0,0,1
28016,0,1,0,0,1
28017,0,1,0,0,1
28018,0,1,0,0,1
28019,1,0,0,0,1
28020,1,0,0,0,1
28021,0,1,0,0,1
28022,0,1,0,0,1
28023,0,1,0,0,1
28024,0,1,0,0,1
28025,0,1,0,0,1
28026,0,1,0,0,1
28027,0,0,0,1,1
28028,0,1,0,0,1
28029,1,0,0,0,1
28030,0,1,0,0,1
28031,0,1,0,0,1
28032,0,1,0,0,1
28033,1,0,0,0,1
28034,0,1,0,0,1
28035,0,1,0,0,1
28036,0,1,0,0,1
28037,0,1,0,0,1
28038,0,1,0,0,1
28039,0,1,0,0,1
28040,0,1,0,0,1
28041,0,1,0,0,1
28042,0,1,0,0,1
28043,0,1,0,0,1
28044,0,1,0,0,1
28045,0,1,0,0,1
28046,0,1,0,0,1
28047,0,1,0,0,1
28048,0,1,0,0,1
28049,0,1,0,0,1
28050,0,1,0,0,1
28051,0,1,0,0,1
28052,0,1,0,0,1
28053,0,1,0,0,1
28054,0,1,0,0,1
28055,1,0,0,0,1
28056,1,0,0,0,1
28057,0,1,0,0,1
28058,0,1,0,0,1
28059,0,1,0,0,1
28060,0,1,0,0,1
28061,0,1,0,0,1
28062,1,0,0,0,1
28063,0,1,0,0,1
28064,0,1,0,0,1
28065,0,1,0,0,1
28066,0,1,0,0,1
28067,0,1,0,0,1
28068,0,1,0,0,1
28069,0,1,0,0,1
28070,1,0,0,0,1
28071,0,1,0,0,1
28072,0,1,0,0,1
28073,0,1,0,0,1
28074,1,0,0,0,1
28075,0,1,0,0,1
28076,0,1,0,0,1
28077,0,1,0,0,1
28078,0,0,1,0,1
28079,0,1,0,0,1
28080,0,1,0,0,1
28081,0,1,0,0,1
28082,0,1,0,0,1
28083,0,1,0,0,1
28084,0,1,0,0,1
28085,1,0,0,0,1
28086,0,1,0,0,1
28087,0,1,0,0,1
28088,0,1,0,0,1
28089,0,1,0,0,1
28090,0,1,0,0,1
28091,1,0,0,0,1
28092,1,0,0,0,1
28093,0,1,0,0,1
28094,0,1,0,0,1
28095,0,1,0,0,1
28096,0,1,0,0,1
28097,0,0,1,0,1
28098,0,1,0,0,1
28099,1,0,0,0,1
28100,0,1,0,0,1
28101,0,1,0,0,1
28102,1,0,0,0,1
28103,0,1,0,0,1
28104,1,0,0,0,1
28105,0,1,0,0,1
28106,0,1,0,0,1
28107,0,1,0,0,1
28108,0,1,0,0,1
28109,0,1,0,0,1
28110,1,0,0,0,1
28111,0,1,0,0,1
28112,0,1,0,0,1
28113,0,1,0,0,1
28114,0,1,0,0,1
28115,0,1,0,0,1
28116,0,1,0,0,1
28117,0,1,0,0,1
28118,0,1,0,0,1
28119,0,0,0,1,1
28120,0,1,0,0,1
28121,0,1,0,0,1
28122,0,1,0,0,1
28123,1,0,0,0,1
28124,0,1,0,0,1
28125,0,1,0,0,1
28126,0,1,0,0,1
28127,0,1,0,0,1
28128,0,1,0,0,1
28129,0,1,0,0,1
28130,0,1,0,0,1
28131,1,0,0,0,1
28132,0,1,0,0,1
28133,1,0,0,0,1
28134,0,1,0,0,1
28135,0,1,0,0,1
28136,0,1,0,0,1
28137,1,0,0,0,1
28138,0,0,1,0,1
28139,0,1,0,0,1
28140,0,1,0,0,1
28141,0,1,0,0,1
28142,0,1,0,0,1
28143,0,1,0,0,1
28144,0,1,0,0,1
28145,0,1,0,0,1
28146,0,0,1,0,1
28147,0,0,0,1,1
28148,0,1,0,0,1
28149,0,1,0,0,1
28150,0,1,0,0,1
28151,0,1,0,0,1
28152,1,0,0,0,1
28153,0,1,0,0,1
28154,0,1,0,0,1
28155,0,1,0,0,1
28156,0,1,0,0,1
28157,0,1,0,0,1
28158,0,1,0,0,1
28159,0,1,0,0,1
28160,0,1,0,0,1
28161,0,1,0,0,1
28162,0,1,0,0,1
28163,0,1,0,0,1
28164,0,1,0,0,1
28165,1,0,0,0,1
28166,0,1,0,0,1
28167,0,1,0,0,1
28168,0,1,0,0,1
28169,0,1,0,0,1
28170,0,1,0,0,1
28171,0,1,0,0,1
28172,0,1,0,0,1
28173,1,0,0,0,1
28174,0,1,0,0,1
28175,1,0,0,0,1
28176,0,1,0,0,1
28177,0,1,0,0,1
28178,0,1,0,0,1
28179,0,1,0,0,1
28180,0,1,0,0,1
28181,0,1,0,0,1
28182,0,1,0,0,1
28183,1,0,0,0,1
28184,0,1,0,0,1
28185,1,0,0,0,1
28186,0,1,0,0,1
28187,1,0,0,0,1
28188,0,1,0,0,1
28189,0,1,0,0,1
28190,0,1,0,0,1
28191,0,1,0,0,1
28192,1,0,0,0,1
28193,1,0,0,0,1
28194,1,0,0,0,1
28195,0,1,0,0,1
28196,0,1,0,0,1
28197,0,1,0,0,1
28198,0,1,0,0,1
28199,0,1,0,0,1
28200,0,0,0,1,1
28201,0,1,0,0,1
28202,0,1,0,0,1
28203,0,1,0,0,1
28204,0,1,0,0,1
28205,0,1,0,0,1
28206,0,1,0,0,1
28207,0,1,0,0,1
28208,0,1,0,0,1
28209,0,1,0,0,1
28210,0,1,0,0,1
28211,0,1,0,0,1
28212,0,1,0,0,1
28213,0,1,0,0,1
28214,0,1,0,0,1
28215,0,1,0,0,1
28216,0,1,0,0,1
28217,0,1,0,0,1
28218,0,0,0,1,1
28219,0,1,0,0,1
28220,0,1,0,0,1
28221,0,1,0,0,1
28222,0,1,0,0,1
28223,0,1,0,0,1
28224,0,1,0,0,1
28225,0,1,0,0,1
28226,0,1,0,0,1
28227,0,1,0,0,1
28228,0,1,0,0,1
28229,0,0,0,1,1
28230,0,1,0,0,1
28231,0,1,0,0,1
28232,0,1,0,0,1
28233,0,0,1,0,1
28234,0,1,0,0,1
28235,0,1,0,0,1
28236,0,1,0,0,1
28237,1,0,0,0,1
28238,0,1,0,0,1
28239,1,0,0,0,1
28240,1,0,0,0,1
28241,0,1,0,0,1
28242,0,1,0,0,1
28243,0,1,0,0,1
28244,1,0,0,0,1
28245,1,0,0,0,1
28246,1,0,0,0,1
28247,0,1,0,0,1
28248,0,1,0,0,1
28249,0,1,0,0,1
28250,0,1,0,0,1
28251,0,1,0,0,1
28252,1,0,0,0,1
28253,0,1,0,0,1
28254,0,1,0,0,1
28255,0,1,0,0,1
28256,0,1,0,0,1
28257,0,1,0,0,1
28258,0,1,0,0,1
28259,0,1,0,0,1
28260,1,0,0,0,1
28261,1,0,0,0,1
28262,1,0,0,0,1
28263,0,1,0,0,1
28264,0,0,0,1,1
28265,0,1,0,0,1
28266,0,1,0,0,1
28267,0,1,0,0,1
28268,0,1,0,0,1
28269,0,1,0,0,1
28270,0,1,0,0,1
28271,0,1,0,0,1
28272,0,1,0,0,1
28273,0,1,0,0,1
28274,0,1,0,0,1
28275,1,0,0,0,1
28276,0,1,0,0,1
28277,0,1,0,0,1
28278,0,1,0,0,1
28279,0,0,0,1,1
28280,0,1,0,0,1
28281,0,1,0,0,1
28282,0,1,0,0,1
28283,0,1,0,0,1
28284,0,1,0,0,1
28285,0,1,0,0,1
28286,0,1,0,0,1
28287,0,1,0,0,1
28288,0,1,0,0,1
28289,0,1,0,0,1
28290,0,1,0,0,1
28291,0,0,0,1,1
28292,0,1,0,0,1
28293,0,1,0,0,1
28294,0,0,1,0,1
28295,0,1,0,0,1
28296,0,1,0,0,1
28297,1,0,0,0,1
28298,0,1,0,0,1
28299,0,1,0,0,1
28300,0,1,0,0,1
28301,0,1,0,0,1
28302,1,0,0,0,1
28303,0,1,0,0,1
28304,0,1,0,0,1
28305,0,1,0,0,1
28306,0,1,0,0,1
28307,1,0,0,0,1
28308,0,1,0,0,1
28309,0,1,0,0,1
28310,1,0,0,0,1
28311,0,1,0,0,1
28312,0,1,0,0,1
28313,0,1,0,0,1
28314,0,1,0,0,1
28315,0,1,0,0,1
28316,0,1,0,0,1
28317,0,1,0,0,1
28318,0,1,0,0,1
28319,0,1,0,0,1
28320,0,0,0,1,1
28321,0,1,0,0,1
28322,0,1,0,0,1
28323,1,0,0,0,1
28324,0,1,0,0,1
28325,0,1,0,0,1
28326,0,1,0,0,1
28327,0,1,0,0,1
28328,0,1,0,0,1
28329,0,1,0,0,1
28330,0,1,0,0,1
28331,0,1,0,0,1
28332,0,1,0,0,1
28333,0,1,0,0,1
28334,0,1,0,0,1
28335,0,1,0,0,1
28336,1,0,0,0,1
28337,0,1,0,0,1
28338,1,0,0,0,1
28339,0,1,0,0,1
28340,0,1,0,0,1
28341,0,1,0,0,1
28342,1,0,0,0,1
28343,0,1,0,0,1
28344,0,0,0,1,1
28345,0,1,0,0,1
28346,0,0,1,0,1
28347,0,1,0,0,1
28348,0,1,0,0,1
28349,0,1,0,0,1
28350,0,1,0,0,1
28351,0,1,0,0,1
28352,1,0,0,0,1
28353,0,1,0,0,1
28354,0,1,0,0,1
28355,0,1,0,0,1
28356,0,1,0,0,1
28357,1,0,0,0,1
28358,0,0,1,0,1
28359,0,0,0,1,1
28360,0,1,0,0,1
28361,0,1,0,0,1
28362,1,0,0,0,1
28363,0,1,0,0,1
28364,0,1,0,0,1
28365,0,1,0,0,1
28366,1,0,0,0,1
28367,1,0,0,0,1
28368,0,1,0,0,1
28369,1,0,0,0,1
28370,0,0,1,0,1
28371,0,1,0,0,1
28372,0,1,0,0,1
28373,0,1,0,0,1
28374,0,0,0,1,1
28375,1,0,0,0,1
28376,0,1,0,0,1
28377,0,1,0,0,1
28378,1,0,0,0,1
28379,0,1,0,0,1
28380,1,0,0,0,1
28381,1,0,0,0,1
28382,0,1,0,0,1
28383,0,1,0,0,1
28384,0,1,0,0,1
28385,0,1,0,0,1
28386,0,1,0,0,1
28387,0,1,0,0,1
28388,0,1,0,0,1
28389,0,1,0,0,1
28390,0,1,0,0,1
28391,0,1,0,0,1
28392,0,1,0,0,1
28393,0,1,0,0,1
28394,0,1,0,0,1
28395,0,0,0,1,1
28396,1,0,0,0,1
28397,0,1,0,0,1
28398,0,1,0,0,1
28399,0,1,0,0,1
28400,1,0,0,0,1
28401,0,0,0,1,1
28402,0,1,0,0,1
28403,0,1,0,0,1
28404,0,1,0,0,1
28405,0,1,0,0,1
28406,0,1,0,0,1
28407,0,1,0,0,1
28408,0,0,1,0,1
28409,0,0,0,1,1
28410,0,1,0,0,1
28411,0,1,0,0,1
28412,0,1,0,0,1
28413,0,1,0,0,1
28414,0,1,0,0,1
28415,0,1,0,0,1
28416,0,1,0,0,1
28417,0,1,0,0,1
28418,0,1,0,0,1
28419,0,1,0,0,1
28420,0,1,0,0,1
28421,1,0,0,0,1
28422,0,1,0,0,1
28423,0,1,0,0,1
28424,1,0,0,0,1
28425,0,1,0,0,1
28426,0,1,0,0,1
28427,0,1,0,0,1
28428,0,1,0,0,1
28429,0,1,0,0,1
28430,0,1,0,0,1
28431,0,1,0,0,1
28432,0,1,0,0,1
28433,0,1,0,0,1
28434,0,1,0,0,1
28435,0,1,0,0,1
28436,0,1,0,0,1
28437,0,1,0,0,1
28438,0,0,0,1,1
28439,1,0,0,0,1
28440,0,1,0,0,1
28441,0,1,0,0,1
28442,0,1,0,0,1
28443,0,1,0,0,1
28444,1,0,0,0,1
28445,0,1,0,0,1
28446,0,1,0,0,1
28447,0,0,0,1,1
28448,0,1,0,0,1
28449,0,1,0,0,1
28450,1,0,0,0,1
28451,0,1,0,0,1
28452,1,0,0,0,1
28453,0,1,0,0,1
28454,0,1,0,0,1
28455,0,0,1,0,1
28456,0,1,0,0,1
28457,1,0,0,0,1
28458,0,0,0,1,1
28459,0,1,0,0,1
28460,1,0,0,0,1
28461,0,1,0,0,1
28462,0,1,0,0,1
28463,1,0,0,0,1
28464,1,0,0,0,1
28465,1,0,0,0,1
28466,0,1,0,0,1
28467,0,1,0,0,1
28468,0,1,0,0,1
28469,0,1,0,0,1
28470,0,1,0,0,1
28471,0,0,0,1,1
28472,1,0,0,0,1
28473,0,0,0,1,1
28474,0,1,0,0,1
28475,0,1,0,0,1
28476,0,1,0,0,1
28477,0,1,0,0,1
28478,0,1,0,0,1
28479,0,1,0,0,1
28480,0,1,0,0,1
28481,1,0,0,0,1
28482,0,1,0,0,1
28483,1,0,0,0,1
28484,1,0,0,0,1
28485,0,0,0,1,1
28486,0,1,0,0,1
28487,0,1,0,0,1
28488,0,1,0,0,1
28489,0,1,0,0,1
28490,1,0,0,0,1
28491,0,1,0,0,1
28492,0,1,0,0,1
28493,1,0,0,0,1
28494,0,1,0,0,1
28495,0,1,0,0,1
28496,0,1,0,0,1
28497,1,0,0,0,1
28498,0,1,0,0,1
28499,0,1,0,0,1
28500,0,1,0,0,1
28501,0,1,0,0,1
28502,1,0,0,0,1
28503,0,1,0,0,1
28504,0,1,0,0,1
28505,0,1,0,0,1
28506,0,1,0,0,1
28507,0,1,0,0,1
28508,0,1,0,0,1
28509,0,1,0,0,1
28510,0,1,0,0,1
28511,0,1,0,0,1
28512,0,1,0,0,1
28513,1,0,0,0,1
28514,0,1,0,0,1
28515,0,1,0,0,1
28516,0,1,0,0,1
28517,0,1,0,0,1
28518,0,0,0,1,1
28519,0,1,0,0,1
28520,1,0,0,0,1
28521,1,0,0,0,1
28522,0,0,0,1,1
28523,0,1,0,0,1
28524,1,0,0,0,1
28525,0,1,0,0,1
28526,0,1,0,0,1
28527,1,0,0,0,1
28528,1,0,0,0,1
28529,0,1,0,0,1
28530,0,1,0,0,1
28531,1,0,0,0,1
28532,0,1,0,0,1
28533,0,1,0,0,1
28534,1,0,0,0,1
28535,0,1,0,0,1
28536,0,1,0,0,1
28537,0,0,0,1,1
28538,0,1,0,0,1
28539,0,1,0,0,1
28540,0,1,0,0,1
28541,0,1,0,0,1
28542,0,1,0,0,1
28543,0,1,0,0,1
28544,0,1,0,0,1
28545,1,0,0,0,1
28546,0,1,0,0,1
28547,0,1,0,0,1
28548,1,0,0,0,1
28549,0,1,0,0,1
28550,0,1,0,0,1
28551,0,0,1,0,1
28552,0,1,0,0,1
28553,0,1,0,0,1
28554,0,1,0,0,1
28555,0,1,0,0,1
28556,0,1,0,0,1
28557,1,0,0,0,1
28558,0,1,0,0,1
28559,0,1,0,0,1
28560,0,1,0,0,1
28561,0,1,0,0,1
28562,0,1,0,0,1
28563,1,0,0,0,1
28564,0,1,0,0,1
28565,0,1,0,0,1
28566,0,1,0,0,1
28567,0,1,0,0,1
28568,0,1,0,0,1
28569,1,0,0,0,1
28570,0,1,0,0,1
28571,0,1,0,0,1
28572,0,1,0,0,1
28573,0,0,0,1,1
28574,0,1,0,0,1
28575,0,0,0,1,1
28576,0,1,0,0,1
28577,0,1,0,0,1
28578,0,1,0,0,1
28579,0,1,0,0,1
28580,0,1,0,0,1
28581,0,1,0,0,1
28582,0,1,0,0,1
28583,0,1,0,0,1
28584,0,1,0,0,1
28585,0,1,0,0,1
28586,1,0,0,0,1
28587,0,1,0,0,1
28588,0,1,0,0,1
28589,1,0,0,0,1
28590,0,1,0,0,1
28591,0,1,0,0,1
28592,0,1,0,0,1
28593,0,1,0,0,1
28594,0,1,0,0,1
28595,0,1,0,0,1
28596,0,1,0,0,1
28597,0,1,0,0,1
28598,0,1,0,0,1
28599,0,1,0,0,1
28600,0,1,0,0,1
28601,0,1,0,0,1
28602,0,1,0,0,1
28603,1,0,0,0,1
28604,0,0,1,0,1
28605,1,0,0,0,1
28606,0,1,0,0,1
28607,0,1,0,0,1
28608,0,1,0,0,1
28609,0,1,0,0,1
28610,1,0,0,0,1
28611,1,0,0,0,1
28612,0,0,1,0,1
28613,0,1,0,0,1
28614,1,0,0,0,1
28615,0,0,0,1,1
28616,0,1,0,0,1
28617,0,1,0,0,1
28618,0,1,0,0,1
28619,0,1,0,0,1
28620,0,1,0,0,1
28621,1,0,0,0,1
28622,1,0,0,0,1
28623,0,1,0,0,1
28624,0,1,0,0,1
28625,0,1,0,0,1
28626,0,1,0,0,1
28627,0,1,0,0,1
28628,0,1,0,0,1
28629,1,0,0,0,1
28630,0,1,0,0,1
28631,0,1,0,0,1
28632,0,0,0,1,1
28633,0,1,0,0,1
28634,1,0,0,0,1
28635,0,1,0,0,1
28636,0,1,0,0,1
28637,0,1,0,0,1
28638,1,0,0,0,1
28639,0,1,0,0,1
28640,0,0,0,1,1
28641,0,1,0,0,1
28642,0,1,0,0,1
28643,0,0,1,0,1
28644,0,1,0,0,1
28645,0,1,0,0,1
28646,0,1,0,0,1
28647,1,0,0,0,1
28648,0,1,0,0,1
28649,0,1,0,0,1
28650,0,1,0,0,1
28651,0,1,0,0,1
28652,0,1,0,0,1
28653,0,0,0,1,1
28654,0,0,0,1,1
28655,0,1,0,0,1
28656,0,1,0,0,1
28657,1,0,0,0,1
28658,0,1,0,0,1
28659,0,1,0,0,1
28660,0,1,0,0,1
28661,0,1,0,0,1
28662,0,1,0,0,1
28663,0,1,0,0,1
28664,0,1,0,0,1
28665,0,1,0,0,1
28666,0,1,0,0,1
28667,0,0,1,0,1
28668,0,1,0,0,1
28669,0,1,0,0,1
28670,0,1,0,0,1
28671,0,1,0,0,1
28672,1,0,0,0,1
28673,0,1,0,0,1
28674,0,1,0,0,1
28675,0,1,0,0,1
28676,0,1,0,0,1
28677,1,0,0,0,1
28678,0,1,0,0,1
28679,0,1,0,0,1
28680,0,1,0,0,1
28681,0,1,0,0,1
28682,0,1,0,0,1
28683,0,1,0,0,1
28684,0,1,0,0,1
28685,0,1,0,0,1
28686,0,1,0,0,1
28687,0,1,0,0,1
28688,0,1,0,0,1
28689,1,0,0,0,1
28690,0,1,0,0,1
28691,0,1,0,0,1
28692,0,1,0,0,1
28693,0,1,0,0,1
28694,1,0,0,0,1
28695,0,1,0,0,1
28696,0,1,0,0,1
28697,0,1,0,0,1
28698,0,1,0,0,1
28699,0,1,0,0,1
28700,0,1,0,0,1
28701,0,1,0,0,1
28702,0,1,0,0,1
28703,1,0,0,0,1
28704,0,1,0,0,1
28705,0,0,0,1,1
28706,0,1,0,0,1
28707,0,1,0,0,1
28708,0,1,0,0,1
28709,0,0,0,1,1
28710,0,1,0,0,1
28711,0,0,0,1,1
28712,0,1,0,0,1
28713,0,0,0,1,1
28714,1,0,0,0,1
28715,1,0,0,0,1
28716,0,1,0,0,1
28717,0,1,0,0,1
28718,0,0,0,1,1
28719,1,0,0,0,1
28720,0,1,0,0,1
28721,1,0,0,0,1
28722,0,1,0,0,1
28723,0,1,0,0,1
28724,0,1,0,0,1
28725,0,1,0,0,1
28726,0,1,0,0,1
28727,0,0,0,1,1
28728,1,0,0,0,1
28729,0,1,0,0,1
28730,0,0,0,1,1
28731,0,1,0,0,1
28732,0,1,0,0,1
28733,0,1,0,0,1
28734,0,0,0,1,1
28735,0,1,0,0,1
28736,0,1,0,0,1
28737,0,1,0,0,1
28738,0,1,0,0,1
28739,0,0,1,0,1
28740,0,1,0,0,1
28741,0,1,0,0,1
28742,0,1,0,0,1
28743,0,0,0,1,1
28744,0,1,0,0,1
28745,0,1,0,0,1
28746,0,1,0,0,1
28747,0,1,0,0,1
28748,1,0,0,0,1
28749,0,1,0,0,1
28750,0,1,0,0,1
28751,0,0,1,0,1
28752,0,1,0,0,1
28753,0,1,0,0,1
28754,0,1,0,0,1
28755,0,1,0,0,1
28756,0,1,0,0,1
28757,0,0,1,0,1
28758,0,1,0,0,1
28759,0,1,0,0,1
28760,0,1,0,0,1
28761,1,0,0,0,1
28762,0,1,0,0,1
28763,0,1,0,0,1
28764,1,0,0,0,1
28765,0,1,0,0,1
28766,0,1,0,0,1
28767,0,1,0,0,1
28768,0,1,0,0,1
28769,0,1,0,0,1
28770,0,1,0,0,1
28771,1,0,0,0,1
28772,1,0,0,0,1
28773,0,1,0,0,1
28774,0,1,0,0,1
28775,0,1,0,0,1
28776,0,1,0,0,1
28777,0,1,0,0,1
28778,1,0,0,0,1
28779,0,1,0,0,1
28780,1,0,0,0,1
28781,1,0,0,0,1
28782,0,1,0,0,1
28783,0,1,0,0,1
28784,1,0,0,0,1
28785,0,1,0,0,1
28786,1,0,0,0,1
28787,0,0,0,1,1
28788,0,1,0,0,1
28789,0,0,0,1,1
28790,0,1,0,0,1
28791,0,1,0,0,1
28792,0,1,0,0,1
28793,0,1,0,0,1
28794,0,1,0,0,1
28795,0,1,0,0,1
28796,0,1,0,0,1
28797,0,1,0,0,1
28798,0,1,0,0,1
28799,1,0,0,0,1
28800,0,1,0,0,1
28801,0,1,0,0,1
28802,0,1,0,0,1
28803,0,1,0,0,1
28804,1,0,0,0,1
28805,0,1,0,0,1
28806,0,1,0,0,1
28807,0,1,0,0,1
28808,0,1,0,0,1
28809,0,1,0,0,1
28810,0,1,0,0,1
28811,1,0,0,0,1
28812,0,1,0,0,1
28813,1,0,0,0,1
28814,0,1,0,0,1
28815,0,1,0,0,1
28816,0,1,0,0,1
28817,0,1,0,0,1
28818,0,1,0,0,1
28819,1,0,0,0,1
28820,0,1,0,0,1
28821,1,0,0,0,1
28822,0,1,0,0,1
28823,0,1,0,0,1
28824,0,1,0,0,1
28825,0,1,0,0,1
28826,0,1,0,0,1
28827,0,1,0,0,1
28828,0,1,0,0,1
28829,0,1,0,0,1
28830,0,1,0,0,1
28831,1,0,0,0,1
28832,0,1,0,0,1
28833,1,0,0,0,1
28834,0,1,0,0,1
28835,0,1,0,0,1
28836,0,1,0,0,1
28837,0,1,0,0,1
28838,0,1,0,0,1
28839,0,1,0,0,1
28840,0,1,0,0,1
28841,0,1,0,0,1
28842,1,0,0,0,1
28843,0,0,0,1,1
28844,0,0,0,1,1
28845,1,0,0,0,1
28846,1,0,0,0,1
28847,0,1,0,0,1
28848,1,0,0,0,1
28849,0,1,0,0,1
28850,0,1,0,0,1
28851,0,1,0,0,1
28852,0,1,0,0,1
28853,0,1,0,0,1
28854,1,0,0,0,1
28855,1,0,0,0,1
28856,0,1,0,0,1
28857,1,0,0,0,1
28858,0,1,0,0,1
28859,0,1,0,0,1
28860,0,1,0,0,1
28861,1,0,0,0,1
28862,0,1,0,0,1
28863,1,0,0,0,1
28864,0,1,0,0,1
28865,0,1,0,0,1
28866,0,1,0,0,1
28867,0,0,0,1,1
28868,0,1,0,0,1
28869,0,0,0,1,1
28870,0,1,0,0,1
28871,1,0,0,0,1
28872,0,1,0,0,1
28873,0,1,0,0,1
28874,0,1,0,0,1
28875,0,1,0,0,1
28876,0,1,0,0,1
28877,0,1,0,0,1
28878,0,0,0,1,1
28879,1,0,0,0,1
28880,0,1,0,0,1
28881,1,0,0,0,1
28882,0,1,0,0,1
28883,0,1,0,0,1
28884,0,1,0,0,1
28885,0,1,0,0,1
28886,1,0,0,0,1
28887,0,1,0,0,1
28888,0,1,0,0,1
28889,0,1,0,0,1
28890,1,0,0,0,1
28891,1,0,0,0,1
28892,0,1,0,0,1
28893,0,1,0,0,1
28894,0,1,0,0,1
28895,0,1,0,0,1
28896,0,1,0,0,1
28897,0,1,0,0,1
28898,0,1,0,0,1
28899,0,1,0,0,1
28900,1,0,0,0,1
28901,1,0,0,0,1
28902,0,1,0,0,1
28903,0,1,0,0,1
28904,1,0,0,0,1
28905,0,1,0,0,1
28906,0,1,0,0,1
28907,0,1,0,0,1
28908,0,1,0,0,1
28909,0,1,0,0,1
28910,0,1,0,0,1
28911,1,0,0,0,1
28912,0,1,0,0,1
28913,0,1,0,0,1
28914,1,0,0,0,1
28915,0,0,1,0,1
28916,0,1,0,0,1
28917,1,0,0,0,1
28918,0,0,1,0,1
28919,0,1,0,0,1
28920,0,1,0,0,1
28921,0,1,0,0,1
28922,0,1,0,0,1
28923,0,1,0,0,1
28924,1,0,0,0,1
28925,0,0,1,0,1
28926,0,0,0,1,1
28927,0,0,1,0,1
28928,0,1,0,0,1
28929,0,1,0,0,1
28930,0,0,0,1,1
28931,0,1,0,0,1
28932,1,0,0,0,1
28933,1,0,0,0,1
28934,0,1,0,0,1
28935,0,1,0,0,1
28936,0,1,0,0,1
28937,0,1,0,0,1
28938,0,1,0,0,1
28939,0,1,0,0,1
28940,1,0,0,0,1
28941,0,1,0,0,1
28942,1,0,0,0,1
28943,1,0,0,0,1
28944,0,1,0,0,1
28945,0,1,0,0,1
28946,0,1,0,0,1
28947,1,0,0,0,1
28948,0,1,0,0,1
28949,0,0,0,1,1
28950,0,1,0,0,1
28951,1,0,0,0,1
28952,0,1,0,0,1
28953,0,1,0,0,1
28954,1,0,0,0,1
28955,0,1,0,0,1
28956,0,0,1,0,1
28957,1,0,0,0,1
28958,0,1,0,0,1
28959,1,0,0,0,1
28960,0,0,1,0,1
28961,1,0,0,0,1
28962,0,1,0,0,1
28963,0,1,0,0,1
28964,0,1,0,0,1
28965,0,1,0,0,1
28966,0,1,0,0,1
28967,0,1,0,0,1
28968,0,1,0,0,1
28969,0,1,0,0,1
28970,0,1,0,0,1
28971,0,1,0,0,1
28972,0,1,0,0,1
28973,0,1,0,0,1
28974,0,1,0,0,1
28975,0,1,0,0,1
28976,0,1,0,0,1
28977,0,1,0,0,1
28978,0,1,0,0,1
28979,0,1,0,0,1
28980,1,0,0,0,1
28981,0,1,0,0,1
28982,1,0,0,0,1
28983,0,1,0,0,1
28984,0,1,0,0,1
28985,0,1,0,0,1
28986,1,0,0,0,1
28987,1,0,0,0,1
28988,0,1,0,0,1
28989,0,1,0,0,1
28990,0,1,0,0,1
28991,0,1,0,0,1
28992,0,1,0,0,1
28993,0,1,0,0,1
28994,1,0,0,0,1
28995,0,1,0,0,1
28996,0,1,0,0,1
28997,1,0,0,0,1
28998,0,1,0,0,1
28999,0,1,0,0,1
29000,0,1,0,0,1
29001,1,0,0,0,1
29002,1,0,0,0,1
29003,0,1,0,0,1
29004,0,1,0,0,1
29005,0,1,0,0,1
29006,0,1,0,0,1
29007,1,0,0,0,1
29008,0,0,1,0,1
29009,0,1,0,0,1
29010,0,1,0,0,1
29011,0,1,0,0,1
29012,0,1,0,0,1
29013,1,0,0,0,1
29014,0,1,0,0,1
29015,0,1,0,0,1
29016,0,1,0,0,1
29017,0,1,0,0,1
29018,0,1,0,0,1
29019,0,1,0,0,1
29020,0,1,0,0,1
29021,0,1,0,0,1
29022,1,0,0,0,1
29023,1,0,0,0,1
29024,1,0,0,0,1
29025,0,1,0,0,1
29026,0,1,0,0,1
29027,0,1,0,0,1
29028,0,1,0,0,1
29029,0,1,0,0,1
29030,0,0,1,0,1
29031,0,1,0,0,1
29032,0,1,0,0,1
29033,0,1,0,0,1
29034,0,1,0,0,1
29035,0,1,0,0,1
29036,0,1,0,0,1
29037,0,1,0,0,1
29038,0,1,0,0,1
29039,0,0,0,1,1
29040,0,1,0,0,1
29041,0,1,0,0,1
29042,1,0,0,0,1
29043,0,1,0,0,1
29044,1,0,0,0,1
29045,0,1,0,0,1
29046,0,1,0,0,1
29047,1,0,0,0,1
29048,0,1,0,0,1
29049,0,1,0,0,1
29050,0,1,0,0,1
29051,1,0,0,0,1
29052,0,1,0,0,1
29053,0,1,0,0,1
29054,1,0,0,0,1
29055,0,1,0,0,1
29056,0,1,0,0,1
29057,0,1,0,0,1
29058,1,0,0,0,1
29059,0,1,0,0,1
29060,0,1,0,0,1
29061,0,1,0,0,1
29062,0,1,0,0,1
29063,0,1,0,0,1
29064,0,1,0,0,1
29065,1,0,0,0,1
29066,0,1,0,0,1
29067,0,1,0,0,1
29068,1,0,0,0,1
29069,0,1,0,0,1
29070,0,1,0,0,1
29071,0,1,0,0,1
29072,0,1,0,0,1
29073,0,1,0,0,1
29074,0,1,0,0,1
29075,0,1,0,0,1
29076,0,1,0,0,1
29077,0,1,0,0,1
29078,0,1,0,0,1
29079,0,1,0,0,1
29080,0,1,0,0,1
29081,0,0,0,1,1
29082,0,1,0,0,1
29083,0,1,0,0,1
29084,1,0,0,0,1
29085,1,0,0,0,1
29086,0,1,0,0,1
29087,0,0,1,0,1
29088,1,0,0,0,1
29089,0,1,0,0,1
29090,0,1,0,0,1
29091,0,1,0,0,1
29092,1,0,0,0,1
29093,1,0,0,0,1
29094,0,1,0,0,1
29095,0,1,0,0,1
29096,0,1,0,0,1
29097,0,1,0,0,1
29098,0,1,0,0,1
29099,0,1,0,0,1
29100,0,1,0,0,1
29101,1,0,0,0,1
29102,0,1,0,0,1
29103,0,1,0,0,1
29104,0,1,0,0,1
29105,0,1,0,0,1
29106,0,1,0,0,1
29107,0,1,0,0,1
29108,0,1,0,0,1
29109,0,1,0,0,1
29110,0,1,0,0,1
29111,0,1,0,0,1
29112,0,1,0,0,1
29113,0,1,0,0,1
29114,0,1,0,0,1
29115,0,1,0,0,1
29116,0,1,0,0,1
29117,1,0,0,0,1
29118,0,1,0,0,1
29119,0,1,0,0,1
29120,0,1,0,0,1
29121,1,0,0,0,1
29122,0,1,0,0,1
29123,0,1,0,0,1
29124,0,1,0,0,1
29125,0,1,0,0,1
29126,0,1,0,0,1
29127,0,1,0,0,1
29128,0,1,0,0,1
29129,0,1,0,0,1
29130,0,1,0,0,1
29131,0,1,0,0,1
29132,0,1,0,0,1
29133,0,1,0,0,1
29134,0,1,0,0,1
29135,1,0,0,0,1
29136,0,1,0,0,1
29137,0,1,0,0,1
29138,0,1,0,0,1
29139,0,1,0,0,1
29140,1,0,0,0,1
29141,0,1,0,0,1
29142,0,1,0,0,1
29143,0,1,0,0,1
29144,1,0,0,0,1
29145,0,1,0,0,1
29146,1,0,0,0,1
29147,1,0,0,0,1
29148,0,0,1,0,1
29149,0,1,0,0,1
29150,0,1,0,0,1
29151,0,1,0,0,1
29152,1,0,0,0,1
29153,0,1,0,0,1
29154,0,1,0,0,1
29155,0,1,0,0,1
29156,0,1,0,0,1
29157,0,1,0,0,1
29158,1,0,0,0,1
29159,0,1,0,0,1
29160,0,1,0,0,1
29161,0,1,0,0,1
29162,0,1,0,0,1
29163,0,1,0,0,1
29164,0,1,0,0,1
29165,0,1,0,0,1
29166,0,1,0,0,1
29167,0,1,0,0,1
29168,1,0,0,0,1
29169,0,1,0,0,1
29170,1,0,0,0,1
29171,1,0,0,0,1
29172,0,1,0,0,1
29173,1,0,0,0,1
29174,0,1,0,0,1
29175,0,1,0,0,1
29176,1,0,0,0,1
29177,0,0,0,1,1
29178,0,1,0,0,1
29179,0,1,0,0,1
29180,1,0,0,0,1
29181,1,0,0,0,1
29182,0,1,0,0,1
29183,0,1,0,0,1
29184,0,1,0,0,1
29185,0,1,0,0,1
29186,0,1,0,0,1
29187,0,1,0,0,1
29188,0,0,1,0,1
29189,1,0,0,0,1
29190,0,1,0,0,1
29191,0,1,0,0,1
29192,0,1,0,0,1
29193,1,0,0,0,1
29194,0,1,0,0,1
29195,0,1,0,0,1
29196,1,0,0,0,1
29197,0,1,0,0,1
29198,0,1,0,0,1
29199,0,1,0,0,1
29200,0,1,0,0,1
29201,0,1,0,0,1
29202,1,0,0,0,1
29203,1,0,0,0,1
29204,0,1,0,0,1
29205,0,1,0,0,1
29206,1,0,0,0,1
29207,0,1,0,0,1
29208,0,1,0,0,1
29209,0,1,0,0,1
29210,0,1,0,0,1
29211,0,1,0,0,1
29212,1,0,0,0,1
29213,0,1,0,0,1
29214,1,0,0,0,1
29215,0,1,0,0,1
29216,0,1,0,0,1
29217,1,0,0,0,1
29218,0,1,0,0,1
29219,0,1,0,0,1
29220,0,1,0,0,1
29221,0,1,0,0,1
29222,0,1,0,0,1
29223,0,1,0,0,1
29224,0,1,0,0,1
29225,0,1,0,0,1
29226,0,1,0,0,1
29227,0,1,0,0,1
29228,1,0,0,0,1
29229,0,1,0,0,1
29230,0,1,0,0,1
29231,0,1,0,0,1
29232,0,1,0,0,1
29233,0,1,0,0,1
29234,0,1,0,0,1
29235,0,1,0,0,1
29236,1,0,0,0,1
29237,0,1,0,0,1
29238,0,1,0,0,1
29239,1,0,0,0,1
29240,0,1,0,0,1
29241,0,0,0,1,1
29242,0,1,0,0,1
29243,0,1,0,0,1
29244,0,1,0,0,1
29245,0,1,0,0,1
29246,1,0,0,0,1
29247,0,1,0,0,1
29248,0,1,0,0,1
29249,0,1,0,0,1
29250,0,1,0,0,1
29251,1,0,0,0,1
29252,0,1,0,0,1
29253,0,0,0,1,1
29254,0,1,0,0,1
29255,0,1,0,0,1
29256,0,1,0,0,1
29257,1,0,0,0,1
29258,0,1,0,0,1
29259,0,1,0,0,1
29260,0,1,0,0,1
29261,0,1,0,0,1
29262,1,0,0,0,1
29263,0,1,0,0,1
29264,0,1,0,0,1
29265,0,1,0,0,1
29266,0,1,0,0,1
29267,0,1,0,0,1
29268,0,1,0,0,1
29269,0,1,0,0,1
29270,0,1,0,0,1
29271,0,1,0,0,1
29272,0,1,0,0,1
29273,0,1,0,0,1
29274,0,1,0,0,1
29275,0,1,0,0,1
29276,0,1,0,0,1
29277,1,0,0,0,1
29278,0,1,0,0,1
29279,0,1,0,0,1
29280,0,1,0,0,1
29281,0,1,0,0,1
29282,1,0,0,0,1
29283,1,0,0,0,1
29284,0,1,0,0,1
29285,0,1,0,0,1
29286,0,1,0,0,1
29287,1,0,0,0,1
29288,0,0,1,0,1
29289,0,1,0,0,1
29290,1,0,0,0,1
29291,1,0,0,0,1
29292,0,1,0,0,1
29293,0,1,0,0,1
29294,0,0,0,1,1
29295,0,1,0,0,1
29296,0,1,0,0,1
29297,0,1,0,0,1
29298,0,1,0,0,1
29299,0,1,0,0,1
29300,0,1,0,0,1
29301,0,1,0,0,1
29302,0,1,0,0,1
29303,1,0,0,0,1
29304,0,1,0,0,1
29305,0,1,0,0,1
29306,1,0,0,0,1
29307,1,0,0,0,1
29308,0,0,0,1,1
29309,0,0,0,1,1
29310,0,1,0,0,1
29311,0,1,0,0,1
29312,0,1,0,0,1
29313,1,0,0,0,1
29314,1,0,0,0,1
29315,1,0,0,0,1
29316,0,0,1,0,1
29317,0,1,0,0,1
29318,0,1,0,0,1
29319,0,0,0,1,1
29320,0,1,0,0,1
29321,0,1,0,0,1
29322,0,1,0,0,1
29323,0,1,0,0,1
29324,1,0,0,0,1
29325,0,1,0,0,1
29326,0,1,0,0,1
29327,0,1,0,0,1
29328,0,0,0,1,1
29329,0,1,0,0,1
29330,0,1,0,0,1
29331,0,0,1,0,1
29332,1,0,0,0,1
29333,0,1,0,0,1
29334,0,1,0,0,1
29335,0,1,0,0,1
29336,0,1,0,0,1
29337,0,1,0,0,1
29338,0,1,0,0,1
29339,0,1,0,0,1
29340,1,0,0,0,1
29341,0,1,0,0,1
29342,0,1,0,0,1
29343,0,1,0,0,1
29344,0,1,0,0,1
29345,0,1,0,0,1
29346,0,1,0,0,1
29347,0,1,0,0,1
29348,0,1,0,0,1
29349,0,1,0,0,1
29350,0,1,0,0,1
29351,1,0,0,0,1
29352,0,1,0,0,1
29353,0,1,0,0,1
29354,0,1,0,0,1
29355,0,1,0,0,1
29356,0,1,0,0,1
29357,1,0,0,0,1
29358,0,1,0,0,1
29359,0,1,0,0,1
29360,1,0,0,0,1
29361,0,1,0,0,1
29362,0,1,0,0,1
29363,0,1,0,0,1
29364,0,1,0,0,1
29365,0,1,0,0,1
29366,0,1,0,0,1
29367,0,1,0,0,1
29368,0,1,0,0,1
29369,0,1,0,0,1
29370,1,0,0,0,1
29371,0,1,0,0,1
29372,1,0,0,0,1
29373,0,1,0,0,1
29374,0,1,0,0,1
29375,0,1,0,0,1
29376,0,1,0,0,1
29377,0,1,0,0,1
29378,0,1,0,0,1
29379,0,1,0,0,1
29380,0,0,1,0,1
29381,0,0,0,1,1
29382,0,1,0,0,1
29383,0,1,0,0,1
29384,1,0,0,0,1
29385,0,1,0,0,1
29386,0,1,0,0,1
29387,0,0,0,1,1
29388,0,1,0,0,1
29389,0,1,0,0,1
29390,0,0,0,1,1
29391,0,1,0,0,1
29392,0,1,0,0,1
29393,0,1,0,0,1
29394,1,0,0,0,1
29395,0,1,0,0,1
29396,0,1,0,0,1
29397,0,1,0,0,1
29398,0,1,0,0,1
29399,1,0,0,0,1
29400,0,1,0,0,1
29401,0,1,0,0,1
29402,0,1,0,0,1
29403,0,1,0,0,1
29404,0,1,0,0,1
29405,0,1,0,0,1
29406,0,1,0,0,1
29407,1,0,0,0,1
29408,0,0,0,1,1
29409,0,1,0,0,1
29410,1,0,0,0,1
29411,0,1,0,0,1
29412,1,0,0,0,1
29413,0,1,0,0,1
29414,0,1,0,0,1
29415,0,1,0,0,1
29416,0,0,0,1,1
29417,1,0,0,0,1
29418,0,1,0,0,1
29419,0,1,0,0,1
29420,0,1,0,0,1
29421,0,1,0,0,1
29422,0,1,0,0,1
29423,1,0,0,0,1
29424,0,1,0,0,1
29425,0,1,0,0,1
29426,0,1,0,0,1
29427,0,1,0,0,1
29428,0,1,0,0,1
29429,0,1,0,0,1
29430,0,1,0,0,1
29431,0,0,0,1,1
29432,0,1,0,0,1
29433,0,1,0,0,1
29434,0,1,0,0,1
29435,0,1,0,0,1
29436,0,1,0,0,1
29437,0,1,0,0,1
29438,0,1,0,0,1
29439,0,1,0,0,1
29440,0,1,0,0,1
29441,0,1,0,0,1
29442,0,1,0,0,1
29443,1,0,0,0,1
29444,0,1,0,0,1
29445,0,1,0,0,1
29446,1,0,0,0,1
29447,0,1,0,0,1
29448,0,1,0,0,1
29449,0,1,0,0,1
29450,0,1,0,0,1
29451,0,1,0,0,1
29452,0,1,0,0,1
29453,0,1,0,0,1
29454,1,0,0,0,1
29455,0,1,0,0,1
29456,0,1,0,0,1
29457,1,0,0,0,1
29458,0,1,0,0,1
29459,0,1,0,0,1
29460,0,1,0,0,1
29461,0,1,0,0,1
29462,0,1,0,0,1
29463,0,1,0,0,1
29464,0,1,0,0,1
29465,0,1,0,0,1
29466,0,0,1,0,1
29467,0,1,0,0,1
29468,0,1,0,0,1
29469,0,1,0,0,1
29470,0,1,0,0,1
29471,0,0,0,1,1
29472,0,1,0,0,1
29473,1,0,0,0,1
29474,0,1,0,0,1
29475,0,1,0,0,1
29476,1,0,0,0,1
29477,1,0,0,0,1
29478,0,1,0,0,1
29479,0,1,0,0,1
29480,0,1,0,0,1
29481,0,1,0,0,1
29482,0,1,0,0,1
29483,0,1,0,0,1
29484,0,1,0,0,1
29485,0,1,0,0,1
29486,0,1,0,0,1
29487,0,1,0,0,1
29488,1,0,0,0,1
29489,0,1,0,0,1
29490,0,1,0,0,1
29491,0,1,0,0,1
29492,1,0,0,0,1
29493,0,1,0,0,1
29494,0,1,0,0,1
29495,0,1,0,0,1
29496,1,0,0,0,1
29497,0,1,0,0,1
29498,0,1,0,0,1
29499,0,1,0,0,1
29500,0,1,0,0,1
29501,0,0,1,0,1
29502,0,1,0,0,1
29503,0,1,0,0,1
29504,0,1,0,0,1
29505,0,0,0,1,1
29506,0,1,0,0,1
29507,1,0,0,0,1
29508,1,0,0,0,1
29509,0,0,0,1,1
29510,0,1,0,0,1
29511,0,1,0,0,1
29512,0,1,0,0,1
29513,1,0,0,0,1
29514,0,1,0,0,1
29515,0,1,0,0,1
29516,0,1,0,0,1
29517,0,1,0,0,1
29518,0,1,0,0,1
29519,0,1,0,0,1
29520,0,1,0,0,1
29521,0,1,0,0,1
29522,0,1,0,0,1
29523,0,1,0,0,1
29524,0,1,0,0,1
29525,1,0,0,0,1
29526,1,0,0,0,1
29527,0,1,0,0,1
29528,1,0,0,0,1
29529,0,1,0,0,1
29530,0,1,0,0,1
29531,0,1,0,0,1
29532,1,0,0,0,1
29533,0,1,0,0,1
29534,0,1,0,0,1
29535,1,0,0,0,1
29536,0,1,0,0,1
29537,0,1,0,0,1
29538,0,1,0,0,1
29539,0,1,0,0,1
29540,0,1,0,0,1
29541,0,1,0,0,1
29542,0,1,0,0,1
29543,0,0,0,1,1
29544,0,1,0,0,1
29545,0,0,0,1,1
29546,0,1,0,0,1
29547,0,1,0,0,1
29548,0,1,0,0,1
29549,1,0,0,0,1
29550,0,1,0,0,1
29551,0,0,0,1,1
29552,0,1,0,0,1
29553,0,1,0,0,1
29554,0,1,0,0,1
29555,1,0,0,0,1
29556,0,1,0,0,1
29557,1,0,0,0,1
29558,0,1,0,0,1
29559,0,1,0,0,1
29560,1,0,0,0,1
29561,1,0,0,0,1
29562,0,1,0,0,1
29563,0,1,0,0,1
29564,0,1,0,0,1
29565,0,1,0,0,1
29566,1,0,0,0,1
29567,0,1,0,0,1
29568,0,1,0,0,1
29569,0,1,0,0,1
29570,0,1,0,0,1
29571,0,1,0,0,1
29572,0,1,0,0,1
29573,0,0,0,1,1
29574,0,1,0,0,1
29575,0,1,0,0,1
29576,0,1,0,0,1
29577,1,0,0,0,1
29578,1,0,0,0,1
29579,0,1,0,0,1
29580,0,1,0,0,1
29581,1,0,0,0,1
29582,0,0,0,1,1
29583,0,1,0,0,1
29584,0,1,0,0,1
29585,0,1,0,0,1
29586,0,1,0,0,1
29587,0,1,0,0,1
29588,0,1,0,0,1
29589,1,0,0,0,1
29590,0,0,0,1,1
29591,0,1,0,0,1
29592,0,0,1,0,1
29593,0,1,0,0,1
29594,0,1,0,0,1
29595,1,0,0,0,1
29596,0,1,0,0,1
29597,0,0,0,1,1
29598,1,0,0,0,1
29599,0,0,1,0,1
29600,0,1,0,0,1
29601,0,1,0,0,1
29602,0,1,0,0,1
29603,0,1,0,0,1
29604,0,0,1,0,1
29605,0,1,0,0,1
29606,0,1,0,0,1
29607,1,0,0,0,1
29608,0,0,1,0,1
29609,1,0,0,0,1
29610,0,0,0,1,1
29611,0,1,0,0,1
29612,0,1,0,0,1
29613,0,1,0,0,1
29614,0,1,0,0,1
29615,1,0,0,0,1
29616,0,1,0,0,1
29617,1,0,0,0,1
29618,0,1,0,0,1
29619,0,1,0,0,1
29620,0,0,0,1,1
29621,0,1,0,0,1
29622,0,1,0,0,1
29623,0,1,0,0,1
29624,0,1,0,0,1
29625,1,0,0,0,1
29626,0,1,0,0,1
29627,0,1,0,0,1
29628,0,1,0,0,1
29629,1,0,0,0,1
29630,0,1,0,0,1
29631,1,0,0,0,1
29632,0,1,0,0,1
29633,1,0,0,0,1
29634,0,1,0,0,1
29635,0,1,0,0,1
29636,0,0,0,1,1
29637,0,1,0,0,1
29638,1,0,0,0,1
29639,0,1,0,0,1
29640,0,0,1,0,1
29641,0,1,0,0,1
29642,0,1,0,0,1
29643,1,0,0,0,1
29644,0,1,0,0,1
29645,0,1,0,0,1
29646,0,1,0,0,1
29647,0,1,0,0,1
29648,0,1,0,0,1
29649,0,0,1,0,1
29650,0,1,0,0,1
29651,0,1,0,0,1
29652,1,0,0,0,1
29653,0,1,0,0,1
29654,0,1,0,0,1
29655,1,0,0,0,1
29656,0,1,0,0,1
29657,0,1,0,0,1
29658,0,1,0,0,1
29659,0,1,0,0,1
29660,0,1,0,0,1
29661,0,1,0,0,1
29662,0,1,0,0,1
29663,0,1,0,0,1
29664,0,1,0,0,1
29665,0,1,0,0,1
29666,0,1,0,0,1
29667,0,1,0,0,1
29668,0,1,0,0,1
29669,0,1,0,0,1
29670,0,1,0,0,1
29671,0,1,0,0,1
29672,1,0,0,0,1
29673,0,0,0,1,1
29674,1,0,0,0,1
29675,0,1,0,0,1
29676,0,1,0,0,1
29677,0,0,1,0,1
29678,1,0,0,0,1
29679,0,1,0,0,1
29680,0,1,0,0,1
29681,0,1,0,0,1
29682,1,0,0,0,1
29683,0,1,0,0,1
29684,0,1,0,0,1
29685,0,1,0,0,1
29686,0,1,0,0,1
29687,0,1,0,0,1
29688,0,1,0,0,1
29689,1,0,0,0,1
29690,0,1,0,0,1
29691,0,1,0,0,1
29692,0,1,0,0,1
29693,1,0,0,0,1
29694,1,0,0,0,1
29695,0,1,0,0,1
29696,0,1,0,0,1
29697,0,1,0,0,1
29698,0,1,0,0,1
29699,0,0,0,1,1
29700,0,1,0,0,1
29701,0,1,0,0,1
29702,1,0,0,0,1
29703,1,0,0,0,1
29704,1,0,0,0,1
29705,0,1,0,0,1
29706,0,1,0,0,1
29707,0,1,0,0,1
29708,0,1,0,0,1
29709,0,1,0,0,1
29710,1,0,0,0,1
29711,0,1,0,0,1
29712,0,1,0,0,1
29713,0,1,0,0,1
29714,0,1,0,0,1
29715,0,1,0,0,1
29716,1,0,0,0,1
29717,0,1,0,0,1
29718,0,1,0,0,1
29719,0,0,0,1,1
29720,0,1,0,0,1
29721,0,1,0,0,1
29722,1,0,0,0,1
29723,1,0,0,0,1
29724,0,0,1,0,1
29725,0,1,0,0,1
29726,0,1,0,0,1
29727,0,1,0,0,1
29728,0,1,0,0,1
29729,0,1,0,0,1
29730,0,0,0,1,1
29731,0,1,0,0,1
29732,0,1,0,0,1
29733,0,1,0,0,1
29734,0,1,0,0,1
29735,0,1,0,0,1
29736,0,1,0,0,1
29737,0,1,0,0,1
29738,1,0,0,0,1
29739,0,1,0,0,1
29740,0,1,0,0,1
29741,0,1,0,0,1
29742,0,1,0,0,1
29743,0,1,0,0,1
29744,0,1,0,0,1
29745,0,1,0,0,1
29746,1,0,0,0,1
29747,0,1,0,0,1
29748,0,1,0,0,1
29749,1,0,0,0,1
29750,0,1,0,0,1
29751,1,0,0,0,1
29752,0,1,0,0,1
29753,1,0,0,0,1
29754,0,1,0,0,1
29755,0,1,0,0,1
29756,1,0,0,0,1
29757,0,0,0,1,1
29758,0,1,0,0,1
29759,0,1,0,0,1
29760,0,1,0,0,1
29761,0,0,1,0,1
29762,0,1,0,0,1
29763,1,0,0,0,1
29764,1,0,0,0,1
29765,0,1,0,0,1
29766,1,0,0,0,1
29767,0,1,0,0,1
29768,0,0,0,1,1
29769,0,1,0,0,1
29770,0,1,0,0,1
29771,0,0,0,1,1
29772,0,1,0,0,1
29773,1,0,0,0,1
29774,1,0,0,0,1
29775,1,0,0,0,1
29776,0,1,0,0,1
29777,0,1,0,0,1
29778,0,1,0,0,1
29779,0,1,0,0,1
29780,1,0,0,0,1
29781,0,1,0,0,1
29782,0,0,0,1,1
29783,0,1,0,0,1
29784,0,1,0,0,1
29785,0,1,0,0,1
29786,0,1,0,0,1
29787,1,0,0,0,1
29788,0,1,0,0,1
29789,0,1,0,0,1
29790,1,0,0,0,1
29791,0,1,0,0,1
29792,0,1,0,0,1
29793,0,1,0,0,1
29794,1,0,0,0,1
29795,0,1,0,0,1
29796,0,1,0,0,1
29797,1,0,0,0,1
29798,0,1,0,0,1
29799,0,0,0,1,1
29800,0,1,0,0,1
29801,1,0,0,0,1
29802,0,1,0,0,1
29803,0,1,0,0,1
29804,0,1,0,0,1
29805,0,1,0,0,1
29806,0,1,0,0,1
29807,1,0,0,0,1
29808,1,0,0,0,1
29809,1,0,0,0,1
29810,0,1,0,0,1
29811,0,1,0,0,1
29812,0,1,0,0,1
29813,1,0,0,0,1
29814,0,1,0,0,1
29815,0,1,0,0,1
29816,0,0,0,1,1
29817,0,1,0,0,1
29818,0,1,0,0,1
29819,0,1,0,0,1
29820,0,1,0,0,1
29821,1,0,0,0,1
29822,0,0,0,1,1
29823,0,1,0,0,1
29824,0,0,1,0,1
29825,0,1,0,0,1
29826,0,1,0,0,1
29827,0,1,0,0,1
29828,0,1,0,0,1
29829,0,1,0,0,1
29830,1,0,0,0,1
29831,0,1,0,0,1
29832,0,1,0,0,1
29833,0,1,0,0,1
29834,0,1,0,0,1
29835,0,1,0,0,1
29836,0,1,0,0,1
29837,1,0,0,0,1
29838,1,0,0,0,1
29839,0,1,0,0,1
29840,0,1,0,0,1
29841,0,1,0,0,1
29842,0,1,0,0,1
29843,0,1,0,0,1
29844,0,1,0,0,1
29845,0,1,0,0,1
29846,0,0,0,1,1
29847,1,0,0,0,1
29848,0,1,0,0,1
29849,0,1,0,0,1
29850,0,1,0,0,1
29851,1,0,0,0,1
29852,0,1,0,0,1
29853,0,1,0,0,1
29854,0,1,0,0,1
29855,0,1,0,0,1
29856,0,1,0,0,1
29857,1,0,0,0,1
29858,0,1,0,0,1
29859,0,1,0,0,1
29860,1,0,0,0,1
29861,0,1,0,0,1
29862,0,1,0,0,1
29863,0,1,0,0,1
29864,1,0,0,0,1
29865,1,0,0,0,1
29866,0,1,0,0,1
29867,1,0,0,0,1
29868,0,1,0,0,1
29869,0,1,0,0,1
29870,0,1,0,0,1
29871,0,1,0,0,1
29872,1,0,0,0,1
29873,0,1,0,0,1
29874,0,1,0,0,1
29875,1,0,0,0,1
29876,0,1,0,0,1
29877,0,1,0,0,1
29878,0,1,0,0,1
29879,0,1,0,0,1
29880,1,0,0,0,1
29881,0,1,0,0,1
29882,0,1,0,0,1
29883,0,1,0,0,1
29884,1,0,0,0,1
29885,1,0,0,0,1
29886,0,1,0,0,1
29887,0,1,0,0,1
29888,0,1,0,0,1
29889,0,1,0,0,1
29890,0,1,0,0,1
29891,0,1,0,0,1
29892,0,1,0,0,1
29893,0,0,1,0,1
29894,1,0,0,0,1
29895,0,1,0,0,1
29896,0,1,0,0,1
29897,0,1,0,0,1
29898,0,1,0,0,1
29899,0,0,1,0,1
29900,0,0,0,1,1
29901,0,1,0,0,1
29902,0,1,0,0,1
29903,0,1,0,0,1
29904,0,1,0,0,1
29905,0,1,0,0,1
29906,0,1,0,0,1
29907,0,1,0,0,1
29908,0,1,0,0,1
29909,0,0,0,1,1
29910,0,1,0,0,1
29911,1,0,0,0,1
29912,0,1,0,0,1
29913,1,0,0,0,1
29914,1,0,0,0,1
29915,0,1,0,0,1
29916,0,1,0,0,1
29917,0,1,0,0,1
29918,1,0,0,0,1
29919,0,1,0,0,1
29920,0,1,0,0,1
29921,0,1,0,0,1
29922,0,1,0,0,1
29923,1,0,0,0,1
29924,0,1,0,0,1
29925,0,0,0,1,1
29926,0,1,0,0,1
29927,0,1,0,0,1
29928,0,1,0,0,1
29929,0,1,0,0,1
29930,0,1,0,0,1
29931,0,1,0,0,1
29932,0,0,1,0,1
29933,0,1,0,0,1
29934,1,0,0,0,1
29935,0,1,0,0,1
29936,0,1,0,0,1
29937,0,0,0,1,1
29938,0,1,0,0,1
29939,0,1,0,0,1
29940,0,1,0,0,1
29941,0,1,0,0,1
29942,0,1,0,0,1
29943,0,1,0,0,1
29944,1,0,0,0,1
29945,0,0,1,0,1
29946,0,1,0,0,1
29947,0,1,0,0,1
29948,0,1,0,0,1
29949,0,1,0,0,1
29950,0,1,0,0,1
29951,0,1,0,0,1
29952,0,0,0,1,1
29953,0,1,0,0,1
29954,0,0,0,1,1
29955,0,1,0,0,1
29956,0,1,0,0,1
29957,0,1,0,0,1
29958,1,0,0,0,1
29959,0,1,0,0,1
29960,0,1,0,0,1
29961,0,1,0,0,1
29962,0,1,0,0,1
29963,1,0,0,0,1
29964,1,0,0,0,1
29965,0,1,0,0,1
29966,1,0,0,0,1
29967,0,0,1,0,1
29968,0,1,0,0,1
29969,0,1,0,0,1
29970,0,1,0,0,1
29971,0,1,0,0,1
29972,0,0,0,1,1
29973,0,1,0,0,1
29974,0,1,0,0,1
29975,0,1,0,0,1
29976,0,1,0,0,1
29977,0,1,0,0,1
29978,0,1,0,0,1
29979,1,0,0,0,1
29980,0,1,0,0,1
29981,0,1,0,0,1
29982,1,0,0,0,1
29983,1,0,0,0,1
29984,1,0,0,0,1
29985,0,1,0,0,1
29986,0,1,0,0,1
29987,0,1,0,0,1
29988,0,1,0,0,1
29989,1,0,0,0,1
29990,0,1,0,0,1
29991,0,1,0,0,1
29992,0,1,0,0,1
29993,0,1,0,0,1
29994,0,1,0,0,1
29995,0,1,0,0,1
29996,0,1,0,0,1
29997,0,1,0,0,1
29998,0,1,0,0,1
29999,0,1,0,0,1
30000,0,1,0,0,1
30001,0,1,0,0,1
30002,0,1,0,0,1
30003,0,1,0,0,1
30004,0,1,0,0,1
30005,0,1,0,0,1
30006,0,1,0,0,1
30007,0,1,0,0,1
30008,1,0,0,0,1
30009,0,1,0,0,1
30010,0,1,0,0,1
30011,1,0,0,0,1
30012,1,0,0,0,1
30013,0,1,0,0,1
30014,0,1,0,0,1
30015,0,1,0,0,1
30016,0,1,0,0,1
30017,0,1,0,0,1
30018,0,1,0,0,1
30019,0,1,0,0,1
30020,0,1,0,0,1
30021,0,1,0,0,1
30022,0,0,0,1,1
30023,0,1,0,0,1
30024,0,1,0,0,1
30025,0,1,0,0,1
30026,0,0,0,1,1
30027,1,0,0,0,1
30028,0,0,0,1,1
30029,1,0,0,0,1
30030,0,1,0,0,1
30031,0,1,0,0,1
30032,0,1,0,0,1
30033,0,1,0,0,1
30034,0,1,0,0,1
30035,0,1,0,0,1
30036,0,1,0,0,1
30037,0,1,0,0,1
30038,0,1,0,0,1
30039,1,0,0,0,1
30040,0,1,0,0,1
30041,0,1,0,0,1
30042,1,0,0,0,1
30043,0,1,0,0,1
30044,0,1,0,0,1
30045,0,1,0,0,1
30046,0,1,0,0,1
30047,0,1,0,0,1
30048,0,1,0,0,1
30049,0,1,0,0,1
30050,0,1,0,0,1
30051,0,1,0,0,1
30052,0,1,0,0,1
30053,0,1,0,0,1
30054,0,1,0,0,1
30055,0,1,0,0,1
30056,0,1,0,0,1
30057,0,1,0,0,1
30058,0,1,0,0,1
30059,0,1,0,0,1
30060,1,0,0,0,1
30061,0,1,0,0,1
30062,0,1,0,0,1
30063,0,1,0,0,1
30064,0,0,1,0,1
30065,1,0,0,0,1
30066,0,1,0,0,1
30067,0,1,0,0,1
30068,0,1,0,0,1
30069,0,1,0,0,1
30070,1,0,0,0,1
30071,0,1,0,0,1
30072,0,1,0,0,1
30073,0,1,0,0,1
30074,0,0,0,1,1
30075,0,1,0,0,1
30076,0,1,0,0,1
30077,0,1,0,0,1
30078,1,0,0,0,1
30079,0,1,0,0,1
30080,0,1,0,0,1
30081,0,1,0,0,1
30082,0,1,0,0,1
30083,0,0,1,0,1
30084,0,1,0,0,1
30085,0,1,0,0,1
30086,0,1,0,0,1
30087,1,0,0,0,1
30088,0,1,0,0,1
30089,0,1,0,0,1
30090,0,1,0,0,1
30091,1,0,0,0,1
30092,0,1,0,0,1
30093,0,1,0,0,1
30094,0,1,0,0,1
30095,0,1,0,0,1
30096,0,1,0,0,1
30097,0,1,0,0,1
30098,0,0,0,1,1
30099,0,1,0,0,1
30100,0,1,0,0,1
30101,0,1,0,0,1
30102,0,1,0,0,1
30103,0,1,0,0,1
30104,0,0,0,1,1
30105,0,1,0,0,1
30106,0,1,0,0,1
30107,0,1,0,0,1
30108,0,1,0,0,1
30109,0,1,0,0,1
30110,0,1,0,0,1
30111,1,0,0,0,1
30112,1,0,0,0,1
30113,0,1,0,0,1
30114,0,1,0,0,1
30115,0,1,0,0,1
30116,0,1,0,0,1
30117,1,0,0,0,1
30118,0,0,1,0,1
30119,0,1,0,0,1
30120,0,1,0,0,1
30121,0,0,0,1,1
30122,0,1,0,0,1
30123,0,1,0,0,1
30124,0,1,0,0,1
30125,0,1,0,0,1
30126,0,1,0,0,1
30127,0,1,0,0,1
30128,1,0,0,0,1
30129,0,1,0,0,1
30130,0,1,0,0,1
30131,0,1,0,0,1
30132,0,1,0,0,1
30133,0,1,0,0,1
30134,0,0,0,1,1
30135,0,1,0,0,1
30136,0,1,0,0,1
30137,0,1,0,0,1
30138,0,1,0,0,1
30139,0,1,0,0,1
30140,0,1,0,0,1
30141,0,1,0,0,1
30142,0,1,0,0,1
30143,0,1,0,0,1
30144,0,1,0,0,1
30145,0,1,0,0,1
30146,0,1,0,0,1
30147,1,0,0,0,1
30148,0,0,1,0,1
30149,0,1,0,0,1
30150,0,1,0,0,1
30151,0,1,0,0,1
30152,0,1,0,0,1
30153,0,1,0,0,1
30154,0,1,0,0,1
30155,1,0,0,0,1
30156,0,1,0,0,1
30157,0,1,0,0,1
30158,0,1,0,0,1
30159,0,1,0,0,1
30160,0,1,0,0,1
30161,1,0,0,0,1
30162,0,1,0,0,1
30163,0,1,0,0,1
30164,0,1,0,0,1
30165,0,1,0,0,1
30166,1,0,0,0,1
30167,0,1,0,0,1
30168,0,1,0,0,1
30169,0,1,0,0,1
30170,0,1,0,0,1
30171,1,0,0,0,1
30172,0,1,0,0,1
30173,0,1,0,0,1
30174,0,1,0,0,1
30175,0,1,0,0,1
30176,0,1,0,0,1
30177,1,0,0,0,1
30178,0,0,0,1,1
30179,1,0,0,0,1
30180,0,1,0,0,1
30181,0,1,0,0,1
30182,1,0,0,0,1
30183,0,1,0,0,1
30184,0,1,0,0,1
30185,1,0,0,0,1
30186,0,1,0,0,1
30187,0,1,0,0,1
30188,0,1,0,0,1
30189,0,1,0,0,1
30190,0,1,0,0,1
30191,1,0,0,0,1
30192,0,1,0,0,1
30193,0,1,0,0,1
30194,1,0,0,0,1
30195,0,1,0,0,1
30196,0,1,0,0,1
30197,0,1,0,0,1
30198,0,1,0,0,1
30199,0,1,0,0,1
30200,0,1,0,0,1
30201,0,1,0,0,1
30202,1,0,0,0,1
30203,0,1,0,0,1
30204,1,0,0,0,1
30205,0,1,0,0,1
30206,0,1,0,0,1
30207,0,0,0,1,1
30208,0,1,0,0,1
30209,0,1,0,0,1
30210,0,1,0,0,1
30211,1,0,0,0,1
30212,0,1,0,0,1
30213,0,1,0,0,1
30214,0,1,0,0,1
30215,0,1,0,0,1
30216,1,0,0,0,1
30217,1,0,0,0,1
30218,0,1,0,0,1
30219,1,0,0,0,1
30220,0,1,0,0,1
30221,0,1,0,0,1
30222,0,1,0,0,1
30223,0,1,0,0,1
30224,0,1,0,0,1
30225,1,0,0,0,1
30226,0,1,0,0,1
30227,1,0,0,0,1
30228,0,1,0,0,1
30229,0,1,0,0,1
30230,0,1,0,0,1
30231,0,1,0,0,1
30232,0,1,0,0,1
30233,0,0,0,1,1
30234,0,1,0,0,1
30235,1,0,0,0,1
30236,0,0,0,1,1
30237,0,1,0,0,1
30238,0,0,0,1,1
30239,0,1,0,0,1
30240,0,1,0,0,1
30241,0,1,0,0,1
30242,0,1,0,0,1
30243,0,1,0,0,1
30244,0,1,0,0,1
30245,0,0,1,0,1
30246,0,1,0,0,1
30247,1,0,0,0,1
30248,0,1,0,0,1
30249,0,1,0,0,1
30250,0,1,0,0,1
30251,0,1,0,0,1
30252,0,1,0,0,1
30253,0,1,0,0,1
30254,0,1,0,0,1
30255,0,1,0,0,1
30256,0,1,0,0,1
30257,0,1,0,0,1
30258,0,1,0,0,1
30259,0,1,0,0,1
30260,0,1,0,0,1
30261,0,1,0,0,1
30262,0,1,0,0,1
30263,0,1,0,0,1
30264,1,0,0,0,1
30265,1,0,0,0,1
30266,0,1,0,0,1
30267,0,1,0,0,1
30268,1,0,0,0,1
30269,1,0,0,0,1
30270,0,1,0,0,1
30271,0,1,0,0,1
30272,0,1,0,0,1
30273,0,1,0,0,1
30274,0,1,0,0,1
30275,0,1,0,0,1
30276,1,0,0,0,1
30277,0,1,0,0,1
30278,0,1,0,0,1
30279,0,1,0,0,1
30280,0,0,0,1,1
30281,0,1,0,0,1
30282,0,1,0,0,1
30283,0,1,0,0,1
30284,0,1,0,0,1
30285,0,1,0,0,1
30286,1,0,0,0,1
30287,0,1,0,0,1
30288,0,1,0,0,1
30289,0,1,0,0,1
30290,0,1,0,0,1
30291,0,1,0,0,1
30292,0,1,0,0,1
30293,0,1,0,0,1
30294,0,1,0,0,1
30295,0,0,1,0,1
30296,0,1,0,0,1
30297,0,1,0,0,1
30298,0,1,0,0,1
30299,0,1,0,0,1
30300,1,0,0,0,1
30301,0,1,0,0,1
30302,1,0,0,0,1
30303,0,1,0,0,1
30304,0,1,0,0,1
30305,0,0,0,1,1
30306,0,1,0,0,1
30307,1,0,0,0,1
30308,0,1,0,0,1
30309,0,1,0,0,1
30310,0,1,0,0,1
30311,0,0,0,1,1
30312,0,1,0,0,1
30313,0,1,0,0,1
30314,0,1,0,0,1
30315,0,1,0,0,1
30316,0,1,0,0,1
30317,0,1,0,0,1
30318,0,0,0,1,1
30319,0,0,1,0,1
30320,0,1,0,0,1
30321,0,1,0,0,1
30322,0,1,0,0,1
30323,0,0,1,0,1
30324,0,1,0,0,1
30325,0,1,0,0,1
30326,0,0,0,1,1
30327,0,1,0,0,1
30328,1,0,0,0,1
30329,0,1,0,0,1
30330,0,0,0,1,1
30331,0,0,0,1,1
30332,0,1,0,0,1
30333,0,1,0,0,1
30334,1,0,0,0,1
30335,0,1,0,0,1
30336,0,1,0,0,1
30337,0,1,0,0,1
30338,0,1,0,0,1
30339,0,1,0,0,1
30340,1,0,0,0,1
30341,0,0,0,1,1
30342,0,1,0,0,1
30343,0,1,0,0,1
30344,0,1,0,0,1
30345,0,1,0,0,1
30346,0,1,0,0,1
30347,0,0,0,1,1
30348,0,1,0,0,1
30349,1,0,0,0,1
30350,0,1,0,0,1
30351,1,0,0,0,1
30352,0,1,0,0,1
30353,0,1,0,0,1
30354,0,1,0,0,1
30355,0,1,0,0,1
30356,0,0,0,1,1
30357,1,0,0,0,1
30358,0,1,0,0,1
30359,0,1,0,0,1
30360,0,1,0,0,1
30361,0,1,0,0,1
30362,0,0,1,0,1
30363,0,0,0,1,1
30364,1,0,0,0,1
30365,0,0,0,1,1
30366,0,1,0,0,1
30367,1,0,0,0,1
30368,0,1,0,0,1
30369,0,0,0,1,1
30370,0,1,0,0,1
30371,0,1,0,0,1
30372,0,1,0,0,1
30373,1,0,0,0,1
30374,0,1,0,0,1
30375,0,1,0,0,1
30376,0,1,0,0,1
30377,0,1,0,0,1
30378,1,0,0,0,1
30379,0,1,0,0,1
30380,0,0,0,1,1
30381,0,1,0,0,1
30382,0,1,0,0,1
30383,0,1,0,0,1
30384,1,0,0,0,1
30385,0,1,0,0,1
30386,0,0,0,1,1
30387,0,1,0,0,1
30388,0,1,0,0,1
30389,0,1,0,0,1
30390,0,1,0,0,1
30391,0,1,0,0,1
30392,0,0,0,1,1
30393,0,1,0,0,1
30394,0,1,0,0,1
30395,0,1,0,0,1
30396,0,1,0,0,1
30397,0,0,0,1,1
30398,0,1,0,0,1
30399,0,1,0,0,1
30400,0,1,0,0,1
30401,0,0,0,1,1
30402,0,1,0,0,1
30403,1,0,0,0,1
30404,0,0,1,0,1
30405,0,1,0,0,1
30406,0,1,0,0,1
30407,0,0,1,0,1
30408,0,1,0,0,1
30409,0,1,0,0,1
30410,0,1,0,0,1
30411,0,0,0,1,1
30412,0,1,0,0,1
30413,0,1,0,0,1
30414,0,1,0,0,1
30415,0,1,0,0,1
30416,0,1,0,0,1
30417,0,1,0,0,1
30418,0,0,0,1,1
30419,0,1,0,0,1
30420,1,0,0,0,1
30421,0,1,0,0,1
30422,0,1,0,0,1
30423,0,1,0,0,1
30424,0,1,0,0,1
30425,0,1,0,0,1
30426,1,0,0,0,1
30427,0,1,0,0,1
30428,0,1,0,0,1
30429,0,1,0,0,1
30430,0,1,0,0,1
30431,1,0,0,0,1
30432,0,1,0,0,1
30433,1,0,0,0,1
30434,0,1,0,0,1
30435,0,1,0,0,1
30436,0,1,0,0,1
30437,0,1,0,0,1
30438,0,1,0,0,1
30439,0,1,0,0,1
30440,0,1,0,0,1
30441,0,1,0,0,1
30442,0,0,0,1,1
30443,0,1,0,0,1
30444,0,1,0,0,1
30445,0,1,0,0,1
30446,0,1,0,0,1
30447,0,0,0,1,1
30448,0,1,0,0,1
30449,0,1,0,0,1
30450,0,1,0,0,1
30451,0,0,0,1,1
30452,0,0,0,1,1
30453,0,1,0,0,1
30454,0,1,0,0,1
30455,0,1,0,0,1
30456,0,0,0,1,1
30457,0,1,0,0,1
30458,0,1,0,0,1
30459,1,0,0,0,1
30460,0,1,0,0,1
30461,0,1,0,0,1
30462,0,1,0,0,1
30463,0,1,0,0,1
30464,0,1,0,0,1
30465,0,1,0,0,1
30466,0,0,0,1,1
30467,0,1,0,0,1
30468,0,1,0,0,1
30469,0,1,0,0,1
30470,0,1,0,0,1
30471,0,1,0,0,1
30472,0,1,0,0,1
30473,0,0,0,1,1
30474,1,0,0,0,1
30475,0,1,0,0,1
30476,0,1,0,0,1
30477,0,1,0,0,1
30478,0,1,0,0,1
30479,0,1,0,0,1
30480,1,0,0,0,1
30481,0,1,0,0,1
30482,0,1,0,0,1
30483,0,1,0,0,1
30484,0,1,0,0,1
30485,0,1,0,0,1
30486,0,1,0,0,1
30487,1,0,0,0,1
30488,0,0,1,0,1
30489,0,1,0,0,1
30490,0,1,0,0,1
30491,0,1,0,0,1
30492,0,1,0,0,1
30493,0,1,0,0,1
30494,0,1,0,0,1
30495,0,1,0,0,1
30496,1,0,0,0,1
30497,0,1,0,0,1
30498,0,1,0,0,1
30499,0,0,1,0,1
30500,0,1,0,0,1
30501,0,1,0,0,1
30502,1,0,0,0,1
30503,0,1,0,0,1
30504,0,1,0,0,1
30505,0,1,0,0,1
30506,0,1,0,0,1
30507,0,1,0,0,1
30508,0,1,0,0,1
30509,1,0,0,0,1
30510,1,0,0,0,1
30511,0,1,0,0,1
30512,0,1,0,0,1
30513,0,1,0,0,1
30514,0,1,0,0,1
30515,0,1,0,0,1
30516,1,0,0,0,1
30517,0,1,0,0,1
30518,0,1,0,0,1
30519,0,1,0,0,1
30520,0,1,0,0,1
30521,0,0,1,0,1
30522,1,0,0,0,1
30523,0,1,0,0,1
30524,0,1,0,0,1
30525,1,0,0,0,1
30526,1,0,0,0,1
30527,1,0,0,0,1
30528,1,0,0,0,1
30529,1,0,0,0,1
30530,0,1,0,0,1
30531,1,0,0,0,1
30532,1,0,0,0,1
30533,0,1,0,0,1
30534,0,1,0,0,1
30535,0,1,0,0,1
30536,0,1,0,0,1
30537,0,1,0,0,1
30538,1,0,0,0,1
30539,0,1,0,0,1
30540,0,0,0,1,1
30541,0,1,0,0,1
30542,0,1,0,0,1
30543,0,1,0,0,1
30544,0,1,0,0,1
30545,0,1,0,0,1
30546,0,1,0,0,1
30547,0,0,0,1,1
30548,0,1,0,0,1
30549,0,1,0,0,1
30550,1,0,0,0,1
30551,0,1,0,0,1
30552,0,1,0,0,1
30553,0,0,1,0,1
30554,0,1,0,0,1
30555,0,1,0,0,1
30556,1,0,0,0,1
30557,0,1,0,0,1
30558,0,1,0,0,1
30559,0,1,0,0,1
30560,0,1,0,0,1
30561,0,1,0,0,1
30562,0,1,0,0,1
30563,0,1,0,0,1
30564,0,1,0,0,1
30565,1,0,0,0,1
30566,0,1,0,0,1
30567,0,0,0,1,1
30568,0,1,0,0,1
30569,1,0,0,0,1
30570,0,1,0,0,1
30571,0,1,0,0,1
30572,0,1,0,0,1
30573,0,1,0,0,1
30574,0,1,0,0,1
30575,1,0,0,0,1
30576,0,1,0,0,1
30577,0,1,0,0,1
30578,0,1,0,0,1
30579,0,1,0,0,1
30580,0,1,0,0,1
30581,0,1,0,0,1
30582,1,0,0,0,1
30583,0,1,0,0,1
30584,0,1,0,0,1
30585,0,1,0,0,1
30586,1,0,0,0,1
30587,0,1,0,0,1
30588,0,1,0,0,1
30589,1,0,0,0,1
30590,0,1,0,0,1
30591,0,1,0,0,1
30592,1,0,0,0,1
30593,1,0,0,0,1
30594,0,1,0,0,1
30595,0,1,0,0,1
30596,0,1,0,0,1
30597,0,1,0,0,1
30598,0,1,0,0,1
30599,0,1,0,0,1
30600,0,1,0,0,1
30601,0,1,0,0,1
30602,0,1,0,0,1
30603,0,1,0,0,1
30604,0,1,0,0,1
30605,0,1,0,0,1
30606,0,1,0,0,1
30607,0,1,0,0,1
30608,0,1,0,0,1
30609,1,0,0,0,1
30610,0,1,0,0,1
30611,1,0,0,0,1
30612,0,1,0,0,1
30613,1,0,0,0,1
30614,0,1,0,0,1
30615,0,1,0,0,1
30616,0,1,0,0,1
30617,0,1,0,0,1
30618,0,1,0,0,1
30619,0,1,0,0,1
30620,0,0,0,1,1
30621,0,1,0,0,1
30622,0,1,0,0,1
30623,0,1,0,0,1
30624,0,1,0,0,1
30625,0,1,0,0,1
30626,0,1,0,0,1
30627,0,1,0,0,1
30628,0,1,0,0,1
30629,0,1,0,0,1
30630,0,1,0,0,1
30631,0,1,0,0,1
30632,0,1,0,0,1
30633,1,0,0,0,1
30634,1,0,0,0,1
30635,0,1,0,0,1
30636,0,1,0,0,1
30637,0,1,0,0,1
30638,0,1,0,0,1
30639,0,1,0,0,1
30640,0,1,0,0,1
30641,0,0,0,1,1
30642,1,0,0,0,1
30643,0,0,1,0,1
30644,0,1,0,0,1
30645,0,1,0,0,1
30646,0,1,0,0,1
30647,0,1,0,0,1
30648,0,1,0,0,1
30649,0,1,0,0,1
30650,0,1,0,0,1
30651,0,1,0,0,1
30652,0,1,0,0,1
30653,0,1,0,0,1
30654,1,0,0,0,1
30655,1,0,0,0,1
30656,1,0,0,0,1
30657,1,0,0,0,1
30658,0,1,0,0,1
30659,1,0,0,0,1
30660,1,0,0,0,1
30661,0,1,0,0,1
30662,0,1,0,0,1
30663,0,1,0,0,1
30664,0,1,0,0,1
30665,0,1,0,0,1
30666,0,1,0,0,1
30667,0,1,0,0,1
30668,0,0,1,0,1
30669,0,1,0,0,1
30670,0,1,0,0,1
30671,0,1,0,0,1
30672,0,1,0,0,1
30673,0,1,0,0,1
30674,0,1,0,0,1
30675,0,0,1,0,1
30676,0,1,0,0,1
30677,0,1,0,0,1
30678,0,1,0,0,1
30679,0,1,0,0,1
30680,0,1,0,0,1
30681,0,1,0,0,1
30682,0,1,0,0,1
30683,0,1,0,0,1
30684,1,0,0,0,1
30685,0,1,0,0,1
30686,0,1,0,0,1
30687,0,1,0,0,1
30688,0,1,0,0,1
30689,0,1,0,0,1
30690,0,1,0,0,1
30691,0,1,0,0,1
30692,0,1,0,0,1
30693,0,0,1,0,1
30694,0,1,0,0,1
30695,0,0,1,0,1
30696,0,1,0,0,1
30697,0,1,0,0,1
30698,0,1,0,0,1
30699,0,1,0,0,1
30700,1,0,0,0,1
30701,0,1,0,0,1
30702,1,0,0,0,1
30703,0,1,0,0,1
30704,1,0,0,0,1
30705,0,1,0,0,1
30706,0,1,0,0,1
30707,0,1,0,0,1
30708,0,0,0,1,1
30709,0,0,0,1,1
30710,0,1,0,0,1
30711,0,0,1,0,1
30712,1,0,0,0,1
30713,0,1,0,0,1
30714,0,1,0,0,1
30715,0,0,1,0,1
30716,1,0,0,0,1
30717,1,0,0,0,1
30718,0,1,0,0,1
30719,0,1,0,0,1
30720,0,1,0,0,1
30721,0,1,0,0,1
30722,0,1,0,0,1
30723,0,0,1,0,1
30724,0,1,0,0,1
30725,0,1,0,0,1
30726,0,1,0,0,1
30727,0,1,0,0,1
30728,0,1,0,0,1
30729,0,1,0,0,1
30730,0,1,0,0,1
30731,0,1,0,0,1
30732,1,0,0,0,1
30733,0,1,0,0,1
30734,0,1,0,0,1
30735,0,1,0,0,1
30736,0,1,0,0,1
30737,0,1,0,0,1
30738,1,0,0,0,1
30739,1,0,0,0,1
30740,0,1,0,0,1
30741,0,1,0,0,1
30742,0,1,0,0,1
30743,0,1,0,0,1
30744,0,1,0,0,1
30745,0,1,0,0,1
30746,0,1,0,0,1
30747,0,1,0,0,1
30748,0,1,0,0,1
30749,0,1,0,0,1
30750,0,1,0,0,1
30751,0,1,0,0,1
30752,0,1,0,0,1
30753,0,1,0,0,1
30754,1,0,0,0,1
30755,0,1,0,0,1
30756,0,1,0,0,1
30757,0,1,0,0,1
30758,0,0,0,1,1
30759,0,1,0,0,1
30760,0,1,0,0,1
30761,0,1,0,0,1
30762,1,0,0,0,1
30763,0,1,0,0,1
30764,1,0,0,0,1
30765,1,0,0,0,1
30766,0,1,0,0,1
30767,0,1,0,0,1
30768,0,1,0,0,1
30769,1,0,0,0,1
30770,0,1,0,0,1
30771,0,1,0,0,1
30772,0,1,0,0,1
30773,1,0,0,0,1
30774,0,1,0,0,1
30775,1,0,0,0,1
30776,1,0,0,0,1
30777,0,1,0,0,1
30778,0,1,0,0,1
30779,1,0,0,0,1
30780,1,0,0,0,1
30781,0,1,0,0,1
30782,0,1,0,0,1
30783,0,1,0,0,1
30784,0,1,0,0,1
30785,0,1,0,0,1
30786,0,1,0,0,1
30787,1,0,0,0,1
30788,0,1,0,0,1
30789,1,0,0,0,1
30790,1,0,0,0,1
30791,0,1,0,0,1
30792,0,1,0,0,1
30793,0,1,0,0,1
30794,1,0,0,0,1
30795,0,1,0,0,1
30796,0,1,0,0,1
30797,0,1,0,0,1
30798,0,1,0,0,1
30799,0,1,0,0,1
30800,0,1,0,0,1
30801,0,1,0,0,1
30802,0,1,0,0,1
30803,1,0,0,0,1
30804,0,0,0,1,1
30805,0,1,0,0,1
30806,1,0,0,0,1
30807,0,1,0,0,1
30808,1,0,0,0,1
30809,1,0,0,0,1
30810,0,0,1,0,1
30811,0,1,0,0,1
30812,0,1,0,0,1
30813,0,1,0,0,1
30814,0,1,0,0,1
30815,0,1,0,0,1
30816,0,1,0,0,1
30817,0,1,0,0,1
30818,0,1,0,0,1
30819,0,0,0,1,1
30820,0,0,0,1,1
30821,1,0,0,0,1
30822,0,1,0,0,1
30823,0,1,0,0,1
30824,0,1,0,0,1
30825,0,1,0,0,1
30826,0,1,0,0,1
30827,0,1,0,0,1
30828,0,1,0,0,1
30829,0,1,0,0,1
30830,0,1,0,0,1
30831,0,0,0,1,1
30832,0,1,0,0,1
30833,0,1,0,0,1
30834,1,0,0,0,1
30835,0,0,1,0,1
30836,0,1,0,0,1
30837,0,0,0,1,1
30838,1,0,0,0,1
30839,0,1,0,0,1
30840,1,0,0,0,1
30841,0,0,0,1,1
30842,0,1,0,0,1
30843,0,1,0,0,1
30844,0,1,0,0,1
30845,0,1,0,0,1
30846,1,0,0,0,1
30847,0,1,0,0,1
30848,1,0,0,0,1
30849,0,1,0,0,1
30850,0,1,0,0,1
30851,0,1,0,0,1
30852,0,1,0,0,1
30853,0,1,0,0,1
30854,0,1,0,0,1
30855,0,1,0,0,1
30856,0,1,0,0,1
30857,0,1,0,0,1
30858,0,1,0,0,1
30859,0,1,0,0,1
30860,0,0,0,1,1
30861,1,0,0,0,1
30862,0,1,0,0,1
30863,0,1,0,0,1
30864,0,1,0,0,1
30865,0,1,0,0,1
30866,0,1,0,0,1
30867,1,0,0,0,1
30868,1,0,0,0,1
30869,0,1,0,0,1
30870,0,0,0,1,1
30871,0,1,0,0,1
30872,0,0,0,1,1
30873,0,1,0,0,1
30874,1,0,0,0,1
30875,1,0,0,0,1
30876,0,1,0,0,1
30877,0,1,0,0,1
30878,0,1,0,0,1
30879,0,0,0,1,1
30880,0,1,0,0,1
30881,0,1,0,0,1
30882,0,1,0,0,1
30883,0,1,0,0,1
30884,1,0,0,0,1
30885,0,0,0,1,1
30886,0,1,0,0,1
30887,0,0,1,0,1
30888,0,1,0,0,1
30889,0,1,0,0,1
30890,0,1,0,0,1
30891,0,1,0,0,1
30892,1,0,0,0,1
30893,1,0,0,0,1
30894,0,1,0,0,1
30895,0,1,0,0,1
30896,0,1,0,0,1
30897,1,0,0,0,1
30898,0,1,0,0,1
30899,0,1,0,0,1
30900,1,0,0,0,1
30901,0,1,0,0,1
30902,0,1,0,0,1
30903,0,1,0,0,1
30904,0,1,0,0,1
30905,0,0,1,0,1
30906,1,0,0,0,1
30907,0,0,1,0,1
30908,1,0,0,0,1
30909,0,1,0,0,1
30910,0,1,0,0,1
30911,0,1,0,0,1
30912,1,0,0,0,1
30913,0,1,0,0,1
30914,0,1,0,0,1
30915,1,0,0,0,1
30916,1,0,0,0,1
30917,0,1,0,0,1
30918,1,0,0,0,1
30919,0,1,0,0,1
30920,0,1,0,0,1
30921,0,1,0,0,1
30922,0,1,0,0,1
30923,0,1,0,0,1
30924,1,0,0,0,1
30925,0,1,0,0,1
30926,0,1,0,0,1
30927,0,1,0,0,1
30928,0,1,0,0,1
30929,1,0,0,0,1
30930,0,1,0,0,1
30931,1,0,0,0,1
30932,0,1,0,0,1
30933,0,1,0,0,1
30934,0,1,0,0,1
30935,0,1,0,0,1
30936,0,1,0,0,1
30937,0,1,0,0,1
30938,0,1,0,0,1
30939,0,1,0,0,1
30940,0,1,0,0,1
30941,0,0,1,0,1
30942,0,1,0,0,1
30943,0,1,0,0,1
30944,0,1,0,0,1
30945,0,1,0,0,1
30946,1,0,0,0,1
30947,0,1,0,0,1
30948,1,0,0,0,1
30949,1,0,0,0,1
30950,0,1,0,0,1
30951,0,1,0,0,1
30952,1,0,0,0,1
30953,1,0,0,0,1
30954,0,1,0,0,1
30955,0,1,0,0,1
30956,0,1,0,0,1
30957,1,0,0,0,1
30958,1,0,0,0,1
30959,0,1,0,0,1
30960,1,0,0,0,1
30961,0,1,0,0,1
30962,0,1,0,0,1
30963,0,1,0,0,1
30964,0,1,0,0,1
30965,0,1,0,0,1
30966,0,1,0,0,1
30967,0,0,0,1,1
30968,1,0,0,0,1
30969,0,1,0,0,1
30970,0,1,0,0,1
30971,0,0,1,0,1
30972,1,0,0,0,1
30973,0,1,0,0,1
30974,0,1,0,0,1
30975,0,1,0,0,1
30976,1,0,0,0,1
30977,0,1,0,0,1
30978,0,1,0,0,1
30979,0,1,0,0,1
30980,0,1,0,0,1
30981,0,0,0,1,1
30982,0,1,0,0,1
30983,1,0,0,0,1
30984,0,1,0,0,1
30985,0,1,0,0,1
30986,0,1,0,0,1
30987,1,0,0,0,1
30988,0,1,0,0,1
30989,1,0,0,0,1
30990,0,1,0,0,1
30991,0,1,0,0,1
30992,0,1,0,0,1
30993,0,1,0,0,1
30994,0,1,0,0,1
30995,0,1,0,0,1
30996,1,0,0,0,1
30997,0,1,0,0,1
30998,0,1,0,0,1
30999,0,1,0,0,1
31000,0,1,0,0,1
31001,0,1,0,0,1
31002,0,1,0,0,1
31003,0,1,0,0,1
31004,0,1,0,0,1
31005,0,1,0,0,1
31006,1,0,0,0,1
31007,1,0,0,0,1
31008,0,1,0,0,1
31009,1,0,0,0,1
31010,0,1,0,0,1
31011,0,1,0,0,1
31012,0,1,0,0,1
31013,1,0,0,0,1
31014,0,1,0,0,1
31015,0,1,0,0,1
31016,0,1,0,0,1
31017,0,1,0,0,1
31018,0,1,0,0,1
31019,0,1,0,0,1
31020,0,1,0,0,1
31021,1,0,0,0,1
31022,0,1,0,0,1
31023,1,0,0,0,1
31024,0,1,0,0,1
31025,0,1,0,0,1
31026,0,1,0,0,1
31027,1,0,0,0,1
31028,0,1,0,0,1
31029,0,1,0,0,1
31030,1,0,0,0,1
31031,0,1,0,0,1
31032,0,1,0,0,1
31033,0,1,0,0,1
31034,0,1,0,0,1
31035,0,1,0,0,1
31036,0,1,0,0,1
31037,1,0,0,0,1
31038,0,1,0,0,1
31039,0,1,0,0,1
31040,0,1,0,0,1
31041,0,1,0,0,1
31042,0,1,0,0,1
31043,0,1,0,0,1
31044,0,1,0,0,1
31045,0,1,0,0,1
31046,0,1,0,0,1
31047,0,1,0,0,1
31048,0,1,0,0,1
31049,0,1,0,0,1
31050,1,0,0,0,1
31051,0,0,0,1,1
31052,1,0,0,0,1
31053,0,1,0,0,1
31054,0,1,0,0,1
31055,0,1,0,0,1
31056,0,1,0,0,1
31057,1,0,0,0,1
31058,0,1,0,0,1
31059,1,0,0,0,1
31060,1,0,0,0,1
31061,0,1,0,0,1
31062,1,0,0,0,1
31063,1,0,0,0,1
31064,0,1,0,0,1
31065,1,0,0,0,1
31066,1,0,0,0,1
31067,0,1,0,0,1
31068,1,0,0,0,1
31069,0,1,0,0,1
31070,1,0,0,0,1
31071,0,1,0,0,1
31072,0,1,0,0,1
31073,1,0,0,0,1
31074,0,1,0,0,1
31075,0,1,0,0,1
31076,0,1,0,0,1
31077,0,1,0,0,1
31078,1,0,0,0,1
31079,0,1,0,0,1
31080,0,1,0,0,1
31081,0,1,0,0,1
31082,0,1,0,0,1
31083,0,1,0,0,1
31084,1,0,0,0,1
31085,0,1,0,0,1
31086,1,0,0,0,1
31087,0,1,0,0,1
31088,0,1,0,0,1
31089,0,1,0,0,1
31090,0,1,0,0,1
31091,0,1,0,0,1
31092,0,1,0,0,1
31093,0,1,0,0,1
31094,0,1,0,0,1
31095,0,1,0,0,1
31096,0,1,0,0,1
31097,0,1,0,0,1
31098,0,1,0,0,1
31099,0,1,0,0,1
31100,0,1,0,0,1
31101,0,1,0,0,1
31102,0,1,0,0,1
31103,0,1,0,0,1
31104,0,0,0,1,1
31105,0,1,0,0,1
31106,0,1,0,0,1
31107,0,1,0,0,1
31108,0,1,0,0,1
31109,0,1,0,0,1
31110,1,0,0,0,1
31111,0,1,0,0,1
31112,0,1,0,0,1
31113,0,1,0,0,1
31114,0,1,0,0,1
31115,0,1,0,0,1
31116,0,1,0,0,1
31117,1,0,0,0,1
31118,0,1,0,0,1
31119,0,1,0,0,1
31120,0,1,0,0,1
31121,0,1,0,0,1
31122,0,1,0,0,1
31123,0,1,0,0,1
31124,0,1,0,0,1
31125,0,1,0,0,1
31126,0,1,0,0,1
31127,0,1,0,0,1
31128,0,1,0,0,1
31129,0,1,0,0,1
31130,0,1,0,0,1
31131,1,0,0,0,1
31132,0,1,0,0,1
31133,0,1,0,0,1
31134,0,1,0,0,1
31135,0,1,0,0,1
31136,0,1,0,0,1
31137,0,1,0,0,1
31138,0,1,0,0,1
31139,0,1,0,0,1
31140,0,1,0,0,1
31141,0,1,0,0,1
31142,0,1,0,0,1
31143,0,0,1,0,1
31144,1,0,0,0,1
31145,1,0,0,0,1
31146,0,1,0,0,1
31147,0,1,0,0,1
31148,0,1,0,0,1
31149,0,1,0,0,1
31150,0,1,0,0,1
31151,0,1,0,0,1
31152,0,1,0,0,1
31153,0,1,0,0,1
31154,1,0,0,0,1
31155,1,0,0,0,1
31156,0,1,0,0,1
31157,1,0,0,0,1
31158,0,1,0,0,1
31159,0,1,0,0,1
31160,0,1,0,0,1
31161,0,1,0,0,1
31162,1,0,0,0,1
31163,0,1,0,0,1
31164,1,0,0,0,1
31165,1,0,0,0,1
31166,0,1,0,0,1
31167,1,0,0,0,1
31168,0,1,0,0,1
31169,0,1,0,0,1
31170,0,1,0,0,1
31171,0,0,0,1,1
31172,0,1,0,0,1
31173,0,1,0,0,1
31174,0,1,0,0,1
31175,0,1,0,0,1
31176,0,0,1,0,1
31177,0,1,0,0,1
31178,0,1,0,0,1
31179,0,1,0,0,1
31180,0,1,0,0,1
31181,1,0,0,0,1
31182,0,1,0,0,1
31183,1,0,0,0,1
31184,0,1,0,0,1
31185,1,0,0,0,1
31186,1,0,0,0,1
31187,1,0,0,0,1
31188,0,1,0,0,1
31189,0,1,0,0,1
31190,0,1,0,0,1
31191,0,1,0,0,1
31192,0,0,0,1,1
31193,1,0,0,0,1
31194,0,1,0,0,1
31195,1,0,0,0,1
31196,0,1,0,0,1
31197,0,1,0,0,1
31198,0,1,0,0,1
31199,0,1,0,0,1
31200,0,1,0,0,1
31201,0,1,0,0,1
31202,0,1,0,0,1
31203,1,0,0,0,1
31204,0,1,0,0,1
31205,0,1,0,0,1
31206,1,0,0,0,1
31207,0,1,0,0,1
31208,0,1,0,0,1
31209,0,1,0,0,1
31210,0,1,0,0,1
31211,0,1,0,0,1
31212,0,1,0,0,1
31213,0,1,0,0,1
31214,0,0,0,1,1
31215,0,1,0,0,1
31216,0,1,0,0,1
31217,0,1,0,0,1
31218,1,0,0,0,1
31219,0,1,0,0,1
31220,0,1,0,0,1
31221,0,1,0,0,1
31222,1,0,0,0,1
31223,1,0,0,0,1
31224,0,0,0,1,1
31225,0,1,0,0,1
31226,0,1,0,0,1
31227,0,1,0,0,1
31228,0,1,0,0,1
31229,1,0,0,0,1
31230,0,1,0,0,1
31231,0,0,0,1,1
31232,0,0,0,1,1
31233,0,1,0,0,1
31234,0,1,0,0,1
31235,0,1,0,0,1
31236,0,0,0,1,1
31237,0,1,0,0,1
31238,0,1,0,0,1
31239,0,1,0,0,1
31240,1,0,0,0,1
31241,0,1,0,0,1
31242,1,0,0,0,1
31243,0,1,0,0,1
31244,1,0,0,0,1
31245,0,1,0,0,1
31246,1,0,0,0,1
31247,0,1,0,0,1
31248,0,1,0,0,1
31249,0,1,0,0,1
31250,0,1,0,0,1
31251,0,1,0,0,1
31252,1,0,0,0,1
31253,1,0,0,0,1
31254,0,0,0,1,1
31255,0,1,0,0,1
31256,0,1,0,0,1
31257,0,1,0,0,1
31258,1,0,0,0,1
31259,0,0,0,1,1
31260,0,1,0,0,1
31261,0,1,0,0,1
31262,1,0,0,0,1
31263,0,1,0,0,1
31264,0,1,0,0,1
31265,0,1,0,0,1
31266,0,1,0,0,1
31267,0,1,0,0,1
31268,1,0,0,0,1
31269,0,1,0,0,1
31270,0,1,0,0,1
31271,1,0,0,0,1
31272,0,1,0,0,1
31273,0,0,1,0,1
31274,1,0,0,0,1
31275,0,1,0,0,1
31276,0,1,0,0,1
31277,0,1,0,0,1
31278,1,0,0,0,1
31279,0,1,0,0,1
31280,0,1,0,0,1
31281,0,1,0,0,1
31282,0,1,0,0,1
31283,0,1,0,0,1
31284,0,1,0,0,1
31285,0,1,0,0,1
31286,0,1,0,0,1
31287,0,1,0,0,1
31288,0,1,0,0,1
31289,1,0,0,0,1
31290,0,1,0,0,1
31291,0,1,0,0,1
31292,0,1,0,0,1
31293,0,1,0,0,1
31294,1,0,0,0,1
31295,0,1,0,0,1
31296,0,1,0,0,1
31297,0,1,0,0,1
31298,0,1,0,0,1
31299,0,1,0,0,1
31300,0,1,0,0,1
31301,1,0,0,0,1
31302,0,1,0,0,1
31303,1,0,0,0,1
31304,0,1,0,0,1
31305,1,0,0,0,1
31306,0,1,0,0,1
31307,0,1,0,0,1
31308,0,1,0,0,1
31309,0,1,0,0,1
31310,0,1,0,0,1
31311,0,1,0,0,1
31312,0,0,0,1,1
31313,0,1,0,0,1
31314,0,1,0,0,1
31315,0,1,0,0,1
31316,0,1,0,0,1
31317,0,1,0,0,1
31318,0,1,0,0,1
31319,0,1,0,0,1
31320,0,1,0,0,1
31321,0,1,0,0,1
31322,1,0,0,0,1
31323,0,1,0,0,1
31324,0,1,0,0,1
31325,0,1,0,0,1
31326,0,1,0,0,1
31327,0,1,0,0,1
31328,0,1,0,0,1
31329,1,0,0,0,1
31330,1,0,0,0,1
31331,0,1,0,0,1
31332,0,1,0,0,1
31333,0,1,0,0,1
31334,0,1,0,0,1
31335,0,0,0,1,1
31336,0,1,0,0,1
31337,0,1,0,0,1
31338,0,0,0,1,1
31339,1,0,0,0,1
31340,0,1,0,0,1
31341,0,1,0,0,1
31342,0,0,0,1,1
31343,0,1,0,0,1
31344,0,1,0,0,1
31345,0,1,0,0,1
31346,0,1,0,0,1
31347,0,1,0,0,1
31348,0,1,0,0,1
31349,0,1,0,0,1
31350,0,1,0,0,1
31351,0,1,0,0,1
31352,0,1,0,0,1
31353,0,1,0,0,1
31354,0,1,0,0,1
31355,1,0,0,0,1
31356,0,1,0,0,1
31357,0,1,0,0,1
31358,0,1,0,0,1
31359,0,1,0,0,1
31360,1,0,0,0,1
31361,0,1,0,0,1
31362,0,1,0,0,1
31363,0,1,0,0,1
31364,1,0,0,0,1
31365,0,1,0,0,1
31366,0,1,0,0,1
31367,0,1,0,0,1
31368,0,0,0,1,1
31369,0,1,0,0,1
31370,0,1,0,0,1
31371,0,1,0,0,1
31372,0,1,0,0,1
31373,0,1,0,0,1
31374,0,1,0,0,1
31375,1,0,0,0,1
31376,0,1,0,0,1
31377,1,0,0,0,1
31378,0,1,0,0,1
31379,0,1,0,0,1
31380,0,1,0,0,1
31381,0,1,0,0,1
31382,0,1,0,0,1
31383,1,0,0,0,1
31384,0,1,0,0,1
31385,0,1,0,0,1
31386,0,1,0,0,1
31387,0,1,0,0,1
31388,1,0,0,0,1
31389,0,1,0,0,1
31390,0,1,0,0,1
31391,0,0,0,1,1
31392,0,1,0,0,1
31393,0,0,1,0,1
31394,1,0,0,0,1
31395,0,1,0,0,1
31396,0,1,0,0,1
31397,0,1,0,0,1
31398,0,1,0,0,1
31399,0,1,0,0,1
31400,0,1,0,0,1
31401,0,1,0,0,1
31402,0,1,0,0,1
31403,0,1,0,0,1
31404,0,1,0,0,1
31405,0,1,0,0,1
31406,1,0,0,0,1
31407,0,1,0,0,1
31408,1,0,0,0,1
31409,1,0,0,0,1
31410,0,1,0,0,1
31411,1,0,0,0,1
31412,0,1,0,0,1
31413,1,0,0,0,1
31414,0,1,0,0,1
31415,0,1,0,0,1
31416,0,1,0,0,1
31417,0,1,0,0,1
31418,1,0,0,0,1
31419,0,1,0,0,1
31420,0,1,0,0,1
31421,0,1,0,0,1
31422,0,1,0,0,1
31423,0,1,0,0,1
31424,1,0,0,0,1
31425,0,1,0,0,1
31426,0,1,0,0,1
31427,0,1,0,0,1
31428,0,1,0,0,1
31429,0,1,0,0,1
31430,0,1,0,0,1
31431,0,1,0,0,1
31432,0,1,0,0,1
31433,0,1,0,0,1
31434,0,1,0,0,1
31435,0,1,0,0,1
31436,0,1,0,0,1
31437,0,1,0,0,1
31438,0,1,0,0,1
31439,0,1,0,0,1
31440,0,1,0,0,1
31441,0,1,0,0,1
31442,0,1,0,0,1
31443,0,1,0,0,1
31444,0,1,0,0,1
31445,0,1,0,0,1
31446,0,1,0,0,1
31447,0,1,0,0,1
31448,1,0,0,0,1
31449,1,0,0,0,1
31450,0,0,1,0,1
31451,0,1,0,0,1
31452,1,0,0,0,1
31453,0,1,0,0,1
31454,0,1,0,0,1
31455,0,1,0,0,1
31456,0,1,0,0,1
31457,0,1,0,0,1
31458,0,1,0,0,1
31459,1,0,0,0,1
31460,0,1,0,0,1
31461,0,0,0,1,1
31462,1,0,0,0,1
31463,0,1,0,0,1
31464,0,0,0,1,1
31465,0,1,0,0,1
31466,0,1,0,0,1
31467,0,1,0,0,1
31468,0,1,0,0,1
31469,1,0,0,0,1
31470,1,0,0,0,1
31471,1,0,0,0,1
31472,0,0,0,1,1
31473,0,0,1,0,1
31474,0,1,0,0,1
31475,0,1,0,0,1
31476,0,1,0,0,1
31477,0,1,0,0,1
31478,0,1,0,0,1
31479,0,1,0,0,1
31480,0,1,0,0,1
31481,0,1,0,0,1
31482,1,0,0,0,1
31483,0,1,0,0,1
31484,0,1,0,0,1
31485,0,1,0,0,1
31486,0,1,0,0,1
31487,0,1,0,0,1
31488,0,1,0,0,1
31489,0,1,0,0,1
31490,0,1,0,0,1
31491,1,0,0,0,1
31492,0,1,0,0,1
31493,0,1,0,0,1
31494,0,1,0,0,1
31495,0,1,0,0,1
31496,0,1,0,0,1
31497,0,1,0,0,1
31498,0,1,0,0,1
31499,0,1,0,0,1
31500,0,1,0,0,1
31501,0,0,0,1,1
31502,0,1,0,0,1
31503,0,1,0,0,1
31504,0,1,0,0,1
31505,1,0,0,0,1
31506,0,1,0,0,1
31507,0,1,0,0,1
31508,1,0,0,0,1
31509,0,1,0,0,1
31510,0,1,0,0,1
31511,0,1,0,0,1
31512,0,1,0,0,1
31513,0,1,0,0,1
31514,0,1,0,0,1
31515,0,1,0,0,1
31516,1,0,0,0,1
31517,0,1,0,0,1
31518,0,1,0,0,1
31519,0,1,0,0,1
31520,0,1,0,0,1
31521,1,0,0,0,1
31522,1,0,0,0,1
31523,0,1,0,0,1
31524,0,1,0,0,1
31525,0,1,0,0,1
31526,0,1,0,0,1
31527,0,1,0,0,1
31528,0,1,0,0,1
31529,0,1,0,0,1
31530,0,1,0,0,1
31531,1,0,0,0,1
31532,0,1,0,0,1
31533,0,0,0,1,1
31534,0,1,0,0,1
31535,0,1,0,0,1
31536,0,1,0,0,1
31537,0,1,0,0,1
31538,0,1,0,0,1
31539,0,1,0,0,1
31540,0,1,0,0,1
31541,0,1,0,0,1
31542,0,1,0,0,1
31543,0,1,0,0,1
31544,0,1,0,0,1
31545,0,1,0,0,1
31546,0,1,0,0,1
31547,0,1,0,0,1
31548,0,1,0,0,1
31549,0,1,0,0,1
31550,0,1,0,0,1
31551,1,0,0,0,1
31552,1,0,0,0,1
31553,0,1,0,0,1
31554,0,1,0,0,1
31555,1,0,0,0,1
31556,0,1,0,0,1
31557,1,0,0,0,1
31558,1,0,0,0,1
31559,0,1,0,0,1
31560,0,1,0,0,1
31561,0,1,0,0,1
31562,0,1,0,0,1
31563,1,0,0,0,1
31564,0,1,0,0,1
31565,0,1,0,0,1
31566,0,1,0,0,1
31567,1,0,0,0,1
31568,0,1,0,0,1
31569,0,1,0,0,1
31570,0,1,0,0,1
31571,0,1,0,0,1
31572,0,1,0,0,1
31573,0,1,0,0,1
31574,0,1,0,0,1
31575,1,0,0,0,1
31576,0,1,0,0,1
31577,0,1,0,0,1
31578,1,0,0,0,1
31579,0,1,0,0,1
31580,0,1,0,0,1
31581,0,1,0,0,1
31582,0,1,0,0,1
31583,0,1,0,0,1
31584,1,0,0,0,1
31585,0,1,0,0,1
31586,0,1,0,0,1
31587,0,1,0,0,1
31588,1,0,0,0,1
31589,0,1,0,0,1
31590,0,1,0,0,1
31591,1,0,0,0,1
31592,1,0,0,0,1
31593,1,0,0,0,1
31594,0,1,0,0,1
31595,0,1,0,0,1
31596,0,1,0,0,1
31597,0,1,0,0,1
31598,1,0,0,0,1
31599,1,0,0,0,1
31600,1,0,0,0,1
31601,0,1,0,0,1
31602,0,0,0,1,1
31603,0,1,0,0,1
31604,1,0,0,0,1
31605,0,1,0,0,1
31606,1,0,0,0,1
31607,0,1,0,0,1
31608,1,0,0,0,1
31609,0,1,0,0,1
31610,0,1,0,0,1
31611,0,1,0,0,1
31612,0,1,0,0,1
31613,0,1,0,0,1
31614,0,1,0,0,1
31615,0,1,0,0,1
31616,0,1,0,0,1
31617,0,1,0,0,1
31618,0,1,0,0,1
31619,0,1,0,0,1
31620,0,1,0,0,1
31621,0,1,0,0,1
31622,0,1,0,0,1
31623,0,1,0,0,1
31624,0,1,0,0,1
31625,0,1,0,0,1
31626,0,1,0,0,1
31627,0,1,0,0,1
31628,0,1,0,0,1
31629,1,0,0,0,1
31630,1,0,0,0,1
31631,0,1,0,0,1
31632,0,1,0,0,1
31633,0,0,1,0,1
31634,0,1,0,0,1
31635,0,1,0,0,1
31636,0,1,0,0,1
31637,1,0,0,0,1
31638,0,1,0,0,1
31639,0,1,0,0,1
31640,0,1,0,0,1
31641,1,0,0,0,1
31642,0,1,0,0,1
31643,0,1,0,0,1
31644,0,1,0,0,1
31645,0,1,0,0,1
31646,1,0,0,0,1
31647,0,1,0,0,1
31648,1,0,0,0,1
31649,0,1,0,0,1
31650,0,1,0,0,1
31651,0,1,0,0,1
31652,0,1,0,0,1
31653,0,1,0,0,1
31654,1,0,0,0,1
31655,0,1,0,0,1
31656,0,1,0,0,1
31657,0,1,0,0,1
31658,0,0,0,1,1
31659,0,1,0,0,1
31660,0,1,0,0,1
31661,0,0,0,1,1
31662,0,1,0,0,1
31663,0,1,0,0,1
31664,0,1,0,0,1
31665,0,1,0,0,1
31666,0,1,0,0,1
31667,0,1,0,0,1
31668,0,0,0,1,1
31669,0,1,0,0,1
31670,0,1,0,0,1
31671,1,0,0,0,1
31672,1,0,0,0,1
31673,0,1,0,0,1
31674,0,1,0,0,1
31675,0,1,0,0,1
31676,0,1,0,0,1
31677,1,0,0,0,1
31678,0,1,0,0,1
31679,0,1,0,0,1
31680,0,1,0,0,1
31681,0,1,0,0,1
31682,0,1,0,0,1
31683,0,0,0,1,1
31684,0,0,1,0,1
31685,0,1,0,0,1
31686,0,1,0,0,1
31687,1,0,0,0,1
31688,0,1,0,0,1
31689,0,1,0,0,1
31690,0,1,0,0,1
31691,0,1,0,0,1
31692,0,1,0,0,1
31693,1,0,0,0,1
31694,0,1,0,0,1
31695,0,1,0,0,1
31696,0,1,0,0,1
31697,0,1,0,0,1
31698,0,1,0,0,1
31699,1,0,0,0,1
31700,0,1,0,0,1
31701,1,0,0,0,1
31702,0,1,0,0,1
31703,1,0,0,0,1
31704,1,0,0,0,1
31705,0,1,0,0,1
31706,0,1,0,0,1
31707,0,1,0,0,1
31708,0,0,0,1,1
31709,0,1,0,0,1
31710,0,1,0,0,1
31711,0,1,0,0,1
31712,0,0,0,1,1
31713,0,1,0,0,1
31714,1,0,0,0,1
31715,1,0,0,0,1
31716,0,1,0,0,1
31717,0,1,0,0,1
31718,0,1,0,0,1
31719,0,1,0,0,1
31720,0,1,0,0,1
31721,0,1,0,0,1
31722,1,0,0,0,1
31723,0,0,1,0,1
31724,1,0,0,0,1
31725,0,1,0,0,1
31726,1,0,0,0,1
31727,0,1,0,0,1
31728,1,0,0,0,1
31729,1,0,0,0,1
31730,0,1,0,0,1
31731,1,0,0,0,1
31732,0,1,0,0,1
31733,0,0,1,0,1
31734,1,0,0,0,1
31735,0,1,0,0,1
31736,0,1,0,0,1
31737,0,1,0,0,1
31738,0,1,0,0,1
31739,0,1,0,0,1
31740,1,0,0,0,1
31741,0,1,0,0,1
31742,0,1,0,0,1
31743,0,1,0,0,1
31744,0,1,0,0,1
31745,1,0,0,0,1
31746,0,1,0,0,1
31747,0,0,1,0,1
31748,0,1,0,0,1
31749,0,1,0,0,1
31750,0,1,0,0,1
31751,0,1,0,0,1
31752,0,1,0,0,1
31753,0,1,0,0,1
31754,0,1,0,0,1
31755,0,1,0,0,1
31756,0,1,0,0,1
31757,0,1,0,0,1
31758,0,1,0,0,1
31759,0,1,0,0,1
31760,0,1,0,0,1
31761,0,0,1,0,1
31762,0,1,0,0,1
31763,1,0,0,0,1
31764,0,1,0,0,1
31765,0,1,0,0,1
31766,0,1,0,0,1
31767,0,1,0,0,1
31768,0,1,0,0,1
31769,1,0,0,0,1
31770,0,0,1,0,1
31771,0,1,0,0,1
31772,0,1,0,0,1
31773,0,1,0,0,1
31774,1,0,0,0,1
31775,1,0,0,0,1
31776,0,1,0,0,1
31777,0,1,0,0,1
31778,0,1,0,0,1
31779,0,1,0,0,1
31780,0,1,0,0,1
31781,0,1,0,0,1
31782,0,1,0,0,1
31783,0,0,0,1,1
31784,0,1,0,0,1
31785,1,0,0,0,1
31786,0,1,0,0,1
31787,0,1,0,0,1
31788,0,1,0,0,1
31789,1,0,0,0,1
31790,0,1,0,0,1
31791,0,1,0,0,1
31792,0,1,0,0,1
31793,0,1,0,0,1
31794,0,1,0,0,1
31795,0,1,0,0,1
31796,1,0,0,0,1
31797,0,1,0,0,1
31798,0,1,0,0,1
31799,0,0,0,1,1
31800,0,0,0,1,1
31801,0,1,0,0,1
31802,0,1,0,0,1
31803,1,0,0,0,1
31804,0,1,0,0,1
31805,1,0,0,0,1
31806,0,1,0,0,1
31807,1,0,0,0,1
31808,0,1,0,0,1
31809,0,1,0,0,1
31810,0,1,0,0,1
31811,0,1,0,0,1
31812,0,1,0,0,1
31813,0,1,0,0,1
31814,0,1,0,0,1
31815,1,0,0,0,1
31816,0,1,0,0,1
31817,0,1,0,0,1
31818,0,1,0,0,1
31819,1,0,0,0,1
31820,0,1,0,0,1
31821,0,0,1,0,1
31822,0,1,0,0,1
31823,0,1,0,0,1
31824,0,1,0,0,1
31825,0,1,0,0,1
31826,0,1,0,0,1
31827,0,0,0,1,1
31828,0,1,0,0,1
31829,0,1,0,0,1
31830,0,1,0,0,1
31831,1,0,0,0,1
31832,0,1,0,0,1
31833,1,0,0,0,1
31834,0,1,0,0,1
31835,1,0,0,0,1
31836,0,1,0,0,1
31837,0,1,0,0,1
31838,1,0,0,0,1
31839,0,1,0,0,1
31840,0,1,0,0,1
31841,0,1,0,0,1
31842,0,1,0,0,1
31843,0,1,0,0,1
31844,0,1,0,0,1
31845,0,0,0,1,1
31846,0,1,0,0,1
31847,0,1,0,0,1
31848,0,1,0,0,1
31849,0,1,0,0,1
31850,1,0,0,0,1
31851,0,0,0,1,1
31852,0,1,0,0,1
31853,0,1,0,0,1
31854,0,1,0,0,1
31855,0,1,0,0,1
31856,0,1,0,0,1
31857,0,1,0,0,1
31858,0,1,0,0,1
31859,0,1,0,0,1
31860,0,1,0,0,1
31861,1,0,0,0,1
31862,0,1,0,0,1
31863,1,0,0,0,1
31864,0,0,1,0,1
31865,0,1,0,0,1
31866,0,0,0,1,1
31867,0,0,0,1,1
31868,1,0,0,0,1
31869,0,1,0,0,1
31870,0,1,0,0,1
31871,0,1,0,0,1
31872,0,1,0,0,1
31873,0,1,0,0,1
31874,0,1,0,0,1
31875,0,1,0,0,1
31876,0,1,0,0,1
31877,1,0,0,0,1
31878,0,1,0,0,1
31879,0,0,1,0,1
31880,0,1,0,0,1
31881,0,1,0,0,1
31882,0,1,0,0,1
31883,0,1,0,0,1
31884,0,1,0,0,1
31885,0,1,0,0,1
31886,0,1,0,0,1
31887,0,1,0,0,1
31888,0,1,0,0,1
31889,0,0,0,1,1
31890,0,1,0,0,1
31891,0,1,0,0,1
31892,0,1,0,0,1
31893,0,1,0,0,1
31894,0,1,0,0,1
31895,0,1,0,0,1
31896,0,1,0,0,1
31897,1,0,0,0,1
31898,0,1,0,0,1
31899,1,0,0,0,1
31900,0,1,0,0,1
31901,1,0,0,0,1
31902,0,1,0,0,1
31903,1,0,0,0,1
31904,1,0,0,0,1
31905,0,0,0,1,1
31906,0,1,0,0,1
31907,0,1,0,0,1
31908,0,1,0,0,1
31909,1,0,0,0,1
31910,1,0,0,0,1
31911,0,1,0,0,1
31912,0,1,0,0,1
31913,0,1,0,0,1
31914,0,1,0,0,1
31915,0,0,0,1,1
31916,1,0,0,0,1
31917,0,1,0,0,1
31918,0,1,0,0,1
31919,0,1,0,0,1
31920,0,1,0,0,1
31921,0,1,0,0,1
31922,0,1,0,0,1
31923,1,0,0,0,1
31924,0,0,0,1,1
31925,0,1,0,0,1
31926,0,1,0,0,1
31927,0,1,0,0,1
31928,0,1,0,0,1
31929,0,1,0,0,1
31930,1,0,0,0,1
31931,1,0,0,0,1
31932,0,1,0,0,1
31933,0,1,0,0,1
31934,0,1,0,0,1
31935,0,0,0,1,1
31936,0,1,0,0,1
31937,0,1,0,0,1
31938,0,1,0,0,1
31939,0,1,0,0,1
31940,0,1,0,0,1
31941,0,0,0,1,1
31942,0,1,0,0,1
31943,0,1,0,0,1
31944,0,1,0,0,1
31945,0,1,0,0,1
31946,0,1,0,0,1
31947,1,0,0,0,1
31948,0,0,0,1,1
31949,0,1,0,0,1
31950,0,1,0,0,1
31951,0,1,0,0,1
31952,0,1,0,0,1
31953,0,1,0,0,1
31954,1,0,0,0,1
31955,0,1,0,0,1
31956,0,1,0,0,1
31957,0,1,0,0,1
31958,0,1,0,0,1
31959,0,1,0,0,1
31960,0,1,0,0,1
31961,0,1,0,0,1
31962,1,0,0,0,1
31963,0,1,0,0,1
31964,1,0,0,0,1
31965,0,0,1,0,1
31966,1,0,0,0,1
31967,0,1,0,0,1
31968,0,1,0,0,1
31969,1,0,0,0,1
31970,0,1,0,0,1
31971,0,1,0,0,1
31972,0,1,0,0,1
31973,0,1,0,0,1
31974,0,1,0,0,1
31975,0,1,0,0,1
31976,0,1,0,0,1
31977,0,1,0,0,1
31978,0,1,0,0,1
31979,0,1,0,0,1
31980,0,1,0,0,1
31981,0,1,0,0,1
31982,0,1,0,0,1
31983,0,1,0,0,1
31984,0,1,0,0,1
31985,0,1,0,0,1
31986,0,1,0,0,1
31987,1,0,0,0,1
31988,0,0,0,1,1
31989,0,1,0,0,1
31990,0,1,0,0,1
31991,0,1,0,0,1
31992,0,1,0,0,1
31993,0,1,0,0,1
31994,0,1,0,0,1
31995,0,1,0,0,1
31996,0,1,0,0,1
31997,0,1,0,0,1
31998,0,0,0,1,1
31999,0,1,0,0,1
32000,1,0,0,0,1
32001,0,1,0,0,1
32002,1,0,0,0,1
32003,1,0,0,0,1
32004,0,1,0,0,1
32005,0,1,0,0,1
32006,0,1,0,0,1
32007,1,0,0,0,1
32008,0,1,0,0,1
32009,1,0,0,0,1
32010,0,1,0,0,1
32011,0,1,0,0,1
32012,1,0,0,0,1
32013,0,1,0,0,1
32014,1,0,0,0,1
32015,0,1,0,0,1
32016,0,1,0,0,1
32017,0,1,0,0,1
32018,0,1,0,0,1
32019,0,1,0,0,1
32020,0,1,0,0,1
32021,0,1,0,0,1
32022,1,0,0,0,1
32023,1,0,0,0,1
32024,0,1,0,0,1
32025,0,1,0,0,1
32026,0,1,0,0,1
32027,0,1,0,0,1
32028,0,1,0,0,1
32029,1,0,0,0,1
32030,0,1,0,0,1
32031,0,1,0,0,1
32032,0,1,0,0,1
32033,0,1,0,0,1
32034,0,1,0,0,1
32035,0,1,0,0,1
32036,0,1,0,0,1
32037,1,0,0,0,1
32038,0,1,0,0,1
32039,0,1,0,0,1
32040,0,1,0,0,1
32041,0,1,0,0,1
32042,0,1,0,0,1
32043,0,1,0,0,1
32044,1,0,0,0,1
32045,0,0,0,1,1
32046,0,0,1,0,1
32047,0,1,0,0,1
32048,0,1,0,0,1
32049,0,1,0,0,1
32050,0,1,0,0,1
32051,0,1,0,0,1
32052,0,1,0,0,1
32053,0,1,0,0,1
32054,0,0,0,1,1
32055,1,0,0,0,1
32056,1,0,0,0,1
32057,0,1,0,0,1
32058,0,1,0,0,1
32059,0,1,0,0,1
32060,0,0,0,1,1
32061,0,1,0,0,1
32062,0,1,0,0,1
32063,1,0,0,0,1
32064,0,1,0,0,1
32065,1,0,0,0,1
32066,0,0,0,1,1
32067,0,1,0,0,1
32068,0,1,0,0,1
32069,1,0,0,0,1
32070,0,1,0,0,1
32071,0,1,0,0,1
32072,0,1,0,0,1
32073,0,1,0,0,1
32074,0,1,0,0,1
32075,0,1,0,0,1
32076,0,1,0,0,1
32077,0,0,1,0,1
32078,0,0,1,0,1
32079,0,1,0,0,1
32080,0,1,0,0,1
32081,1,0,0,0,1
32082,0,1,0,0,1
32083,0,1,0,0,1
32084,1,0,0,0,1
32085,0,1,0,0,1
32086,0,1,0,0,1
32087,1,0,0,0,1
32088,0,1,0,0,1
32089,0,1,0,0,1
32090,0,1,0,0,1
32091,0,1,0,0,1
32092,0,0,1,0,1
32093,0,1,0,0,1
32094,0,1,0,0,1
32095,1,0,0,0,1
32096,0,1,0,0,1
32097,0,0,0,1,1
32098,1,0,0,0,1
32099,0,1,0,0,1
32100,0,1,0,0,1
32101,0,1,0,0,1
32102,0,0,1,0,1
32103,0,1,0,0,1
32104,1,0,0,0,1
32105,0,1,0,0,1
32106,1,0,0,0,1
32107,0,1,0,0,1
32108,1,0,0,0,1
32109,0,1,0,0,1
32110,1,0,0,0,1
32111,0,0,0,1,1
32112,0,1,0,0,1
32113,0,1,0,0,1
32114,0,1,0,0,1
32115,0,1,0,0,1
32116,0,1,0,0,1
32117,0,1,0,0,1
32118,0,0,0,1,1
32119,0,0,0,1,1
32120,1,0,0,0,1
32121,0,1,0,0,1
32122,0,1,0,0,1
32123,0,1,0,0,1
32124,0,1,0,0,1
32125,0,0,1,0,1
32126,0,1,0,0,1
32127,0,1,0,0,1
32128,0,1,0,0,1
32129,0,1,0,0,1
32130,1,0,0,0,1
32131,0,1,0,0,1
32132,1,0,0,0,1
32133,0,1,0,0,1
32134,0,1,0,0,1
32135,0,1,0,0,1
32136,1,0,0,0,1
32137,0,1,0,0,1
32138,0,1,0,0,1
32139,0,1,0,0,1
32140,0,1,0,0,1
32141,0,1,0,0,1
32142,0,1,0,0,1
32143,0,1,0,0,1
32144,0,1,0,0,1
32145,0,1,0,0,1
32146,0,1,0,0,1
32147,0,1,0,0,1
32148,1,0,0,0,1
32149,0,1,0,0,1
32150,0,0,1,0,1
32151,1,0,0,0,1
32152,0,1,0,0,1
32153,0,1,0,0,1
32154,0,1,0,0,1
32155,0,1,0,0,1
32156,0,1,0,0,1
32157,0,1,0,0,1
32158,1,0,0,0,1
32159,0,0,0,1,1
32160,1,0,0,0,1
32161,1,0,0,0,1
32162,0,1,0,0,1
32163,0,1,0,0,1
32164,0,1,0,0,1
32165,0,0,0,1,1
32166,0,1,0,0,1
32167,0,1,0,0,1
32168,0,1,0,0,1
32169,1,0,0,0,1
32170,0,0,0,1,1
32171,0,1,0,0,1
32172,0,0,0,1,1
32173,0,1,0,0,1
32174,0,1,0,0,1
32175,1,0,0,0,1
32176,1,0,0,0,1
32177,0,1,0,0,1
32178,0,0,0,1,1
32179,0,1,0,0,1
32180,0,1,0,0,1
32181,0,1,0,0,1
32182,0,1,0,0,1
32183,1,0,0,0,1
32184,0,1,0,0,1
32185,1,0,0,0,1
32186,0,1,0,0,1
32187,0,1,0,0,1
32188,0,1,0,0,1
32189,0,0,1,0,1
32190,0,1,0,0,1
32191,1,0,0,0,1
32192,0,1,0,0,1
32193,0,1,0,0,1
32194,0,1,0,0,1
32195,0,1,0,0,1
32196,0,1,0,0,1
32197,0,1,0,0,1
32198,0,1,0,0,1
32199,1,0,0,0,1
32200,0,1,0,0,1
32201,0,1,0,0,1
32202,0,1,0,0,1
32203,0,1,0,0,1
32204,0,1,0,0,1
32205,0,1,0,0,1
32206,0,1,0,0,1
32207,0,1,0,0,1
32208,0,1,0,0,1
32209,0,1,0,0,1
32210,0,1,0,0,1
32211,0,1,0,0,1
32212,1,0,0,0,1
32213,1,0,0,0,1
32214,0,1,0,0,1
32215,0,1,0,0,1
32216,0,1,0,0,1
32217,1,0,0,0,1
32218,0,1,0,0,1
32219,0,1,0,0,1
32220,0,1,0,0,1
32221,0,1,0,0,1
32222,1,0,0,0,1
32223,0,1,0,0,1
32224,0,0,0,1,1
32225,1,0,0,0,1
32226,0,0,0,1,1
32227,1,0,0,0,1
32228,0,1,0,0,1
32229,0,1,0,0,1
32230,1,0,0,0,1
32231,0,1,0,0,1
32232,0,1,0,0,1
32233,0,1,0,0,1
32234,0,1,0,0,1
32235,0,1,0,0,1
32236,0,0,0,1,1
32237,0,0,0,1,1
32238,0,1,0,0,1
32239,0,1,0,0,1
32240,0,1,0,0,1
32241,0,1,0,0,1
32242,1,0,0,0,1
32243,1,0,0,0,1
32244,0,1,0,0,1
32245,0,1,0,0,1
32246,0,1,0,0,1
32247,0,1,0,0,1
32248,0,1,0,0,1
32249,1,0,0,0,1
32250,0,1,0,0,1
32251,0,0,0,1,1
32252,0,1,0,0,1
32253,0,1,0,0,1
32254,1,0,0,0,1
32255,0,1,0,0,1
32256,0,1,0,0,1
32257,1,0,0,0,1
32258,0,0,1,0,1
32259,0,1,0,0,1
32260,0,1,0,0,1
32261,0,0,1,0,1
32262,0,1,0,0,1
32263,0,1,0,0,1
32264,0,1,0,0,1
32265,0,1,0,0,1
32266,0,1,0,0,1
32267,0,1,0,0,1
32268,0,1,0,0,1
32269,0,1,0,0,1
32270,0,1,0,0,1
32271,1,0,0,0,1
32272,0,1,0,0,1
32273,1,0,0,0,1
32274,0,1,0,0,1
32275,0,1,0,0,1
32276,1,0,0,0,1
32277,0,1,0,0,1
32278,0,1,0,0,1
32279,0,1,0,0,1
32280,0,1,0,0,1
32281,0,1,0,0,1
32282,0,1,0,0,1
32283,0,1,0,0,1
32284,0,1,0,0,1
32285,0,1,0,0,1
32286,0,1,0,0,1
32287,0,1,0,0,1
32288,1,0,0,0,1
32289,0,1,0,0,1
32290,0,1,0,0,1
32291,0,1,0,0,1
32292,0,1,0,0,1
32293,0,1,0,0,1
32294,1,0,0,0,1
32295,0,1,0,0,1
32296,1,0,0,0,1
32297,0,1,0,0,1
32298,0,1,0,0,1
32299,1,0,0,0,1
32300,1,0,0,0,1
32301,0,1,0,0,1
32302,0,1,0,0,1
32303,0,1,0,0,1
32304,0,1,0,0,1
32305,0,1,0,0,1
32306,0,1,0,0,1
32307,1,0,0,0,1
32308,0,1,0,0,1
32309,0,0,1,0,1
32310,0,1,0,0,1
32311,0,1,0,0,1
32312,0,1,0,0,1
32313,0,1,0,0,1
32314,0,1,0,0,1
32315,0,1,0,0,1
32316,0,1,0,0,1
32317,0,1,0,0,1
32318,0,1,0,0,1
32319,1,0,0,0,1
32320,0,1,0,0,1
32321,0,0,0,1,1
32322,0,1,0,0,1
32323,0,1,0,0,1
32324,0,1,0,0,1
32325,0,1,0,0,1
32326,0,1,0,0,1
32327,0,1,0,0,1
32328,0,1,0,0,1
32329,0,1,0,0,1
32330,0,1,0,0,1
32331,0,1,0,0,1
32332,0,1,0,0,1
32333,0,1,0,0,1
32334,0,1,0,0,1
32335,0,1,0,0,1
32336,0,1,0,0,1
32337,1,0,0,0,1
32338,0,1,0,0,1
32339,0,0,1,0,1
32340,0,1,0,0,1
32341,0,1,0,0,1
32342,0,1,0,0,1
32343,1,0,0,0,1
32344,0,1,0,0,1
32345,0,1,0,0,1
32346,0,1,0,0,1
32347,0,1,0,0,1
32348,0,1,0,0,1
32349,0,0,0,1,1
32350,0,1,0,0,1
32351,0,1,0,0,1
32352,1,0,0,0,1
32353,0,1,0,0,1
32354,1,0,0,0,1
32355,0,1,0,0,1
32356,0,1,0,0,1
32357,0,1,0,0,1
32358,0,1,0,0,1
32359,0,1,0,0,1
32360,0,0,0,1,1
32361,0,1,0,0,1
32362,0,1,0,0,1
32363,0,1,0,0,1
32364,0,1,0,0,1
32365,0,1,0,0,1
32366,1,0,0,0,1
32367,0,1,0,0,1
32368,0,1,0,0,1
32369,0,1,0,0,1
32370,0,1,0,0,1
32371,0,1,0,0,1
32372,0,1,0,0,1
32373,0,1,0,0,1
32374,0,1,0,0,1
32375,1,0,0,0,1
32376,0,1,0,0,1
32377,0,1,0,0,1
32378,0,1,0,0,1
32379,0,1,0,0,1
32380,1,0,0,0,1
32381,1,0,0,0,1
32382,0,1,0,0,1
32383,1,0,0,0,1
32384,0,1,0,0,1
32385,0,1,0,0,1
32386,0,1,0,0,1
32387,0,0,1,0,1
32388,0,1,0,0,1
32389,0,1,0,0,1
32390,0,1,0,0,1
32391,0,1,0,0,1
32392,0,1,0,0,1
32393,0,1,0,0,1
32394,1,0,0,0,1
32395,0,1,0,0,1
32396,1,0,0,0,1
32397,0,0,0,1,1
32398,1,0,0,0,1
32399,1,0,0,0,1
32400,0,1,0,0,1
32401,0,1,0,0,1
32402,1,0,0,0,1
32403,1,0,0,0,1
32404,0,1,0,0,1
32405,0,1,0,0,1
32406,0,1,0,0,1
32407,0,1,0,0,1
32408,0,1,0,0,1
32409,0,1,0,0,1
32410,0,1,0,0,1
32411,0,1,0,0,1
32412,1,0,0,0,1
32413,0,1,0,0,1
32414,0,1,0,0,1
32415,1,0,0,0,1
32416,0,1,0,0,1
32417,1,0,0,0,1
32418,1,0,0,0,1
32419,0,1,0,0,1
32420,0,1,0,0,1
32421,0,1,0,0,1
32422,0,1,0,0,1
32423,0,1,0,0,1
32424,0,1,0,0,1
32425,1,0,0,0,1
32426,0,1,0,0,1
32427,1,0,0,0,1
32428,0,1,0,0,1
32429,0,1,0,0,1
32430,0,1,0,0,1
32431,0,1,0,0,1
32432,0,1,0,0,1
32433,0,1,0,0,1
32434,0,1,0,0,1
32435,0,1,0,0,1
32436,0,0,1,0,1
32437,0,1,0,0,1
32438,0,1,0,0,1
32439,1,0,0,0,1
32440,0,1,0,0,1
32441,0,1,0,0,1
32442,0,1,0,0,1
32443,1,0,0,0,1
32444,1,0,0,0,1
32445,0,1,0,0,1
32446,0,1,0,0,1
32447,0,1,0,0,1
32448,0,1,0,0,1
32449,0,1,0,0,1
32450,0,1,0,0,1
32451,1,0,0,0,1
32452,0,1,0,0,1
32453,0,1,0,0,1
32454,1,0,0,0,1
32455,0,1,0,0,1
32456,0,1,0,0,1
32457,0,1,0,0,1
32458,0,1,0,0,1
32459,0,1,0,0,1
32460,0,1,0,0,1
32461,0,1,0,0,1
32462,0,1,0,0,1
32463,0,1,0,0,1
32464,0,1,0,0,1
32465,0,1,0,0,1
32466,0,1,0,0,1
32467,0,0,1,0,1
32468,0,1,0,0,1
32469,0,1,0,0,1
32470,0,1,0,0,1
32471,0,0,1,0,1
32472,0,1,0,0,1
32473,0,1,0,0,1
32474,0,1,0,0,1
32475,0,1,0,0,1
32476,1,0,0,0,1
32477,0,1,0,0,1
32478,0,1,0,0,1
32479,0,1,0,0,1
32480,0,1,0,0,1
32481,0,1,0,0,1
32482,0,1,0,0,1
32483,0,1,0,0,1
32484,0,1,0,0,1
32485,0,1,0,0,1
32486,0,1,0,0,1
32487,0,1,0,0,1
32488,1,0,0,0,1
32489,0,1,0,0,1
32490,0,1,0,0,1
32491,0,1,0,0,1
32492,0,1,0,0,1
32493,0,1,0,0,1
32494,0,1,0,0,1
32495,0,1,0,0,1
32496,1,0,0,0,1
32497,0,1,0,0,1
32498,0,1,0,0,1
32499,0,1,0,0,1
32500,0,1,0,0,1
32501,0,1,0,0,1
32502,0,1,0,0,1
32503,0,1,0,0,1
32504,1,0,0,0,1
32505,0,1,0,0,1
32506,1,0,0,0,1
32507,1,0,0,0,1
32508,0,1,0,0,1
32509,0,1,0,0,1
32510,0,1,0,0,1
32511,1,0,0,0,1
32512,0,1,0,0,1
32513,0,1,0,0,1
32514,1,0,0,0,1
32515,0,1,0,0,1
32516,0,1,0,0,1
32517,0,1,0,0,1
32518,0,1,0,0,1
32519,0,1,0,0,1
32520,0,1,0,0,1
32521,0,1,0,0,1
32522,0,1,0,0,1
32523,0,1,0,0,1
32524,0,1,0,0,1
32525,0,1,0,0,1
32526,0,1,0,0,1
32527,0,1,0,0,1
32528,1,0,0,0,1
32529,0,1,0,0,1
32530,1,0,0,0,1
32531,0,1,0,0,1
32532,0,1,0,0,1
32533,0,1,0,0,1
32534,0,1,0,0,1
32535,0,1,0,0,1
32536,1,0,0,0,1
32537,1,0,0,0,1
32538,0,1,0,0,1
32539,0,1,0,0,1
32540,0,1,0,0,1
32541,0,1,0,0,1
32542,0,1,0,0,1
32543,0,1,0,0,1
32544,0,1,0,0,1
32545,0,1,0,0,1
32546,1,0,0,0,1
32547,0,1,0,0,1
32548,0,0,0,1,1
32549,0,1,0,0,1
32550,0,1,0,0,1
32551,1,0,0,0,1
32552,0,1,0,0,1
32553,0,1,0,0,1
32554,1,0,0,0,1
32555,1,0,0,0,1
32556,0,1,0,0,1
32557,0,1,0,0,1
32558,0,1,0,0,1
32559,0,1,0,0,1
32560,1,0,0,0,1
32561,0,1,0,0,1
32562,1,0,0,0,1
32563,0,1,0,0,1
32564,0,1,0,0,1
32565,0,1,0,0,1
32566,0,1,0,0,1
32567,0,1,0,0,1
32568,0,1,0,0,1
32569,0,1,0,0,1
32570,0,1,0,0,1
32571,0,1,0,0,1
32572,1,0,0,0,1
32573,1,0,0,0,1
32574,0,1,0,0,1
32575,0,1,0,0,1
32576,0,1,0,0,1
32577,0,1,0,0,1
32578,0,1,0,0,1
32579,0,1,0,0,1
32580,0,1,0,0,1
32581,0,1,0,0,1
32582,1,0,0,0,1
32583,0,0,0,1,1
32584,0,1,0,0,1
32585,0,1,0,0,1
32586,1,0,0,0,1
32587,1,0,0,0,1
32588,0,1,0,0,1
32589,0,1,0,0,1
32590,1,0,0,0,1
32591,0,1,0,0,1
32592,1,0,0,0,1
32593,0,1,0,0,1
32594,1,0,0,0,1
32595,0,1,0,0,1
32596,0,1,0,0,1
32597,0,1,0,0,1
32598,0,1,0,0,1
32599,0,1,0,0,1
32600,0,1,0,0,1
32601,0,1,0,0,1
32602,1,0,0,0,1
32603,0,0,0,1,1
32604,0,1,0,0,1
32605,0,1,0,0,1
32606,0,1,0,0,1
32607,0,0,0,1,1
32608,0,1,0,0,1
32609,0,1,0,0,1
32610,0,1,0,0,1
32611,0,0,0,1,1
32612,0,1,0,0,1
32613,0,1,0,0,1
32614,0,1,0,0,1
32615,1,0,0,0,1
32616,0,1,0,0,1
32617,0,0,0,1,1
32618,0,1,0,0,1
32619,0,1,0,0,1
32620,0,0,0,1,1
32621,1,0,0,0,1
32622,0,1,0,0,1
32623,0,1,0,0,1
32624,0,1,0,0,1
32625,0,1,0,0,1
32626,0,1,0,0,1
32627,0,1,0,0,1
32628,0,1,0,0,1
32629,0,1,0,0,1
32630,0,1,0,0,1
32631,0,1,0,0,1
32632,0,1,0,0,1
32633,1,0,0,0,1
32634,0,1,0,0,1
32635,0,1,0,0,1
32636,1,0,0,0,1
32637,0,1,0,0,1
32638,0,1,0,0,1
32639,1,0,0,0,1
32640,1,0,0,0,1
32641,0,1,0,0,1
32642,1,0,0,0,1
32643,1,0,0,0,1
32644,0,1,0,0,1
32645,1,0,0,0,1
32646,0,1,0,0,1
32647,0,1,0,0,1
32648,0,1,0,0,1
32649,0,1,0,0,1
32650,0,1,0,0,1
32651,0,1,0,0,1
32652,0,1,0,0,1
32653,0,1,0,0,1
32654,1,0,0,0,1
32655,0,0,1,0,1
32656,0,1,0,0,1
32657,0,0,0,1,1
32658,0,1,0,0,1
32659,0,1,0,0,1
32660,0,1,0,0,1
32661,1,0,0,0,1
32662,1,0,0,0,1
32663,0,1,0,0,1
32664,0,1,0,0,1
32665,1,0,0,0,1
32666,0,1,0,0,1
32667,0,1,0,0,1
32668,0,1,0,0,1
32669,0,1,0,0,1
32670,0,1,0,0,1
32671,0,1,0,0,1
32672,0,1,0,0,1
32673,0,1,0,0,1
32674,0,1,0,0,1
32675,0,1,0,0,1
32676,0,1,0,0,1
32677,0,1,0,0,1
32678,0,1,0,0,1
32679,0,1,0,0,1
32680,0,1,0,0,1
32681,0,1,0,0,1
32682,0,1,0,0,1
32683,0,1,0,0,1
32684,0,1,0,0,1
32685,0,0,0,1,1
32686,1,0,0,0,1
32687,0,1,0,0,1
32688,0,1,0,0,1
32689,1,0,0,0,1
32690,1,0,0,0,1
32691,0,1,0,0,1
32692,1,0,0,0,1
32693,0,1,0,0,1
32694,0,1,0,0,1
32695,0,1,0,0,1
32696,1,0,0,0,1
32697,0,1,0,0,1
32698,0,1,0,0,1
32699,0,1,0,0,1
32700,0,1,0,0,1
32701,0,1,0,0,1
32702,1,0,0,0,1
32703,0,1,0,0,1
32704,0,1,0,0,1
32705,1,0,0,0,1
32706,0,1,0,0,1
32707,1,0,0,0,1
32708,1,0,0,0,1
32709,0,1,0,0,1
32710,0,1,0,0,1
32711,1,0,0,0,1
32712,0,1,0,0,1
32713,0,0,1,0,1
32714,1,0,0,0,1
32715,0,0,1,0,1
32716,0,1,0,0,1
32717,0,1,0,0,1
32718,0,0,0,1,1
32719,0,1,0,0,1
32720,1,0,0,0,1
32721,0,1,0,0,1
32722,0,0,0,1,1
32723,0,1,0,0,1
32724,0,1,0,0,1
32725,1,0,0,0,1
32726,1,0,0,0,1
32727,0,1,0,0,1
32728,0,1,0,0,1
32729,0,1,0,0,1
32730,1,0,0,0,1
32731,0,1,0,0,1
32732,0,1,0,0,1
32733,1,0,0,0,1
32734,0,1,0,0,1
32735,0,1,0,0,1
32736,1,0,0,0,1
32737,0,1,0,0,1
32738,0,1,0,0,1
32739,0,1,0,0,1
32740,0,1,0,0,1
32741,0,1,0,0,1
32742,0,1,0,0,1
32743,0,1,0,0,1
32744,0,1,0,0,1
32745,1,0,0,0,1
32746,0,1,0,0,1
32747,0,1,0,0,1
32748,0,1,0,0,1
32749,0,1,0,0,1
32750,0,1,0,0,1
32751,0,0,0,1,1
32752,0,1,0,0,1
32753,0,1,0,0,1
32754,0,1,0,0,1
32755,0,1,0,0,1
32756,0,1,0,0,1
32757,0,1,0,0,1
32758,0,1,0,0,1
32759,0,1,0,0,1
32760,0,1,0,0,1
32761,0,1,0,0,1
32762,0,1,0,0,1
32763,0,1,0,0,1
32764,0,1,0,0,1
32765,0,1,0,0,1
32766,0,0,1,0,1
32767,0,0,0,1,1
32768,0,1,0,0,1
32769,0,1,0,0,1
32770,0,1,0,0,1
32771,0,1,0,0,1
32772,0,0,0,1,1
32773,0,1,0,0,1
32774,0,1,0,0,1
32775,0,1,0,0,1
32776,0,1,0,0,1
32777,0,0,0,1,1
32778,0,1,0,0,1
32779,0,0,0,1,1
32780,1,0,0,0,1
32781,0,0,1,0,1
32782,1,0,0,0,1
32783,0,1,0,0,1
32784,1,0,0,0,1
32785,0,1,0,0,1
32786,0,1,0,0,1
32787,0,1,0,0,1
32788,0,1,0,0,1
32789,0,1,0,0,1
32790,0,1,0,0,1
32791,0,1,0,0,1
32792,0,1,0,0,1
32793,0,1,0,0,1
32794,0,1,0,0,1
32795,0,1,0,0,1
32796,0,1,0,0,1
32797,0,0,1,0,1
32798,0,1,0,0,1
32799,0,1,0,0,1
32800,0,1,0,0,1
32801,0,1,0,0,1
32802,0,1,0,0,1
32803,0,0,1,0,1
32804,0,1,0,0,1
32805,0,1,0,0,1
32806,0,1,0,0,1
32807,0,1,0,0,1
32808,1,0,0,0,1
32809,1,0,0,0,1
32810,0,1,0,0,1
32811,1,0,0,0,1
32812,0,1,0,0,1
32813,0,1,0,0,1
32814,1,0,0,0,1
32815,0,1,0,0,1
32816,1,0,0,0,1
32817,0,1,0,0,1
32818,0,1,0,0,1
32819,0,0,0,1,1
32820,1,0,0,0,1
32821,0,1,0,0,1
32822,0,1,0,0,1
32823,0,1,0,0,1
32824,0,1,0,0,1
32825,0,1,0,0,1
32826,0,0,1,0,1
32827,0,1,0,0,1
32828,0,1,0,0,1
32829,1,0,0,0,1
32830,0,1,0,0,1
32831,0,1,0,0,1
32832,0,1,0,0,1
32833,0,1,0,0,1
32834,0,1,0,0,1
32835,0,1,0,0,1
32836,0,1,0,0,1
32837,1,0,0,0,1
32838,0,1,0,0,1
32839,0,1,0,0,1
32840,0,1,0,0,1
32841,0,1,0,0,1
32842,0,1,0,0,1
32843,0,1,0,0,1
32844,0,0,1,0,1
32845,0,1,0,0,1
32846,0,0,0,1,1
32847,0,1,0,0,1
32848,0,1,0,0,1
32849,0,1,0,0,1
32850,0,1,0,0,1
32851,0,1,0,0,1
32852,0,1,0,0,1
32853,0,1,0,0,1
32854,0,0,0,1,1
32855,0,0,0,1,1
32856,0,1,0,0,1
32857,0,1,0,0,1
32858,0,1,0,0,1
32859,1,0,0,0,1
32860,1,0,0,0,1
32861,0,0,0,1,1
32862,0,1,0,0,1
32863,0,1,0,0,1
32864,0,1,0,0,1
32865,1,0,0,0,1
32866,0,0,0,1,1
32867,0,1,0,0,1
32868,0,1,0,0,1
32869,0,1,0,0,1
32870,0,1,0,0,1
32871,0,1,0,0,1
32872,0,1,0,0,1
32873,0,0,1,0,1
32874,0,1,0,0,1
32875,0,1,0,0,1
32876,0,1,0,0,1
32877,0,1,0,0,1
32878,0,1,0,0,1
32879,0,1,0,0,1
32880,0,1,0,0,1
32881,0,1,0,0,1
32882,0,1,0,0,1
32883,1,0,0,0,1
32884,0,1,0,0,1
32885,0,1,0,0,1
32886,0,1,0,0,1
32887,1,0,0,0,1
32888,0,1,0,0,1
32889,0,1,0,0,1
32890,0,1,0,0,1
32891,0,1,0,0,1
32892,0,1,0,0,1
32893,0,1,0,0,1
32894,0,1,0,0,1
32895,0,1,0,0,1
32896,0,1,0,0,1
32897,0,1,0,0,1
32898,0,1,0,0,1
32899,0,1,0,0,1
32900,0,1,0,0,1
32901,0,1,0,0,1
32902,0,1,0,0,1
32903,0,1,0,0,1
32904,0,1,0,0,1
32905,0,1,0,0,1
32906,0,1,0,0,1
32907,0,1,0,0,1
32908,0,1,0,0,1
32909,0,1,0,0,1
32910,0,1,0,0,1
32911,0,0,0,1,1
32912,0,1,0,0,1
32913,0,1,0,0,1
32914,1,0,0,0,1
32915,0,1,0,0,1
32916,0,1,0,0,1
32917,0,1,0,0,1
32918,0,1,0,0,1
32919,0,1,0,0,1
32920,1,0,0,0,1
32921,0,1,0,0,1
32922,0,1,0,0,1
32923,0,1,0,0,1
32924,0,1,0,0,1
32925,0,1,0,0,1
32926,0,1,0,0,1
32927,0,1,0,0,1
32928,0,1,0,0,1
32929,0,1,0,0,1
32930,0,1,0,0,1
32931,0,1,0,0,1
32932,0,1,0,0,1
32933,0,1,0,0,1
32934,1,0,0,0,1
32935,0,1,0,0,1
32936,0,1,0,0,1
32937,0,0,0,1,1
32938,0,1,0,0,1
32939,0,1,0,0,1
32940,0,1,0,0,1
32941,0,1,0,0,1
32942,0,1,0,0,1
32943,0,1,0,0,1
32944,0,1,0,0,1
32945,0,1,0,0,1
32946,0,1,0,0,1
32947,0,0,0,1,1
32948,1,0,0,0,1
32949,0,1,0,0,1
32950,0,0,0,1,1
32951,0,1,0,0,1
32952,0,1,0,0,1
32953,0,1,0,0,1
32954,0,1,0,0,1
32955,0,1,0,0,1
32956,0,1,0,0,1
32957,1,0,0,0,1
32958,0,1,0,0,1
32959,0,1,0,0,1
32960,0,1,0,0,1
32961,0,1,0,0,1
32962,0,1,0,0,1
32963,0,1,0,0,1
32964,0,1,0,0,1
32965,0,1,0,0,1
32966,0,0,0,1,1
32967,0,1,0,0,1
32968,0,1,0,0,1
32969,0,0,0,1,1
32970,0,1,0,0,1
32971,0,1,0,0,1
32972,0,1,0,0,1
32973,0,1,0,0,1
32974,0,1,0,0,1
32975,0,1,0,0,1
32976,0,1,0,0,1
32977,0,1,0,0,1
32978,0,1,0,0,1
32979,0,1,0,0,1
32980,0,1,0,0,1
32981,0,1,0,0,1
32982,1,0,0,0,1
32983,0,1,0,0,1
32984,0,1,0,0,1
32985,0,1,0,0,1
32986,0,1,0,0,1
32987,1,0,0,0,1
32988,0,1,0,0,1
32989,0,1,0,0,1
32990,0,1,0,0,1
32991,0,0,0,1,1
32992,0,1,0,0,1
32993,1,0,0,0,1
32994,0,1,0,0,1
32995,0,1,0,0,1
32996,0,1,0,0,1
32997,0,1,0,0,1
32998,0,1,0,0,1
32999,1,0,0,0,1
33000,0,1,0,0,1
33001,1,0,0,0,1
33002,0,1,0,0,1
33003,0,0,0,1,1
33004,0,1,0,0,1
33005,0,1,0,0,1
33006,0,0,1,0,1
33007,0,1,0,0,1
33008,0,1,0,0,1
33009,1,0,0,0,1
33010,0,1,0,0,1
33011,1,0,0,0,1
33012,0,1,0,0,1
33013,1,0,0,0,1
33014,0,1,0,0,1
33015,0,1,0,0,1
33016,0,1,0,0,1
33017,0,1,0,0,1
33018,1,0,0,0,1
33019,0,1,0,0,1
33020,0,1,0,0,1
33021,0,1,0,0,1
33022,0,1,0,0,1
33023,0,1,0,0,1
33024,0,1,0,0,1
33025,0,1,0,0,1
33026,0,1,0,0,1
33027,1,0,0,0,1
33028,0,1,0,0,1
33029,0,0,0,1,1
33030,0,1,0,0,1
33031,0,1,0,0,1
33032,0,1,0,0,1
33033,0,1,0,0,1
33034,0,1,0,0,1
33035,0,1,0,0,1
33036,0,1,0,0,1
33037,0,1,0,0,1
33038,0,1,0,0,1
33039,0,1,0,0,1
33040,1,0,0,0,1
33041,0,1,0,0,1
33042,0,1,0,0,1
33043,0,1,0,0,1
33044,0,1,0,0,1
33045,0,1,0,0,1
33046,0,1,0,0,1
33047,1,0,0,0,1
33048,0,1,0,0,1
33049,0,1,0,0,1
33050,0,1,0,0,1
33051,0,1,0,0,1
33052,0,1,0,0,1
33053,1,0,0,0,1
33054,0,1,0,0,1
33055,1,0,0,0,1
33056,1,0,0,0,1
33057,0,1,0,0,1
33058,0,1,0,0,1
33059,1,0,0,0,1
33060,0,1,0,0,1
33061,0,1,0,0,1
33062,1,0,0,0,1
33063,0,1,0,0,1
33064,1,0,0,0,1
33065,0,1,0,0,1
33066,0,1,0,0,1
33067,0,1,0,0,1
33068,0,1,0,0,1
33069,0,1,0,0,1
33070,0,1,0,0,1
33071,0,1,0,0,1
33072,0,1,0,0,1
33073,0,1,0,0,1
33074,0,1,0,0,1
33075,0,1,0,0,1
33076,0,1,0,0,1
33077,0,1,0,0,1
33078,0,1,0,0,1
33079,0,1,0,0,1
33080,0,1,0,0,1
33081,0,1,0,0,1
33082,1,0,0,0,1
33083,0,1,0,0,1
33084,0,1,0,0,1
33085,1,0,0,0,1
33086,0,1,0,0,1
33087,0,1,0,0,1
33088,1,0,0,0,1
33089,0,1,0,0,1
33090,0,1,0,0,1
33091,0,1,0,0,1
33092,0,1,0,0,1
33093,0,1,0,0,1
33094,0,1,0,0,1
33095,1,0,0,0,1
33096,0,1,0,0,1
33097,0,1,0,0,1
33098,0,1,0,0,1
33099,0,1,0,0,1
33100,0,1,0,0,1
33101,1,0,0,0,1
33102,0,1,0,0,1
33103,1,0,0,0,1
33104,0,1,0,0,1
33105,1,0,0,0,1
33106,0,0,0,1,1
33107,0,1,0,0,1
33108,0,1,0,0,1
33109,0,1,0,0,1
33110,0,1,0,0,1
33111,0,1,0,0,1
33112,0,1,0,0,1
33113,0,1,0,0,1
33114,0,1,0,0,1
33115,0,1,0,0,1
33116,0,1,0,0,1
33117,0,1,0,0,1
33118,0,1,0,0,1
33119,0,1,0,0,1
33120,0,1,0,0,1
33121,0,1,0,0,1
33122,0,1,0,0,1
33123,0,1,0,0,1
33124,0,1,0,0,1
33125,0,1,0,0,1
33126,0,1,0,0,1
33127,0,1,0,0,1
33128,1,0,0,0,1
33129,0,1,0,0,1
33130,0,1,0,0,1
33131,0,1,0,0,1
33132,0,0,0,1,1
33133,1,0,0,0,1
33134,0,1,0,0,1
33135,0,1,0,0,1
33136,0,0,1,0,1
33137,0,1,0,0,1
33138,0,1,0,0,1
33139,0,1,0,0,1
33140,1,0,0,0,1
33141,0,1,0,0,1
33142,0,1,0,0,1
33143,0,1,0,0,1
33144,0,1,0,0,1
33145,0,1,0,0,1
33146,0,1,0,0,1
33147,0,0,0,1,1
33148,1,0,0,0,1
33149,1,0,0,0,1
33150,0,1,0,0,1
33151,0,1,0,0,1
33152,0,0,1,0,1
33153,1,0,0,0,1
33154,0,1,0,0,1
33155,0,1,0,0,1
33156,0,1,0,0,1
33157,0,1,0,0,1
33158,0,1,0,0,1
33159,0,0,0,1,1
33160,0,1,0,0,1
33161,1,0,0,0,1
33162,0,1,0,0,1
33163,0,1,0,0,1
33164,0,1,0,0,1
33165,0,0,0,1,1
33166,0,0,1,0,1
33167,0,1,0,0,1
33168,1,0,0,0,1
33169,0,1,0,0,1
33170,0,1,0,0,1
33171,0,1,0,0,1
33172,0,1,0,0,1
33173,1,0,0,0,1
33174,0,1,0,0,1
33175,1,0,0,0,1
33176,0,1,0,0,1
33177,0,1,0,0,1
33178,0,1,0,0,1
33179,0,1,0,0,1
33180,1,0,0,0,1
33181,0,1,0,0,1
33182,0,1,0,0,1
33183,0,1,0,0,1
33184,0,1,0,0,1
33185,1,0,0,0,1
33186,0,1,0,0,1
33187,0,1,0,0,1
33188,0,1,0,0,1
33189,1,0,0,0,1
33190,0,1,0,0,1
33191,1,0,0,0,1
33192,0,1,0,0,1
33193,0,1,0,0,1
33194,0,1,0,0,1
33195,0,1,0,0,1
33196,0,1,0,0,1
33197,0,1,0,0,1
33198,0,1,0,0,1
33199,0,1,0,0,1
33200,0,1,0,0,1
33201,1,0,0,0,1
33202,1,0,0,0,1
33203,0,1,0,0,1
33204,0,1,0,0,1
33205,0,0,1,0,1
33206,0,1,0,0,1
33207,0,1,0,0,1
33208,0,0,0,1,1
33209,0,1,0,0,1
33210,1,0,0,0,1
33211,1,0,0,0,1
33212,0,1,0,0,1
33213,1,0,0,0,1
33214,1,0,0,0,1
33215,0,1,0,0,1
33216,0,1,0,0,1
33217,1,0,0,0,1
33218,0,1,0,0,1
33219,1,0,0,0,1
33220,0,1,0,0,1
33221,0,1,0,0,1
33222,0,1,0,0,1
33223,0,1,0,0,1
33224,0,1,0,0,1
33225,0,1,0,0,1
33226,0,1,0,0,1
33227,1,0,0,0,1
33228,1,0,0,0,1
33229,0,1,0,0,1
33230,0,1,0,0,1
33231,0,1,0,0,1
33232,0,1,0,0,1
33233,0,1,0,0,1
33234,0,1,0,0,1
33235,1,0,0,0,1
33236,0,1,0,0,1
33237,0,1,0,0,1
33238,0,1,0,0,1
33239,1,0,0,0,1
33240,0,1,0,0,1
33241,0,1,0,0,1
33242,0,1,0,0,1
33243,0,1,0,0,1
33244,0,1,0,0,1
33245,0,1,0,0,1
33246,0,1,0,0,1
33247,0,1,0,0,1
33248,0,0,0,1,1
33249,0,1,0,0,1
33250,0,1,0,0,1
33251,0,0,1,0,1
33252,0,1,0,0,1
33253,1,0,0,0,1
33254,0,1,0,0,1
33255,0,1,0,0,1
33256,0,1,0,0,1
33257,0,1,0,0,1
33258,0,1,0,0,1
33259,0,1,0,0,1
33260,0,1,0,0,1
33261,0,1,0,0,1
33262,1,0,0,0,1
33263,1,0,0,0,1
33264,0,1,0,0,1
33265,0,1,0,0,1
33266,0,1,0,0,1
33267,0,1,0,0,1
33268,0,1,0,0,1
33269,0,1,0,0,1
33270,0,1,0,0,1
33271,0,1,0,0,1
33272,1,0,0,0,1
33273,0,1,0,0,1
33274,0,1,0,0,1
33275,0,1,0,0,1
33276,0,1,0,0,1
33277,0,1,0,0,1
33278,0,1,0,0,1
33279,0,1,0,0,1
33280,1,0,0,0,1
33281,0,1,0,0,1
33282,0,1,0,0,1
33283,0,1,0,0,1
33284,0,1,0,0,1
33285,0,1,0,0,1
33286,1,0,0,0,1
33287,0,1,0,0,1
33288,0,1,0,0,1
33289,0,1,0,0,1
33290,0,1,0,0,1
33291,0,0,0,1,1
33292,0,1,0,0,1
33293,0,1,0,0,1
33294,0,1,0,0,1
33295,1,0,0,0,1
33296,0,1,0,0,1
33297,0,1,0,0,1
33298,0,1,0,0,1
33299,0,1,0,0,1
33300,0,1,0,0,1
33301,0,1,0,0,1
33302,0,1,0,0,1
33303,0,1,0,0,1
33304,0,1,0,0,1
33305,0,1,0,0,1
33306,0,1,0,0,1
33307,0,1,0,0,1
33308,1,0,0,0,1
33309,0,1,0,0,1
33310,0,1,0,0,1
33311,0,1,0,0,1
33312,0,1,0,0,1
33313,0,1,0,0,1
33314,0,1,0,0,1
33315,0,0,0,1,1
33316,0,1,0,0,1
33317,0,1,0,0,1
33318,0,1,0,0,1
33319,0,1,0,0,1
33320,0,1,0,0,1
33321,1,0,0,0,1
33322,0,1,0,0,1
33323,0,1,0,0,1
33324,0,0,0,1,1
33325,0,1,0,0,1
33326,0,1,0,0,1
33327,0,1,0,0,1
33328,1,0,0,0,1
33329,0,1,0,0,1
33330,0,0,0,1,1
33331,1,0,0,0,1
33332,0,1,0,0,1
33333,0,1,0,0,1
33334,0,1,0,0,1
33335,0,1,0,0,1
33336,0,0,1,0,1
33337,0,1,0,0,1
33338,0,1,0,0,1
33339,0,1,0,0,1
33340,0,1,0,0,1
33341,0,0,0,1,1
33342,0,1,0,0,1
33343,0,1,0,0,1
33344,1,0,0,0,1
33345,0,1,0,0,1
33346,0,1,0,0,1
33347,0,1,0,0,1
33348,0,1,0,0,1
33349,1,0,0,0,1
33350,0,1,0,0,1
33351,0,1,0,0,1
33352,0,1,0,0,1
33353,0,1,0,0,1
33354,0,1,0,0,1
33355,0,1,0,0,1
33356,0,1,0,0,1
33357,0,1,0,0,1
33358,1,0,0,0,1
33359,0,1,0,0,1
33360,0,1,0,0,1
33361,0,1,0,0,1
33362,0,1,0,0,1
33363,1,0,0,0,1
33364,0,1,0,0,1
33365,0,0,0,1,1
33366,0,1,0,0,1
33367,0,1,0,0,1
33368,0,1,0,0,1
33369,1,0,0,0,1
33370,0,1,0,0,1
33371,0,1,0,0,1
33372,0,1,0,0,1
33373,0,1,0,0,1
33374,1,0,0,0,1
33375,0,1,0,0,1
33376,0,1,0,0,1
33377,0,1,0,0,1
33378,0,1,0,0,1
33379,0,0,0,1,1
33380,0,1,0,0,1
33381,1,0,0,0,1
33382,0,1,0,0,1
33383,0,1,0,0,1
33384,1,0,0,0,1
33385,0,1,0,0,1
33386,1,0,0,0,1
33387,1,0,0,0,1
33388,0,1,0,0,1
33389,0,1,0,0,1
33390,0,1,0,0,1
33391,1,0,0,0,1
33392,0,1,0,0,1
33393,0,0,1,0,1
33394,0,1,0,0,1
33395,0,1,0,0,1
33396,0,1,0,0,1
33397,0,1,0,0,1
33398,0,1,0,0,1
33399,0,1,0,0,1
33400,0,1,0,0,1
33401,0,1,0,0,1
33402,0,1,0,0,1
33403,0,1,0,0,1
33404,0,1,0,0,1
33405,1,0,0,0,1
33406,0,1,0,0,1
33407,0,1,0,0,1
33408,0,1,0,0,1
33409,1,0,0,0,1
33410,0,1,0,0,1
33411,0,1,0,0,1
33412,0,1,0,0,1
33413,0,1,0,0,1
33414,1,0,0,0,1
33415,0,1,0,0,1
33416,0,1,0,0,1
33417,0,1,0,0,1
33418,0,1,0,0,1
33419,0,1,0,0,1
33420,1,0,0,0,1
33421,1,0,0,0,1
33422,0,1,0,0,1
33423,1,0,0,0,1
33424,0,0,0,1,1
33425,1,0,0,0,1
33426,0,1,0,0,1
33427,1,0,0,0,1
33428,0,1,0,0,1
33429,0,0,0,1,1
33430,1,0,0,0,1
33431,0,1,0,0,1
33432,0,1,0,0,1
33433,0,1,0,0,1
33434,0,1,0,0,1
33435,0,1,0,0,1
33436,0,1,0,0,1
33437,0,0,0,1,1
33438,0,1,0,0,1
33439,0,1,0,0,1
33440,0,1,0,0,1
33441,0,1,0,0,1
33442,0,1,0,0,1
33443,0,1,0,0,1
33444,0,1,0,0,1
33445,0,1,0,0,1
33446,1,0,0,0,1
33447,0,1,0,0,1
33448,0,1,0,0,1
33449,0,1,0,0,1
33450,1,0,0,0,1
33451,0,1,0,0,1
33452,0,1,0,0,1
33453,0,1,0,0,1
33454,0,1,0,0,1
33455,0,1,0,0,1
33456,0,1,0,0,1
33457,0,1,0,0,1
33458,0,0,0,1,1
33459,0,1,0,0,1
33460,0,1,0,0,1
33461,0,1,0,0,1
33462,1,0,0,0,1
33463,1,0,0,0,1
33464,0,1,0,0,1
33465,0,1,0,0,1
33466,0,1,0,0,1
33467,0,1,0,0,1
33468,0,1,0,0,1
33469,0,1,0,0,1
33470,0,1,0,0,1
33471,0,1,0,0,1
33472,1,0,0,0,1
33473,0,1,0,0,1
33474,0,1,0,0,1
33475,0,1,0,0,1
33476,0,1,0,0,1
33477,0,1,0,0,1
33478,0,1,0,0,1
33479,0,1,0,0,1
33480,0,1,0,0,1
33481,1,0,0,0,1
33482,0,1,0,0,1
33483,0,1,0,0,1
33484,0,1,0,0,1
33485,0,1,0,0,1
33486,0,1,0,0,1
33487,0,1,0,0,1
33488,0,1,0,0,1
33489,1,0,0,0,1
33490,1,0,0,0,1
33491,0,1,0,0,1
33492,0,1,0,0,1
33493,0,1,0,0,1
33494,1,0,0,0,1
33495,0,0,0,1,1
33496,0,1,0,0,1
33497,0,1,0,0,1
33498,1,0,0,0,1
33499,0,1,0,0,1
33500,1,0,0,0,1
33501,0,1,0,0,1
33502,0,1,0,0,1
33503,0,1,0,0,1
33504,0,1,0,0,1
33505,0,1,0,0,1
33506,0,1,0,0,1
33507,1,0,0,0,1
33508,0,1,0,0,1
33509,0,1,0,0,1
33510,0,1,0,0,1
33511,0,1,0,0,1
33512,1,0,0,0,1
33513,0,1,0,0,1
33514,0,1,0,0,1
33515,1,0,0,0,1
33516,1,0,0,0,1
33517,0,1,0,0,1
33518,0,1,0,0,1
33519,0,1,0,0,1
33520,1,0,0,0,1
33521,0,1,0,0,1
33522,0,1,0,0,1
33523,0,1,0,0,1
33524,0,1,0,0,1
33525,0,1,0,0,1
33526,0,1,0,0,1
33527,0,1,0,0,1
33528,0,1,0,0,1
33529,0,1,0,0,1
33530,0,1,0,0,1
33531,0,1,0,0,1
33532,0,1,0,0,1
33533,0,1,0,0,1
33534,0,1,0,0,1
33535,1,0,0,0,1
33536,0,1,0,0,1
33537,0,1,0,0,1
33538,0,1,0,0,1
33539,0,1,0,0,1
33540,0,1,0,0,1
33541,0,1,0,0,1
33542,0,1,0,0,1
33543,1,0,0,0,1
33544,0,1,0,0,1
33545,0,1,0,0,1
33546,1,0,0,0,1
33547,0,1,0,0,1
33548,0,1,0,0,1
33549,0,1,0,0,1
33550,0,1,0,0,1
33551,0,1,0,0,1
33552,0,1,0,0,1
33553,1,0,0,0,1
33554,1,0,0,0,1
33555,0,1,0,0,1
33556,1,0,0,0,1
33557,1,0,0,0,1
33558,0,1,0,0,1
33559,0,1,0,0,1
33560,0,1,0,0,1
33561,0,1,0,0,1
33562,0,1,0,0,1
33563,0,1,0,0,1
33564,0,1,0,0,1
33565,0,1,0,0,1
33566,0,1,0,0,1
33567,0,1,0,0,1
33568,0,1,0,0,1
33569,0,1,0,0,1
33570,0,1,0,0,1
33571,0,1,0,0,1
33572,0,1,0,0,1
33573,0,1,0,0,1
33574,1,0,0,0,1
33575,1,0,0,0,1
33576,0,1,0,0,1
33577,0,1,0,0,1
33578,0,1,0,0,1
33579,0,1,0,0,1
33580,0,1,0,0,1
33581,0,1,0,0,1
33582,0,1,0,0,1
33583,0,0,1,0,1
33584,0,1,0,0,1
33585,0,1,0,0,1
33586,0,1,0,0,1
33587,0,1,0,0,1
33588,1,0,0,0,1
33589,0,1,0,0,1
33590,0,1,0,0,1
33591,0,1,0,0,1
33592,0,1,0,0,1
33593,1,0,0,0,1
33594,0,1,0,0,1
33595,0,1,0,0,1
33596,0,1,0,0,1
33597,1,0,0,0,1
33598,0,1,0,0,1
33599,0,1,0,0,1
33600,0,1,0,0,1
33601,0,1,0,0,1
33602,0,0,1,0,1
33603,0,1,0,0,1
33604,0,0,1,0,1
33605,0,1,0,0,1
33606,0,1,0,0,1
33607,0,1,0,0,1
33608,0,1,0,0,1
33609,0,1,0,0,1
33610,0,1,0,0,1
33611,0,1,0,0,1
33612,0,1,0,0,1
33613,0,1,0,0,1
33614,1,0,0,0,1
33615,0,1,0,0,1
33616,0,1,0,0,1
33617,1,0,0,0,1
33618,0,1,0,0,1
33619,1,0,0,0,1
33620,0,0,0,1,1
33621,0,1,0,0,1
33622,0,1,0,0,1
33623,0,1,0,0,1
33624,0,1,0,0,1
33625,0,1,0,0,1
33626,1,0,0,0,1
33627,0,1,0,0,1
33628,1,0,0,0,1
33629,0,1,0,0,1
33630,0,1,0,0,1
33631,0,0,0,1,1
33632,1,0,0,0,1
33633,0,1,0,0,1
33634,0,1,0,0,1
33635,0,1,0,0,1
33636,1,0,0,0,1
33637,0,1,0,0,1
33638,0,1,0,0,1
33639,0,1,0,0,1
33640,0,0,0,1,1
33641,0,1,0,0,1
33642,0,0,1,0,1
33643,0,0,1,0,1
33644,0,1,0,0,1
33645,0,1,0,0,1
33646,1,0,0,0,1
33647,1,0,0,0,1
33648,0,1,0,0,1
33649,0,1,0,0,1
33650,0,1,0,0,1
33651,0,1,0,0,1
33652,0,1,0,0,1
33653,0,1,0,0,1
33654,1,0,0,0,1
33655,0,1,0,0,1
33656,0,1,0,0,1
33657,0,1,0,0,1
33658,0,1,0,0,1
33659,0,1,0,0,1
33660,0,1,0,0,1
33661,0,1,0,0,1
33662,0,1,0,0,1
33663,1,0,0,0,1
33664,0,1,0,0,1
33665,0,1,0,0,1
33666,0,1,0,0,1
33667,0,1,0,0,1
33668,0,1,0,0,1
33669,0,1,0,0,1
33670,0,1,0,0,1
33671,0,1,0,0,1
33672,1,0,0,0,1
33673,1,0,0,0,1
33674,0,1,0,0,1
33675,0,1,0,0,1
33676,0,0,1,0,1
33677,0,1,0,0,1
33678,0,1,0,0,1
33679,0,1,0,0,1
33680,0,1,0,0,1
33681,1,0,0,0,1
33682,0,1,0,0,1
33683,0,1,0,0,1
33684,0,0,0,1,1
33685,0,1,0,0,1
33686,0,1,0,0,1
33687,0,0,1,0,1
33688,0,1,0,0,1
33689,0,1,0,0,1
33690,1,0,0,0,1
33691,0,1,0,0,1
33692,0,1,0,0,1
33693,0,1,0,0,1
33694,1,0,0,0,1
33695,1,0,0,0,1
33696,0,1,0,0,1
33697,1,0,0,0,1
33698,1,0,0,0,1
33699,0,1,0,0,1
33700,0,1,0,0,1
33701,0,1,0,0,1
33702,0,1,0,0,1
33703,0,0,0,1,1
33704,0,1,0,0,1
33705,0,1,0,0,1
33706,0,1,0,0,1
33707,0,1,0,0,1
33708,0,1,0,0,1
33709,0,1,0,0,1
33710,0,1,0,0,1
33711,1,0,0,0,1
33712,0,1,0,0,1
33713,1,0,0,0,1
33714,0,1,0,0,1
33715,0,1,0,0,1
33716,0,1,0,0,1
33717,0,1,0,0,1
33718,0,1,0,0,1
33719,1,0,0,0,1
33720,0,1,0,0,1
33721,0,1,0,0,1
33722,0,1,0,0,1
33723,0,1,0,0,1
33724,0,1,0,0,1
33725,1,0,0,0,1
33726,0,1,0,0,1
33727,0,1,0,0,1
33728,0,1,0,0,1
33729,0,1,0,0,1
33730,0,1,0,0,1
33731,0,1,0,0,1
33732,0,0,0,1,1
33733,0,1,0,0,1
33734,0,0,0,1,1
33735,0,1,0,0,1
33736,0,1,0,0,1
33737,0,1,0,0,1
33738,0,1,0,0,1
33739,0,1,0,0,1
33740,0,1,0,0,1
33741,0,1,0,0,1
33742,0,1,0,0,1
33743,0,1,0,0,1
33744,0,1,0,0,1
33745,0,1,0,0,1
33746,0,1,0,0,1
33747,0,1,0,0,1
33748,1,0,0,0,1
33749,0,1,0,0,1
33750,1,0,0,0,1
33751,0,1,0,0,1
33752,1,0,0,0,1
33753,0,1,0,0,1
33754,0,1,0,0,1
33755,0,1,0,0,1
33756,1,0,0,0,1
33757,0,1,0,0,1
33758,0,1,0,0,1
33759,0,1,0,0,1
33760,0,1,0,0,1
33761,0,1,0,0,1
33762,0,1,0,0,1
33763,0,1,0,0,1
33764,0,1,0,0,1
33765,1,0,0,0,1
33766,0,1,0,0,1
33767,0,1,0,0,1
33768,0,1,0,0,1
33769,0,1,0,0,1
33770,1,0,0,0,1
33771,0,1,0,0,1
33772,0,1,0,0,1
33773,0,0,0,1,1
33774,0,1,0,0,1
33775,0,1,0,0,1
33776,0,1,0,0,1
33777,1,0,0,0,1
33778,0,1,0,0,1
33779,0,1,0,0,1
33780,0,1,0,0,1
33781,0,1,0,0,1
33782,0,1,0,0,1
33783,0,1,0,0,1
33784,0,1,0,0,1
33785,1,0,0,0,1
33786,0,1,0,0,1
33787,0,1,0,0,1
33788,0,1,0,0,1
33789,0,1,0,0,1
33790,0,1,0,0,1
33791,0,1,0,0,1
33792,0,1,0,0,1
33793,0,1,0,0,1
33794,1,0,0,0,1
33795,0,1,0,0,1
33796,0,1,0,0,1
33797,0,1,0,0,1
33798,1,0,0,0,1
33799,1,0,0,0,1
33800,0,0,0,1,1
33801,0,1,0,0,1
33802,0,1,0,0,1
33803,0,1,0,0,1
33804,0,1,0,0,1
33805,0,1,0,0,1
33806,0,1,0,0,1
33807,0,0,0,1,1
33808,1,0,0,0,1
33809,0,1,0,0,1
33810,0,1,0,0,1
33811,0,1,0,0,1
33812,0,1,0,0,1
33813,0,1,0,0,1
33814,0,1,0,0,1
33815,1,0,0,0,1
33816,0,1,0,0,1
33817,0,1,0,0,1
33818,0,1,0,0,1
33819,0,1,0,0,1
33820,1,0,0,0,1
33821,0,1,0,0,1
33822,0,1,0,0,1
33823,0,1,0,0,1
33824,0,1,0,0,1
33825,0,1,0,0,1
33826,0,1,0,0,1
33827,0,1,0,0,1
33828,0,0,1,0,1
33829,1,0,0,0,1
33830,0,1,0,0,1
33831,0,0,0,1,1
33832,0,1,0,0,1
33833,0,1,0,0,1
33834,1,0,0,0,1
33835,0,1,0,0,1
33836,0,1,0,0,1
33837,0,1,0,0,1
33838,0,1,0,0,1
33839,0,1,0,0,1
33840,1,0,0,0,1
33841,0,1,0,0,1
33842,1,0,0,0,1
33843,0,1,0,0,1
33844,0,1,0,0,1
33845,0,1,0,0,1
33846,0,0,0,1,1
33847,0,1,0,0,1
33848,0,1,0,0,1
33849,0,0,1,0,1
33850,0,1,0,0,1
33851,0,1,0,0,1
33852,0,1,0,0,1
33853,0,1,0,0,1
33854,0,1,0,0,1
33855,1,0,0,0,1
33856,0,1,0,0,1
33857,0,1,0,0,1
33858,0,0,1,0,1
33859,0,1,0,0,1
33860,1,0,0,0,1
33861,0,1,0,0,1
33862,0,1,0,0,1
33863,0,1,0,0,1
33864,0,1,0,0,1
33865,1,0,0,0,1
33866,0,1,0,0,1
33867,0,1,0,0,1
33868,0,1,0,0,1
33869,0,1,0,0,1
33870,0,1,0,0,1
33871,0,1,0,0,1
33872,0,1,0,0,1
33873,0,1,0,0,1
33874,0,1,0,0,1
33875,1,0,0,0,1
33876,0,1,0,0,1
33877,0,0,0,1,1
33878,0,1,0,0,1
33879,0,1,0,0,1
33880,0,1,0,0,1
33881,0,1,0,0,1
33882,0,1,0,0,1
33883,1,0,0,0,1
33884,0,1,0,0,1
33885,0,0,1,0,1
33886,0,1,0,0,1
33887,0,1,0,0,1
33888,0,0,0,1,1
33889,0,1,0,0,1
33890,0,1,0,0,1
33891,0,1,0,0,1
33892,0,1,0,0,1
33893,0,1,0,0,1
33894,0,1,0,0,1
33895,1,0,0,0,1
33896,0,1,0,0,1
33897,1,0,0,0,1
33898,1,0,0,0,1
33899,0,1,0,0,1
33900,0,1,0,0,1
33901,1,0,0,0,1
33902,0,1,0,0,1
33903,1,0,0,0,1
33904,0,1,0,0,1
33905,0,1,0,0,1
33906,1,0,0,0,1
33907,1,0,0,0,1
33908,1,0,0,0,1
33909,0,1,0,0,1
33910,1,0,0,0,1
33911,0,1,0,0,1
33912,1,0,0,0,1
33913,0,1,0,0,1
33914,0,1,0,0,1
33915,0,1,0,0,1
33916,0,1,0,0,1
33917,0,1,0,0,1
33918,0,1,0,0,1
33919,0,0,0,1,1
33920,0,1,0,0,1
33921,0,1,0,0,1
33922,0,1,0,0,1
33923,0,1,0,0,1
33924,0,1,0,0,1
33925,0,1,0,0,1
33926,1,0,0,0,1
33927,0,1,0,0,1
33928,0,1,0,0,1
33929,1,0,0,0,1
33930,0,1,0,0,1
33931,0,1,0,0,1
33932,0,1,0,0,1
33933,0,1,0,0,1
33934,0,1,0,0,1
33935,1,0,0,0,1
33936,0,1,0,0,1
33937,0,1,0,0,1
33938,1,0,0,0,1
33939,0,1,0,0,1
33940,0,1,0,0,1
33941,0,1,0,0,1
33942,0,1,0,0,1
33943,1,0,0,0,1
33944,0,1,0,0,1
33945,0,0,1,0,1
33946,0,1,0,0,1
33947,0,1,0,0,1
33948,0,1,0,0,1
33949,0,1,0,0,1
33950,0,1,0,0,1
33951,0,1,0,0,1
33952,0,1,0,0,1
33953,0,1,0,0,1
33954,1,0,0,0,1
33955,0,1,0,0,1
33956,0,1,0,0,1
33957,0,1,0,0,1
33958,0,1,0,0,1
33959,0,1,0,0,1
33960,0,1,0,0,1
33961,0,1,0,0,1
33962,0,1,0,0,1
33963,1,0,0,0,1
33964,0,1,0,0,1
33965,0,1,0,0,1
33966,0,1,0,0,1
33967,0,1,0,0,1
33968,0,1,0,0,1
33969,1,0,0,0,1
33970,1,0,0,0,1
33971,0,1,0,0,1
33972,0,1,0,0,1
33973,0,0,0,1,1
33974,0,0,1,0,1
33975,1,0,0,0,1
33976,0,1,0,0,1
33977,0,1,0,0,1
33978,0,1,0,0,1
33979,1,0,0,0,1
33980,0,1,0,0,1
33981,0,1,0,0,1
33982,0,1,0,0,1
33983,0,1,0,0,1
33984,0,1,0,0,1
33985,0,1,0,0,1
33986,0,1,0,0,1
33987,1,0,0,0,1
33988,0,1,0,0,1
33989,1,0,0,0,1
33990,0,1,0,0,1
33991,1,0,0,0,1
33992,0,1,0,0,1
33993,0,1,0,0,1
33994,0,1,0,0,1
33995,0,1,0,0,1
33996,0,0,1,0,1
33997,0,0,1,0,1
33998,0,1,0,0,1
33999,0,1,0,0,1
34000,0,1,0,0,1
34001,0,1,0,0,1
34002,0,1,0,0,1
34003,0,1,0,0,1
34004,0,1,0,0,1
34005,0,1,0,0,1
34006,1,0,0,0,1
34007,0,1,0,0,1
34008,0,0,0,1,1
34009,0,1,0,0,1
34010,0,1,0,0,1
34011,0,1,0,0,1
34012,1,0,0,0,1
34013,0,1,0,0,1
34014,0,0,1,0,1
34015,0,1,0,0,1
34016,0,0,1,0,1
34017,0,1,0,0,1
34018,0,1,0,0,1
34019,0,1,0,0,1
34020,0,1,0,0,1
34021,0,1,0,0,1
34022,0,0,0,1,1
34023,0,1,0,0,1
34024,0,1,0,0,1
34025,0,1,0,0,1
34026,1,0,0,0,1
34027,0,1,0,0,1
34028,0,1,0,0,1
34029,0,1,0,0,1
34030,0,1,0,0,1
34031,0,1,0,0,1
34032,0,0,1,0,1
34033,0,1,0,0,1
34034,1,0,0,0,1
34035,0,1,0,0,1
34036,0,1,0,0,1
34037,0,1,0,0,1
34038,1,0,0,0,1
34039,0,1,0,0,1
34040,0,1,0,0,1
34041,1,0,0,0,1
34042,1,0,0,0,1
34043,0,1,0,0,1
34044,1,0,0,0,1
34045,0,1,0,0,1
34046,0,1,0,0,1
34047,0,1,0,0,1
34048,0,1,0,0,1
34049,0,1,0,0,1
34050,0,1,0,0,1
34051,0,1,0,0,1
34052,0,1,0,0,1
34053,0,1,0,0,1
34054,0,1,0,0,1
34055,0,1,0,0,1
34056,0,1,0,0,1
34057,0,1,0,0,1
34058,0,1,0,0,1
34059,0,1,0,0,1
34060,0,1,0,0,1
34061,0,1,0,0,1
34062,0,1,0,0,1
34063,0,1,0,0,1
34064,0,1,0,0,1
34065,0,1,0,0,1
34066,0,1,0,0,1
34067,0,1,0,0,1
34068,0,1,0,0,1
34069,0,1,0,0,1
34070,0,1,0,0,1
34071,0,1,0,0,1
34072,1,0,0,0,1
34073,0,1,0,0,1
34074,0,0,0,1,1
34075,0,1,0,0,1
34076,1,0,0,0,1
34077,0,1,0,0,1
34078,0,1,0,0,1
34079,0,1,0,0,1
34080,0,1,0,0,1
34081,0,1,0,0,1
34082,0,1,0,0,1
34083,0,1,0,0,1
34084,0,1,0,0,1
34085,0,1,0,0,1
34086,0,1,0,0,1
34087,0,1,0,0,1
34088,0,0,1,0,1
34089,1,0,0,0,1
34090,0,1,0,0,1
34091,0,1,0,0,1
34092,0,1,0,0,1
34093,0,1,0,0,1
34094,0,1,0,0,1
34095,0,1,0,0,1
34096,0,1,0,0,1
34097,0,1,0,0,1
34098,0,1,0,0,1
34099,0,1,0,0,1
34100,0,1,0,0,1
34101,0,1,0,0,1
34102,1,0,0,0,1
34103,0,1,0,0,1
34104,0,1,0,0,1
34105,0,1,0,0,1
34106,0,1,0,0,1
34107,0,1,0,0,1
34108,0,0,0,1,1
34109,0,1,0,0,1
34110,0,1,0,0,1
34111,0,1,0,0,1
34112,0,1,0,0,1
34113,0,1,0,0,1
34114,0,1,0,0,1
34115,1,0,0,0,1
34116,0,1,0,0,1
34117,0,1,0,0,1
34118,0,1,0,0,1
34119,0,1,0,0,1
34120,0,0,1,0,1
34121,0,1,0,0,1
34122,1,0,0,0,1
34123,1,0,0,0,1
34124,1,0,0,0,1
34125,0,1,0,0,1
34126,0,1,0,0,1
34127,1,0,0,0,1
34128,0,1,0,0,1
34129,1,0,0,0,1
34130,0,1,0,0,1
34131,1,0,0,0,1
34132,0,1,0,0,1
34133,0,1,0,0,1
34134,1,0,0,0,1
34135,0,1,0,0,1
34136,0,1,0,0,1
34137,0,1,0,0,1
34138,0,1,0,0,1
34139,0,1,0,0,1
34140,0,1,0,0,1
34141,0,0,1,0,1
34142,0,1,0,0,1
34143,1,0,0,0,1
34144,0,1,0,0,1
34145,0,1,0,0,1
34146,0,1,0,0,1
34147,0,1,0,0,1
34148,0,1,0,0,1
34149,0,1,0,0,1
34150,1,0,0,0,1
34151,1,0,0,0,1
34152,1,0,0,0,1
34153,0,1,0,0,1
34154,0,1,0,0,1
34155,0,1,0,0,1
34156,1,0,0,0,1
34157,0,1,0,0,1
34158,0,0,0,1,1
34159,0,1,0,0,1
34160,0,1,0,0,1
34161,0,1,0,0,1
34162,0,1,0,0,1
34163,0,1,0,0,1
34164,0,1,0,0,1
34165,1,0,0,0,1
34166,1,0,0,0,1
34167,0,1,0,0,1
34168,0,1,0,0,1
34169,0,0,0,1,1
34170,1,0,0,0,1
34171,0,1,0,0,1
34172,0,1,0,0,1
34173,0,1,0,0,1
34174,0,1,0,0,1
34175,0,1,0,0,1
34176,0,1,0,0,1
34177,0,1,0,0,1
34178,0,1,0,0,1
34179,0,1,0,0,1
34180,0,1,0,0,1
34181,1,0,0,0,1
34182,0,1,0,0,1
34183,0,1,0,0,1
34184,0,0,1,0,1
34185,0,1,0,0,1
34186,1,0,0,0,1
34187,0,1,0,0,1
34188,1,0,0,0,1
34189,0,1,0,0,1
34190,0,1,0,0,1
34191,0,1,0,0,1
34192,0,1,0,0,1
34193,0,1,0,0,1
34194,0,1,0,0,1
34195,0,1,0,0,1
34196,0,1,0,0,1
34197,0,1,0,0,1
34198,1,0,0,0,1
34199,0,1,0,0,1
34200,0,1,0,0,1
34201,0,1,0,0,1
34202,0,1,0,0,1
34203,0,1,0,0,1
34204,0,1,0,0,1
34205,0,1,0,0,1
34206,0,0,1,0,1
34207,0,1,0,0,1
34208,0,1,0,0,1
34209,0,1,0,0,1
34210,0,1,0,0,1
34211,0,1,0,0,1
34212,0,1,0,0,1
34213,1,0,0,0,1
34214,0,1,0,0,1
34215,0,1,0,0,1
34216,0,1,0,0,1
34217,0,1,0,0,1
34218,0,1,0,0,1
34219,0,1,0,0,1
34220,0,1,0,0,1
34221,0,1,0,0,1
34222,0,1,0,0,1
34223,1,0,0,0,1
34224,0,1,0,0,1
34225,1,0,0,0,1
34226,1,0,0,0,1
34227,0,1,0,0,1
34228,0,1,0,0,1
34229,1,0,0,0,1
34230,0,1,0,0,1
34231,0,1,0,0,1
34232,0,1,0,0,1
34233,0,0,0,1,1
34234,0,1,0,0,1
34235,0,1,0,0,1
34236,0,1,0,0,1
34237,0,1,0,0,1
34238,0,0,0,1,1
34239,0,1,0,0,1
34240,0,1,0,0,1
34241,0,1,0,0,1
34242,1,0,0,0,1
34243,0,1,0,0,1
34244,0,1,0,0,1
34245,0,1,0,0,1
34246,0,1,0,0,1
34247,1,0,0,0,1
34248,0,1,0,0,1
34249,0,1,0,0,1
34250,0,1,0,0,1
34251,0,1,0,0,1
34252,0,1,0,0,1
34253,0,1,0,0,1
34254,0,1,0,0,1
34255,0,1,0,0,1
34256,0,1,0,0,1
34257,0,1,0,0,1
34258,0,1,0,0,1
34259,0,1,0,0,1
34260,0,1,0,0,1
34261,0,1,0,0,1
34262,0,1,0,0,1
34263,1,0,0,0,1
34264,0,1,0,0,1
34265,0,1,0,0,1
34266,0,1,0,0,1
34267,0,1,0,0,1
34268,1,0,0,0,1
34269,0,1,0,0,1
34270,0,1,0,0,1
34271,0,1,0,0,1
34272,0,1,0,0,1
34273,1,0,0,0,1
34274,0,1,0,0,1
34275,0,1,0,0,1
34276,0,1,0,0,1
34277,0,1,0,0,1
34278,0,1,0,0,1
34279,0,1,0,0,1
34280,0,1,0,0,1
34281,0,1,0,0,1
34282,0,1,0,0,1
34283,1,0,0,0,1
34284,0,1,0,0,1
34285,0,1,0,0,1
34286,0,1,0,0,1
34287,0,1,0,0,1
34288,0,1,0,0,1
34289,0,1,0,0,1
34290,0,0,1,0,1
34291,1,0,0,0,1
34292,0,1,0,0,1
34293,0,1,0,0,1
34294,1,0,0,0,1
34295,0,1,0,0,1
34296,0,1,0,0,1
34297,0,1,0,0,1
34298,0,1,0,0,1
34299,0,1,0,0,1
34300,0,1,0,0,1
34301,1,0,0,0,1
34302,0,1,0,0,1
34303,0,1,0,0,1
34304,0,1,0,0,1
34305,1,0,0,0,1
34306,0,1,0,0,1
34307,0,1,0,0,1
34308,0,1,0,0,1
34309,0,1,0,0,1
34310,0,1,0,0,1
34311,1,0,0,0,1
34312,1,0,0,0,1
34313,0,1,0,0,1
34314,0,1,0,0,1
34315,1,0,0,0,1
34316,0,0,0,1,1
34317,0,1,0,0,1
34318,0,1,0,0,1
34319,0,1,0,0,1
34320,0,1,0,0,1
34321,1,0,0,0,1
34322,0,1,0,0,1
34323,0,1,0,0,1
34324,0,1,0,0,1
34325,0,0,0,1,1
34326,0,1,0,0,1
34327,1,0,0,0,1
34328,0,1,0,0,1
34329,0,1,0,0,1
34330,0,1,0,0,1
34331,0,1,0,0,1
34332,0,1,0,0,1
34333,0,1,0,0,1
34334,0,1,0,0,1
34335,0,1,0,0,1
34336,1,0,0,0,1
34337,0,1,0,0,1
34338,1,0,0,0,1
34339,0,0,0,1,1
34340,0,1,0,0,1
34341,0,1,0,0,1
34342,0,0,1,0,1
34343,0,1,0,0,1
34344,1,0,0,0,1
34345,0,1,0,0,1
34346,0,1,0,0,1
34347,0,1,0,0,1
34348,0,1,0,0,1
34349,0,1,0,0,1
34350,0,0,1,0,1
34351,0,1,0,0,1
34352,0,1,0,0,1
34353,1,0,0,0,1
34354,1,0,0,0,1
34355,0,0,0,1,1
34356,0,1,0,0,1
34357,0,1,0,0,1
34358,0,1,0,0,1
34359,0,1,0,0,1
34360,0,1,0,0,1
34361,0,1,0,0,1
34362,1,0,0,0,1
34363,0,1,0,0,1
34364,0,1,0,0,1
34365,0,1,0,0,1
34366,1,0,0,0,1
34367,0,0,0,1,1
34368,0,1,0,0,1
34369,0,1,0,0,1
34370,0,1,0,0,1
34371,1,0,0,0,1
34372,0,1,0,0,1
34373,1,0,0,0,1
34374,0,1,0,0,1
34375,0,1,0,0,1
34376,0,1,0,0,1
34377,0,1,0,0,1
34378,0,1,0,0,1
34379,1,0,0,0,1
34380,0,1,0,0,1
34381,0,1,0,0,1
34382,0,1,0,0,1
34383,0,1,0,0,1
34384,0,1,0,0,1
34385,0,1,0,0,1
34386,0,1,0,0,1
34387,0,1,0,0,1
34388,0,1,0,0,1
34389,0,1,0,0,1
34390,0,1,0,0,1
34391,0,1,0,0,1
34392,0,0,0,1,1
34393,0,1,0,0,1
34394,0,1,0,0,1
34395,0,1,0,0,1
34396,0,1,0,0,1
34397,0,1,0,0,1
34398,0,0,0,1,1
34399,0,1,0,0,1
34400,0,1,0,0,1
34401,0,1,0,0,1
34402,0,1,0,0,1
34403,0,1,0,0,1
34404,0,1,0,0,1
34405,0,1,0,0,1
34406,0,1,0,0,1
34407,0,1,0,0,1
34408,0,1,0,0,1
34409,0,1,0,0,1
34410,0,1,0,0,1
34411,0,1,0,0,1
34412,0,1,0,0,1
34413,0,1,0,0,1
34414,0,1,0,0,1
34415,0,1,0,0,1
34416,0,1,0,0,1
34417,0,1,0,0,1
34418,0,1,0,0,1
34419,0,1,0,0,1
34420,0,1,0,0,1
34421,0,1,0,0,1
34422,0,1,0,0,1
34423,0,1,0,0,1
34424,0,1,0,0,1
34425,1,0,0,0,1
34426,0,0,1,0,1
34427,0,1,0,0,1
34428,0,1,0,0,1
34429,0,1,0,0,1
34430,0,1,0,0,1
34431,0,1,0,0,1
34432,0,1,0,0,1
34433,0,1,0,0,1
34434,0,1,0,0,1
34435,0,1,0,0,1
34436,0,1,0,0,1
34437,0,1,0,0,1
34438,0,1,0,0,1
34439,0,1,0,0,1
34440,1,0,0,0,1
34441,0,1,0,0,1
34442,0,1,0,0,1
34443,0,1,0,0,1
34444,0,1,0,0,1
34445,0,1,0,0,1
34446,0,0,0,1,1
34447,0,1,0,0,1
34448,1,0,0,0,1
34449,0,1,0,0,1
34450,0,1,0,0,1
34451,0,1,0,0,1
34452,0,1,0,0,1
34453,0,1,0,0,1
34454,0,1,0,0,1
34455,0,1,0,0,1
34456,0,1,0,0,1
34457,0,1,0,0,1
34458,0,1,0,0,1
34459,0,1,0,0,1
34460,0,1,0,0,1
34461,0,1,0,0,1
34462,1,0,0,0,1
34463,1,0,0,0,1
34464,0,1,0,0,1
34465,0,1,0,0,1
34466,0,1,0,0,1
34467,0,1,0,0,1
34468,0,1,0,0,1
34469,0,1,0,0,1
34470,0,0,0,1,1
34471,0,1,0,0,1
34472,0,1,0,0,1
34473,0,1,0,0,1
34474,0,1,0,0,1
34475,0,0,0,1,1
34476,0,1,0,0,1
34477,0,1,0,0,1
34478,0,1,0,0,1
34479,0,1,0,0,1
34480,1,0,0,0,1
34481,1,0,0,0,1
34482,0,1,0,0,1
34483,0,1,0,0,1
34484,0,1,0,0,1
34485,0,1,0,0,1
34486,0,1,0,0,1
34487,1,0,0,0,1
34488,0,1,0,0,1
34489,0,1,0,0,1
34490,0,1,0,0,1
34491,0,1,0,0,1
34492,0,1,0,0,1
34493,0,1,0,0,1
34494,0,1,0,0,1
34495,0,1,0,0,1
34496,0,1,0,0,1
34497,1,0,0,0,1
34498,1,0,0,0,1
34499,0,1,0,0,1
34500,0,1,0,0,1
34501,1,0,0,0,1
34502,0,1,0,0,1
34503,0,1,0,0,1
34504,0,1,0,0,1
34505,0,1,0,0,1
34506,0,1,0,0,1
34507,0,1,0,0,1
34508,0,1,0,0,1
34509,1,0,0,0,1
34510,0,1,0,0,1
34511,1,0,0,0,1
34512,0,1,0,0,1
34513,0,1,0,0,1
34514,0,1,0,0,1
34515,1,0,0,0,1
34516,0,1,0,0,1
34517,1,0,0,0,1
34518,0,1,0,0,1
34519,1,0,0,0,1
34520,0,1,0,0,1
34521,0,1,0,0,1
34522,0,1,0,0,1
34523,0,1,0,0,1
34524,1,0,0,0,1
34525,0,1,0,0,1
34526,0,1,0,0,1
34527,0,1,0,0,1
34528,0,1,0,0,1
34529,0,1,0,0,1
34530,0,1,0,0,1
34531,0,1,0,0,1
34532,1,0,0,0,1
34533,0,1,0,0,1
34534,0,1,0,0,1
34535,0,1,0,0,1
34536,0,1,0,0,1
34537,0,1,0,0,1
34538,0,1,0,0,1
34539,0,0,0,1,1
34540,0,1,0,0,1
34541,0,1,0,0,1
34542,0,1,0,0,1
34543,0,1,0,0,1
34544,1,0,0,0,1
34545,0,1,0,0,1
34546,0,1,0,0,1
34547,0,1,0,0,1
34548,0,1,0,0,1
34549,0,1,0,0,1
34550,0,1,0,0,1
34551,0,1,0,0,1
34552,0,1,0,0,1
34553,1,0,0,0,1
34554,0,0,1,0,1
34555,0,1,0,0,1
34556,0,1,0,0,1
34557,0,1,0,0,1
34558,0,1,0,0,1
34559,0,0,1,0,1
34560,0,1,0,0,1
34561,0,1,0,0,1
34562,0,1,0,0,1
34563,0,1,0,0,1
34564,1,0,0,0,1
34565,0,1,0,0,1
34566,0,1,0,0,1
34567,1,0,0,0,1
34568,0,1,0,0,1
34569,0,1,0,0,1
34570,0,1,0,0,1
34571,0,0,1,0,1
34572,0,1,0,0,1
34573,0,1,0,0,1
34574,0,1,0,0,1
34575,0,1,0,0,1
34576,0,1,0,0,1
34577,0,1,0,0,1
34578,0,1,0,0,1
34579,1,0,0,0,1
34580,1,0,0,0,1
34581,0,1,0,0,1
34582,0,1,0,0,1
34583,0,1,0,0,1
34584,0,1,0,0,1
34585,0,1,0,0,1
34586,0,1,0,0,1
34587,0,1,0,0,1
34588,0,1,0,0,1
34589,0,1,0,0,1
34590,0,1,0,0,1
34591,0,1,0,0,1
34592,0,1,0,0,1
34593,0,1,0,0,1
34594,0,1,0,0,1
34595,0,1,0,0,1
34596,0,0,1,0,1
34597,0,1,0,0,1
34598,0,1,0,0,1
34599,0,1,0,0,1
34600,0,1,0,0,1
34601,0,1,0,0,1
34602,0,1,0,0,1
34603,0,1,0,0,1
34604,0,1,0,0,1
34605,0,0,0,1,1
34606,0,1,0,0,1
34607,0,1,0,0,1
34608,0,1,0,0,1
34609,0,1,0,0,1
34610,0,1,0,0,1
34611,1,0,0,0,1
34612,0,1,0,0,1
34613,0,1,0,0,1
34614,0,1,0,0,1
34615,0,1,0,0,1
34616,0,1,0,0,1
34617,0,1,0,0,1
34618,0,1,0,0,1
34619,0,0,0,1,1
34620,0,1,0,0,1
34621,0,1,0,0,1
34622,0,1,0,0,1
34623,0,1,0,0,1
34624,1,0,0,0,1
34625,0,1,0,0,1
34626,0,1,0,0,1
34627,0,1,0,0,1
34628,0,1,0,0,1
34629,0,1,0,0,1
34630,0,1,0,0,1
34631,0,1,0,0,1
34632,0,1,0,0,1
34633,0,1,0,0,1
34634,0,1,0,0,1
34635,0,0,1,0,1
34636,0,0,0,1,1
34637,0,1,0,0,1
34638,0,1,0,0,1
34639,0,1,0,0,1
34640,0,1,0,0,1
34641,0,1,0,0,1
34642,0,0,0,1,1
34643,1,0,0,0,1
34644,1,0,0,0,1
34645,0,1,0,0,1
34646,0,1,0,0,1
34647,1,0,0,0,1
34648,0,1,0,0,1
34649,0,0,1,0,1
34650,0,1,0,0,1
34651,0,1,0,0,1
34652,0,1,0,0,1
34653,0,1,0,0,1
34654,0,1,0,0,1
34655,1,0,0,0,1
34656,0,1,0,0,1
34657,1,0,0,0,1
34658,0,1,0,0,1
34659,0,1,0,0,1
34660,0,1,0,0,1
34661,0,1,0,0,1
34662,0,1,0,0,1
34663,0,1,0,0,1
34664,0,1,0,0,1
34665,0,1,0,0,1
34666,0,1,0,0,1
34667,0,1,0,0,1
34668,0,1,0,0,1
34669,0,1,0,0,1
34670,0,1,0,0,1
34671,0,1,0,0,1
34672,0,1,0,0,1
34673,1,0,0,0,1
34674,0,1,0,0,1
34675,0,1,0,0,1
34676,0,1,0,0,1
34677,0,1,0,0,1
34678,0,1,0,0,1
34679,0,1,0,0,1
34680,0,1,0,0,1
34681,0,1,0,0,1
34682,0,1,0,0,1
34683,1,0,0,0,1
34684,0,1,0,0,1
34685,0,1,0,0,1
34686,0,0,1,0,1
34687,0,1,0,0,1
34688,0,1,0,0,1
34689,0,1,0,0,1
34690,0,1,0,0,1
34691,0,1,0,0,1
34692,0,1,0,0,1
34693,0,1,0,0,1
34694,0,1,0,0,1
34695,1,0,0,0,1
34696,0,1,0,0,1
34697,0,0,0,1,1
34698,0,1,0,0,1
34699,0,1,0,0,1
34700,0,1,0,0,1
34701,0,1,0,0,1
34702,0,1,0,0,1
34703,0,1,0,0,1
34704,0,1,0,0,1
34705,0,1,0,0,1
34706,0,1,0,0,1
34707,0,1,0,0,1
34708,0,1,0,0,1
34709,0,1,0,0,1
34710,0,1,0,0,1
34711,0,1,0,0,1
34712,0,1,0,0,1
34713,0,1,0,0,1
34714,0,1,0,0,1
34715,0,1,0,0,1
34716,0,1,0,0,1
34717,0,1,0,0,1
34718,1,0,0,0,1
34719,0,1,0,0,1
34720,0,1,0,0,1
34721,0,1,0,0,1
34722,1,0,0,0,1
34723,0,1,0,0,1
34724,0,1,0,0,1
34725,0,1,0,0,1
34726,0,1,0,0,1
34727,0,1,0,0,1
34728,0,1,0,0,1
34729,0,1,0,0,1
34730,0,1,0,0,1
34731,0,1,0,0,1
34732,0,1,0,0,1
34733,0,1,0,0,1
34734,1,0,0,0,1
34735,0,1,0,0,1
34736,1,0,0,0,1
34737,0,1,0,0,1
34738,0,0,0,1,1
34739,0,1,0,0,1
34740,0,1,0,0,1
34741,0,1,0,0,1
34742,0,1,0,0,1
34743,0,1,0,0,1
34744,0,1,0,0,1
34745,1,0,0,0,1
34746,0,1,0,0,1
34747,0,1,0,0,1
34748,0,1,0,0,1
34749,1,0,0,0,1
34750,0,1,0,0,1
34751,0,1,0,0,1
34752,0,1,0,0,1
34753,0,1,0,0,1
34754,0,1,0,0,1
34755,0,1,0,0,1
34756,1,0,0,0,1
34757,0,1,0,0,1
34758,0,1,0,0,1
34759,0,1,0,0,1
34760,0,1,0,0,1
34761,0,1,0,0,1
34762,0,1,0,0,1
34763,0,1,0,0,1
34764,0,1,0,0,1
34765,0,1,0,0,1
34766,0,0,0,1,1
34767,0,1,0,0,1
34768,1,0,0,0,1
34769,0,1,0,0,1
34770,0,1,0,0,1
34771,1,0,0,0,1
34772,0,0,0,1,1
34773,0,1,0,0,1
34774,1,0,0,0,1
34775,0,1,0,0,1
34776,0,1,0,0,1
34777,0,1,0,0,1
34778,0,1,0,0,1
34779,0,1,0,0,1
34780,0,1,0,0,1
34781,0,1,0,0,1
34782,0,1,0,0,1
34783,0,1,0,0,1
34784,0,1,0,0,1
34785,0,1,0,0,1
34786,0,1,0,0,1
34787,0,1,0,0,1
34788,0,1,0,0,1
34789,1,0,0,0,1
34790,0,1,0,0,1
34791,0,1,0,0,1
34792,0,1,0,0,1
34793,0,1,0,0,1
34794,0,1,0,0,1
34795,0,1,0,0,1
34796,0,1,0,0,1
34797,0,1,0,0,1
34798,0,1,0,0,1
34799,0,1,0,0,1
34800,0,0,1,0,1
34801,0,1,0,0,1
34802,0,1,0,0,1
34803,0,1,0,0,1
34804,0,0,0,1,1
34805,0,1,0,0,1
34806,0,1,0,0,1
34807,0,1,0,0,1
34808,0,1,0,0,1
34809,0,1,0,0,1
34810,0,1,0,0,1
34811,0,1,0,0,1
34812,0,1,0,0,1
34813,0,1,0,0,1
34814,1,0,0,0,1
34815,0,1,0,0,1
34816,0,1,0,0,1
34817,1,0,0,0,1
34818,0,1,0,0,1
34819,0,1,0,0,1
34820,1,0,0,0,1
34821,0,1,0,0,1
34822,0,0,0,1,1
34823,0,1,0,0,1
34824,0,1,0,0,1
34825,0,1,0,0,1
34826,0,1,0,0,1
34827,0,1,0,0,1
34828,0,1,0,0,1
34829,0,1,0,0,1
34830,0,1,0,0,1
34831,0,1,0,0,1
34832,1,0,0,0,1
34833,0,1,0,0,1
34834,0,1,0,0,1
34835,0,1,0,0,1
34836,0,0,0,1,1
34837,0,1,0,0,1
34838,0,1,0,0,1
34839,0,1,0,0,1
34840,0,1,0,0,1
34841,0,1,0,0,1
34842,0,1,0,0,1
34843,0,1,0,0,1
34844,1,0,0,0,1
34845,0,1,0,0,1
34846,0,1,0,0,1
34847,0,1,0,0,1
34848,0,1,0,0,1
34849,0,1,0,0,1
34850,1,0,0,0,1
34851,0,1,0,0,1
34852,0,1,0,0,1
34853,0,1,0,0,1
34854,0,1,0,0,1
34855,0,1,0,0,1
34856,1,0,0,0,1
34857,0,1,0,0,1
34858,1,0,0,0,1
34859,0,1,0,0,1
34860,1,0,0,0,1
34861,0,1,0,0,1
34862,0,1,0,0,1
34863,0,1,0,0,1
34864,1,0,0,0,1
34865,1,0,0,0,1
34866,0,1,0,0,1
34867,0,1,0,0,1
34868,0,1,0,0,1
34869,0,1,0,0,1
34870,0,1,0,0,1
34871,0,1,0,0,1
34872,1,0,0,0,1
34873,1,0,0,0,1
34874,0,1,0,0,1
34875,1,0,0,0,1
34876,0,1,0,0,1
34877,0,1,0,0,1
34878,0,1,0,0,1
34879,0,1,0,0,1
34880,0,1,0,0,1
34881,0,1,0,0,1
34882,0,1,0,0,1
34883,0,1,0,0,1
34884,0,1,0,0,1
34885,0,1,0,0,1
34886,0,1,0,0,1
34887,0,1,0,0,1
34888,1,0,0,0,1
34889,0,1,0,0,1
34890,0,1,0,0,1
34891,0,1,0,0,1
34892,0,1,0,0,1
34893,0,0,1,0,1
34894,0,1,0,0,1
34895,1,0,0,0,1
34896,0,1,0,0,1
34897,0,1,0,0,1
34898,0,1,0,0,1
34899,1,0,0,0,1
34900,0,1,0,0,1
34901,1,0,0,0,1
34902,0,1,0,0,1
34903,0,1,0,0,1
34904,0,1,0,0,1
34905,0,1,0,0,1
34906,1,0,0,0,1
34907,0,1,0,0,1
34908,0,1,0,0,1
34909,0,1,0,0,1
34910,0,1,0,0,1
34911,0,1,0,0,1
34912,0,1,0,0,1
34913,0,1,0,0,1
34914,0,1,0,0,1
34915,0,1,0,0,1
34916,0,1,0,0,1
34917,0,0,1,0,1
34918,0,1,0,0,1
34919,0,1,0,0,1
34920,0,1,0,0,1
34921,0,1,0,0,1
34922,0,1,0,0,1
34923,0,1,0,0,1
34924,1,0,0,0,1
34925,0,1,0,0,1
34926,0,0,1,0,1
34927,1,0,0,0,1
34928,0,1,0,0,1
34929,0,1,0,0,1
34930,1,0,0,0,1
34931,0,1,0,0,1
34932,0,1,0,0,1
34933,0,1,0,0,1
34934,0,1,0,0,1
34935,0,1,0,0,1
34936,0,1,0,0,1
34937,0,1,0,0,1
34938,0,1,0,0,1
34939,0,1,0,0,1
34940,0,1,0,0,1
34941,1,0,0,0,1
34942,0,1,0,0,1
34943,0,1,0,0,1
34944,1,0,0,0,1
34945,0,0,0,1,1
34946,0,1,0,0,1
34947,0,1,0,0,1
34948,0,1,0,0,1
34949,0,1,0,0,1
34950,0,1,0,0,1
34951,0,1,0,0,1
34952,0,1,0,0,1
34953,0,1,0,0,1
34954,0,1,0,0,1
34955,0,1,0,0,1
34956,0,1,0,0,1
34957,0,1,0,0,1
34958,0,1,0,0,1
34959,0,1,0,0,1
34960,0,1,0,0,1
34961,1,0,0,0,1
34962,1,0,0,0,1
34963,0,1,0,0,1
34964,0,0,1,0,1
34965,0,1,0,0,1
34966,0,1,0,0,1
34967,0,1,0,0,1
34968,0,1,0,0,1
34969,0,1,0,0,1
34970,0,0,0,1,1
34971,0,1,0,0,1
34972,0,1,0,0,1
34973,1,0,0,0,1
34974,0,1,0,0,1
34975,0,1,0,0,1
34976,0,1,0,0,1
34977,1,0,0,0,1
34978,0,1,0,0,1
34979,1,0,0,0,1
34980,0,1,0,0,1
34981,0,1,0,0,1
34982,0,1,0,0,1
34983,1,0,0,0,1
34984,0,1,0,0,1
34985,0,1,0,0,1
34986,1,0,0,0,1
34987,0,1,0,0,1
34988,0,1,0,0,1
34989,0,1,0,0,1
34990,0,1,0,0,1
34991,0,1,0,0,1
34992,1,0,0,0,1
34993,0,1,0,0,1
34994,0,1,0,0,1
34995,0,1,0,0,1
34996,1,0,0,0,1
34997,0,0,1,0,1
34998,0,1,0,0,1
34999,0,1,0,0,1
35000,0,1,0,0,1
35001,0,1,0,0,1
35002,0,1,0,0,1
35003,0,1,0,0,1
35004,0,1,0,0,1
35005,0,1,0,0,1
35006,1,0,0,0,1
35007,0,1,0,0,1
35008,0,1,0,0,1
35009,0,1,0,0,1
35010,0,1,0,0,1
35011,1,0,0,0,1
35012,1,0,0,0,1
35013,0,1,0,0,1
35014,0,1,0,0,1
35015,0,1,0,0,1
35016,1,0,0,0,1
35017,0,1,0,0,1
35018,0,1,0,0,1
35019,0,1,0,0,1
35020,1,0,0,0,1
35021,0,1,0,0,1
35022,0,1,0,0,1
35023,0,1,0,0,1
35024,0,1,0,0,1
35025,0,1,0,0,1
35026,0,1,0,0,1
35027,0,1,0,0,1
35028,1,0,0,0,1
35029,1,0,0,0,1
35030,1,0,0,0,1
35031,1,0,0,0,1
35032,0,1,0,0,1
35033,0,0,1,0,1
35034,0,1,0,0,1
35035,1,0,0,0,1
35036,1,0,0,0,1
35037,0,1,0,0,1
35038,0,1,0,0,1
35039,0,0,1,0,1
35040,0,1,0,0,1
35041,0,1,0,0,1
35042,0,1,0,0,1
35043,0,1,0,0,1
35044,0,1,0,0,1
35045,0,1,0,0,1
35046,0,1,0,0,1
35047,0,1,0,0,1
35048,0,1,0,0,1
35049,0,1,0,0,1
35050,0,1,0,0,1
35051,0,1,0,0,1
35052,0,1,0,0,1
35053,0,1,0,0,1
35054,0,1,0,0,1
35055,0,1,0,0,1
35056,0,1,0,0,1
35057,0,1,0,0,1
35058,0,1,0,0,1
35059,0,1,0,0,1
35060,1,0,0,0,1
35061,0,1,0,0,1
35062,0,1,0,0,1
35063,1,0,0,0,1
35064,1,0,0,0,1
35065,1,0,0,0,1
35066,0,1,0,0,1
35067,0,1,0,0,1
35068,0,1,0,0,1
35069,0,1,0,0,1
35070,0,1,0,0,1
35071,0,1,0,0,1
35072,0,1,0,0,1
35073,0,1,0,0,1
35074,0,1,0,0,1
35075,0,1,0,0,1
35076,0,1,0,0,1
35077,0,1,0,0,1
35078,0,1,0,0,1
35079,0,1,0,0,1
35080,0,1,0,0,1
35081,1,0,0,0,1
35082,0,0,1,0,1
35083,0,1,0,0,1
35084,0,1,0,0,1
35085,0,1,0,0,1
35086,0,1,0,0,1
35087,0,1,0,0,1
35088,0,1,0,0,1
35089,0,1,0,0,1
35090,0,1,0,0,1
35091,0,1,0,0,1
35092,0,1,0,0,1
35093,0,0,0,1,1
35094,0,1,0,0,1
35095,0,1,0,0,1
35096,0,1,0,0,1
35097,1,0,0,0,1
35098,0,1,0,0,1
35099,0,1,0,0,1
35100,0,1,0,0,1
35101,0,1,0,0,1
35102,0,1,0,0,1
35103,1,0,0,0,1
35104,1,0,0,0,1
35105,0,1,0,0,1
35106,0,1,0,0,1
35107,0,1,0,0,1
35108,0,1,0,0,1
35109,0,1,0,0,1
35110,0,1,0,0,1
35111,0,0,1,0,1
35112,0,1,0,0,1
35113,0,1,0,0,1
35114,0,1,0,0,1
35115,1,0,0,0,1
35116,0,1,0,0,1
35117,1,0,0,0,1
35118,0,1,0,0,1
35119,0,1,0,0,1
35120,0,1,0,0,1
35121,0,0,0,1,1
35122,0,1,0,0,1
35123,0,1,0,0,1
35124,0,1,0,0,1
35125,1,0,0,0,1
35126,0,1,0,0,1
35127,0,1,0,0,1
35128,1,0,0,0,1
35129,0,1,0,0,1
35130,0,1,0,0,1
35131,1,0,0,0,1
35132,0,1,0,0,1
35133,0,1,0,0,1
35134,0,1,0,0,1
35135,0,1,0,0,1
35136,0,1,0,0,1
35137,0,1,0,0,1
35138,1,0,0,0,1
35139,0,0,0,1,1
35140,1,0,0,0,1
35141,0,1,0,0,1
35142,0,1,0,0,1
35143,0,0,0,1,1
35144,0,1,0,0,1
35145,0,0,0,1,1
35146,0,1,0,0,1
35147,0,1,0,0,1
35148,0,1,0,0,1
35149,0,1,0,0,1
35150,0,1,0,0,1
35151,0,1,0,0,1
35152,0,1,0,0,1
35153,0,1,0,0,1
35154,0,0,1,0,1
35155,0,1,0,0,1
35156,0,1,0,0,1
35157,0,0,1,0,1
35158,0,1,0,0,1
35159,0,1,0,0,1
35160,1,0,0,0,1
35161,0,1,0,0,1
35162,0,1,0,0,1
35163,0,1,0,0,1
35164,0,1,0,0,1
35165,0,0,0,1,1
35166,0,1,0,0,1
35167,0,1,0,0,1
35168,0,1,0,0,1
35169,0,1,0,0,1
35170,1,0,0,0,1
35171,1,0,0,0,1
35172,0,1,0,0,1
35173,0,0,0,1,1
35174,0,1,0,0,1
35175,0,1,0,0,1
35176,1,0,0,0,1
35177,0,1,0,0,1
35178,0,1,0,0,1
35179,0,1,0,0,1
35180,0,1,0,0,1
35181,0,1,0,0,1
35182,0,1,0,0,1
35183,0,1,0,0,1
35184,0,1,0,0,1
35185,0,0,0,1,1
35186,0,1,0,0,1
35187,0,1,0,0,1
35188,0,1,0,0,1
35189,0,1,0,0,1
35190,1,0,0,0,1
35191,0,1,0,0,1
35192,0,1,0,0,1
35193,0,1,0,0,1
35194,1,0,0,0,1
35195,0,1,0,0,1
35196,0,1,0,0,1
35197,0,1,0,0,1
35198,0,1,0,0,1
35199,1,0,0,0,1
35200,0,1,0,0,1
35201,1,0,0,0,1
35202,0,1,0,0,1
35203,0,1,0,0,1
35204,0,1,0,0,1
35205,1,0,0,0,1
35206,0,1,0,0,1
35207,0,1,0,0,1
35208,0,1,0,0,1
35209,0,1,0,0,1
35210,0,0,0,1,1
35211,0,1,0,0,1
35212,1,0,0,0,1
35213,1,0,0,0,1
35214,0,1,0,0,1
35215,0,1,0,0,1
35216,0,1,0,0,1
35217,1,0,0,0,1
35218,1,0,0,0,1
35219,0,1,0,0,1
35220,0,1,0,0,1
35221,1,0,0,0,1
35222,0,1,0,0,1
35223,0,1,0,0,1
35224,0,1,0,0,1
35225,0,1,0,0,1
35226,0,1,0,0,1
35227,0,1,0,0,1
35228,0,1,0,0,1
35229,1,0,0,0,1
35230,0,1,0,0,1
35231,0,1,0,0,1
35232,0,1,0,0,1
35233,0,1,0,0,1
35234,0,1,0,0,1
35235,0,1,0,0,1
35236,0,1,0,0,1
35237,0,1,0,0,1
35238,1,0,0,0,1
35239,0,0,0,1,1
35240,0,1,0,0,1
35241,0,1,0,0,1
35242,1,0,0,0,1
35243,0,1,0,0,1
35244,0,1,0,0,1
35245,0,1,0,0,1
35246,0,1,0,0,1
35247,1,0,0,0,1
35248,0,1,0,0,1
35249,1,0,0,0,1
35250,1,0,0,0,1
35251,0,1,0,0,1
35252,0,1,0,0,1
35253,0,1,0,0,1
35254,0,1,0,0,1
35255,0,1,0,0,1
35256,0,0,1,0,1
35257,1,0,0,0,1
35258,1,0,0,0,1
35259,0,1,0,0,1
35260,0,0,1,0,1
35261,0,1,0,0,1
35262,0,1,0,0,1
35263,0,1,0,0,1
35264,0,1,0,0,1
35265,0,1,0,0,1
35266,0,1,0,0,1
35267,0,1,0,0,1
35268,0,1,0,0,1
35269,0,1,0,0,1
35270,0,1,0,0,1
35271,0,1,0,0,1
35272,1,0,0,0,1
35273,1,0,0,0,1
35274,0,1,0,0,1
35275,0,1,0,0,1
35276,0,1,0,0,1
35277,1,0,0,0,1
35278,1,0,0,0,1
35279,0,1,0,0,1
35280,0,1,0,0,1
35281,0,1,0,0,1
35282,0,1,0,0,1
35283,0,1,0,0,1
35284,0,1,0,0,1
35285,0,1,0,0,1
35286,0,1,0,0,1
35287,0,1,0,0,1
35288,0,1,0,0,1
35289,0,1,0,0,1
35290,0,1,0,0,1
35291,0,1,0,0,1
35292,0,1,0,0,1
35293,0,1,0,0,1
35294,0,1,0,0,1
35295,0,1,0,0,1
35296,0,0,1,0,1
35297,0,1,0,0,1
35298,0,0,0,1,1
35299,1,0,0,0,1
35300,0,1,0,0,1
35301,0,1,0,0,1
35302,1,0,0,0,1
35303,0,1,0,0,1
35304,0,1,0,0,1
35305,0,1,0,0,1
35306,0,1,0,0,1
35307,0,1,0,0,1
35308,0,1,0,0,1
35309,0,1,0,0,1
35310,0,1,0,0,1
35311,0,1,0,0,1
35312,0,1,0,0,1
35313,0,1,0,0,1
35314,0,1,0,0,1
35315,0,1,0,0,1
35316,0,1,0,0,1
35317,1,0,0,0,1
35318,1,0,0,0,1
35319,0,1,0,0,1
35320,0,1,0,0,1
35321,1,0,0,0,1
35322,0,0,0,1,1
35323,0,1,0,0,1
35324,0,0,0,1,1
35325,0,1,0,0,1
35326,0,1,0,0,1
35327,1,0,0,0,1
35328,0,0,0,1,1
35329,0,1,0,0,1
35330,0,1,0,0,1
35331,0,1,0,0,1
35332,0,1,0,0,1
35333,0,1,0,0,1
35334,0,1,0,0,1
35335,1,0,0,0,1
35336,0,1,0,0,1
35337,0,1,0,0,1
35338,1,0,0,0,1
35339,0,1,0,0,1
35340,0,1,0,0,1
35341,0,1,0,0,1
35342,1,0,0,0,1
35343,0,1,0,0,1
35344,0,1,0,0,1
35345,0,1,0,0,1
35346,0,1,0,0,1
35347,0,1,0,0,1
35348,0,1,0,0,1
35349,1,0,0,0,1
35350,0,1,0,0,1
35351,1,0,0,0,1
35352,0,0,1,0,1
35353,0,1,0,0,1
35354,0,1,0,0,1
35355,0,1,0,0,1
35356,0,1,0,0,1
35357,0,1,0,0,1
35358,0,1,0,0,1
35359,0,1,0,0,1
35360,0,1,0,0,1
35361,0,1,0,0,1
35362,0,1,0,0,1
35363,0,1,0,0,1
35364,1,0,0,0,1
35365,1,0,0,0,1
35366,0,1,0,0,1
35367,0,1,0,0,1
35368,0,1,0,0,1
35369,1,0,0,0,1
35370,0,1,0,0,1
35371,1,0,0,0,1
35372,1,0,0,0,1
35373,0,1,0,0,1
35374,0,1,0,0,1
35375,0,1,0,0,1
35376,1,0,0,0,1
35377,0,1,0,0,1
35378,0,1,0,0,1
35379,0,1,0,0,1
35380,0,1,0,0,1
35381,0,1,0,0,1
35382,0,1,0,0,1
35383,1,0,0,0,1
35384,1,0,0,0,1
35385,0,1,0,0,1
35386,0,1,0,0,1
35387,0,1,0,0,1
35388,0,1,0,0,1
35389,0,1,0,0,1
35390,0,1,0,0,1
35391,1,0,0,0,1
35392,1,0,0,0,1
35393,1,0,0,0,1
35394,0,1,0,0,1
35395,0,1,0,0,1
35396,1,0,0,0,1
35397,0,1,0,0,1
35398,0,1,0,0,1
35399,0,1,0,0,1
35400,1,0,0,0,1
35401,1,0,0,0,1
35402,0,1,0,0,1
35403,0,1,0,0,1
35404,0,1,0,0,1
35405,0,1,0,0,1
35406,0,1,0,0,1
35407,0,1,0,0,1
35408,0,1,0,0,1
35409,0,1,0,0,1
35410,0,1,0,0,1
35411,0,0,0,1,1
35412,1,0,0,0,1
35413,0,1,0,0,1
35414,0,1,0,0,1
35415,0,1,0,0,1
35416,0,1,0,0,1
35417,1,0,0,0,1
35418,0,1,0,0,1
35419,0,1,0,0,1
35420,1,0,0,0,1
35421,1,0,0,0,1
35422,0,1,0,0,1
35423,0,1,0,0,1
35424,0,1,0,0,1
35425,0,1,0,0,1
35426,1,0,0,0,1
35427,0,1,0,0,1
35428,0,0,0,1,1
35429,0,1,0,0,1
35430,0,1,0,0,1
35431,0,1,0,0,1
35432,0,1,0,0,1
35433,0,1,0,0,1
35434,0,1,0,0,1
35435,0,1,0,0,1
35436,0,1,0,0,1
35437,0,1,0,0,1
35438,0,1,0,0,1
35439,1,0,0,0,1
35440,0,1,0,0,1
35441,1,0,0,0,1
35442,0,1,0,0,1
35443,0,1,0,0,1
35444,0,1,0,0,1
35445,0,1,0,0,1
35446,0,1,0,0,1
35447,0,1,0,0,1
35448,1,0,0,0,1
35449,1,0,0,0,1
35450,0,1,0,0,1
35451,0,1,0,0,1
35452,0,1,0,0,1
35453,0,1,0,0,1
35454,0,1,0,0,1
35455,1,0,0,0,1
35456,0,1,0,0,1
35457,0,1,0,0,1
35458,0,1,0,0,1
35459,0,1,0,0,1
35460,0,1,0,0,1
35461,1,0,0,0,1
35462,1,0,0,0,1
35463,1,0,0,0,1
35464,1,0,0,0,1
35465,0,1,0,0,1
35466,1,0,0,0,1
35467,0,1,0,0,1
35468,0,1,0,0,1
35469,1,0,0,0,1
35470,0,1,0,0,1
35471,0,1,0,0,1
35472,0,1,0,0,1
35473,0,1,0,0,1
35474,1,0,0,0,1
35475,0,1,0,0,1
35476,0,0,0,1,1
35477,0,1,0,0,1
35478,0,1,0,0,1
35479,0,1,0,0,1
35480,0,1,0,0,1
35481,0,1,0,0,1
35482,0,1,0,0,1
35483,0,1,0,0,1
35484,1,0,0,0,1
35485,0,1,0,0,1
35486,0,1,0,0,1
35487,0,1,0,0,1
35488,0,1,0,0,1
35489,1,0,0,0,1
35490,0,0,1,0,1
35491,0,1,0,0,1
35492,0,1,0,0,1
35493,0,1,0,0,1
35494,0,0,0,1,1
35495,0,1,0,0,1
35496,0,1,0,0,1
35497,0,1,0,0,1
35498,0,1,0,0,1
35499,0,1,0,0,1
35500,0,1,0,0,1
35501,0,1,0,0,1
35502,0,1,0,0,1
35503,0,1,0,0,1
35504,1,0,0,0,1
35505,0,1,0,0,1
35506,0,1,0,0,1
35507,0,1,0,0,1
35508,1,0,0,0,1
35509,0,1,0,0,1
35510,0,1,0,0,1
35511,0,0,1,0,1
35512,0,1,0,0,1
35513,0,1,0,0,1
35514,1,0,0,0,1
35515,0,1,0,0,1
35516,0,1,0,0,1
35517,0,1,0,0,1
35518,0,1,0,0,1
35519,0,1,0,0,1
35520,0,1,0,0,1
35521,0,1,0,0,1
35522,0,1,0,0,1
35523,0,1,0,0,1
35524,0,1,0,0,1
35525,0,1,0,0,1
35526,0,1,0,0,1
35527,0,1,0,0,1
35528,0,0,1,0,1
35529,1,0,0,0,1
35530,0,1,0,0,1
35531,0,1,0,0,1
35532,0,1,0,0,1
35533,0,1,0,0,1
35534,0,1,0,0,1
35535,1,0,0,0,1
35536,0,1,0,0,1
35537,0,1,0,0,1
35538,0,1,0,0,1
35539,0,1,0,0,1
35540,0,1,0,0,1
35541,1,0,0,0,1
35542,0,1,0,0,1
35543,0,1,0,0,1
35544,0,1,0,0,1
35545,1,0,0,0,1
35546,0,1,0,0,1
35547,0,1,0,0,1
35548,0,1,0,0,1
35549,0,1,0,0,1
35550,0,1,0,0,1
35551,0,1,0,0,1
35552,0,1,0,0,1
35553,0,1,0,0,1
35554,0,1,0,0,1
35555,0,1,0,0,1
35556,0,1,0,0,1
35557,0,1,0,0,1
35558,0,1,0,0,1
35559,0,1,0,0,1
35560,0,1,0,0,1
35561,0,1,0,0,1
35562,0,0,0,1,1
35563,0,1,0,0,1
35564,0,1,0,0,1
35565,0,1,0,0,1
35566,0,1,0,0,1
35567,0,1,0,0,1
35568,0,1,0,0,1
35569,0,1,0,0,1
35570,0,0,0,1,1
35571,0,1,0,0,1
35572,0,1,0,0,1
35573,1,0,0,0,1
35574,0,1,0,0,1
35575,0,1,0,0,1
35576,0,1,0,0,1
35577,0,1,0,0,1
35578,0,1,0,0,1
35579,1,0,0,0,1
35580,0,1,0,0,1
35581,1,0,0,0,1
35582,1,0,0,0,1
35583,0,1,0,0,1
35584,1,0,0,0,1
35585,0,1,0,0,1
35586,0,1,0,0,1
35587,0,0,1,0,1
35588,0,0,0,1,1
35589,0,1,0,0,1
35590,0,1,0,0,1
35591,0,1,0,0,1
35592,0,1,0,0,1
35593,0,0,0,1,1
35594,0,1,0,0,1
35595,0,1,0,0,1
35596,0,1,0,0,1
35597,0,1,0,0,1
35598,0,1,0,0,1
35599,0,1,0,0,1
35600,0,1,0,0,1
35601,0,1,0,0,1
35602,0,1,0,0,1
35603,0,1,0,0,1
35604,0,1,0,0,1
35605,0,1,0,0,1
35606,0,1,0,0,1
35607,0,1,0,0,1
35608,0,1,0,0,1
35609,1,0,0,0,1
35610,0,1,0,0,1
35611,0,1,0,0,1
35612,0,1,0,0,1
35613,0,1,0,0,1
35614,0,0,0,1,1
35615,0,1,0,0,1
35616,0,1,0,0,1
35617,1,0,0,0,1
35618,0,0,1,0,1
35619,0,1,0,0,1
35620,0,1,0,0,1
35621,0,1,0,0,1
35622,0,1,0,0,1
35623,1,0,0,0,1
35624,0,1,0,0,1
35625,1,0,0,0,1
35626,0,1,0,0,1
35627,1,0,0,0,1
35628,0,0,0,1,1
35629,0,1,0,0,1
35630,0,1,0,0,1
35631,1,0,0,0,1
35632,0,1,0,0,1
35633,1,0,0,0,1
35634,0,1,0,0,1
35635,0,1,0,0,1
35636,0,1,0,0,1
35637,0,1,0,0,1
35638,1,0,0,0,1
35639,0,1,0,0,1
35640,0,1,0,0,1
35641,0,1,0,0,1
35642,0,1,0,0,1
35643,0,1,0,0,1
35644,1,0,0,0,1
35645,0,1,0,0,1
35646,1,0,0,0,1
35647,1,0,0,0,1
35648,0,1,0,0,1
35649,0,1,0,0,1
35650,0,1,0,0,1
35651,0,1,0,0,1
35652,0,1,0,0,1
35653,0,1,0,0,1
35654,0,1,0,0,1
35655,0,1,0,0,1
35656,0,1,0,0,1
35657,0,1,0,0,1
35658,0,1,0,0,1
35659,0,1,0,0,1
35660,0,0,1,0,1
35661,1,0,0,0,1
35662,0,1,0,0,1
35663,0,1,0,0,1
35664,0,0,1,0,1
35665,0,1,0,0,1
35666,0,1,0,0,1
35667,0,1,0,0,1
35668,0,1,0,0,1
35669,0,1,0,0,1
35670,0,1,0,0,1
35671,0,1,0,0,1
35672,0,1,0,0,1
35673,0,0,1,0,1
35674,0,1,0,0,1
35675,0,1,0,0,1
35676,0,1,0,0,1
35677,0,1,0,0,1
35678,0,1,0,0,1
35679,0,0,0,1,1
35680,0,1,0,0,1
35681,0,1,0,0,1
35682,0,1,0,0,1
35683,0,1,0,0,1
35684,1,0,0,0,1
35685,1,0,0,0,1
35686,1,0,0,0,1
35687,0,1,0,0,1
35688,0,1,0,0,1
35689,0,1,0,0,1
35690,0,1,0,0,1
35691,1,0,0,0,1
35692,0,1,0,0,1
35693,0,1,0,0,1
35694,1,0,0,0,1
35695,0,1,0,0,1
35696,1,0,0,0,1
35697,0,1,0,0,1
35698,0,1,0,0,1
35699,1,0,0,0,1
35700,0,1,0,0,1
35701,0,1,0,0,1
35702,1,0,0,0,1
35703,0,1,0,0,1
35704,0,1,0,0,1
35705,0,1,0,0,1
35706,0,1,0,0,1
35707,0,1,0,0,1
35708,0,1,0,0,1
35709,1,0,0,0,1
35710,1,0,0,0,1
35711,1,0,0,0,1
35712,0,1,0,0,1
35713,0,0,0,1,1
35714,0,1,0,0,1
35715,0,1,0,0,1
35716,0,1,0,0,1
35717,1,0,0,0,1
35718,0,1,0,0,1
35719,0,1,0,0,1
35720,0,1,0,0,1
35721,0,1,0,0,1
35722,0,0,0,1,1
35723,1,0,0,0,1
35724,0,1,0,0,1
35725,1,0,0,0,1
35726,0,1,0,0,1
35727,0,0,1,0,1
35728,0,1,0,0,1
35729,0,1,0,0,1
35730,0,1,0,0,1
35731,0,1,0,0,1
35732,0,1,0,0,1
35733,0,1,0,0,1
35734,0,1,0,0,1
35735,0,0,1,0,1
35736,0,1,0,0,1
35737,0,1,0,0,1
35738,0,1,0,0,1
35739,0,1,0,0,1
35740,0,1,0,0,1
35741,0,1,0,0,1
35742,0,1,0,0,1
35743,0,1,0,0,1
35744,0,0,1,0,1
35745,0,1,0,0,1
35746,0,1,0,0,1
35747,0,1,0,0,1
35748,1,0,0,0,1
35749,1,0,0,0,1
35750,1,0,0,0,1
35751,1,0,0,0,1
35752,0,0,0,1,1
35753,0,1,0,0,1
35754,0,1,0,0,1
35755,0,1,0,0,1
35756,0,1,0,0,1
35757,0,1,0,0,1
35758,0,1,0,0,1
35759,0,1,0,0,1
35760,0,1,0,0,1
35761,0,0,0,1,1
35762,0,1,0,0,1
35763,0,1,0,0,1
35764,0,1,0,0,1
35765,0,1,0,0,1
35766,1,0,0,0,1
35767,0,1,0,0,1
35768,0,1,0,0,1
35769,1,0,0,0,1
35770,0,1,0,0,1
35771,0,1,0,0,1
35772,0,1,0,0,1
35773,0,1,0,0,1
35774,1,0,0,0,1
35775,0,1,0,0,1
35776,0,1,0,0,1
35777,0,1,0,0,1
35778,1,0,0,0,1
35779,0,1,0,0,1
35780,0,1,0,0,1
35781,0,1,0,0,1
35782,0,1,0,0,1
35783,1,0,0,0,1
35784,0,1,0,0,1
35785,0,1,0,0,1
35786,0,1,0,0,1
35787,0,1,0,0,1
35788,0,1,0,0,1
35789,0,1,0,0,1
35790,0,1,0,0,1
35791,0,1,0,0,1
35792,0,1,0,0,1
35793,0,1,0,0,1
35794,0,1,0,0,1
35795,0,1,0,0,1
35796,0,1,0,0,1
35797,0,1,0,0,1
35798,0,1,0,0,1
35799,1,0,0,0,1
35800,1,0,0,0,1
35801,0,1,0,0,1
35802,1,0,0,0,1
35803,0,1,0,0,1
35804,0,1,0,0,1
35805,0,1,0,0,1
35806,0,1,0,0,1
35807,0,0,0,1,1
35808,0,1,0,0,1
35809,0,1,0,0,1
35810,0,1,0,0,1
35811,0,1,0,0,1
35812,0,1,0,0,1
35813,0,1,0,0,1
35814,0,1,0,0,1
35815,0,1,0,0,1
35816,1,0,0,0,1
35817,0,1,0,0,1
35818,0,1,0,0,1
35819,0,1,0,0,1
35820,0,1,0,0,1
35821,0,1,0,0,1
35822,1,0,0,0,1
35823,0,1,0,0,1
35824,0,1,0,0,1
35825,0,1,0,0,1
35826,1,0,0,0,1
35827,1,0,0,0,1
35828,1,0,0,0,1
35829,0,1,0,0,1
35830,0,1,0,0,1
35831,0,1,0,0,1
35832,0,1,0,0,1
35833,0,1,0,0,1
35834,0,0,0,1,1
35835,0,0,0,1,1
35836,0,1,0,0,1
35837,0,1,0,0,1
35838,0,0,1,0,1
35839,0,1,0,0,1
35840,0,1,0,0,1
35841,1,0,0,0,1
35842,0,1,0,0,1
35843,0,1,0,0,1
35844,0,1,0,0,1
35845,0,1,0,0,1
35846,0,1,0,0,1
35847,0,1,0,0,1
35848,0,1,0,0,1
35849,1,0,0,0,1
35850,0,1,0,0,1
35851,0,1,0,0,1
35852,0,1,0,0,1
35853,0,1,0,0,1
35854,0,1,0,0,1
35855,1,0,0,0,1
35856,0,1,0,0,1
35857,0,1,0,0,1
35858,0,1,0,0,1
35859,0,1,0,0,1
35860,0,1,0,0,1
35861,0,1,0,0,1
35862,0,1,0,0,1
35863,0,1,0,0,1
35864,0,1,0,0,1
35865,1,0,0,0,1
35866,1,0,0,0,1
35867,0,0,1,0,1
35868,0,0,0,1,1
35869,0,1,0,0,1
35870,0,1,0,0,1
35871,0,1,0,0,1
35872,0,1,0,0,1
35873,0,1,0,0,1
35874,1,0,0,0,1
35875,1,0,0,0,1
35876,0,1,0,0,1
35877,0,1,0,0,1
35878,0,1,0,0,1
35879,1,0,0,0,1
35880,0,1,0,0,1
35881,0,1,0,0,1
35882,0,1,0,0,1
35883,0,1,0,0,1
35884,0,0,1,0,1
35885,0,1,0,0,1
35886,0,1,0,0,1
35887,0,1,0,0,1
35888,0,1,0,0,1
35889,0,1,0,0,1
35890,0,0,0,1,1
35891,0,1,0,0,1
35892,1,0,0,0,1
35893,0,1,0,0,1
35894,0,1,0,0,1
35895,0,1,0,0,1
35896,0,1,0,0,1
35897,0,0,0,1,1
35898,0,1,0,0,1
35899,0,1,0,0,1
35900,0,1,0,0,1
35901,0,1,0,0,1
35902,0,1,0,0,1
35903,0,1,0,0,1
35904,0,1,0,0,1
35905,0,1,0,0,1
35906,0,0,0,1,1
35907,0,1,0,0,1
35908,0,1,0,0,1
35909,0,1,0,0,1
35910,0,1,0,0,1
35911,0,1,0,0,1
35912,0,0,0,1,1
35913,1,0,0,0,1
35914,1,0,0,0,1
35915,0,1,0,0,1
35916,0,1,0,0,1
35917,0,1,0,0,1
35918,0,0,1,0,1
35919,0,1,0,0,1
35920,0,1,0,0,1
35921,0,1,0,0,1
35922,1,0,0,0,1
35923,0,1,0,0,1
35924,0,1,0,0,1
35925,0,1,0,0,1
35926,0,1,0,0,1
35927,0,1,0,0,1
35928,0,1,0,0,1
35929,1,0,0,0,1
35930,1,0,0,0,1
35931,1,0,0,0,1
35932,0,1,0,0,1
35933,0,1,0,0,1
35934,0,1,0,0,1
35935,0,1,0,0,1
35936,0,0,0,1,1
35937,0,1,0,0,1
35938,0,1,0,0,1
35939,0,1,0,0,1
35940,1,0,0,0,1
35941,0,1,0,0,1
35942,0,1,0,0,1
35943,0,1,0,0,1
35944,0,1,0,0,1
35945,0,1,0,0,1
35946,0,1,0,0,1
35947,1,0,0,0,1
35948,0,1,0,0,1
35949,0,1,0,0,1
35950,0,1,0,0,1
35951,0,1,0,0,1
35952,0,1,0,0,1
35953,0,1,0,0,1
35954,0,1,0,0,1
35955,0,1,0,0,1
35956,0,1,0,0,1
35957,0,1,0,0,1
35958,1,0,0,0,1
35959,0,0,0,1,1
35960,0,0,0,1,1
35961,0,1,0,0,1
35962,0,1,0,0,1
35963,0,1,0,0,1
35964,1,0,0,0,1
35965,0,1,0,0,1
35966,0,1,0,0,1
35967,0,1,0,0,1
35968,0,1,0,0,1
35969,0,1,0,0,1
35970,0,1,0,0,1
35971,1,0,0,0,1
35972,0,1,0,0,1
35973,0,1,0,0,1
35974,0,1,0,0,1
35975,0,0,1,0,1
35976,0,1,0,0,1
35977,0,1,0,0,1
35978,0,1,0,0,1
35979,0,1,0,0,1
35980,0,1,0,0,1
35981,0,1,0,0,1
35982,0,1,0,0,1
35983,0,1,0,0,1
35984,0,1,0,0,1
35985,1,0,0,0,1
35986,1,0,0,0,1
35987,0,1,0,0,1
35988,0,1,0,0,1
35989,0,1,0,0,1
35990,0,0,1,0,1
35991,1,0,0,0,1
35992,0,1,0,0,1
35993,1,0,0,0,1
35994,0,0,1,0,1
35995,1,0,0,0,1
35996,0,1,0,0,1
35997,0,1,0,0,1
35998,0,1,0,0,1
35999,0,1,0,0,1
36000,1,0,0,0,1
36001,1,0,0,0,1
36002,0,1,0,0,1
36003,0,1,0,0,1
36004,0,1,0,0,1
36005,0,1,0,0,1
36006,0,1,0,0,1
36007,0,1,0,0,1
36008,0,1,0,0,1
36009,0,1,0,0,1
36010,0,1,0,0,1
36011,0,1,0,0,1
36012,0,1,0,0,1
36013,0,1,0,0,1
36014,0,1,0,0,1
36015,1,0,0,0,1
36016,0,1,0,0,1
36017,0,1,0,0,1
36018,0,1,0,0,1
36019,0,1,0,0,1
36020,0,1,0,0,1
36021,0,1,0,0,1
36022,0,1,0,0,1
36023,0,1,0,0,1
36024,0,1,0,0,1
36025,0,1,0,0,1
36026,0,1,0,0,1
36027,0,1,0,0,1
36028,0,1,0,0,1
36029,0,0,1,0,1
36030,0,1,0,0,1
36031,1,0,0,0,1
36032,0,1,0,0,1
36033,1,0,0,0,1
36034,1,0,0,0,1
36035,0,0,0,1,1
36036,0,1,0,0,1
36037,0,0,1,0,1
36038,0,1,0,0,1
36039,0,1,0,0,1
36040,0,1,0,0,1
36041,0,1,0,0,1
36042,1,0,0,0,1
36043,1,0,0,0,1
36044,0,1,0,0,1
36045,0,1,0,0,1
36046,0,0,0,1,1
36047,1,0,0,0,1
36048,0,0,0,1,1
36049,0,1,0,0,1
36050,0,1,0,0,1
36051,0,1,0,0,1
36052,0,1,0,0,1
36053,1,0,0,0,1
36054,1,0,0,0,1
36055,0,1,0,0,1
36056,0,1,0,0,1
36057,0,0,0,1,1
36058,1,0,0,0,1
36059,1,0,0,0,1
36060,0,1,0,0,1
36061,0,1,0,0,1
36062,1,0,0,0,1
36063,0,1,0,0,1
36064,1,0,0,0,1
36065,0,1,0,0,1
36066,0,1,0,0,1
36067,0,1,0,0,1
36068,1,0,0,0,1
36069,0,1,0,0,1
36070,0,1,0,0,1
36071,1,0,0,0,1
36072,0,0,0,1,1
36073,0,1,0,0,1
36074,0,0,1,0,1
36075,0,1,0,0,1
36076,0,1,0,0,1
36077,0,1,0,0,1
36078,0,1,0,0,1
36079,0,1,0,0,1
36080,0,1,0,0,1
36081,0,1,0,0,1
36082,1,0,0,0,1
36083,0,1,0,0,1
36084,1,0,0,0,1
36085,0,1,0,0,1
36086,0,1,0,0,1
36087,1,0,0,0,1
36088,0,0,0,1,1
36089,0,1,0,0,1
36090,0,1,0,0,1
36091,0,1,0,0,1
36092,0,1,0,0,1
36093,1,0,0,0,1
36094,0,1,0,0,1
36095,1,0,0,0,1
36096,0,1,0,0,1
36097,0,1,0,0,1
36098,0,1,0,0,1
36099,0,1,0,0,1
36100,1,0,0,0,1
36101,0,1,0,0,1
36102,1,0,0,0,1
36103,0,1,0,0,1
36104,0,0,1,0,1
36105,0,1,0,0,1
36106,0,1,0,0,1
36107,1,0,0,0,1
36108,1,0,0,0,1
36109,1,0,0,0,1
36110,0,1,0,0,1
36111,0,1,0,0,1
36112,0,1,0,0,1
36113,0,0,1,0,1
36114,0,0,1,0,1
36115,0,1,0,0,1
36116,0,1,0,0,1
36117,0,1,0,0,1
36118,0,1,0,0,1
36119,1,0,0,0,1
36120,0,1,0,0,1
36121,0,1,0,0,1
36122,1,0,0,0,1
36123,1,0,0,0,1
36124,0,1,0,0,1
36125,0,1,0,0,1
36126,0,1,0,0,1
36127,0,1,0,0,1
36128,0,1,0,0,1
36129,0,1,0,0,1
36130,0,1,0,0,1
36131,0,1,0,0,1
36132,1,0,0,0,1
36133,0,1,0,0,1
36134,0,1,0,0,1
36135,0,1,0,0,1
36136,0,1,0,0,1
36137,1,0,0,0,1
36138,1,0,0,0,1
36139,1,0,0,0,1
36140,0,1,0,0,1
36141,0,1,0,0,1
36142,0,0,1,0,1
36143,0,1,0,0,1
36144,0,1,0,0,1
36145,0,1,0,0,1
36146,0,1,0,0,1
36147,0,1,0,0,1
36148,0,1,0,0,1
36149,0,0,0,1,1
36150,1,0,0,0,1
36151,0,1,0,0,1
36152,0,1,0,0,1
36153,1,0,0,0,1
36154,0,1,0,0,1
36155,0,1,0,0,1
36156,0,0,1,0,1
36157,0,1,0,0,1
36158,0,1,0,0,1
36159,0,1,0,0,1
36160,0,1,0,0,1
36161,0,1,0,0,1
36162,0,1,0,0,1
36163,0,1,0,0,1
36164,0,1,0,0,1
36165,0,1,0,0,1
36166,1,0,0,0,1
36167,0,1,0,0,1
36168,0,1,0,0,1
36169,0,1,0,0,1
36170,0,1,0,0,1
36171,1,0,0,0,1
36172,0,1,0,0,1
36173,1,0,0,0,1
36174,0,1,0,0,1
36175,1,0,0,0,1
36176,0,1,0,0,1
36177,0,1,0,0,1
36178,0,1,0,0,1
36179,0,1,0,0,1
36180,0,1,0,0,1
36181,0,1,0,0,1
36182,0,1,0,0,1
36183,0,1,0,0,1
36184,1,0,0,0,1
36185,1,0,0,0,1
36186,0,1,0,0,1
36187,0,1,0,0,1
36188,0,1,0,0,1
36189,0,1,0,0,1
36190,0,1,0,0,1
36191,0,1,0,0,1
36192,1,0,0,0,1
36193,0,1,0,0,1
36194,1,0,0,0,1
36195,0,1,0,0,1
36196,0,1,0,0,1
36197,1,0,0,0,1
36198,0,1,0,0,1
36199,1,0,0,0,1
36200,0,1,0,0,1
36201,0,1,0,0,1
36202,0,1,0,0,1
36203,1,0,0,0,1
36204,0,1,0,0,1
36205,0,1,0,0,1
36206,1,0,0,0,1
36207,0,1,0,0,1
36208,0,1,0,0,1
36209,1,0,0,0,1
36210,0,1,0,0,1
36211,1,0,0,0,1
36212,0,1,0,0,1
36213,0,1,0,0,1
36214,0,1,0,0,1
36215,0,1,0,0,1
36216,1,0,0,0,1
36217,0,1,0,0,1
36218,1,0,0,0,1
36219,0,1,0,0,1
36220,0,0,1,0,1
36221,0,1,0,0,1
36222,0,1,0,0,1
36223,0,1,0,0,1
36224,0,1,0,0,1
36225,1,0,0,0,1
36226,0,1,0,0,1
36227,0,1,0,0,1
36228,0,1,0,0,1
36229,0,1,0,0,1
36230,0,1,0,0,1
36231,0,1,0,0,1
36232,0,1,0,0,1
36233,0,1,0,0,1
36234,0,1,0,0,1
36235,0,1,0,0,1
36236,0,1,0,0,1
36237,0,1,0,0,1
36238,0,1,0,0,1
36239,0,1,0,0,1
36240,0,1,0,0,1
36241,0,1,0,0,1
36242,0,1,0,0,1
36243,1,0,0,0,1
36244,0,1,0,0,1
36245,1,0,0,0,1
36246,0,1,0,0,1
36247,1,0,0,0,1
36248,0,1,0,0,1
36249,0,1,0,0,1
36250,0,1,0,0,1
36251,0,1,0,0,1
36252,0,0,0,1,1
36253,0,1,0,0,1
36254,0,1,0,0,1
36255,0,1,0,0,1
36256,0,1,0,0,1
36257,0,1,0,0,1
36258,0,1,0,0,1
36259,0,1,0,0,1
36260,0,1,0,0,1
36261,0,1,0,0,1
36262,0,1,0,0,1
36263,0,1,0,0,1
36264,0,1,0,0,1
36265,0,1,0,0,1
36266,0,1,0,0,1
36267,0,1,0,0,1
36268,0,1,0,0,1
36269,0,1,0,0,1
36270,0,1,0,0,1
36271,0,1,0,0,1
36272,0,1,0,0,1
36273,0,1,0,0,1
36274,0,1,0,0,1
36275,0,0,0,1,1
36276,0,1,0,0,1
36277,1,0,0,0,1
36278,0,1,0,0,1
36279,1,0,0,0,1
36280,0,1,0,0,1
36281,1,0,0,0,1
36282,0,0,1,0,1
36283,0,1,0,0,1
36284,0,1,0,0,1
36285,0,1,0,0,1
36286,0,1,0,0,1
36287,0,1,0,0,1
36288,0,1,0,0,1
36289,0,1,0,0,1
36290,1,0,0,0,1
36291,0,1,0,0,1
36292,0,1,0,0,1
36293,0,1,0,0,1
36294,1,0,0,0,1
36295,1,0,0,0,1
36296,0,1,0,0,1
36297,0,1,0,0,1
36298,0,1,0,0,1
36299,0,1,0,0,1
36300,0,1,0,0,1
36301,0,1,0,0,1
36302,0,1,0,0,1
36303,0,0,0,1,1
36304,1,0,0,0,1
36305,1,0,0,0,1
36306,1,0,0,0,1
36307,0,1,0,0,1
36308,0,1,0,0,1
36309,0,1,0,0,1
36310,0,1,0,0,1
36311,0,1,0,0,1
36312,0,1,0,0,1
36313,0,1,0,0,1
36314,0,0,0,1,1
36315,0,1,0,0,1
36316,0,1,0,0,1
36317,0,1,0,0,1
36318,0,1,0,0,1
36319,0,1,0,0,1
36320,0,1,0,0,1
36321,0,1,0,0,1
36322,1,0,0,0,1
36323,0,1,0,0,1
36324,1,0,0,0,1
36325,0,1,0,0,1
36326,1,0,0,0,1
36327,0,1,0,0,1
36328,0,1,0,0,1
36329,0,1,0,0,1
36330,0,0,0,1,1
36331,0,1,0,0,1
36332,0,1,0,0,1
36333,0,1,0,0,1
36334,0,1,0,0,1
36335,0,1,0,0,1
36336,0,1,0,0,1
36337,1,0,0,0,1
36338,0,1,0,0,1
36339,0,1,0,0,1
36340,1,0,0,0,1
36341,0,1,0,0,1
36342,0,1,0,0,1
36343,1,0,0,0,1
36344,1,0,0,0,1
36345,0,1,0,0,1
36346,0,1,0,0,1
36347,0,1,0,0,1
36348,0,1,0,0,1
36349,0,1,0,0,1
36350,0,1,0,0,1
36351,0,1,0,0,1
36352,0,1,0,0,1
36353,1,0,0,0,1
36354,0,1,0,0,1
36355,0,1,0,0,1
36356,0,1,0,0,1
36357,1,0,0,0,1
36358,0,1,0,0,1
36359,0,1,0,0,1
36360,0,1,0,0,1
36361,0,1,0,0,1
36362,0,1,0,0,1
36363,0,1,0,0,1
36364,0,1,0,0,1
36365,1,0,0,0,1
36366,0,1,0,0,1
36367,1,0,0,0,1
36368,0,1,0,0,1
36369,1,0,0,0,1
36370,0,1,0,0,1
36371,1,0,0,0,1
36372,0,1,0,0,1
36373,0,1,0,0,1
36374,1,0,0,0,1
36375,1,0,0,0,1
36376,0,1,0,0,1
36377,0,0,1,0,1
36378,0,1,0,0,1
36379,0,1,0,0,1
36380,0,1,0,0,1
36381,0,1,0,0,1
36382,0,1,0,0,1
36383,0,1,0,0,1
36384,0,1,0,0,1
36385,0,1,0,0,1
36386,0,0,1,0,1
36387,0,1,0,0,1
36388,0,1,0,0,1
36389,0,1,0,0,1
36390,0,1,0,0,1
36391,0,1,0,0,1
36392,0,1,0,0,1
36393,0,1,0,0,1
36394,0,1,0,0,1
36395,0,1,0,0,1
36396,0,1,0,0,1
36397,0,1,0,0,1
36398,0,1,0,0,1
36399,1,0,0,0,1
36400,0,1,0,0,1
36401,0,1,0,0,1
36402,0,1,0,0,1
36403,0,0,1,0,1
36404,0,1,0,0,1
36405,0,1,0,0,1
36406,0,0,0,1,1
36407,0,1,0,0,1
36408,0,1,0,0,1
36409,0,1,0,0,1
36410,1,0,0,0,1
36411,0,1,0,0,1
36412,0,1,0,0,1
36413,0,1,0,0,1
36414,0,1,0,0,1
36415,0,1,0,0,1
36416,0,1,0,0,1
36417,0,1,0,0,1
36418,0,1,0,0,1
36419,0,1,0,0,1
36420,1,0,0,0,1
36421,0,1,0,0,1
36422,0,1,0,0,1
36423,1,0,0,0,1
36424,1,0,0,0,1
36425,0,1,0,0,1
36426,1,0,0,0,1
36427,1,0,0,0,1
36428,0,1,0,0,1
36429,0,1,0,0,1
36430,0,1,0,0,1
36431,0,1,0,0,1
36432,0,1,0,0,1
36433,1,0,0,0,1
36434,1,0,0,0,1
36435,0,1,0,0,1
36436,0,1,0,0,1
36437,0,1,0,0,1
36438,0,1,0,0,1
36439,0,1,0,0,1
36440,0,1,0,0,1
36441,0,0,1,0,1
36442,0,1,0,0,1
36443,0,0,1,0,1
36444,0,1,0,0,1
36445,1,0,0,0,1
36446,0,1,0,0,1
36447,0,1,0,0,1
36448,0,1,0,0,1
36449,0,1,0,0,1
36450,0,1,0,0,1
36451,0,1,0,0,1
36452,0,1,0,0,1
36453,0,1,0,0,1
36454,0,1,0,0,1
36455,0,1,0,0,1
36456,1,0,0,0,1
36457,0,1,0,0,1
36458,0,0,0,1,1
36459,1,0,0,0,1
36460,1,0,0,0,1
36461,0,1,0,0,1
36462,0,1,0,0,1
36463,0,1,0,0,1
36464,1,0,0,0,1
36465,0,1,0,0,1
36466,1,0,0,0,1
36467,0,0,0,1,1
36468,0,1,0,0,1
36469,0,1,0,0,1
36470,1,0,0,0,1
36471,1,0,0,0,1
36472,0,1,0,0,1
36473,0,1,0,0,1
36474,1,0,0,0,1
36475,0,1,0,0,1
36476,0,1,0,0,1
36477,0,1,0,0,1
36478,0,1,0,0,1
36479,1,0,0,0,1
36480,0,1,0,0,1
36481,0,1,0,0,1
36482,0,1,0,0,1
36483,0,1,0,0,1
36484,1,0,0,0,1
36485,0,1,0,0,1
36486,1,0,0,0,1
36487,0,1,0,0,1
36488,1,0,0,0,1
36489,0,1,0,0,1
36490,1,0,0,0,1
36491,0,1,0,0,1
36492,0,1,0,0,1
36493,0,1,0,0,1
36494,0,1,0,0,1
36495,0,1,0,0,1
36496,0,1,0,0,1
36497,0,1,0,0,1
36498,0,1,0,0,1
36499,0,0,1,0,1
36500,0,1,0,0,1
36501,0,1,0,0,1
36502,1,0,0,0,1
36503,1,0,0,0,1
36504,0,1,0,0,1
36505,0,1,0,0,1
36506,1,0,0,0,1
36507,0,1,0,0,1
36508,0,1,0,0,1
36509,0,1,0,0,1
36510,0,1,0,0,1
36511,0,1,0,0,1
36512,0,1,0,0,1
36513,0,1,0,0,1
36514,1,0,0,0,1
36515,0,1,0,0,1
36516,0,1,0,0,1
36517,0,1,0,0,1
36518,0,1,0,0,1
36519,0,1,0,0,1
36520,0,1,0,0,1
36521,0,1,0,0,1
36522,0,1,0,0,1
36523,0,1,0,0,1
36524,0,1,0,0,1
36525,0,0,1,0,1
36526,1,0,0,0,1
36527,0,1,0,0,1
36528,0,1,0,0,1
36529,0,1,0,0,1
36530,1,0,0,0,1
36531,0,1,0,0,1
36532,1,0,0,0,1
36533,0,1,0,0,1
36534,0,1,0,0,1
36535,1,0,0,0,1
36536,1,0,0,0,1
36537,1,0,0,0,1
36538,0,1,0,0,1
36539,0,1,0,0,1
36540,0,1,0,0,1
36541,0,1,0,0,1
36542,0,1,0,0,1
36543,0,1,0,0,1
36544,0,0,0,1,1
36545,1,0,0,0,1
36546,0,1,0,0,1
36547,0,0,0,1,1
36548,0,1,0,0,1
36549,1,0,0,0,1
36550,0,1,0,0,1
36551,0,1,0,0,1
36552,0,1,0,0,1
36553,1,0,0,0,1
36554,0,1,0,0,1
36555,0,1,0,0,1
36556,0,1,0,0,1
36557,0,1,0,0,1
36558,0,1,0,0,1
36559,0,1,0,0,1
36560,1,0,0,0,1
36561,0,1,0,0,1
36562,0,1,0,0,1
36563,0,1,0,0,1
36564,0,1,0,0,1
36565,0,1,0,0,1
36566,0,0,1,0,1
36567,1,0,0,0,1
36568,0,0,1,0,1
36569,0,1,0,0,1
36570,1,0,0,0,1
36571,0,1,0,0,1
36572,0,1,0,0,1
36573,0,1,0,0,1
36574,0,1,0,0,1
36575,0,1,0,0,1
36576,0,0,0,1,1
36577,0,1,0,0,1
36578,0,1,0,0,1
36579,0,0,0,1,1
36580,1,0,0,0,1
36581,0,1,0,0,1
36582,0,1,0,0,1
36583,0,1,0,0,1
36584,0,1,0,0,1
36585,0,1,0,0,1
36586,0,1,0,0,1
36587,0,1,0,0,1
36588,0,1,0,0,1
36589,0,1,0,0,1
36590,1,0,0,0,1
36591,0,1,0,0,1
36592,0,1,0,0,1
36593,1,0,0,0,1
36594,0,1,0,0,1
36595,0,1,0,0,1
36596,0,1,0,0,1
36597,0,1,0,0,1
36598,0,1,0,0,1
36599,0,1,0,0,1
36600,0,1,0,0,1
36601,0,1,0,0,1
36602,0,1,0,0,1
36603,0,1,0,0,1
36604,0,1,0,0,1
36605,0,1,0,0,1
36606,0,0,1,0,1
36607,1,0,0,0,1
36608,1,0,0,0,1
36609,0,1,0,0,1
36610,0,0,1,0,1
36611,1,0,0,0,1
36612,0,1,0,0,1
36613,0,1,0,0,1
36614,0,1,0,0,1
36615,0,1,0,0,1
36616,0,1,0,0,1
36617,0,1,0,0,1
36618,0,1,0,0,1
36619,0,1,0,0,1
36620,0,1,0,0,1
36621,0,1,0,0,1
36622,0,1,0,0,1
36623,0,1,0,0,1
36624,0,1,0,0,1
36625,0,1,0,0,1
36626,0,0,1,0,1
36627,0,1,0,0,1
36628,0,1,0,0,1
36629,0,1,0,0,1
36630,0,0,1,0,1
36631,0,1,0,0,1
36632,0,1,0,0,1
36633,0,1,0,0,1
36634,0,1,0,0,1
36635,0,1,0,0,1
36636,0,1,0,0,1
36637,0,1,0,0,1
36638,0,1,0,0,1
36639,0,1,0,0,1
36640,0,1,0,0,1
36641,0,1,0,0,1
36642,0,1,0,0,1
36643,1,0,0,0,1
36644,0,1,0,0,1
36645,0,1,0,0,1
36646,0,1,0,0,1
36647,1,0,0,0,1
36648,0,1,0,0,1
36649,0,1,0,0,1
36650,0,1,0,0,1
36651,0,1,0,0,1
36652,0,1,0,0,1
36653,0,1,0,0,1
36654,0,1,0,0,1
36655,0,1,0,0,1
36656,0,1,0,0,1
36657,0,1,0,0,1
36658,1,0,0,0,1
36659,0,0,1,0,1
36660,1,0,0,0,1
36661,0,1,0,0,1
36662,1,0,0,0,1
36663,0,1,0,0,1
36664,0,1,0,0,1
36665,0,1,0,0,1
36666,0,1,0,0,1
36667,0,1,0,0,1
36668,0,1,0,0,1
36669,0,1,0,0,1
36670,0,1,0,0,1
36671,0,1,0,0,1
36672,0,1,0,0,1
36673,0,1,0,0,1
36674,1,0,0,0,1
36675,0,1,0,0,1
36676,0,1,0,0,1
36677,0,1,0,0,1
36678,1,0,0,0,1
36679,0,1,0,0,1
36680,0,1,0,0,1
36681,0,1,0,0,1
36682,0,1,0,0,1
36683,0,1,0,0,1
36684,0,1,0,0,1
36685,0,1,0,0,1
36686,1,0,0,0,1
36687,0,1,0,0,1
36688,0,1,0,0,1
36689,0,1,0,0,1
36690,0,1,0,0,1
36691,0,1,0,0,1
36692,0,1,0,0,1
36693,0,1,0,0,1
36694,0,1,0,0,1
36695,1,0,0,0,1
36696,0,1,0,0,1
36697,1,0,0,0,1
36698,0,1,0,0,1
36699,0,0,1,0,1
36700,0,1,0,0,1
36701,0,1,0,0,1
36702,0,1,0,0,1
36703,1,0,0,0,1
36704,0,1,0,0,1
36705,0,1,0,0,1
36706,0,1,0,0,1
36707,0,1,0,0,1
36708,0,1,0,0,1
36709,0,1,0,0,1
36710,0,0,1,0,1
36711,0,1,0,0,1
36712,0,1,0,0,1
36713,0,1,0,0,1
36714,1,0,0,0,1
36715,0,1,0,0,1
36716,0,1,0,0,1
36717,0,1,0,0,1
36718,0,1,0,0,1
36719,0,1,0,0,1
36720,0,1,0,0,1
36721,0,1,0,0,1
36722,0,1,0,0,1
36723,0,1,0,0,1
36724,0,1,0,0,1
36725,1,0,0,0,1
36726,1,0,0,0,1
36727,0,1,0,0,1
36728,0,1,0,0,1
36729,0,1,0,0,1
36730,0,1,0,0,1
36731,0,1,0,0,1
36732,0,1,0,0,1
36733,0,1,0,0,1
36734,0,1,0,0,1
36735,0,1,0,0,1
36736,0,1,0,0,1
36737,0,1,0,0,1
36738,0,1,0,0,1
36739,0,1,0,0,1
36740,0,1,0,0,1
36741,0,0,1,0,1
36742,1,0,0,0,1
36743,0,1,0,0,1
36744,1,0,0,0,1
36745,0,1,0,0,1
36746,0,1,0,0,1
36747,0,1,0,0,1
36748,0,1,0,0,1
36749,0,1,0,0,1
36750,0,1,0,0,1
36751,0,1,0,0,1
36752,0,1,0,0,1
36753,0,0,0,1,1
36754,1,0,0,0,1
36755,0,1,0,0,1
36756,0,0,0,1,1
36757,0,1,0,0,1
36758,0,1,0,0,1
36759,1,0,0,0,1
36760,0,1,0,0,1
36761,1,0,0,0,1
36762,0,1,0,0,1
36763,0,1,0,0,1
36764,0,1,0,0,1
36765,0,1,0,0,1
36766,1,0,0,0,1
36767,0,1,0,0,1
36768,1,0,0,0,1
36769,0,1,0,0,1
36770,0,1,0,0,1
36771,0,1,0,0,1
36772,1,0,0,0,1
36773,0,1,0,0,1
36774,0,1,0,0,1
36775,0,1,0,0,1
36776,0,0,1,0,1
36777,0,1,0,0,1
36778,0,1,0,0,1
36779,1,0,0,0,1
36780,1,0,0,0,1
36781,0,1,0,0,1
36782,0,1,0,0,1
36783,0,1,0,0,1
36784,0,1,0,0,1
36785,0,1,0,0,1
36786,1,0,0,0,1
36787,0,1,0,0,1
36788,0,1,0,0,1
36789,1,0,0,0,1
36790,0,1,0,0,1
36791,0,1,0,0,1
36792,1,0,0,0,1
36793,0,1,0,0,1
36794,0,1,0,0,1
36795,0,1,0,0,1
36796,0,1,0,0,1
36797,0,1,0,0,1
36798,0,1,0,0,1
36799,1,0,0,0,1
36800,0,1,0,0,1
36801,0,1,0,0,1
36802,0,1,0,0,1
36803,0,1,0,0,1
36804,0,1,0,0,1
36805,1,0,0,0,1
36806,0,1,0,0,1
36807,1,0,0,0,1
36808,0,1,0,0,1
36809,0,1,0,0,1
36810,0,1,0,0,1
36811,0,0,0,1,1
36812,0,1,0,0,1
36813,0,1,0,0,1
36814,0,1,0,0,1
36815,0,1,0,0,1
36816,1,0,0,0,1
36817,0,1,0,0,1
36818,0,1,0,0,1
36819,0,1,0,0,1
36820,0,1,0,0,1
36821,0,1,0,0,1
36822,0,1,0,0,1
36823,0,1,0,0,1
36824,0,1,0,0,1
36825,0,1,0,0,1
36826,0,0,0,1,1
36827,0,1,0,0,1
36828,0,1,0,0,1
36829,0,1,0,0,1
36830,0,0,0,1,1
36831,0,0,0,1,1
36832,1,0,0,0,1
36833,1,0,0,0,1
36834,0,1,0,0,1
36835,0,1,0,0,1
36836,0,1,0,0,1
36837,0,1,0,0,1
36838,1,0,0,0,1
36839,0,1,0,0,1
36840,1,0,0,0,1
36841,0,1,0,0,1
36842,0,1,0,0,1
36843,0,1,0,0,1
36844,0,1,0,0,1
36845,0,1,0,0,1
36846,0,1,0,0,1
36847,1,0,0,0,1
36848,1,0,0,0,1
36849,0,1,0,0,1
36850,0,1,0,0,1
36851,0,1,0,0,1
36852,0,1,0,0,1
36853,0,1,0,0,1
36854,0,1,0,0,1
36855,1,0,0,0,1
36856,0,1,0,0,1
36857,0,1,0,0,1
36858,0,1,0,0,1
36859,0,1,0,0,1
36860,1,0,0,0,1
36861,0,1,0,0,1
36862,1,0,0,0,1
36863,0,1,0,0,1
36864,0,0,0,1,1
36865,0,1,0,0,1
36866,0,1,0,0,1
36867,0,1,0,0,1
36868,0,1,0,0,1
36869,0,1,0,0,1
36870,0,1,0,0,1
36871,0,1,0,0,1
36872,0,1,0,0,1
36873,0,1,0,0,1
36874,0,1,0,0,1
36875,0,1,0,0,1
36876,0,1,0,0,1
36877,0,1,0,0,1
36878,0,1,0,0,1
36879,0,1,0,0,1
36880,0,1,0,0,1
36881,0,1,0,0,1
36882,0,1,0,0,1
36883,0,0,0,1,1
36884,0,1,0,0,1
36885,0,1,0,0,1
36886,0,1,0,0,1
36887,0,0,1,0,1
36888,0,1,0,0,1
36889,1,0,0,0,1
36890,0,1,0,0,1
36891,1,0,0,0,1
36892,0,1,0,0,1
36893,0,1,0,0,1
36894,0,1,0,0,1
36895,0,1,0,0,1
36896,0,1,0,0,1
36897,1,0,0,0,1
36898,0,1,0,0,1
36899,0,1,0,0,1
36900,0,1,0,0,1
36901,0,0,1,0,1
36902,0,1,0,0,1
36903,0,1,0,0,1
36904,0,0,0,1,1
36905,0,1,0,0,1
36906,1,0,0,0,1
36907,0,0,0,1,1
36908,0,1,0,0,1
36909,0,1,0,0,1
36910,1,0,0,0,1
36911,0,1,0,0,1
36912,0,1,0,0,1
36913,0,1,0,0,1
36914,0,1,0,0,1
36915,1,0,0,0,1
36916,0,1,0,0,1
36917,1,0,0,0,1
36918,0,1,0,0,1
36919,0,1,0,0,1
36920,0,1,0,0,1
36921,0,1,0,0,1
36922,0,1,0,0,1
36923,1,0,0,0,1
36924,0,0,0,1,1
36925,0,1,0,0,1
36926,0,0,0,1,1
36927,1,0,0,0,1
36928,0,1,0,0,1
36929,0,1,0,0,1
36930,0,0,1,0,1
36931,0,1,0,0,1
36932,0,1,0,0,1
36933,0,1,0,0,1
36934,0,1,0,0,1
36935,0,1,0,0,1
36936,0,0,0,1,1
36937,0,1,0,0,1
36938,1,0,0,0,1
36939,0,1,0,0,1
36940,0,1,0,0,1
36941,0,1,0,0,1
36942,0,1,0,0,1
36943,0,1,0,0,1
36944,0,1,0,0,1
36945,0,0,0,1,1
36946,0,1,0,0,1
36947,1,0,0,0,1
36948,0,0,1,0,1
36949,0,0,0,1,1
36950,0,1,0,0,1
36951,0,0,1,0,1
36952,0,1,0,0,1
36953,0,1,0,0,1
36954,0,1,0,0,1
36955,0,1,0,0,1
36956,0,1,0,0,1
36957,0,1,0,0,1
36958,0,1,0,0,1
36959,0,1,0,0,1
36960,0,1,0,0,1
36961,0,1,0,0,1
36962,1,0,0,0,1
36963,1,0,0,0,1
36964,0,1,0,0,1
36965,1,0,0,0,1
36966,0,1,0,0,1
36967,0,1,0,0,1
36968,1,0,0,0,1
36969,0,1,0,0,1
36970,1,0,0,0,1
36971,1,0,0,0,1
36972,0,1,0,0,1
36973,0,1,0,0,1
36974,0,1,0,0,1
36975,0,1,0,0,1
36976,0,1,0,0,1
36977,0,1,0,0,1
36978,0,1,0,0,1
36979,0,1,0,0,1
36980,1,0,0,0,1
36981,0,1,0,0,1
36982,1,0,0,0,1
36983,0,1,0,0,1
36984,0,1,0,0,1
36985,0,1,0,0,1
36986,0,0,1,0,1
36987,0,1,0,0,1
36988,0,1,0,0,1
36989,1,0,0,0,1
36990,0,1,0,0,1
36991,0,1,0,0,1
36992,0,1,0,0,1
36993,0,1,0,0,1
36994,0,1,0,0,1
36995,1,0,0,0,1
36996,0,1,0,0,1
36997,0,1,0,0,1
36998,0,1,0,0,1
36999,0,1,0,0,1
37000,1,0,0,0,1
37001,0,1,0,0,1
37002,0,0,0,1,1
37003,0,0,0,1,1
37004,0,1,0,0,1
37005,1,0,0,0,1
37006,0,1,0,0,1
37007,0,1,0,0,1
37008,0,1,0,0,1
37009,0,1,0,0,1
37010,0,1,0,0,1
37011,0,1,0,0,1
37012,0,1,0,0,1
37013,0,1,0,0,1
37014,0,1,0,0,1
37015,0,0,1,0,1
37016,0,1,0,0,1
37017,0,1,0,0,1
37018,0,1,0,0,1
37019,0,1,0,0,1
37020,0,1,0,0,1
37021,0,1,0,0,1
37022,0,1,0,0,1
37023,0,1,0,0,1
37024,0,0,1,0,1
37025,0,1,0,0,1
37026,0,1,0,0,1
37027,0,1,0,0,1
37028,1,0,0,0,1
37029,1,0,0,0,1
37030,1,0,0,0,1
37031,1,0,0,0,1
37032,0,1,0,0,1
37033,0,1,0,0,1
37034,0,1,0,0,1
37035,0,1,0,0,1
37036,0,1,0,0,1
37037,0,1,0,0,1
37038,0,1,0,0,1
37039,0,1,0,0,1
37040,1,0,0,0,1
37041,1,0,0,0,1
37042,0,1,0,0,1
37043,0,1,0,0,1
37044,0,1,0,0,1
37045,0,0,1,0,1
37046,0,1,0,0,1
37047,1,0,0,0,1
37048,1,0,0,0,1
37049,0,1,0,0,1
37050,0,1,0,0,1
37051,1,0,0,0,1
37052,0,1,0,0,1
37053,0,0,0,1,1
37054,0,0,0,1,1
37055,0,1,0,0,1
37056,0,1,0,0,1
37057,0,0,0,1,1
37058,1,0,0,0,1
37059,0,1,0,0,1
37060,0,1,0,0,1
37061,0,1,0,0,1
37062,0,0,1,0,1
37063,0,1,0,0,1
37064,0,1,0,0,1
37065,1,0,0,0,1
37066,0,1,0,0,1
37067,0,1,0,0,1
37068,0,0,0,1,1
37069,0,1,0,0,1
37070,0,1,0,0,1
37071,0,1,0,0,1
37072,0,1,0,0,1
37073,0,1,0,0,1
37074,0,1,0,0,1
37075,0,1,0,0,1
37076,1,0,0,0,1
37077,0,1,0,0,1
37078,0,1,0,0,1
37079,0,1,0,0,1
37080,0,1,0,0,1
37081,0,1,0,0,1
37082,1,0,0,0,1
37083,0,1,0,0,1
37084,0,1,0,0,1
37085,0,1,0,0,1
37086,0,1,0,0,1
37087,0,1,0,0,1
37088,0,1,0,0,1
37089,0,1,0,0,1
37090,0,1,0,0,1
37091,0,1,0,0,1
37092,1,0,0,0,1
37093,0,1,0,0,1
37094,0,1,0,0,1
37095,1,0,0,0,1
37096,0,1,0,0,1
37097,0,1,0,0,1
37098,0,1,0,0,1
37099,0,1,0,0,1
37100,0,1,0,0,1
37101,0,1,0,0,1
37102,0,1,0,0,1
37103,0,1,0,0,1
37104,0,0,0,1,1
37105,0,1,0,0,1
37106,0,1,0,0,1
37107,0,1,0,0,1
37108,1,0,0,0,1
37109,0,1,0,0,1
37110,0,1,0,0,1
37111,0,1,0,0,1
37112,1,0,0,0,1
37113,0,1,0,0,1
37114,0,1,0,0,1
37115,1,0,0,0,1
37116,0,1,0,0,1
37117,1,0,0,0,1
37118,0,1,0,0,1
37119,0,1,0,0,1
37120,0,1,0,0,1
37121,0,1,0,0,1
37122,0,1,0,0,1
37123,0,1,0,0,1
37124,1,0,0,0,1
37125,0,1,0,0,1
37126,0,1,0,0,1
37127,0,0,0,1,1
37128,1,0,0,0,1
37129,0,1,0,0,1
37130,0,1,0,0,1
37131,0,1,0,0,1
37132,0,1,0,0,1
37133,1,0,0,0,1
37134,0,1,0,0,1
37135,0,1,0,0,1
37136,0,1,0,0,1
37137,0,1,0,0,1
37138,0,1,0,0,1
37139,0,1,0,0,1
37140,0,1,0,0,1
37141,0,1,0,0,1
37142,0,1,0,0,1
37143,0,1,0,0,1
37144,0,1,0,0,1
37145,0,1,0,0,1
37146,0,1,0,0,1
37147,0,1,0,0,1
37148,1,0,0,0,1
37149,1,0,0,0,1
37150,0,1,0,0,1
37151,0,1,0,0,1
37152,0,1,0,0,1
37153,1,0,0,0,1
37154,0,1,0,0,1
37155,0,1,0,0,1
37156,0,1,0,0,1
37157,0,1,0,0,1
37158,0,1,0,0,1
37159,0,1,0,0,1
37160,0,1,0,0,1
37161,0,1,0,0,1
37162,0,1,0,0,1
37163,1,0,0,0,1
37164,0,1,0,0,1
37165,0,1,0,0,1
37166,0,1,0,0,1
37167,1,0,0,0,1
37168,1,0,0,0,1
37169,0,1,0,0,1
37170,0,1,0,0,1
37171,0,0,1,0,1
37172,1,0,0,0,1
37173,1,0,0,0,1
37174,0,1,0,0,1
37175,0,0,0,1,1
37176,0,1,0,0,1
37177,0,1,0,0,1
37178,1,0,0,0,1
37179,0,1,0,0,1
37180,0,1,0,0,1
37181,0,1,0,0,1
37182,0,1,0,0,1
37183,0,1,0,0,1
37184,0,1,0,0,1
37185,0,1,0,0,1
37186,0,1,0,0,1
37187,0,1,0,0,1
37188,1,0,0,0,1
37189,1,0,0,0,1
37190,0,1,0,0,1
37191,0,1,0,0,1
37192,0,1,0,0,1
37193,0,1,0,0,1
37194,1,0,0,0,1
37195,0,1,0,0,1
37196,0,1,0,0,1
37197,0,1,0,0,1
37198,0,1,0,0,1
37199,1,0,0,0,1
37200,0,1,0,0,1
37201,1,0,0,0,1
37202,0,1,0,0,1
37203,0,1,0,0,1
37204,0,1,0,0,1
37205,1,0,0,0,1
37206,1,0,0,0,1
37207,0,1,0,0,1
37208,0,1,0,0,1
37209,0,1,0,0,1
37210,0,1,0,0,1
37211,1,0,0,0,1
37212,0,1,0,0,1
37213,0,1,0,0,1
37214,0,1,0,0,1
37215,0,1,0,0,1
37216,1,0,0,0,1
37217,0,1,0,0,1
37218,0,0,0,1,1
37219,1,0,0,0,1
37220,0,1,0,0,1
37221,0,1,0,0,1
37222,0,1,0,0,1
37223,0,1,0,0,1
37224,1,0,0,0,1
37225,0,1,0,0,1
37226,0,0,0,1,1
37227,0,1,0,0,1
37228,0,1,0,0,1
37229,0,1,0,0,1
37230,0,0,1,0,1
37231,0,1,0,0,1
37232,1,0,0,0,1
37233,0,1,0,0,1
37234,0,1,0,0,1
37235,1,0,0,0,1
37236,0,1,0,0,1
37237,0,1,0,0,1
37238,0,1,0,0,1
37239,0,1,0,0,1
37240,1,0,0,0,1
37241,1,0,0,0,1
37242,0,1,0,0,1
37243,0,1,0,0,1
37244,0,1,0,0,1
37245,0,1,0,0,1
37246,0,1,0,0,1
37247,0,1,0,0,1
37248,0,1,0,0,1
37249,0,1,0,0,1
37250,0,1,0,0,1
37251,0,1,0,0,1
37252,0,0,0,1,1
37253,0,0,0,1,1
37254,0,0,0,1,1
37255,0,1,0,0,1
37256,1,0,0,0,1
37257,0,1,0,0,1
37258,1,0,0,0,1
37259,0,1,0,0,1
37260,0,1,0,0,1
37261,0,1,0,0,1
37262,0,1,0,0,1
37263,0,1,0,0,1
37264,0,1,0,0,1
37265,0,1,0,0,1
37266,0,1,0,0,1
37267,1,0,0,0,1
37268,0,1,0,0,1
37269,1,0,0,0,1
37270,0,1,0,0,1
37271,1,0,0,0,1
37272,0,1,0,0,1
37273,1,0,0,0,1
37274,0,1,0,0,1
37275,1,0,0,0,1
37276,0,1,0,0,1
37277,0,1,0,0,1
37278,0,1,0,0,1
37279,0,1,0,0,1
37280,0,1,0,0,1
37281,0,1,0,0,1
37282,0,1,0,0,1
37283,0,1,0,0,1
37284,0,1,0,0,1
37285,0,1,0,0,1
37286,0,1,0,0,1
37287,0,1,0,0,1
37288,0,1,0,0,1
37289,1,0,0,0,1
37290,0,1,0,0,1
37291,0,1,0,0,1
37292,0,1,0,0,1
37293,0,1,0,0,1
37294,0,1,0,0,1
37295,0,1,0,0,1
37296,0,1,0,0,1
37297,0,1,0,0,1
37298,1,0,0,0,1
37299,0,1,0,0,1
37300,1,0,0,0,1
37301,0,1,0,0,1
37302,1,0,0,0,1
37303,0,1,0,0,1
37304,0,1,0,0,1
37305,0,1,0,0,1
37306,0,1,0,0,1
37307,0,1,0,0,1
37308,0,1,0,0,1
37309,0,1,0,0,1
37310,0,1,0,0,1
37311,0,1,0,0,1
37312,0,1,0,0,1
37313,0,1,0,0,1
37314,0,1,0,0,1
37315,0,1,0,0,1
37316,0,0,0,1,1
37317,0,1,0,0,1
37318,0,1,0,0,1
37319,0,1,0,0,1
37320,0,1,0,0,1
37321,1,0,0,0,1
37322,1,0,0,0,1
37323,0,1,0,0,1
37324,0,1,0,0,1
37325,0,1,0,0,1
37326,0,1,0,0,1
37327,0,1,0,0,1
37328,0,1,0,0,1
37329,1,0,0,0,1
37330,0,1,0,0,1
37331,0,1,0,0,1
37332,0,1,0,0,1
37333,0,1,0,0,1
37334,0,1,0,0,1
37335,0,1,0,0,1
37336,0,1,0,0,1
37337,0,1,0,0,1
37338,0,1,0,0,1
37339,0,1,0,0,1
37340,1,0,0,0,1
37341,0,0,0,1,1
37342,0,1,0,0,1
37343,1,0,0,0,1
37344,0,1,0,0,1
37345,0,1,0,0,1
37346,1,0,0,0,1
37347,0,1,0,0,1
37348,0,1,0,0,1
37349,0,1,0,0,1
37350,0,1,0,0,1
37351,0,1,0,0,1
37352,0,1,0,0,1
37353,0,1,0,0,1
37354,0,1,0,0,1
37355,0,1,0,0,1
37356,0,1,0,0,1
37357,0,1,0,0,1
37358,0,1,0,0,1
37359,0,1,0,0,1
37360,0,1,0,0,1
37361,0,1,0,0,1
37362,0,1,0,0,1
37363,1,0,0,0,1
37364,0,1,0,0,1
37365,0,1,0,0,1
37366,0,1,0,0,1
37367,1,0,0,0,1
37368,0,1,0,0,1
37369,1,0,0,0,1
37370,0,1,0,0,1
37371,0,1,0,0,1
37372,0,1,0,0,1
37373,1,0,0,0,1
37374,0,1,0,0,1
37375,1,0,0,0,1
37376,0,1,0,0,1
37377,0,1,0,0,1
37378,0,1,0,0,1
37379,0,1,0,0,1
37380,1,0,0,0,1
37381,0,1,0,0,1
37382,0,1,0,0,1
37383,0,1,0,0,1
37384,0,1,0,0,1
37385,0,1,0,0,1
37386,0,1,0,0,1
37387,0,1,0,0,1
37388,0,1,0,0,1
37389,0,0,0,1,1
37390,1,0,0,0,1
37391,0,1,0,0,1
37392,1,0,0,0,1
37393,1,0,0,0,1
37394,1,0,0,0,1
37395,0,1,0,0,1
37396,0,1,0,0,1
37397,0,1,0,0,1
37398,0,1,0,0,1
37399,0,0,1,0,1
37400,1,0,0,0,1
37401,0,1,0,0,1
37402,0,1,0,0,1
37403,0,1,0,0,1
37404,0,1,0,0,1
37405,0,1,0,0,1
37406,0,1,0,0,1
37407,0,1,0,0,1
37408,0,1,0,0,1
37409,0,1,0,0,1
37410,0,1,0,0,1
37411,0,1,0,0,1
37412,0,1,0,0,1
37413,0,1,0,0,1
37414,0,1,0,0,1
37415,0,1,0,0,1
37416,0,1,0,0,1
37417,0,1,0,0,1
37418,0,1,0,0,1
37419,0,1,0,0,1
37420,1,0,0,0,1
37421,0,1,0,0,1
37422,0,1,0,0,1
37423,0,1,0,0,1
37424,0,1,0,0,1
37425,0,1,0,0,1
37426,0,1,0,0,1
37427,0,1,0,0,1
37428,0,1,0,0,1
37429,0,1,0,0,1
37430,0,1,0,0,1
37431,0,1,0,0,1
37432,0,1,0,0,1
37433,1,0,0,0,1
37434,1,0,0,0,1
37435,0,1,0,0,1
37436,1,0,0,0,1
37437,1,0,0,0,1
37438,0,1,0,0,1
37439,0,1,0,0,1
37440,0,1,0,0,1
37441,1,0,0,0,1
37442,0,1,0,0,1
37443,0,1,0,0,1
37444,1,0,0,0,1
37445,0,1,0,0,1
37446,0,1,0,0,1
37447,0,1,0,0,1
37448,0,1,0,0,1
37449,0,0,1,0,1
37450,0,1,0,0,1
37451,1,0,0,0,1
37452,0,1,0,0,1
37453,1,0,0,0,1
37454,0,1,0,0,1
37455,0,1,0,0,1
37456,0,1,0,0,1
37457,0,1,0,0,1
37458,0,0,0,1,1
37459,0,1,0,0,1
37460,1,0,0,0,1
37461,0,1,0,0,1
37462,0,1,0,0,1
37463,0,1,0,0,1
37464,0,1,0,0,1
37465,0,1,0,0,1
37466,0,1,0,0,1
37467,0,1,0,0,1
37468,0,1,0,0,1
37469,0,1,0,0,1
37470,0,1,0,0,1
37471,0,1,0,0,1
37472,0,1,0,0,1
37473,0,1,0,0,1
37474,0,1,0,0,1
37475,0,1,0,0,1
37476,0,0,0,1,1
37477,0,1,0,0,1
37478,0,0,0,1,1
37479,1,0,0,0,1
37480,1,0,0,0,1
37481,0,1,0,0,1
37482,1,0,0,0,1
37483,0,1,0,0,1
37484,0,1,0,0,1
37485,0,1,0,0,1
37486,0,1,0,0,1
37487,0,0,0,1,1
37488,0,1,0,0,1
37489,0,1,0,0,1
37490,0,0,1,0,1
37491,0,1,0,0,1
37492,0,1,0,0,1
37493,0,1,0,0,1
37494,1,0,0,0,1
37495,0,1,0,0,1
37496,0,1,0,0,1
37497,0,1,0,0,1
37498,0,1,0,0,1
37499,0,1,0,0,1
37500,0,1,0,0,1
37501,0,1,0,0,1
37502,0,1,0,0,1
37503,0,1,0,0,1
37504,1,0,0,0,1
37505,0,1,0,0,1
37506,1,0,0,0,1
37507,0,1,0,0,1
37508,0,1,0,0,1
37509,0,1,0,0,1
37510,0,1,0,0,1
37511,0,1,0,0,1
37512,1,0,0,0,1
37513,0,1,0,0,1
37514,0,1,0,0,1
37515,0,1,0,0,1
37516,0,1,0,0,1
37517,0,1,0,0,1
37518,1,0,0,0,1
37519,0,0,0,1,1
37520,0,0,0,1,1
37521,0,1,0,0,1
37522,0,1,0,0,1
37523,0,1,0,0,1
37524,0,1,0,0,1
37525,0,1,0,0,1
37526,1,0,0,0,1
37527,1,0,0,0,1
37528,0,1,0,0,1
37529,1,0,0,0,1
37530,0,1,0,0,1
37531,0,1,0,0,1
37532,1,0,0,0,1
37533,0,1,0,0,1
37534,1,0,0,0,1
37535,0,1,0,0,1
37536,1,0,0,0,1
37537,0,1,0,0,1
37538,1,0,0,0,1
37539,0,1,0,0,1
37540,1,0,0,0,1
37541,0,1,0,0,1
37542,1,0,0,0,1
37543,0,1,0,0,1
37544,0,1,0,0,1
37545,0,1,0,0,1
37546,0,1,0,0,1
37547,0,1,0,0,1
37548,0,1,0,0,1
37549,0,1,0,0,1
37550,0,1,0,0,1
37551,1,0,0,0,1
37552,0,1,0,0,1
37553,0,1,0,0,1
37554,1,0,0,0,1
37555,0,1,0,0,1
37556,0,1,0,0,1
37557,0,1,0,0,1
37558,0,1,0,0,1
37559,0,1,0,0,1
37560,1,0,0,0,1
37561,0,1,0,0,1
37562,0,1,0,0,1
37563,0,1,0,0,1
37564,1,0,0,0,1
37565,0,1,0,0,1
37566,1,0,0,0,1
37567,0,1,0,0,1
37568,1,0,0,0,1
37569,0,1,0,0,1
37570,0,1,0,0,1
37571,0,1,0,0,1
37572,0,1,0,0,1
37573,0,1,0,0,1
37574,0,1,0,0,1
37575,0,1,0,0,1
37576,0,1,0,0,1
37577,0,1,0,0,1
37578,1,0,0,0,1
37579,0,1,0,0,1
37580,1,0,0,0,1
37581,0,1,0,0,1
37582,0,1,0,0,1
37583,0,1,0,0,1
37584,0,1,0,0,1
37585,0,0,1,0,1
37586,0,1,0,0,1
37587,0,1,0,0,1
37588,0,1,0,0,1
37589,0,1,0,0,1
37590,0,1,0,0,1
37591,0,1,0,0,1
37592,0,1,0,0,1
37593,0,0,1,0,1
37594,0,1,0,0,1
37595,0,1,0,0,1
37596,0,1,0,0,1
37597,0,1,0,0,1
37598,0,1,0,0,1
37599,0,1,0,0,1
37600,0,1,0,0,1
37601,0,1,0,0,1
37602,0,1,0,0,1
37603,0,1,0,0,1
37604,0,1,0,0,1
37605,1,0,0,0,1
37606,0,1,0,0,1
37607,0,0,0,1,1
37608,1,0,0,0,1
37609,0,1,0,0,1
37610,0,1,0,0,1
37611,0,1,0,0,1
37612,0,1,0,0,1
37613,0,1,0,0,1
37614,0,1,0,0,1
37615,1,0,0,0,1
37616,0,1,0,0,1
37617,0,1,0,0,1
37618,0,1,0,0,1
37619,0,1,0,0,1
37620,1,0,0,0,1
37621,0,1,0,0,1
37622,0,1,0,0,1
37623,0,1,0,0,1
37624,0,1,0,0,1
37625,0,1,0,0,1
37626,0,1,0,0,1
37627,0,1,0,0,1
37628,0,1,0,0,1
37629,0,1,0,0,1
37630,1,0,0,0,1
37631,0,1,0,0,1
37632,1,0,0,0,1
37633,0,1,0,0,1
37634,0,1,0,0,1
37635,1,0,0,0,1
37636,0,1,0,0,1
37637,0,1,0,0,1
37638,0,1,0,0,1
37639,1,0,0,0,1
37640,0,1,0,0,1
37641,0,1,0,0,1
37642,0,1,0,0,1
37643,0,1,0,0,1
37644,0,1,0,0,1
37645,1,0,0,0,1
37646,0,1,0,0,1
37647,1,0,0,0,1
37648,0,1,0,0,1
37649,0,1,0,0,1
37650,0,1,0,0,1
37651,1,0,0,0,1
37652,1,0,0,0,1
37653,0,1,0,0,1
37654,0,1,0,0,1
37655,0,1,0,0,1
37656,0,1,0,0,1
37657,0,1,0,0,1
37658,0,1,0,0,1
37659,0,1,0,0,1
37660,0,1,0,0,1
37661,0,0,0,1,1
37662,0,1,0,0,1
37663,0,1,0,0,1
37664,0,1,0,0,1
37665,0,1,0,0,1
37666,0,1,0,0,1
37667,0,1,0,0,1
37668,0,1,0,0,1
37669,1,0,0,0,1
37670,0,1,0,0,1
37671,0,1,0,0,1
37672,1,0,0,0,1
37673,0,1,0,0,1
37674,0,1,0,0,1
37675,0,1,0,0,1
37676,0,1,0,0,1
37677,0,1,0,0,1
37678,1,0,0,0,1
37679,1,0,0,0,1
37680,1,0,0,0,1
37681,0,1,0,0,1
37682,0,1,0,0,1
37683,1,0,0,0,1
37684,0,1,0,0,1
37685,0,1,0,0,1
37686,0,1,0,0,1
37687,0,1,0,0,1
37688,0,1,0,0,1
37689,1,0,0,0,1
37690,0,1,0,0,1
37691,0,1,0,0,1
37692,0,1,0,0,1
37693,0,0,0,1,1
37694,1,0,0,0,1
37695,1,0,0,0,1
37696,0,1,0,0,1
37697,0,1,0,0,1
37698,0,1,0,0,1
37699,0,1,0,0,1
37700,0,0,1,0,1
37701,0,1,0,0,1
37702,0,0,1,0,1
37703,0,1,0,0,1
37704,0,1,0,0,1
37705,0,1,0,0,1
37706,0,0,0,1,1
37707,0,1,0,0,1
37708,0,1,0,0,1
37709,1,0,0,0,1
37710,0,1,0,0,1
37711,0,1,0,0,1
37712,0,1,0,0,1
37713,0,1,0,0,1
37714,0,1,0,0,1
37715,1,0,0,0,1
37716,0,1,0,0,1
37717,0,1,0,0,1
37718,0,1,0,0,1
37719,0,1,0,0,1
37720,0,1,0,0,1
37721,0,1,0,0,1
37722,0,1,0,0,1
37723,1,0,0,0,1
37724,0,1,0,0,1
37725,0,1,0,0,1
37726,0,1,0,0,1
37727,0,1,0,0,1
37728,0,1,0,0,1
37729,0,0,1,0,1
37730,1,0,0,0,1
37731,0,1,0,0,1
37732,0,1,0,0,1
37733,0,1,0,0,1
37734,0,1,0,0,1
37735,0,1,0,0,1
37736,0,1,0,0,1
37737,0,1,0,0,1
37738,1,0,0,0,1
37739,0,1,0,0,1
37740,0,1,0,0,1
37741,0,1,0,0,1
37742,0,0,1,0,1
37743,1,0,0,0,1
37744,0,1,0,0,1
37745,0,1,0,0,1
37746,0,1,0,0,1
37747,0,1,0,0,1
37748,0,1,0,0,1
37749,1,0,0,0,1
37750,0,1,0,0,1
37751,0,1,0,0,1
37752,0,1,0,0,1
37753,0,1,0,0,1
37754,1,0,0,0,1
37755,1,0,0,0,1
37756,1,0,0,0,1
37757,0,1,0,0,1
37758,0,1,0,0,1
37759,0,1,0,0,1
37760,1,0,0,0,1
37761,0,1,0,0,1
37762,0,1,0,0,1
37763,0,1,0,0,1
37764,1,0,0,0,1
37765,0,1,0,0,1
37766,0,1,0,0,1
37767,0,1,0,0,1
37768,0,1,0,0,1
37769,0,1,0,0,1
37770,0,1,0,0,1
37771,0,1,0,0,1
37772,1,0,0,0,1
37773,0,1,0,0,1
37774,1,0,0,0,1
37775,1,0,0,0,1
37776,0,1,0,0,1
37777,1,0,0,0,1
37778,0,1,0,0,1
37779,1,0,0,0,1
37780,0,0,1,0,1
37781,0,1,0,0,1
37782,1,0,0,0,1
37783,0,0,1,0,1
37784,0,1,0,0,1
37785,1,0,0,0,1
37786,0,1,0,0,1
37787,0,1,0,0,1
37788,0,1,0,0,1
37789,0,1,0,0,1
37790,0,1,0,0,1
37791,0,1,0,0,1
37792,0,1,0,0,1
37793,0,1,0,0,1
37794,0,1,0,0,1
37795,0,1,0,0,1
37796,0,1,0,0,1
37797,0,1,0,0,1
37798,0,1,0,0,1
37799,0,1,0,0,1
37800,0,1,0,0,1
37801,0,1,0,0,1
37802,1,0,0,0,1
37803,1,0,0,0,1
37804,0,1,0,0,1
37805,0,1,0,0,1
37806,0,1,0,0,1
37807,1,0,0,0,1
37808,0,1,0,0,1
37809,0,1,0,0,1
37810,1,0,0,0,1
37811,0,1,0,0,1
37812,0,1,0,0,1
37813,1,0,0,0,1
37814,0,1,0,0,1
37815,0,1,0,0,1
37816,0,1,0,0,1
37817,0,1,0,0,1
37818,0,1,0,0,1
37819,0,1,0,0,1
37820,1,0,0,0,1
37821,1,0,0,0,1
37822,1,0,0,0,1
37823,0,1,0,0,1
37824,0,1,0,0,1
37825,0,1,0,0,1
37826,0,1,0,0,1
37827,0,1,0,0,1
37828,0,1,0,0,1
37829,0,0,1,0,1
37830,0,1,0,0,1
37831,0,1,0,0,1
37832,0,0,0,1,1
37833,0,1,0,0,1
37834,0,1,0,0,1
37835,0,1,0,0,1
37836,0,1,0,0,1
37837,0,1,0,0,1
37838,0,1,0,0,1
37839,0,1,0,0,1
37840,0,1,0,0,1
37841,1,0,0,0,1
37842,0,1,0,0,1
37843,0,1,0,0,1
37844,1,0,0,0,1
37845,0,1,0,0,1
37846,0,1,0,0,1
37847,0,1,0,0,1
37848,0,1,0,0,1
37849,0,1,0,0,1
37850,1,0,0,0,1
37851,0,1,0,0,1
37852,0,0,0,1,1
37853,0,1,0,0,1
37854,0,1,0,0,1
37855,0,1,0,0,1
37856,0,1,0,0,1
37857,0,1,0,0,1
37858,0,1,0,0,1
37859,0,1,0,0,1
37860,0,1,0,0,1
37861,0,1,0,0,1
37862,0,1,0,0,1
37863,1,0,0,0,1
37864,0,1,0,0,1
37865,0,1,0,0,1
37866,1,0,0,0,1
37867,1,0,0,0,1
37868,0,1,0,0,1
37869,0,1,0,0,1
37870,0,1,0,0,1
37871,0,1,0,0,1
37872,1,0,0,0,1
37873,0,1,0,0,1
37874,0,0,0,1,1
37875,0,1,0,0,1
37876,1,0,0,0,1
37877,1,0,0,0,1
37878,0,1,0,0,1
37879,0,1,0,0,1
37880,0,1,0,0,1
37881,0,1,0,0,1
37882,0,1,0,0,1
37883,0,1,0,0,1
37884,0,1,0,0,1
37885,0,1,0,0,1
37886,0,1,0,0,1
37887,0,0,0,1,1
37888,0,1,0,0,1
37889,1,0,0,0,1
37890,1,0,0,0,1
37891,0,1,0,0,1
37892,0,1,0,0,1
37893,1,0,0,0,1
37894,0,1,0,0,1
37895,0,1,0,0,1
37896,0,1,0,0,1
37897,1,0,0,0,1
37898,0,1,0,0,1
37899,0,1,0,0,1
37900,0,1,0,0,1
37901,0,1,0,0,1
37902,0,1,0,0,1
37903,0,1,0,0,1
37904,0,1,0,0,1
37905,0,1,0,0,1
37906,0,1,0,0,1
37907,0,1,0,0,1
37908,0,1,0,0,1
37909,0,1,0,0,1
37910,0,1,0,0,1
37911,1,0,0,0,1
37912,0,1,0,0,1
37913,0,1,0,0,1
37914,1,0,0,0,1
37915,0,1,0,0,1
37916,0,1,0,0,1
37917,0,1,0,0,1
37918,0,1,0,0,1
37919,0,1,0,0,1
37920,0,1,0,0,1
37921,0,1,0,0,1
37922,0,1,0,0,1
37923,0,1,0,0,1
37924,0,1,0,0,1
37925,1,0,0,0,1
37926,0,1,0,0,1
37927,0,1,0,0,1
37928,1,0,0,0,1
37929,1,0,0,0,1
37930,0,1,0,0,1
37931,0,0,1,0,1
37932,0,1,0,0,1
37933,0,1,0,0,1
37934,0,1,0,0,1
37935,0,1,0,0,1
37936,0,1,0,0,1
37937,0,1,0,0,1
37938,0,0,1,0,1
37939,0,1,0,0,1
37940,0,1,0,0,1
37941,0,1,0,0,1
37942,0,1,0,0,1
37943,0,1,0,0,1
37944,1,0,0,0,1
37945,1,0,0,0,1
37946,0,1,0,0,1
37947,0,1,0,0,1
37948,0,1,0,0,1
37949,0,1,0,0,1
37950,1,0,0,0,1
37951,0,1,0,0,1
37952,1,0,0,0,1
37953,0,0,0,1,1
37954,0,1,0,0,1
37955,0,1,0,0,1
37956,0,1,0,0,1
37957,0,1,0,0,1
37958,1,0,0,0,1
37959,0,0,1,0,1
37960,1,0,0,0,1
37961,0,1,0,0,1
37962,0,1,0,0,1
37963,1,0,0,0,1
37964,0,1,0,0,1
37965,0,1,0,0,1
37966,0,1,0,0,1
37967,0,1,0,0,1
37968,0,1,0,0,1
37969,0,1,0,0,1
37970,0,1,0,0,1
37971,1,0,0,0,1
37972,0,1,0,0,1
37973,0,1,0,0,1
37974,0,1,0,0,1
37975,0,1,0,0,1
37976,0,1,0,0,1
37977,0,1,0,0,1
37978,0,1,0,0,1
37979,0,1,0,0,1
37980,1,0,0,0,1
37981,0,1,0,0,1
37982,0,1,0,0,1
37983,0,1,0,0,1
37984,0,1,0,0,1
37985,0,1,0,0,1
37986,1,0,0,0,1
37987,1,0,0,0,1
37988,0,0,0,1,1
37989,0,1,0,0,1
37990,1,0,0,0,1
37991,0,1,0,0,1
37992,1,0,0,0,1
37993,1,0,0,0,1
37994,0,1,0,0,1
37995,1,0,0,0,1
37996,0,1,0,0,1
37997,0,1,0,0,1
37998,0,1,0,0,1
37999,0,1,0,0,1
38000,0,1,0,0,1
38001,1,0,0,0,1
38002,0,1,0,0,1
38003,0,1,0,0,1
38004,0,1,0,0,1
38005,0,1,0,0,1
38006,0,1,0,0,1
38007,0,1,0,0,1
38008,0,0,1,0,1
38009,0,1,0,0,1
38010,0,1,0,0,1
38011,0,1,0,0,1
38012,0,1,0,0,1
38013,0,1,0,0,1
38014,0,1,0,0,1
38015,0,1,0,0,1
38016,0,1,0,0,1
38017,0,1,0,0,1
38018,0,1,0,0,1
38019,0,1,0,0,1
38020,0,1,0,0,1
38021,0,1,0,0,1
38022,0,1,0,0,1
38023,0,1,0,0,1
38024,0,1,0,0,1
38025,0,1,0,0,1
38026,1,0,0,0,1
38027,0,1,0,0,1
38028,0,1,0,0,1
38029,0,1,0,0,1
38030,0,1,0,0,1
38031,1,0,0,0,1
38032,0,1,0,0,1
38033,0,1,0,0,1
38034,0,1,0,0,1
38035,0,1,0,0,1
38036,0,1,0,0,1
38037,1,0,0,0,1
38038,0,1,0,0,1
38039,1,0,0,0,1
38040,1,0,0,0,1
38041,0,1,0,0,1
38042,0,1,0,0,1
38043,0,1,0,0,1
38044,0,1,0,0,1
38045,0,1,0,0,1
38046,0,1,0,0,1
38047,0,1,0,0,1
38048,0,1,0,0,1
38049,0,1,0,0,1
38050,1,0,0,0,1
38051,0,1,0,0,1
38052,0,1,0,0,1
38053,0,1,0,0,1
38054,0,1,0,0,1
38055,0,1,0,0,1
38056,0,1,0,0,1
38057,1,0,0,0,1
38058,0,1,0,0,1
38059,0,1,0,0,1
38060,0,1,0,0,1
38061,0,1,0,0,1
38062,0,0,0,1,1
38063,0,1,0,0,1
38064,0,1,0,0,1
38065,0,1,0,0,1
38066,0,0,1,0,1
38067,0,1,0,0,1
38068,0,1,0,0,1
38069,0,1,0,0,1
38070,1,0,0,0,1
38071,0,1,0,0,1
38072,1,0,0,0,1
38073,0,0,0,1,1
38074,0,1,0,0,1
38075,0,1,0,0,1
38076,0,1,0,0,1
38077,0,1,0,0,1
38078,0,1,0,0,1
38079,0,1,0,0,1
38080,0,1,0,0,1
38081,0,1,0,0,1
38082,0,1,0,0,1
38083,1,0,0,0,1
38084,0,1,0,0,1
38085,0,1,0,0,1
38086,0,0,0,1,1
38087,0,1,0,0,1
38088,0,0,0,1,1
38089,0,1,0,0,1
38090,0,1,0,0,1
38091,0,1,0,0,1
38092,1,0,0,0,1
38093,0,1,0,0,1
38094,1,0,0,0,1
38095,0,1,0,0,1
38096,0,1,0,0,1
38097,0,1,0,0,1
38098,0,1,0,0,1
38099,0,1,0,0,1
38100,0,1,0,0,1
38101,0,1,0,0,1
38102,0,1,0,0,1
38103,0,0,1,0,1
38104,0,0,0,1,1
38105,0,1,0,0,1
38106,0,1,0,0,1
38107,0,1,0,0,1
38108,0,1,0,0,1
38109,0,1,0,0,1
38110,0,1,0,0,1
38111,0,1,0,0,1
38112,0,1,0,0,1
38113,0,1,0,0,1
38114,0,1,0,0,1
38115,1,0,0,0,1
38116,0,1,0,0,1
38117,0,1,0,0,1
38118,0,1,0,0,1
38119,1,0,0,0,1
38120,0,1,0,0,1
38121,0,1,0,0,1
38122,0,1,0,0,1
38123,1,0,0,0,1
38124,0,1,0,0,1
38125,0,1,0,0,1
38126,0,1,0,0,1
38127,0,1,0,0,1
38128,0,1,0,0,1
38129,0,1,0,0,1
38130,1,0,0,0,1
38131,0,1,0,0,1
38132,1,0,0,0,1
38133,0,1,0,0,1
38134,1,0,0,0,1
38135,1,0,0,0,1
38136,0,1,0,0,1
38137,0,1,0,0,1
38138,0,1,0,0,1
38139,1,0,0,0,1
38140,0,1,0,0,1
38141,0,1,0,0,1
38142,0,1,0,0,1
38143,1,0,0,0,1
38144,0,1,0,0,1
38145,0,1,0,0,1
38146,0,1,0,0,1
38147,0,1,0,0,1
38148,0,0,1,0,1
38149,0,1,0,0,1
38150,0,1,0,0,1
38151,0,1,0,0,1
38152,1,0,0,0,1
38153,0,0,1,0,1
38154,0,1,0,0,1
38155,0,1,0,0,1
38156,0,1,0,0,1
38157,0,1,0,0,1
38158,1,0,0,0,1
38159,0,1,0,0,1
38160,0,1,0,0,1
38161,0,1,0,0,1
38162,0,1,0,0,1
38163,0,1,0,0,1
38164,0,1,0,0,1
38165,0,1,0,0,1
38166,0,0,1,0,1
38167,0,0,0,1,1
38168,1,0,0,0,1
38169,0,1,0,0,1
38170,1,0,0,0,1
38171,0,1,0,0,1
38172,0,1,0,0,1
38173,0,1,0,0,1
38174,0,0,0,1,1
38175,0,1,0,0,1
38176,1,0,0,0,1
38177,1,0,0,0,1
38178,0,1,0,0,1
38179,1,0,0,0,1
38180,0,1,0,0,1
38181,0,1,0,0,1
38182,1,0,0,0,1
38183,0,0,0,1,1
38184,0,1,0,0,1
38185,0,1,0,0,1
38186,1,0,0,0,1
38187,0,1,0,0,1
38188,0,1,0,0,1
38189,0,1,0,0,1
38190,0,1,0,0,1
38191,0,1,0,0,1
38192,0,1,0,0,1
38193,0,1,0,0,1
38194,0,1,0,0,1
38195,0,1,0,0,1
38196,0,1,0,0,1
38197,0,1,0,0,1
38198,0,1,0,0,1
38199,0,1,0,0,1
38200,0,1,0,0,1
38201,0,1,0,0,1
38202,0,1,0,0,1
38203,1,0,0,0,1
38204,1,0,0,0,1
38205,0,1,0,0,1
38206,0,1,0,0,1
38207,0,1,0,0,1
38208,0,1,0,0,1
38209,1,0,0,0,1
38210,0,1,0,0,1
38211,0,1,0,0,1
38212,0,1,0,0,1
38213,0,0,0,1,1
38214,0,1,0,0,1
38215,0,1,0,0,1
38216,1,0,0,0,1
38217,0,1,0,0,1
38218,0,1,0,0,1
38219,1,0,0,0,1
38220,1,0,0,0,1
38221,0,1,0,0,1
38222,1,0,0,0,1
38223,0,1,0,0,1
38224,0,1,0,0,1
38225,0,1,0,0,1
38226,0,1,0,0,1
38227,0,1,0,0,1
38228,0,1,0,0,1
38229,0,1,0,0,1
38230,1,0,0,0,1
38231,0,1,0,0,1
38232,0,1,0,0,1
38233,0,1,0,0,1
38234,0,1,0,0,1
38235,0,1,0,0,1
38236,0,1,0,0,1
38237,1,0,0,0,1
38238,1,0,0,0,1
38239,0,0,0,1,1
38240,1,0,0,0,1
38241,0,1,0,0,1
38242,0,1,0,0,1
38243,0,1,0,0,1
38244,0,1,0,0,1
38245,0,1,0,0,1
38246,0,1,0,0,1
38247,1,0,0,0,1
38248,0,1,0,0,1
38249,0,1,0,0,1
38250,1,0,0,0,1
38251,1,0,0,0,1
38252,0,1,0,0,1
38253,0,1,0,0,1
38254,0,1,0,0,1
38255,0,1,0,0,1
38256,1,0,0,0,1
38257,1,0,0,0,1
38258,1,0,0,0,1
38259,0,1,0,0,1
38260,0,1,0,0,1
38261,0,1,0,0,1
38262,0,1,0,0,1
38263,0,1,0,0,1
38264,1,0,0,0,1
38265,0,0,1,0,1
38266,1,0,0,0,1
38267,0,1,0,0,1
38268,0,1,0,0,1
38269,1,0,0,0,1
38270,0,1,0,0,1
38271,0,1,0,0,1
38272,0,1,0,0,1
38273,0,1,0,0,1
38274,0,1,0,0,1
38275,0,1,0,0,1
38276,0,1,0,0,1
38277,0,1,0,0,1
38278,0,1,0,0,1
38279,0,1,0,0,1
38280,1,0,0,0,1
38281,0,1,0,0,1
38282,1,0,0,0,1
38283,0,1,0,0,1
38284,0,1,0,0,1
38285,0,1,0,0,1
38286,0,1,0,0,1
38287,1,0,0,0,1
38288,0,0,1,0,1
38289,0,1,0,0,1
38290,0,1,0,0,1
38291,0,1,0,0,1
38292,0,1,0,0,1
38293,0,1,0,0,1
38294,0,1,0,0,1
38295,0,1,0,0,1
38296,0,1,0,0,1
38297,1,0,0,0,1
38298,0,1,0,0,1
38299,1,0,0,0,1
38300,1,0,0,0,1
38301,0,1,0,0,1
38302,0,1,0,0,1
38303,0,1,0,0,1
38304,0,1,0,0,1
38305,0,0,1,0,1
38306,0,1,0,0,1
38307,0,1,0,0,1
38308,0,1,0,0,1
38309,0,1,0,0,1
38310,0,1,0,0,1
38311,0,1,0,0,1
38312,0,1,0,0,1
38313,0,1,0,0,1
38314,1,0,0,0,1
38315,0,1,0,0,1
38316,0,1,0,0,1
38317,0,1,0,0,1
38318,0,1,0,0,1
38319,1,0,0,0,1
38320,0,1,0,0,1
38321,0,1,0,0,1
38322,0,1,0,0,1
38323,0,1,0,0,1
38324,0,1,0,0,1
38325,0,1,0,0,1
38326,0,1,0,0,1
38327,0,1,0,0,1
38328,0,1,0,0,1
38329,0,1,0,0,1
38330,0,1,0,0,1
38331,0,1,0,0,1
38332,0,1,0,0,1
38333,0,1,0,0,1
38334,0,1,0,0,1
38335,0,1,0,0,1
38336,0,1,0,0,1
38337,0,1,0,0,1
38338,0,0,1,0,1
38339,0,1,0,0,1
38340,0,1,0,0,1
38341,1,0,0,0,1
38342,0,1,0,0,1
38343,1,0,0,0,1
38344,0,1,0,0,1
38345,0,1,0,0,1
38346,0,1,0,0,1
38347,0,1,0,0,1
38348,0,1,0,0,1
38349,0,1,0,0,1
38350,0,1,0,0,1
38351,0,1,0,0,1
38352,0,1,0,0,1
38353,0,1,0,0,1
38354,0,0,1,0,1
38355,0,1,0,0,1
38356,0,1,0,0,1
38357,0,0,0,1,1
38358,0,1,0,0,1
38359,0,1,0,0,1
38360,0,1,0,0,1
38361,0,1,0,0,1
38362,0,1,0,0,1
38363,0,1,0,0,1
38364,0,1,0,0,1
38365,0,1,0,0,1
38366,0,1,0,0,1
38367,0,1,0,0,1
38368,0,1,0,0,1
38369,0,1,0,0,1
38370,0,1,0,0,1
38371,0,1,0,0,1
38372,1,0,0,0,1
38373,0,0,1,0,1
38374,1,0,0,0,1
38375,0,1,0,0,1
38376,0,1,0,0,1
38377,0,1,0,0,1
38378,0,1,0,0,1
38379,0,0,0,1,1
38380,1,0,0,0,1
38381,1,0,0,0,1
38382,0,1,0,0,1
38383,0,1,0,0,1
38384,0,1,0,0,1
38385,1,0,0,0,1
38386,0,1,0,0,1
38387,1,0,0,0,1
38388,0,1,0,0,1
38389,0,1,0,0,1
38390,0,1,0,0,1
38391,0,1,0,0,1
38392,0,1,0,0,1
38393,1,0,0,0,1
38394,0,1,0,0,1
38395,0,1,0,0,1
38396,0,1,0,0,1
38397,0,1,0,0,1
38398,1,0,0,0,1
38399,1,0,0,0,1
38400,0,1,0,0,1
38401,0,1,0,0,1
38402,0,1,0,0,1
38403,0,0,0,1,1
38404,0,1,0,0,1
38405,0,1,0,0,1
38406,0,1,0,0,1
38407,0,1,0,0,1
38408,0,1,0,0,1
38409,0,1,0,0,1
38410,0,1,0,0,1
38411,0,1,0,0,1
38412,0,1,0,0,1
38413,0,1,0,0,1
38414,0,1,0,0,1
38415,0,1,0,0,1
38416,0,1,0,0,1
38417,0,1,0,0,1
38418,0,1,0,0,1
38419,1,0,0,0,1
38420,0,1,0,0,1
38421,0,1,0,0,1
38422,0,1,0,0,1
38423,0,1,0,0,1
38424,0,1,0,0,1
38425,0,1,0,0,1
38426,0,1,0,0,1
38427,0,0,0,1,1
38428,0,1,0,0,1
38429,0,1,0,0,1
38430,0,1,0,0,1
38431,1,0,0,0,1
38432,0,1,0,0,1
38433,0,0,0,1,1
38434,0,1,0,0,1
38435,0,1,0,0,1
38436,0,1,0,0,1
38437,0,1,0,0,1
38438,0,1,0,0,1
38439,0,1,0,0,1
38440,0,1,0,0,1
38441,0,1,0,0,1
38442,0,1,0,0,1
38443,0,1,0,0,1
38444,0,1,0,0,1
38445,1,0,0,0,1
38446,0,1,0,0,1
38447,0,1,0,0,1
38448,0,1,0,0,1
38449,0,1,0,0,1
38450,0,1,0,0,1
38451,1,0,0,0,1
38452,1,0,0,0,1
38453,1,0,0,0,1
38454,0,1,0,0,1
38455,0,1,0,0,1
38456,0,1,0,0,1
38457,0,1,0,0,1
38458,0,1,0,0,1
38459,0,1,0,0,1
38460,0,1,0,0,1
38461,0,1,0,0,1
38462,0,1,0,0,1
38463,0,1,0,0,1
38464,0,1,0,0,1
38465,0,1,0,0,1
38466,1,0,0,0,1
38467,1,0,0,0,1
38468,0,1,0,0,1
38469,1,0,0,0,1
38470,0,1,0,0,1
38471,0,1,0,0,1
38472,0,1,0,0,1
38473,0,1,0,0,1
38474,0,1,0,0,1
38475,0,1,0,0,1
38476,0,1,0,0,1
38477,0,1,0,0,1
38478,0,0,0,1,1
38479,0,0,1,0,1
38480,0,1,0,0,1
38481,1,0,0,0,1
38482,0,1,0,0,1
38483,0,1,0,0,1
38484,0,1,0,0,1
38485,1,0,0,0,1
38486,0,1,0,0,1
38487,0,1,0,0,1
38488,0,1,0,0,1
38489,0,1,0,0,1
38490,0,1,0,0,1
38491,0,1,0,0,1
38492,0,1,0,0,1
38493,0,1,0,0,1
38494,1,0,0,0,1
38495,0,1,0,0,1
38496,1,0,0,0,1
38497,0,1,0,0,1
38498,0,1,0,0,1
38499,1,0,0,0,1
38500,0,1,0,0,1
38501,1,0,0,0,1
38502,0,1,0,0,1
38503,0,1,0,0,1
38504,0,1,0,0,1
38505,0,1,0,0,1
38506,1,0,0,0,1
38507,0,1,0,0,1
38508,0,1,0,0,1
38509,0,1,0,0,1
38510,0,1,0,0,1
38511,0,1,0,0,1
38512,0,1,0,0,1
38513,0,1,0,0,1
38514,0,1,0,0,1
38515,0,1,0,0,1
38516,0,1,0,0,1
38517,0,1,0,0,1
38518,0,1,0,0,1
38519,0,1,0,0,1
38520,0,1,0,0,1
38521,0,1,0,0,1
38522,0,1,0,0,1
38523,0,1,0,0,1
38524,0,1,0,0,1
38525,0,1,0,0,1
38526,0,1,0,0,1
38527,0,1,0,0,1
38528,0,1,0,0,1
38529,0,1,0,0,1
38530,0,1,0,0,1
38531,0,1,0,0,1
38532,1,0,0,0,1
38533,0,0,0,1,1
38534,0,1,0,0,1
38535,0,1,0,0,1
38536,1,0,0,0,1
38537,1,0,0,0,1
38538,0,1,0,0,1
38539,0,1,0,0,1
38540,0,0,0,1,1
38541,0,1,0,0,1
38542,0,1,0,0,1
38543,0,0,1,0,1
38544,0,1,0,0,1
38545,0,1,0,0,1
38546,0,1,0,0,1
38547,0,0,1,0,1
38548,0,1,0,0,1
38549,0,1,0,0,1
38550,0,1,0,0,1
38551,0,0,0,1,1
38552,0,1,0,0,1
38553,0,1,0,0,1
38554,0,1,0,0,1
38555,0,1,0,0,1
38556,0,1,0,0,1
38557,0,1,0,0,1
38558,0,1,0,0,1
38559,0,1,0,0,1
38560,1,0,0,0,1
38561,1,0,0,0,1
38562,0,1,0,0,1
38563,0,1,0,0,1
38564,0,1,0,0,1
38565,0,1,0,0,1
38566,0,1,0,0,1
38567,0,1,0,0,1
38568,0,1,0,0,1
38569,0,1,0,0,1
38570,0,1,0,0,1
38571,0,1,0,0,1
38572,0,1,0,0,1
38573,0,1,0,0,1
38574,0,0,0,1,1
38575,0,1,0,0,1
38576,0,1,0,0,1
38577,0,1,0,0,1
38578,0,1,0,0,1
38579,1,0,0,0,1
38580,0,1,0,0,1
38581,0,1,0,0,1
38582,0,1,0,0,1
38583,0,1,0,0,1
38584,0,1,0,0,1
38585,0,1,0,0,1
38586,0,1,0,0,1
38587,0,1,0,0,1
38588,0,1,0,0,1
38589,0,1,0,0,1
38590,0,1,0,0,1
38591,0,1,0,0,1
38592,0,1,0,0,1
38593,0,1,0,0,1
38594,0,1,0,0,1
38595,0,1,0,0,1
38596,0,1,0,0,1
38597,0,1,0,0,1
38598,0,1,0,0,1
38599,0,1,0,0,1
38600,0,1,0,0,1
38601,0,1,0,0,1
38602,0,1,0,0,1
38603,0,1,0,0,1
38604,0,1,0,0,1
38605,0,1,0,0,1
38606,1,0,0,0,1
38607,0,1,0,0,1
38608,0,1,0,0,1
38609,0,1,0,0,1
38610,0,1,0,0,1
38611,0,1,0,0,1
38612,1,0,0,0,1
38613,0,1,0,0,1
38614,0,1,0,0,1
38615,0,1,0,0,1
38616,0,1,0,0,1
38617,0,1,0,0,1
38618,0,1,0,0,1
38619,0,1,0,0,1
38620,1,0,0,0,1
38621,0,1,0,0,1
38622,0,1,0,0,1
38623,0,1,0,0,1
38624,0,1,0,0,1
38625,1,0,0,0,1
38626,0,0,1,0,1
38627,0,1,0,0,1
38628,0,1,0,0,1
38629,1,0,0,0,1
38630,0,1,0,0,1
38631,0,1,0,0,1
38632,0,1,0,0,1
38633,0,1,0,0,1
38634,0,1,0,0,1
38635,0,1,0,0,1
38636,1,0,0,0,1
38637,0,1,0,0,1
38638,0,1,0,0,1
38639,0,1,0,0,1
38640,0,0,0,1,1
38641,0,1,0,0,1
38642,0,1,0,0,1
38643,0,1,0,0,1
38644,0,1,0,0,1
38645,0,1,0,0,1
38646,0,1,0,0,1
38647,0,1,0,0,1
38648,0,0,0,1,1
38649,0,1,0,0,1
38650,0,1,0,0,1
38651,0,1,0,0,1
38652,0,1,0,0,1
38653,0,1,0,0,1
38654,0,1,0,0,1
38655,0,0,0,1,1
38656,0,0,0,1,1
38657,0,1,0,0,1
38658,0,1,0,0,1
38659,0,1,0,0,1
38660,0,1,0,0,1
38661,0,1,0,0,1
38662,0,1,0,0,1
38663,0,1,0,0,1
38664,0,1,0,0,1
38665,0,1,0,0,1
38666,0,1,0,0,1
38667,0,0,1,0,1
38668,0,1,0,0,1
38669,0,1,0,0,1
38670,0,1,0,0,1
38671,0,1,0,0,1
38672,1,0,0,0,1
38673,0,1,0,0,1
38674,1,0,0,0,1
38675,0,1,0,0,1
38676,0,1,0,0,1
38677,0,1,0,0,1
38678,1,0,0,0,1
38679,0,1,0,0,1
38680,0,1,0,0,1
38681,0,1,0,0,1
38682,0,1,0,0,1
38683,0,1,0,0,1
38684,1,0,0,0,1
38685,0,0,0,1,1
38686,1,0,0,0,1
38687,0,1,0,0,1
38688,0,1,0,0,1
38689,0,1,0,0,1
38690,0,0,1,0,1
38691,0,1,0,0,1
38692,0,1,0,0,1
38693,0,1,0,0,1
38694,0,1,0,0,1
38695,0,1,0,0,1
38696,0,1,0,0,1
38697,0,1,0,0,1
38698,0,1,0,0,1
38699,0,1,0,0,1
38700,1,0,0,0,1
38701,0,1,0,0,1
38702,0,1,0,0,1
38703,0,1,0,0,1
38704,1,0,0,0,1
38705,0,1,0,0,1
38706,0,1,0,0,1
38707,0,1,0,0,1
38708,0,1,0,0,1
38709,0,1,0,0,1
38710,0,1,0,0,1
38711,0,1,0,0,1
38712,0,1,0,0,1
38713,0,1,0,0,1
38714,0,1,0,0,1
38715,0,1,0,0,1
38716,0,1,0,0,1
38717,0,1,0,0,1
38718,0,1,0,0,1
38719,0,1,0,0,1
38720,0,1,0,0,1
38721,0,1,0,0,1
38722,0,1,0,0,1
38723,0,1,0,0,1
38724,0,1,0,0,1
38725,0,1,0,0,1
38726,0,1,0,0,1
38727,0,1,0,0,1
38728,0,1,0,0,1
38729,0,1,0,0,1
38730,0,1,0,0,1
38731,0,1,0,0,1
38732,0,1,0,0,1
38733,0,1,0,0,1
38734,0,1,0,0,1
38735,0,1,0,0,1
38736,0,0,1,0,1
38737,0,1,0,0,1
38738,0,1,0,0,1
38739,0,1,0,0,1
38740,0,1,0,0,1
38741,0,1,0,0,1
38742,1,0,0,0,1
38743,0,1,0,0,1
38744,1,0,0,0,1
38745,0,1,0,0,1
38746,0,1,0,0,1
38747,0,0,0,1,1
38748,0,1,0,0,1
38749,1,0,0,0,1
38750,1,0,0,0,1
38751,0,1,0,0,1
38752,0,1,0,0,1
38753,1,0,0,0,1
38754,0,1,0,0,1
38755,0,1,0,0,1
38756,0,1,0,0,1
38757,0,1,0,0,1
38758,0,1,0,0,1
38759,0,1,0,0,1
38760,0,0,1,0,1
38761,0,1,0,0,1
38762,0,1,0,0,1
38763,1,0,0,0,1
38764,0,1,0,0,1
38765,0,1,0,0,1
38766,1,0,0,0,1
38767,0,1,0,0,1
38768,1,0,0,0,1
38769,0,1,0,0,1
38770,1,0,0,0,1
38771,0,1,0,0,1
38772,1,0,0,0,1
38773,0,0,1,0,1
38774,0,0,0,1,1
38775,0,1,0,0,1
38776,1,0,0,0,1
38777,0,1,0,0,1
38778,0,1,0,0,1
38779,0,1,0,0,1
38780,0,1,0,0,1
38781,1,0,0,0,1
38782,0,1,0,0,1
38783,0,1,0,0,1
38784,0,1,0,0,1
38785,0,1,0,0,1
38786,0,1,0,0,1
38787,0,1,0,0,1
38788,0,1,0,0,1
38789,0,1,0,0,1
38790,0,1,0,0,1
38791,0,1,0,0,1
38792,0,1,0,0,1
38793,0,1,0,0,1
38794,0,1,0,0,1
38795,0,0,0,1,1
38796,0,1,0,0,1
38797,0,0,0,1,1
38798,0,1,0,0,1
38799,0,0,0,1,1
38800,0,1,0,0,1
38801,0,1,0,0,1
38802,0,1,0,0,1
38803,0,1,0,0,1
38804,0,1,0,0,1
38805,0,1,0,0,1
38806,0,1,0,0,1
38807,0,1,0,0,1
38808,0,1,0,0,1
38809,0,1,0,0,1
38810,0,1,0,0,1
38811,1,0,0,0,1
38812,0,1,0,0,1
38813,0,1,0,0,1
38814,0,1,0,0,1
38815,0,1,0,0,1
38816,0,1,0,0,1
38817,0,1,0,0,1
38818,0,1,0,0,1
38819,0,1,0,0,1
38820,0,1,0,0,1
38821,0,1,0,0,1
38822,0,1,0,0,1
38823,0,1,0,0,1
38824,0,1,0,0,1
38825,0,1,0,0,1
38826,0,1,0,0,1
38827,0,1,0,0,1
38828,0,0,0,1,1
38829,0,1,0,0,1
38830,0,1,0,0,1
38831,0,1,0,0,1
38832,0,1,0,0,1
38833,0,1,0,0,1
38834,0,1,0,0,1
38835,0,1,0,0,1
38836,0,1,0,0,1
38837,0,1,0,0,1
38838,0,1,0,0,1
38839,0,1,0,0,1
38840,0,1,0,0,1
38841,1,0,0,0,1
38842,0,1,0,0,1
38843,0,1,0,0,1
38844,0,1,0,0,1
38845,0,1,0,0,1
38846,0,1,0,0,1
38847,0,1,0,0,1
38848,1,0,0,0,1
38849,0,1,0,0,1
38850,0,1,0,0,1
38851,1,0,0,0,1
38852,0,1,0,0,1
38853,0,1,0,0,1
38854,0,1,0,0,1
38855,1,0,0,0,1
38856,0,1,0,0,1
38857,1,0,0,0,1
38858,1,0,0,0,1
38859,1,0,0,0,1
38860,1,0,0,0,1
38861,0,1,0,0,1
38862,0,1,0,0,1
38863,0,1,0,0,1
38864,0,0,0,1,1
38865,1,0,0,0,1
38866,0,1,0,0,1
38867,0,1,0,0,1
38868,0,1,0,0,1
38869,0,1,0,0,1
38870,0,1,0,0,1
38871,0,1,0,0,1
38872,0,1,0,0,1
38873,0,1,0,0,1
38874,0,1,0,0,1
38875,0,1,0,0,1
38876,0,1,0,0,1
38877,0,1,0,0,1
38878,0,1,0,0,1
38879,0,1,0,0,1
38880,1,0,0,0,1
38881,0,1,0,0,1
38882,1,0,0,0,1
38883,0,1,0,0,1
38884,0,1,0,0,1
38885,0,1,0,0,1
38886,0,1,0,0,1
38887,0,1,0,0,1
38888,0,1,0,0,1
38889,0,1,0,0,1
38890,0,1,0,0,1
38891,0,1,0,0,1
38892,0,1,0,0,1
38893,0,1,0,0,1
38894,0,1,0,0,1
38895,0,1,0,0,1
38896,0,1,0,0,1
38897,0,1,0,0,1
38898,0,1,0,0,1
38899,0,1,0,0,1
38900,0,1,0,0,1
38901,0,1,0,0,1
38902,0,1,0,0,1
38903,0,1,0,0,1
38904,0,1,0,0,1
38905,0,1,0,0,1
38906,0,1,0,0,1
38907,0,1,0,0,1
38908,0,1,0,0,1
38909,0,1,0,0,1
38910,0,1,0,0,1
38911,0,1,0,0,1
38912,0,1,0,0,1
38913,0,1,0,0,1
38914,0,1,0,0,1
38915,0,1,0,0,1
38916,0,1,0,0,1
38917,0,0,0,1,1
38918,0,1,0,0,1
38919,0,1,0,0,1
38920,1,0,0,0,1
38921,0,1,0,0,1
38922,0,1,0,0,1
38923,0,1,0,0,1
38924,0,1,0,0,1
38925,0,1,0,0,1
38926,0,1,0,0,1
38927,1,0,0,0,1
38928,0,1,0,0,1
38929,0,1,0,0,1
38930,0,1,0,0,1
38931,0,1,0,0,1
38932,0,1,0,0,1
38933,0,1,0,0,1
38934,1,0,0,0,1
38935,0,1,0,0,1
38936,0,1,0,0,1
38937,0,1,0,0,1
38938,0,1,0,0,1
38939,1,0,0,0,1
38940,0,1,0,0,1
38941,0,1,0,0,1
38942,0,1,0,0,1
38943,0,0,0,1,1
38944,0,1,0,0,1
38945,0,1,0,0,1
38946,0,1,0,0,1
38947,0,1,0,0,1
38948,0,1,0,0,1
38949,1,0,0,0,1
38950,0,1,0,0,1
38951,1,0,0,0,1
38952,0,1,0,0,1
38953,0,1,0,0,1
38954,0,0,1,0,1
38955,0,1,0,0,1
38956,0,1,0,0,1
38957,0,1,0,0,1
38958,0,1,0,0,1
38959,0,1,0,0,1
38960,1,0,0,0,1
38961,1,0,0,0,1
38962,0,1,0,0,1
38963,0,1,0,0,1
38964,0,1,0,0,1
38965,0,1,0,0,1
38966,0,1,0,0,1
38967,0,1,0,0,1
38968,1,0,0,0,1
38969,1,0,0,0,1
38970,1,0,0,0,1
38971,1,0,0,0,1
38972,1,0,0,0,1
38973,0,1,0,0,1
38974,0,1,0,0,1
38975,0,1,0,0,1
38976,0,1,0,0,1
38977,0,1,0,0,1
38978,0,0,1,0,1
38979,0,1,0,0,1
38980,0,1,0,0,1
38981,1,0,0,0,1
38982,0,1,0,0,1
38983,1,0,0,0,1
38984,0,1,0,0,1
38985,1,0,0,0,1
38986,0,1,0,0,1
38987,0,1,0,0,1
38988,0,1,0,0,1
38989,0,0,1,0,1
38990,0,1,0,0,1
38991,0,1,0,0,1
38992,0,1,0,0,1
38993,0,1,0,0,1
38994,0,1,0,0,1
38995,0,1,0,0,1
38996,0,1,0,0,1
38997,0,1,0,0,1
38998,0,1,0,0,1
38999,0,1,0,0,1
39000,0,1,0,0,1
39001,0,1,0,0,1
39002,1,0,0,0,1
39003,1,0,0,0,1
39004,0,1,0,0,1
39005,0,1,0,0,1
39006,0,1,0,0,1
39007,0,1,0,0,1
39008,0,0,0,1,1
39009,1,0,0,0,1
39010,0,1,0,0,1
39011,0,1,0,0,1
39012,0,0,0,1,1
39013,0,1,0,0,1
39014,0,1,0,0,1
39015,1,0,0,0,1
39016,0,1,0,0,1
39017,0,1,0,0,1
39018,0,1,0,0,1
39019,0,1,0,0,1
39020,0,1,0,0,1
39021,1,0,0,0,1
39022,0,1,0,0,1
39023,0,1,0,0,1
39024,0,1,0,0,1
39025,0,1,0,0,1
39026,0,1,0,0,1
39027,0,0,1,0,1
39028,0,1,0,0,1
39029,0,1,0,0,1
39030,0,1,0,0,1
39031,0,1,0,0,1
39032,0,1,0,0,1
39033,0,1,0,0,1
39034,0,1,0,0,1
39035,0,1,0,0,1
39036,1,0,0,0,1
39037,0,1,0,0,1
39038,0,1,0,0,1
39039,0,1,0,0,1
39040,0,1,0,0,1
39041,0,1,0,0,1
39042,0,1,0,0,1
39043,0,1,0,0,1
39044,0,1,0,0,1
39045,0,1,0,0,1
39046,0,1,0,0,1
39047,0,1,0,0,1
39048,0,1,0,0,1
39049,0,1,0,0,1
39050,1,0,0,0,1
39051,0,1,0,0,1
39052,0,1,0,0,1
39053,0,1,0,0,1
39054,0,1,0,0,1
39055,0,1,0,0,1
39056,0,1,0,0,1
39057,0,1,0,0,1
39058,0,1,0,0,1
39059,0,1,0,0,1
39060,1,0,0,0,1
39061,0,1,0,0,1
39062,0,1,0,0,1
39063,1,0,0,0,1
39064,0,1,0,0,1
39065,0,1,0,0,1
39066,0,1,0,0,1
39067,0,1,0,0,1
39068,1,0,0,0,1
39069,0,1,0,0,1
39070,0,1,0,0,1
39071,0,1,0,0,1
39072,0,1,0,0,1
39073,0,1,0,0,1
39074,0,1,0,0,1
39075,1,0,0,0,1
39076,0,1,0,0,1
39077,0,1,0,0,1
39078,0,1,0,0,1
39079,1,0,0,0,1
39080,0,1,0,0,1
39081,0,0,0,1,1
39082,0,1,0,0,1
39083,1,0,0,0,1
39084,0,1,0,0,1
39085,0,1,0,0,1
39086,0,1,0,0,1
39087,0,1,0,0,1
39088,1,0,0,0,1
39089,0,1,0,0,1
39090,0,1,0,0,1
39091,1,0,0,0,1
39092,0,1,0,0,1
39093,0,1,0,0,1
39094,0,1,0,0,1
39095,0,1,0,0,1
39096,0,1,0,0,1
39097,0,1,0,0,1
39098,0,1,0,0,1
39099,0,1,0,0,1
39100,0,1,0,0,1
39101,0,1,0,0,1
39102,0,1,0,0,1
39103,0,1,0,0,1
39104,0,1,0,0,1
39105,0,1,0,0,1
39106,0,1,0,0,1
39107,0,1,0,0,1
39108,0,1,0,0,1
39109,0,1,0,0,1
39110,1,0,0,0,1
39111,0,0,0,1,1
39112,0,1,0,0,1
39113,0,1,0,0,1
39114,1,0,0,0,1
39115,0,1,0,0,1
39116,0,1,0,0,1
39117,0,1,0,0,1
39118,0,1,0,0,1
39119,0,1,0,0,1
39120,0,1,0,0,1
39121,1,0,0,0,1
39122,1,0,0,0,1
39123,0,1,0,0,1
39124,0,1,0,0,1
39125,0,1,0,0,1
39126,0,1,0,0,1
39127,0,1,0,0,1
39128,0,1,0,0,1
39129,0,1,0,0,1
39130,0,1,0,0,1
39131,0,0,0,1,1
39132,0,1,0,0,1
39133,0,1,0,0,1
39134,0,1,0,0,1
39135,0,1,0,0,1
39136,0,1,0,0,1
39137,0,1,0,0,1
39138,1,0,0,0,1
39139,0,1,0,0,1
39140,0,1,0,0,1
39141,1,0,0,0,1
39142,0,1,0,0,1
39143,1,0,0,0,1
39144,0,1,0,0,1
39145,0,1,0,0,1
39146,1,0,0,0,1
39147,0,1,0,0,1
39148,0,1,0,0,1
39149,0,1,0,0,1
39150,0,1,0,0,1
39151,0,1,0,0,1
39152,0,1,0,0,1
39153,0,1,0,0,1
39154,0,1,0,0,1
39155,0,1,0,0,1
39156,0,1,0,0,1
39157,0,1,0,0,1
39158,0,1,0,0,1
39159,0,1,0,0,1
39160,0,1,0,0,1
39161,0,1,0,0,1
39162,1,0,0,0,1
39163,1,0,0,0,1
39164,1,0,0,0,1
39165,0,1,0,0,1
39166,0,1,0,0,1
39167,0,1,0,0,1
39168,0,1,0,0,1
39169,0,1,0,0,1
39170,0,1,0,0,1
39171,0,1,0,0,1
39172,0,1,0,0,1
39173,0,1,0,0,1
39174,0,1,0,0,1
39175,0,1,0,0,1
39176,0,1,0,0,1
39177,1,0,0,0,1
39178,0,1,0,0,1
39179,0,1,0,0,1
39180,1,0,0,0,1
39181,0,1,0,0,1
39182,1,0,0,0,1
39183,0,1,0,0,1
39184,0,1,0,0,1
39185,0,1,0,0,1
39186,0,1,0,0,1
39187,0,1,0,0,1
39188,0,1,0,0,1
39189,1,0,0,0,1
39190,0,1,0,0,1
39191,0,1,0,0,1
39192,1,0,0,0,1
39193,1,0,0,0,1
39194,0,1,0,0,1
39195,0,1,0,0,1
39196,0,1,0,0,1
39197,0,1,0,0,1
39198,0,1,0,0,1
39199,0,1,0,0,1
39200,0,1,0,0,1
39201,0,1,0,0,1
39202,0,1,0,0,1
39203,0,1,0,0,1
39204,0,1,0,0,1
39205,0,1,0,0,1
39206,1,0,0,0,1
39207,0,0,0,1,1
39208,1,0,0,0,1
39209,0,1,0,0,1
39210,1,0,0,0,1
39211,0,1,0,0,1
39212,0,1,0,0,1
39213,0,1,0,0,1
39214,0,1,0,0,1
39215,0,1,0,0,1
39216,0,1,0,0,1
39217,0,1,0,0,1
39218,1,0,0,0,1
39219,0,1,0,0,1
39220,0,1,0,0,1
39221,1,0,0,0,1
39222,1,0,0,0,1
39223,0,1,0,0,1
39224,0,1,0,0,1
39225,0,1,0,0,1
39226,0,1,0,0,1
39227,0,0,0,1,1
39228,1,0,0,0,1
39229,0,1,0,0,1
39230,0,1,0,0,1
39231,0,1,0,0,1
39232,1,0,0,0,1
39233,1,0,0,0,1
39234,0,1,0,0,1
39235,0,1,0,0,1
39236,0,1,0,0,1
39237,0,1,0,0,1
39238,0,1,0,0,1
39239,0,1,0,0,1
39240,0,1,0,0,1
39241,0,1,0,0,1
39242,0,1,0,0,1
39243,0,1,0,0,1
39244,0,0,1,0,1
39245,0,1,0,0,1
39246,0,1,0,0,1
39247,0,1,0,0,1
39248,0,1,0,0,1
39249,1,0,0,0,1
39250,0,1,0,0,1
39251,0,1,0,0,1
39252,0,1,0,0,1
39253,0,1,0,0,1
39254,0,1,0,0,1
39255,0,1,0,0,1
39256,0,1,0,0,1
39257,0,1,0,0,1
39258,1,0,0,0,1
39259,0,1,0,0,1
39260,0,1,0,0,1
39261,0,1,0,0,1
39262,0,1,0,0,1
39263,0,1,0,0,1
39264,0,1,0,0,1
39265,0,1,0,0,1
39266,0,1,0,0,1
39267,0,1,0,0,1
39268,0,1,0,0,1
39269,0,1,0,0,1
39270,1,0,0,0,1
39271,0,1,0,0,1
39272,0,1,0,0,1
39273,0,1,0,0,1
39274,0,1,0,0,1
39275,1,0,0,0,1
39276,0,1,0,0,1
39277,0,1,0,0,1
39278,0,1,0,0,1
39279,0,1,0,0,1
39280,0,1,0,0,1
39281,0,1,0,0,1
39282,0,1,0,0,1
39283,1,0,0,0,1
39284,0,1,0,0,1
39285,1,0,0,0,1
39286,0,1,0,0,1
39287,0,1,0,0,1
39288,0,1,0,0,1
39289,0,1,0,0,1
39290,0,1,0,0,1
39291,0,1,0,0,1
39292,0,1,0,0,1
39293,0,1,0,0,1
39294,0,1,0,0,1
39295,0,1,0,0,1
39296,1,0,0,0,1
39297,0,1,0,0,1
39298,1,0,0,0,1
39299,0,1,0,0,1
39300,0,1,0,0,1
39301,0,1,0,0,1
39302,0,1,0,0,1
39303,0,1,0,0,1
39304,0,1,0,0,1
39305,0,1,0,0,1
39306,0,1,0,0,1
39307,0,1,0,0,1
39308,0,1,0,0,1
39309,0,1,0,0,1
39310,1,0,0,0,1
39311,0,1,0,0,1
39312,0,0,1,0,1
39313,0,1,0,0,1
39314,0,1,0,0,1
39315,0,1,0,0,1
39316,0,1,0,0,1
39317,0,0,0,1,1
39318,0,1,0,0,1
39319,1,0,0,0,1
39320,0,1,0,0,1
39321,1,0,0,0,1
39322,1,0,0,0,1
39323,1,0,0,0,1
39324,0,1,0,0,1
39325,0,1,0,0,1
39326,0,0,1,0,1
39327,0,1,0,0,1
39328,0,1,0,0,1
39329,0,1,0,0,1
39330,1,0,0,0,1
39331,0,1,0,0,1
39332,1,0,0,0,1
39333,0,1,0,0,1
39334,0,1,0,0,1
39335,0,1,0,0,1
39336,0,1,0,0,1
39337,0,1,0,0,1
39338,0,1,0,0,1
39339,0,1,0,0,1
39340,0,1,0,0,1
39341,0,1,0,0,1
39342,0,1,0,0,1
39343,0,1,0,0,1
39344,0,1,0,0,1
39345,0,1,0,0,1
39346,0,1,0,0,1
39347,0,1,0,0,1
39348,1,0,0,0,1
39349,0,1,0,0,1
39350,0,1,0,0,1
39351,0,1,0,0,1
39352,0,0,1,0,1
39353,0,1,0,0,1
39354,0,1,0,0,1
39355,0,1,0,0,1
39356,0,1,0,0,1
39357,0,1,0,0,1
39358,0,1,0,0,1
39359,0,1,0,0,1
39360,0,1,0,0,1
39361,1,0,0,0,1
39362,0,1,0,0,1
39363,0,1,0,0,1
39364,0,1,0,0,1
39365,0,1,0,0,1
39366,0,1,0,0,1
39367,0,1,0,0,1
39368,0,1,0,0,1
39369,0,1,0,0,1
39370,0,0,0,1,1
39371,0,1,0,0,1
39372,0,0,1,0,1
39373,0,1,0,0,1
39374,0,1,0,0,1
39375,1,0,0,0,1
39376,0,1,0,0,1
39377,1,0,0,0,1
39378,0,1,0,0,1
39379,0,1,0,0,1
39380,0,1,0,0,1
39381,0,1,0,0,1
39382,1,0,0,0,1
39383,0,1,0,0,1
39384,0,1,0,0,1
39385,0,1,0,0,1
39386,0,1,0,0,1
39387,0,1,0,0,1
39388,1,0,0,0,1
39389,0,1,0,0,1
39390,0,1,0,0,1
39391,0,0,0,1,1
39392,0,1,0,0,1
39393,1,0,0,0,1
39394,0,1,0,0,1
39395,0,1,0,0,1
39396,0,1,0,0,1
39397,0,1,0,0,1
39398,1,0,0,0,1
39399,0,1,0,0,1
39400,0,1,0,0,1
39401,0,1,0,0,1
39402,0,1,0,0,1
39403,1,0,0,0,1
39404,0,1,0,0,1
39405,0,1,0,0,1
39406,1,0,0,0,1
39407,0,1,0,0,1
39408,0,1,0,0,1
39409,0,1,0,0,1
39410,0,1,0,0,1
39411,1,0,0,0,1
39412,1,0,0,0,1
39413,0,1,0,0,1
39414,0,1,0,0,1
39415,0,1,0,0,1
39416,0,1,0,0,1
39417,1,0,0,0,1
39418,1,0,0,0,1
39419,0,1,0,0,1
39420,0,1,0,0,1
39421,0,1,0,0,1
39422,0,1,0,0,1
39423,0,1,0,0,1
39424,0,1,0,0,1
39425,0,1,0,0,1
39426,0,1,0,0,1
39427,0,1,0,0,1
39428,0,1,0,0,1
39429,0,1,0,0,1
39430,0,1,0,0,1
39431,0,1,0,0,1
39432,0,1,0,0,1
39433,0,1,0,0,1
39434,1,0,0,0,1
39435,0,1,0,0,1
39436,1,0,0,0,1
39437,0,1,0,0,1
39438,0,1,0,0,1
39439,1,0,0,0,1
39440,0,1,0,0,1
39441,1,0,0,0,1
39442,0,1,0,0,1
39443,0,1,0,0,1
39444,0,1,0,0,1
39445,0,1,0,0,1
39446,0,1,0,0,1
39447,0,1,0,0,1
39448,1,0,0,0,1
39449,0,1,0,0,1
39450,0,1,0,0,1
39451,0,1,0,0,1
39452,0,0,1,0,1
39453,1,0,0,0,1
39454,0,1,0,0,1
39455,0,1,0,0,1
39456,0,0,0,1,1
39457,0,1,0,0,1
39458,0,1,0,0,1
39459,0,1,0,0,1
39460,1,0,0,0,1
39461,0,1,0,0,1
39462,0,1,0,0,1
39463,0,1,0,0,1
39464,1,0,0,0,1
39465,0,1,0,0,1
39466,0,1,0,0,1
39467,0,1,0,0,1
39468,0,1,0,0,1
39469,0,1,0,0,1
39470,0,1,0,0,1
39471,0,1,0,0,1
39472,0,1,0,0,1
39473,0,1,0,0,1
39474,1,0,0,0,1
39475,1,0,0,0,1
39476,0,1,0,0,1
39477,1,0,0,0,1
39478,0,1,0,0,1
39479,0,1,0,0,1
39480,1,0,0,0,1
39481,0,1,0,0,1
39482,0,1,0,0,1
39483,1,0,0,0,1
39484,0,1,0,0,1
39485,0,1,0,0,1
39486,0,1,0,0,1
39487,0,1,0,0,1
39488,0,1,0,0,1
39489,0,1,0,0,1
39490,0,1,0,0,1
39491,0,1,0,0,1
39492,0,1,0,0,1
39493,0,1,0,0,1
39494,0,0,0,1,1
39495,1,0,0,0,1
39496,0,1,0,0,1
39497,1,0,0,0,1
39498,0,1,0,0,1
39499,0,1,0,0,1
39500,0,1,0,0,1
39501,0,1,0,0,1
39502,0,0,1,0,1
39503,1,0,0,0,1
39504,0,1,0,0,1
39505,0,1,0,0,1
39506,0,1,0,0,1
39507,1,0,0,0,1
39508,0,1,0,0,1
39509,1,0,0,0,1
39510,0,1,0,0,1
39511,0,1,0,0,1
39512,1,0,0,0,1
39513,0,1,0,0,1
39514,1,0,0,0,1
39515,0,1,0,0,1
39516,0,1,0,0,1
39517,0,1,0,0,1
39518,0,1,0,0,1
39519,0,1,0,0,1
39520,0,1,0,0,1
39521,0,1,0,0,1
39522,0,1,0,0,1
39523,0,1,0,0,1
39524,0,1,0,0,1
39525,1,0,0,0,1
39526,0,1,0,0,1
39527,0,0,0,1,1
39528,0,1,0,0,1
39529,0,1,0,0,1
39530,0,1,0,0,1
39531,0,1,0,0,1
39532,0,1,0,0,1
39533,0,1,0,0,1
39534,0,1,0,0,1
39535,0,1,0,0,1
39536,0,1,0,0,1
39537,0,1,0,0,1
39538,0,1,0,0,1
39539,0,1,0,0,1
39540,0,1,0,0,1
39541,0,1,0,0,1
39542,0,1,0,0,1
39543,0,1,0,0,1
39544,0,1,0,0,1
39545,0,1,0,0,1
39546,0,1,0,0,1
39547,0,1,0,0,1
39548,0,1,0,0,1
39549,0,1,0,0,1
39550,0,0,0,1,1
39551,0,1,0,0,1
39552,1,0,0,0,1
39553,0,1,0,0,1
39554,0,1,0,0,1
39555,1,0,0,0,1
39556,0,1,0,0,1
39557,0,1,0,0,1
39558,0,1,0,0,1
39559,1,0,0,0,1
39560,0,1,0,0,1
39561,0,1,0,0,1
39562,0,1,0,0,1
39563,0,1,0,0,1
39564,0,1,0,0,1
39565,1,0,0,0,1
39566,0,0,0,1,1
39567,0,1,0,0,1
39568,0,1,0,0,1
39569,0,1,0,0,1
39570,0,0,1,0,1
39571,0,1,0,0,1
39572,0,1,0,0,1
39573,0,1,0,0,1
39574,0,1,0,0,1
39575,0,1,0,0,1
39576,0,1,0,0,1
39577,0,1,0,0,1
39578,0,1,0,0,1
39579,0,1,0,0,1
39580,0,1,0,0,1
39581,0,1,0,0,1
39582,1,0,0,0,1
39583,1,0,0,0,1
39584,0,1,0,0,1
39585,0,1,0,0,1
39586,1,0,0,0,1
39587,0,1,0,0,1
39588,0,1,0,0,1
39589,0,1,0,0,1
39590,0,1,0,0,1
39591,0,1,0,0,1
39592,0,1,0,0,1
39593,0,1,0,0,1
39594,0,1,0,0,1
39595,1,0,0,0,1
39596,0,1,0,0,1
39597,0,1,0,0,1
39598,0,1,0,0,1
39599,0,1,0,0,1
39600,0,1,0,0,1
39601,1,0,0,0,1
39602,0,1,0,0,1
39603,0,1,0,0,1
39604,0,1,0,0,1
39605,0,1,0,0,1
39606,0,1,0,0,1
39607,0,1,0,0,1
39608,0,1,0,0,1
39609,0,1,0,0,1
39610,0,1,0,0,1
39611,0,1,0,0,1
39612,0,1,0,0,1
39613,0,1,0,0,1
39614,0,1,0,0,1
39615,0,0,0,1,1
39616,0,1,0,0,1
39617,0,1,0,0,1
39618,0,1,0,0,1
39619,0,1,0,0,1
39620,0,1,0,0,1
39621,0,0,1,0,1
39622,1,0,0,0,1
39623,0,1,0,0,1
39624,0,1,0,0,1
39625,0,1,0,0,1
39626,0,1,0,0,1
39627,0,1,0,0,1
39628,0,1,0,0,1
39629,0,1,0,0,1
39630,1,0,0,0,1
39631,0,1,0,0,1
39632,0,1,0,0,1
39633,0,1,0,0,1
39634,0,1,0,0,1
39635,0,1,0,0,1
39636,0,1,0,0,1
39637,0,1,0,0,1
39638,0,1,0,0,1
39639,0,1,0,0,1
39640,0,1,0,0,1
39641,0,1,0,0,1
39642,0,1,0,0,1
39643,0,0,0,1,1
39644,0,1,0,0,1
39645,0,1,0,0,1
39646,0,1,0,0,1
39647,0,1,0,0,1
39648,0,1,0,0,1
39649,0,1,0,0,1
39650,1,0,0,0,1
39651,0,1,0,0,1
39652,1,0,0,0,1
39653,0,1,0,0,1
39654,0,1,0,0,1
39655,1,0,0,0,1
39656,0,1,0,0,1
39657,0,0,0,1,1
39658,0,1,0,0,1
39659,1,0,0,0,1
39660,0,1,0,0,1
39661,0,1,0,0,1
39662,0,1,0,0,1
39663,0,1,0,0,1
39664,0,0,1,0,1
39665,0,1,0,0,1
39666,0,1,0,0,1
39667,0,1,0,0,1
39668,1,0,0,0,1
39669,0,1,0,0,1
39670,0,1,0,0,1
39671,0,1,0,0,1
39672,0,1,0,0,1
39673,1,0,0,0,1
39674,0,1,0,0,1
39675,0,1,0,0,1
39676,0,1,0,0,1
39677,0,1,0,0,1
39678,0,1,0,0,1
39679,0,1,0,0,1
39680,0,1,0,0,1
39681,1,0,0,0,1
39682,0,1,0,0,1
39683,0,1,0,0,1
39684,0,0,1,0,1
39685,0,0,0,1,1
39686,0,1,0,0,1
39687,0,0,0,1,1
39688,0,1,0,0,1
39689,0,1,0,0,1
39690,0,1,0,0,1
39691,0,1,0,0,1
39692,1,0,0,0,1
39693,0,1,0,0,1
39694,0,1,0,0,1
39695,0,1,0,0,1
39696,1,0,0,0,1
39697,0,1,0,0,1
39698,0,1,0,0,1
39699,0,1,0,0,1
39700,0,1,0,0,1
39701,0,1,0,0,1
39702,0,1,0,0,1
39703,0,1,0,0,1
39704,0,1,0,0,1
39705,0,1,0,0,1
39706,0,1,0,0,1
39707,1,0,0,0,1
39708,0,1,0,0,1
39709,0,1,0,0,1
39710,0,1,0,0,1
39711,0,1,0,0,1
39712,0,1,0,0,1
39713,0,1,0,0,1
39714,0,1,0,0,1
39715,0,1,0,0,1
39716,0,1,0,0,1
39717,0,1,0,0,1
39718,1,0,0,0,1
39719,0,1,0,0,1
39720,0,1,0,0,1
39721,0,1,0,0,1
39722,0,1,0,0,1
39723,1,0,0,0,1
39724,0,1,0,0,1
39725,0,1,0,0,1
39726,0,1,0,0,1
39727,0,1,0,0,1
39728,1,0,0,0,1
39729,0,1,0,0,1
39730,0,1,0,0,1
39731,0,1,0,0,1
39732,0,1,0,0,1
39733,0,1,0,0,1
39734,1,0,0,0,1
39735,0,1,0,0,1
39736,0,1,0,0,1
39737,0,1,0,0,1
39738,0,1,0,0,1
39739,0,1,0,0,1
39740,1,0,0,0,1
39741,0,1,0,0,1
39742,0,1,0,0,1
39743,1,0,0,0,1
39744,0,1,0,0,1
39745,0,1,0,0,1
39746,0,1,0,0,1
39747,1,0,0,0,1
39748,0,1,0,0,1
39749,0,1,0,0,1
39750,1,0,0,0,1
39751,0,1,0,0,1
39752,0,1,0,0,1
39753,0,1,0,0,1
39754,0,1,0,0,1
39755,0,1,0,0,1
39756,0,1,0,0,1
39757,0,1,0,0,1
39758,0,1,0,0,1
39759,0,1,0,0,1
39760,1,0,0,0,1
39761,0,1,0,0,1
39762,0,1,0,0,1
39763,0,0,1,0,1
39764,0,1,0,0,1
39765,0,1,0,0,1
39766,0,0,1,0,1
39767,0,1,0,0,1
39768,0,1,0,0,1
39769,0,1,0,0,1
39770,0,1,0,0,1
39771,0,1,0,0,1
39772,0,1,0,0,1
39773,0,1,0,0,1
39774,1,0,0,0,1
39775,1,0,0,0,1
39776,0,1,0,0,1
39777,0,1,0,0,1
39778,0,1,0,0,1
39779,0,0,0,1,1
39780,0,1,0,0,1
39781,0,1,0,0,1
39782,0,1,0,0,1
39783,1,0,0,0,1
39784,0,0,0,1,1
39785,0,1,0,0,1
39786,0,1,0,0,1
39787,1,0,0,0,1
39788,0,1,0,0,1
39789,1,0,0,0,1
39790,0,1,0,0,1
39791,0,1,0,0,1
39792,0,1,0,0,1
39793,0,1,0,0,1
39794,0,1,0,0,1
39795,0,1,0,0,1
39796,0,1,0,0,1
39797,0,1,0,0,1
39798,0,1,0,0,1
39799,0,1,0,0,1
39800,0,1,0,0,1
39801,0,1,0,0,1
39802,0,1,0,0,1
39803,0,1,0,0,1
39804,1,0,0,0,1
39805,0,1,0,0,1
39806,0,1,0,0,1
39807,0,1,0,0,1
39808,0,1,0,0,1
39809,0,1,0,0,1
39810,1,0,0,0,1
39811,1,0,0,0,1
39812,1,0,0,0,1
39813,1,0,0,0,1
39814,0,1,0,0,1
39815,0,1,0,0,1
39816,0,1,0,0,1
39817,0,1,0,0,1
39818,0,1,0,0,1
39819,0,1,0,0,1
39820,1,0,0,0,1
39821,0,1,0,0,1
39822,0,1,0,0,1
39823,0,1,0,0,1
39824,0,0,0,1,1
39825,1,0,0,0,1
39826,0,1,0,0,1
39827,0,1,0,0,1
39828,0,1,0,0,1
39829,0,1,0,0,1
39830,0,1,0,0,1
39831,0,1,0,0,1
39832,0,1,0,0,1
39833,0,1,0,0,1
39834,0,1,0,0,1
39835,0,1,0,0,1
39836,0,0,1,0,1
39837,0,1,0,0,1
39838,0,1,0,0,1
39839,0,1,0,0,1
39840,0,1,0,0,1
39841,0,0,0,1,1
39842,0,1,0,0,1
39843,0,1,0,0,1
39844,0,1,0,0,1
39845,0,1,0,0,1
39846,0,1,0,0,1
39847,0,1,0,0,1
39848,0,0,1,0,1
39849,0,1,0,0,1
39850,0,1,0,0,1
39851,0,1,0,0,1
39852,0,1,0,0,1
39853,0,1,0,0,1
39854,0,1,0,0,1
39855,0,1,0,0,1
39856,0,1,0,0,1
39857,0,1,0,0,1
39858,0,1,0,0,1
39859,0,1,0,0,1
39860,0,1,0,0,1
39861,0,1,0,0,1
39862,0,1,0,0,1
39863,0,1,0,0,1
39864,0,1,0,0,1
39865,0,0,0,1,1
39866,0,1,0,0,1
39867,0,1,0,0,1
39868,0,1,0,0,1
39869,0,1,0,0,1
39870,0,1,0,0,1
39871,0,1,0,0,1
39872,0,1,0,0,1
39873,0,1,0,0,1
39874,0,1,0,0,1
39875,0,0,0,1,1
39876,1,0,0,0,1
39877,0,1,0,0,1
39878,0,1,0,0,1
39879,0,1,0,0,1
39880,1,0,0,0,1
39881,0,1,0,0,1
39882,0,1,0,0,1
39883,0,1,0,0,1
39884,0,1,0,0,1
39885,0,0,0,1,1
39886,0,1,0,0,1
39887,0,0,1,0,1
39888,0,1,0,0,1
39889,0,1,0,0,1
39890,1,0,0,0,1
39891,0,1,0,0,1
39892,0,1,0,0,1
39893,0,1,0,0,1
39894,0,1,0,0,1
39895,1,0,0,0,1
39896,0,1,0,0,1
39897,1,0,0,0,1
39898,0,1,0,0,1
39899,0,1,0,0,1
39900,0,1,0,0,1
39901,0,1,0,0,1
39902,0,1,0,0,1
39903,0,1,0,0,1
39904,0,1,0,0,1
39905,0,1,0,0,1
39906,0,1,0,0,1
39907,0,1,0,0,1
39908,0,1,0,0,1
39909,0,1,0,0,1
39910,1,0,0,0,1
39911,0,1,0,0,1
39912,0,1,0,0,1
39913,1,0,0,0,1
39914,0,1,0,0,1
39915,0,1,0,0,1
39916,1,0,0,0,1
39917,0,1,0,0,1
39918,0,1,0,0,1
39919,1,0,0,0,1
39920,0,1,0,0,1
39921,0,1,0,0,1
39922,0,1,0,0,1
39923,0,1,0,0,1
39924,0,1,0,0,1
39925,0,1,0,0,1
39926,0,1,0,0,1
39927,0,0,1,0,1
39928,0,1,0,0,1
39929,0,1,0,0,1
39930,0,1,0,0,1
39931,0,1,0,0,1
39932,0,1,0,0,1
39933,0,1,0,0,1
39934,0,1,0,0,1
39935,0,1,0,0,1
39936,1,0,0,0,1
39937,0,1,0,0,1
39938,0,1,0,0,1
39939,0,1,0,0,1
39940,0,1,0,0,1
39941,0,1,0,0,1
39942,0,1,0,0,1
39943,0,1,0,0,1
39944,0,1,0,0,1
39945,1,0,0,0,1
39946,0,1,0,0,1
39947,0,1,0,0,1
39948,0,1,0,0,1
39949,0,1,0,0,1
39950,0,1,0,0,1
39951,0,1,0,0,1
39952,0,1,0,0,1
39953,0,1,0,0,1
39954,0,1,0,0,1
39955,0,1,0,0,1
39956,0,1,0,0,1
39957,0,1,0,0,1
39958,0,1,0,0,1
39959,0,1,0,0,1
39960,1,0,0,0,1
39961,0,1,0,0,1
39962,0,1,0,0,1
39963,0,1,0,0,1
39964,0,1,0,0,1
39965,0,1,0,0,1
39966,1,0,0,0,1
39967,0,1,0,0,1
39968,0,1,0,0,1
39969,0,1,0,0,1
39970,0,1,0,0,1
39971,0,1,0,0,1
39972,0,1,0,0,1
39973,0,1,0,0,1
39974,1,0,0,0,1
39975,0,1,0,0,1
39976,0,1,0,0,1
39977,0,0,0,1,1
39978,1,0,0,0,1
39979,0,1,0,0,1
39980,0,1,0,0,1
39981,0,1,0,0,1
39982,0,1,0,0,1
39983,0,1,0,0,1
39984,0,1,0,0,1
39985,0,1,0,0,1
39986,0,1,0,0,1
39987,0,1,0,0,1
39988,0,1,0,0,1
39989,0,1,0,0,1
39990,0,1,0,0,1
39991,0,1,0,0,1
39992,0,1,0,0,1
39993,0,1,0,0,1
39994,0,1,0,0,1
39995,0,1,0,0,1
39996,0,1,0,0,1
39997,0,1,0,0,1
39998,0,1,0,0,1
39999,0,1,0,0,1
40000,0,1,0,0,1
40001,0,1,0,0,1
40002,0,1,0,0,1
40003,0,1,0,0,1
40004,0,1,0,0,1
40005,0,1,0,0,1
40006,0,1,0,0,1
40007,1,0,0,0,1
40008,0,1,0,0,1
40009,0,1,0,0,1
40010,0,1,0,0,1
40011,0,1,0,0,1
40012,0,1,0,0,1
40013,0,1,0,0,1
40014,0,1,0,0,1
40015,0,1,0,0,1
40016,1,0,0,0,1
40017,0,1,0,0,1
40018,0,1,0,0,1
40019,0,0,1,0,1
40020,0,1,0,0,1
40021,1,0,0,0,1
40022,0,1,0,0,1
40023,0,1,0,0,1
40024,0,1,0,0,1
40025,1,0,0,0,1
40026,0,1,0,0,1
40027,0,1,0,0,1
40028,0,1,0,0,1
40029,0,1,0,0,1
40030,0,1,0,0,1
40031,0,1,0,0,1
40032,0,0,0,1,1
40033,0,1,0,0,1
40034,0,1,0,0,1
40035,0,1,0,0,1
40036,0,1,0,0,1
40037,0,1,0,0,1
40038,1,0,0,0,1
40039,0,1,0,0,1
40040,0,1,0,0,1
40041,0,1,0,0,1
40042,0,1,0,0,1
40043,0,1,0,0,1
40044,1,0,0,0,1
40045,0,1,0,0,1
40046,0,1,0,0,1
40047,0,1,0,0,1
40048,0,1,0,0,1
40049,0,1,0,0,1
40050,0,0,0,1,1
40051,0,1,0,0,1
40052,0,1,0,0,1
40053,0,1,0,0,1
40054,0,1,0,0,1
40055,0,1,0,0,1
40056,0,1,0,0,1
40057,0,1,0,0,1
40058,0,1,0,0,1
40059,0,1,0,0,1
40060,0,1,0,0,1
40061,0,1,0,0,1
40062,0,1,0,0,1
40063,0,0,0,1,1
40064,0,1,0,0,1
40065,0,1,0,0,1
40066,0,1,0,0,1
40067,0,1,0,0,1
40068,0,0,1,0,1
40069,0,1,0,0,1
40070,0,1,0,0,1
40071,0,1,0,0,1
40072,1,0,0,0,1
40073,0,1,0,0,1
40074,0,0,1,0,1
40075,0,1,0,0,1
40076,0,1,0,0,1
40077,0,1,0,0,1
40078,1,0,0,0,1
40079,0,1,0,0,1
40080,0,1,0,0,1
40081,0,1,0,0,1
40082,0,1,0,0,1
40083,0,1,0,0,1
40084,0,1,0,0,1
40085,1,0,0,0,1
40086,0,1,0,0,1
40087,0,1,0,0,1
40088,0,1,0,0,1
40089,0,1,0,0,1
40090,0,1,0,0,1
40091,1,0,0,0,1
40092,1,0,0,0,1
40093,0,1,0,0,1
40094,0,1,0,0,1
40095,0,1,0,0,1
40096,0,1,0,0,1
40097,1,0,0,0,1
40098,0,1,0,0,1
40099,0,1,0,0,1
40100,0,1,0,0,1
40101,0,1,0,0,1
40102,0,1,0,0,1
40103,0,1,0,0,1
40104,0,1,0,0,1
40105,0,1,0,0,1
40106,0,1,0,0,1
40107,0,1,0,0,1
40108,0,1,0,0,1
40109,0,1,0,0,1
40110,0,1,0,0,1
40111,0,1,0,0,1
40112,0,1,0,0,1
40113,0,1,0,0,1
40114,0,1,0,0,1
40115,0,0,0,1,1
40116,1,0,0,0,1
40117,0,1,0,0,1
40118,0,1,0,0,1
40119,0,1,0,0,1
40120,0,1,0,0,1
40121,0,1,0,0,1
40122,0,1,0,0,1
40123,0,1,0,0,1
40124,0,1,0,0,1
40125,0,1,0,0,1
40126,0,1,0,0,1
40127,0,1,0,0,1
40128,0,1,0,0,1
40129,0,1,0,0,1
40130,0,1,0,0,1
40131,0,1,0,0,1
40132,0,1,0,0,1
40133,1,0,0,0,1
40134,0,1,0,0,1
40135,0,1,0,0,1
40136,0,1,0,0,1
40137,0,1,0,0,1
40138,0,1,0,0,1
40139,0,1,0,0,1
40140,0,1,0,0,1
40141,0,1,0,0,1
40142,0,1,0,0,1
40143,0,1,0,0,1
40144,0,1,0,0,1
40145,0,1,0,0,1
40146,1,0,0,0,1
40147,0,1,0,0,1
40148,0,1,0,0,1
40149,0,1,0,0,1
40150,1,0,0,0,1
40151,0,1,0,0,1
40152,0,1,0,0,1
40153,0,1,0,0,1
40154,1,0,0,0,1
40155,0,1,0,0,1
40156,1,0,0,0,1
40157,0,1,0,0,1
40158,0,1,0,0,1
40159,0,1,0,0,1
40160,0,1,0,0,1
40161,0,1,0,0,1
40162,0,1,0,0,1
40163,0,1,0,0,1
40164,0,1,0,0,1
40165,1,0,0,0,1
40166,0,1,0,0,1
40167,0,1,0,0,1
40168,0,1,0,0,1
40169,0,1,0,0,1
40170,0,1,0,0,1
40171,0,1,0,0,1
40172,0,1,0,0,1
40173,0,0,0,1,1
40174,0,0,0,1,1
40175,0,1,0,0,1
40176,0,1,0,0,1
40177,0,1,0,0,1
40178,0,1,0,0,1
40179,0,1,0,0,1
40180,0,1,0,0,1
40181,0,1,0,0,1
40182,0,1,0,0,1
40183,0,1,0,0,1
40184,0,1,0,0,1
40185,0,1,0,0,1
40186,0,1,0,0,1
40187,0,0,1,0,1
40188,0,1,0,0,1
40189,1,0,0,0,1
40190,0,1,0,0,1
40191,0,1,0,0,1
40192,0,0,0,1,1
40193,0,1,0,0,1
40194,0,1,0,0,1
40195,0,1,0,0,1
40196,0,1,0,0,1
40197,0,1,0,0,1
40198,0,1,0,0,1
40199,0,1,0,0,1
40200,0,1,0,0,1
40201,0,1,0,0,1
40202,0,1,0,0,1
40203,0,1,0,0,1
40204,0,1,0,0,1
40205,0,1,0,0,1
40206,0,1,0,0,1
40207,0,1,0,0,1
40208,0,1,0,0,1
40209,0,1,0,0,1
40210,0,1,0,0,1
40211,0,1,0,0,1
40212,0,1,0,0,1
40213,0,1,0,0,1
40214,0,1,0,0,1
40215,0,1,0,0,1
40216,0,1,0,0,1
40217,0,1,0,0,1
40218,0,0,1,0,1
40219,1,0,0,0,1
40220,0,1,0,0,1
40221,0,1,0,0,1
40222,0,1,0,0,1
40223,0,1,0,0,1
40224,0,1,0,0,1
40225,0,1,0,0,1
40226,0,1,0,0,1
40227,0,1,0,0,1
40228,0,1,0,0,1
40229,1,0,0,0,1
40230,0,1,0,0,1
40231,0,1,0,0,1
40232,0,1,0,0,1
40233,1,0,0,0,1
40234,0,1,0,0,1
40235,0,1,0,0,1
40236,0,1,0,0,1
40237,0,1,0,0,1
40238,1,0,0,0,1
40239,1,0,0,0,1
40240,0,1,0,0,1
40241,0,1,0,0,1
40242,0,1,0,0,1
40243,0,1,0,0,1
40244,0,0,0,1,1
40245,0,1,0,0,1
40246,1,0,0,0,1
40247,1,0,0,0,1
40248,1,0,0,0,1
40249,0,1,0,0,1
40250,0,1,0,0,1
40251,0,1,0,0,1
40252,0,1,0,0,1
40253,0,1,0,0,1
40254,1,0,0,0,1
40255,0,1,0,0,1
40256,0,1,0,0,1
40257,0,1,0,0,1
40258,0,1,0,0,1
40259,0,0,1,0,1
40260,0,1,0,0,1
40261,0,0,0,1,1
40262,0,1,0,0,1
40263,0,1,0,0,1
40264,0,1,0,0,1
40265,0,1,0,0,1
40266,0,1,0,0,1
40267,0,1,0,0,1
40268,0,1,0,0,1
40269,0,1,0,0,1
40270,0,1,0,0,1
40271,0,1,0,0,1
40272,0,1,0,0,1
40273,0,1,0,0,1
40274,0,1,0,0,1
40275,0,1,0,0,1
40276,0,1,0,0,1
40277,0,0,0,1,1
40278,0,1,0,0,1
40279,0,1,0,0,1
40280,0,1,0,0,1
40281,0,1,0,0,1
40282,0,1,0,0,1
40283,0,0,0,1,1
40284,0,1,0,0,1
40285,1,0,0,0,1
40286,0,1,0,0,1
40287,0,1,0,0,1
40288,0,1,0,0,1
40289,0,1,0,0,1
40290,0,1,0,0,1
40291,0,0,1,0,1
40292,0,1,0,0,1
40293,0,1,0,0,1
40294,0,1,0,0,1
40295,0,1,0,0,1
40296,0,1,0,0,1
40297,0,1,0,0,1
40298,0,1,0,0,1
40299,0,1,0,0,1
40300,1,0,0,0,1
40301,0,1,0,0,1
40302,0,1,0,0,1
40303,0,1,0,0,1
40304,1,0,0,0,1
40305,0,1,0,0,1
40306,0,1,0,0,1
40307,0,1,0,0,1
40308,0,1,0,0,1
40309,1,0,0,0,1
40310,0,1,0,0,1
40311,0,1,0,0,1
40312,0,1,0,0,1
40313,0,1,0,0,1
40314,0,1,0,0,1
40315,1,0,0,0,1
40316,0,1,0,0,1
40317,0,1,0,0,1
40318,0,1,0,0,1
40319,0,1,0,0,1
40320,1,0,0,0,1
40321,0,1,0,0,1
40322,0,1,0,0,1
40323,0,1,0,0,1
40324,0,1,0,0,1
40325,0,1,0,0,1
40326,1,0,0,0,1
40327,0,1,0,0,1
40328,0,1,0,0,1
40329,0,1,0,0,1
40330,0,1,0,0,1
40331,0,1,0,0,1
40332,1,0,0,0,1
40333,1,0,0,0,1
40334,0,1,0,0,1
40335,0,1,0,0,1
40336,0,1,0,0,1
40337,0,1,0,0,1
40338,0,1,0,0,1
40339,0,1,0,0,1
40340,0,1,0,0,1
40341,0,1,0,0,1
40342,0,1,0,0,1
40343,0,1,0,0,1
40344,0,1,0,0,1
40345,0,1,0,0,1
40346,0,1,0,0,1
40347,0,1,0,0,1
40348,1,0,0,0,1
40349,0,1,0,0,1
40350,0,1,0,0,1
40351,0,1,0,0,1
40352,0,1,0,0,1
40353,0,1,0,0,1
40354,0,1,0,0,1
40355,0,1,0,0,1
40356,0,1,0,0,1
40357,1,0,0,0,1
40358,0,1,0,0,1
40359,0,1,0,0,1
40360,0,1,0,0,1
40361,0,1,0,0,1
40362,0,1,0,0,1
40363,0,1,0,0,1
40364,0,0,0,1,1
40365,0,1,0,0,1
40366,0,1,0,0,1
40367,1,0,0,0,1
40368,0,1,0,0,1
40369,0,1,0,0,1
40370,1,0,0,0,1
40371,0,1,0,0,1
40372,1,0,0,0,1
40373,0,1,0,0,1
40374,0,1,0,0,1
40375,0,1,0,0,1
40376,0,1,0,0,1
40377,1,0,0,0,1
40378,0,1,0,0,1
40379,1,0,0,0,1
40380,0,1,0,0,1
40381,0,1,0,0,1
40382,0,1,0,0,1
40383,0,1,0,0,1
40384,1,0,0,0,1
40385,0,1,0,0,1
40386,0,1,0,0,1
40387,0,1,0,0,1
40388,0,1,0,0,1
40389,0,1,0,0,1
40390,0,1,0,0,1
40391,0,1,0,0,1
40392,0,1,0,0,1
40393,0,1,0,0,1
40394,0,1,0,0,1
40395,0,1,0,0,1
40396,0,1,0,0,1
40397,0,1,0,0,1
40398,0,1,0,0,1
40399,0,1,0,0,1
40400,0,1,0,0,1
40401,0,1,0,0,1
40402,1,0,0,0,1
40403,0,1,0,0,1
40404,0,1,0,0,1
40405,0,1,0,0,1
40406,1,0,0,0,1
40407,0,1,0,0,1
40408,1,0,0,0,1
40409,0,1,0,0,1
40410,0,1,0,0,1
40411,0,1,0,0,1
40412,1,0,0,0,1
40413,0,1,0,0,1
40414,1,0,0,0,1
40415,0,1,0,0,1
40416,0,1,0,0,1
40417,0,1,0,0,1
40418,0,1,0,0,1
40419,0,1,0,0,1
40420,0,1,0,0,1
40421,0,1,0,0,1
40422,0,0,0,1,1
40423,0,1,0,0,1
40424,0,1,0,0,1
40425,0,1,0,0,1
40426,0,1,0,0,1
40427,0,1,0,0,1
40428,1,0,0,0,1
40429,0,1,0,0,1
40430,0,1,0,0,1
40431,1,0,0,0,1
40432,0,1,0,0,1
40433,0,1,0,0,1
40434,0,1,0,0,1
40435,1,0,0,0,1
40436,0,1,0,0,1
40437,0,1,0,0,1
40438,0,0,1,0,1
40439,0,1,0,0,1
40440,0,1,0,0,1
40441,0,1,0,0,1
40442,0,1,0,0,1
40443,0,1,0,0,1
40444,1,0,0,0,1
40445,0,1,0,0,1
40446,0,1,0,0,1
40447,0,1,0,0,1
40448,0,1,0,0,1
40449,0,1,0,0,1
40450,1,0,0,0,1
40451,0,1,0,0,1
40452,0,1,0,0,1
40453,0,1,0,0,1
40454,1,0,0,0,1
40455,0,1,0,0,1
40456,0,1,0,0,1
40457,0,1,0,0,1
40458,0,1,0,0,1
40459,0,1,0,0,1
40460,0,1,0,0,1
40461,0,1,0,0,1
40462,1,0,0,0,1
40463,0,1,0,0,1
40464,0,1,0,0,1
40465,0,1,0,0,1
40466,0,1,0,0,1
40467,0,0,0,1,1
40468,0,1,0,0,1
40469,0,1,0,0,1
40470,0,1,0,0,1
40471,0,1,0,0,1
40472,0,1,0,0,1
40473,0,1,0,0,1
40474,0,1,0,0,1
40475,0,1,0,0,1
40476,0,1,0,0,1
40477,0,1,0,0,1
40478,0,1,0,0,1
40479,0,1,0,0,1
40480,0,1,0,0,1
40481,0,1,0,0,1
40482,0,1,0,0,1
40483,0,1,0,0,1
40484,0,1,0,0,1
40485,0,1,0,0,1
40486,0,1,0,0,1
40487,0,1,0,0,1
40488,0,1,0,0,1
40489,0,1,0,0,1
40490,0,1,0,0,1
40491,1,0,0,0,1
40492,0,0,0,1,1
40493,0,1,0,0,1
40494,0,1,0,0,1
40495,0,1,0,0,1
40496,0,1,0,0,1
40497,1,0,0,0,1
40498,0,0,0,1,1
40499,0,1,0,0,1
40500,0,1,0,0,1
40501,1,0,0,0,1
40502,1,0,0,0,1
40503,0,1,0,0,1
40504,0,1,0,0,1
40505,0,1,0,0,1
40506,0,1,0,0,1
40507,0,1,0,0,1
40508,0,1,0,0,1
40509,0,1,0,0,1
40510,0,1,0,0,1
40511,0,1,0,0,1
40512,1,0,0,0,1
40513,1,0,0,0,1
40514,1,0,0,0,1
40515,0,1,0,0,1
40516,0,1,0,0,1
40517,1,0,0,0,1
40518,1,0,0,0,1
40519,0,1,0,0,1
40520,0,1,0,0,1
40521,0,1,0,0,1
40522,1,0,0,0,1
40523,0,1,0,0,1
40524,0,1,0,0,1
40525,0,1,0,0,1
40526,0,1,0,0,1
40527,0,0,1,0,1
40528,1,0,0,0,1
40529,0,1,0,0,1
40530,0,0,1,0,1
40531,0,1,0,0,1
40532,0,1,0,0,1
40533,1,0,0,0,1
40534,0,1,0,0,1
40535,0,1,0,0,1
40536,0,1,0,0,1
40537,0,1,0,0,1
40538,0,1,0,0,1
40539,0,1,0,0,1
40540,0,1,0,0,1
40541,0,1,0,0,1
40542,0,1,0,0,1
40543,1,0,0,0,1
40544,1,0,0,0,1
40545,0,1,0,0,1
40546,1,0,0,0,1
40547,0,1,0,0,1
40548,0,1,0,0,1
40549,0,1,0,0,1
40550,0,1,0,0,1
40551,0,1,0,0,1
40552,0,1,0,0,1
40553,0,1,0,0,1
40554,0,1,0,0,1
40555,0,1,0,0,1
40556,1,0,0,0,1
40557,0,1,0,0,1
40558,0,1,0,0,1
40559,0,1,0,0,1
40560,0,1,0,0,1
40561,0,1,0,0,1
40562,0,1,0,0,1
40563,0,1,0,0,1
40564,0,0,0,1,1
40565,0,1,0,0,1
40566,0,1,0,0,1
40567,0,1,0,0,1
40568,1,0,0,0,1
40569,0,1,0,0,1
40570,0,1,0,0,1
40571,0,1,0,0,1
40572,0,1,0,0,1
40573,0,1,0,0,1
40574,1,0,0,0,1
40575,0,1,0,0,1
40576,1,0,0,0,1
40577,0,1,0,0,1
40578,0,1,0,0,1
40579,0,1,0,0,1
40580,0,1,0,0,1
40581,0,1,0,0,1
40582,0,1,0,0,1
40583,1,0,0,0,1
40584,0,1,0,0,1
40585,0,1,0,0,1
40586,0,1,0,0,1
40587,0,1,0,0,1
40588,0,1,0,0,1
40589,0,1,0,0,1
40590,1,0,0,0,1
40591,0,1,0,0,1
40592,0,1,0,0,1
40593,0,1,0,0,1
40594,0,1,0,0,1
40595,0,0,0,1,1
40596,0,1,0,0,1
40597,1,0,0,0,1
40598,0,0,0,1,1
40599,1,0,0,0,1
40600,0,1,0,0,1
40601,0,1,0,0,1
40602,0,1,0,0,1
40603,0,1,0,0,1
40604,0,1,0,0,1
40605,0,1,0,0,1
40606,0,1,0,0,1
40607,1,0,0,0,1
40608,0,1,0,0,1
40609,0,1,0,0,1
40610,0,1,0,0,1
40611,0,1,0,0,1
40612,0,1,0,0,1
40613,1,0,0,0,1
40614,0,1,0,0,1
40615,0,1,0,0,1
40616,0,1,0,0,1
40617,0,1,0,0,1
40618,1,0,0,0,1
40619,0,1,0,0,1
40620,0,1,0,0,1
40621,0,1,0,0,1
40622,0,1,0,0,1
40623,0,1,0,0,1
40624,0,1,0,0,1
40625,0,1,0,0,1
40626,0,1,0,0,1
40627,0,1,0,0,1
40628,0,1,0,0,1
40629,0,1,0,0,1
40630,0,1,0,0,1
40631,0,1,0,0,1
40632,0,0,0,1,1
40633,0,1,0,0,1
40634,0,1,0,0,1
40635,0,1,0,0,1
40636,0,1,0,0,1
40637,0,1,0,0,1
40638,0,1,0,0,1
40639,0,1,0,0,1
40640,0,1,0,0,1
40641,0,1,0,0,1
40642,0,1,0,0,1
40643,0,1,0,0,1
40644,0,1,0,0,1
40645,0,1,0,0,1
40646,1,0,0,0,1
40647,0,1,0,0,1
40648,0,1,0,0,1
40649,0,1,0,0,1
40650,1,0,0,0,1
40651,1,0,0,0,1
40652,0,1,0,0,1
40653,0,1,0,0,1
40654,0,1,0,0,1
40655,0,1,0,0,1
40656,0,1,0,0,1
40657,0,1,0,0,1
40658,1,0,0,0,1
40659,0,1,0,0,1
40660,1,0,0,0,1
40661,0,1,0,0,1
40662,1,0,0,0,1
40663,1,0,0,0,1
40664,0,1,0,0,1
40665,0,1,0,0,1
40666,0,1,0,0,1
40667,0,1,0,0,1
40668,0,0,0,1,1
40669,0,1,0,0,1
40670,0,1,0,0,1
40671,0,1,0,0,1
40672,0,0,1,0,1
40673,0,0,0,1,1
40674,1,0,0,0,1
40675,1,0,0,0,1
40676,0,0,1,0,1
40677,0,0,1,0,1
40678,1,0,0,0,1
40679,0,1,0,0,1
40680,0,1,0,0,1
40681,0,1,0,0,1
40682,0,1,0,0,1
40683,0,1,0,0,1
40684,0,1,0,0,1
40685,0,1,0,0,1
40686,0,1,0,0,1
40687,0,1,0,0,1
40688,0,1,0,0,1
40689,0,1,0,0,1
40690,0,1,0,0,1
40691,0,1,0,0,1
40692,0,1,0,0,1
40693,0,1,0,0,1
40694,0,1,0,0,1
40695,0,1,0,0,1
40696,0,1,0,0,1
40697,0,1,0,0,1
40698,0,1,0,0,1
40699,0,1,0,0,1
40700,0,1,0,0,1
40701,0,1,0,0,1
40702,1,0,0,0,1
40703,0,1,0,0,1
40704,1,0,0,0,1
40705,0,0,1,0,1
40706,0,1,0,0,1
40707,0,1,0,0,1
40708,0,0,0,1,1
40709,0,1,0,0,1
40710,0,0,0,1,1
40711,0,1,0,0,1
40712,0,1,0,0,1
40713,0,1,0,0,1
40714,0,1,0,0,1
40715,0,1,0,0,1
40716,1,0,0,0,1
40717,0,1,0,0,1
40718,0,1,0,0,1
40719,0,1,0,0,1
40720,1,0,0,0,1
40721,1,0,0,0,1
40722,0,1,0,0,1
40723,1,0,0,0,1
40724,0,1,0,0,1
40725,0,1,0,0,1
40726,0,1,0,0,1
40727,0,1,0,0,1
40728,0,1,0,0,1
40729,0,1,0,0,1
40730,0,1,0,0,1
40731,0,1,0,0,1
40732,0,1,0,0,1
40733,0,1,0,0,1
40734,0,1,0,0,1
40735,0,1,0,0,1
40736,0,1,0,0,1
40737,0,1,0,0,1
40738,0,0,0,1,1
40739,0,1,0,0,1
40740,0,0,1,0,1
40741,0,1,0,0,1
40742,0,1,0,0,1
40743,0,1,0,0,1
40744,1,0,0,0,1
40745,0,1,0,0,1
40746,0,1,0,0,1
40747,0,1,0,0,1
40748,0,1,0,0,1
40749,0,1,0,0,1
40750,0,1,0,0,1
40751,0,1,0,0,1
40752,0,1,0,0,1
40753,0,1,0,0,1
40754,0,1,0,0,1
40755,0,1,0,0,1
40756,0,1,0,0,1
40757,1,0,0,0,1
40758,0,1,0,0,1
40759,1,0,0,0,1
40760,0,1,0,0,1
40761,0,1,0,0,1
40762,0,1,0,0,1
40763,0,1,0,0,1
40764,0,1,0,0,1
40765,1,0,0,0,1
40766,1,0,0,0,1
40767,0,0,0,1,1
40768,0,1,0,0,1
40769,0,1,0,0,1
40770,0,1,0,0,1
40771,0,1,0,0,1
40772,0,1,0,0,1
40773,1,0,0,0,1
40774,0,1,0,0,1
40775,0,1,0,0,1
40776,0,1,0,0,1
40777,0,1,0,0,1
40778,0,1,0,0,1
40779,0,1,0,0,1
40780,0,1,0,0,1
40781,1,0,0,0,1
40782,1,0,0,0,1
40783,0,1,0,0,1
40784,0,0,1,0,1
40785,0,1,0,0,1
40786,0,1,0,0,1
40787,0,1,0,0,1
40788,0,1,0,0,1
40789,1,0,0,0,1
40790,0,1,0,0,1
40791,0,1,0,0,1
40792,0,1,0,0,1
40793,0,0,1,0,1
40794,0,1,0,0,1
40795,0,1,0,0,1
40796,0,1,0,0,1
40797,0,0,0,1,1
40798,0,1,0,0,1
40799,0,1,0,0,1
40800,0,1,0,0,1
40801,0,1,0,0,1
40802,0,1,0,0,1
40803,0,1,0,0,1
40804,0,1,0,0,1
40805,1,0,0,0,1
40806,0,1,0,0,1
40807,0,1,0,0,1
40808,0,1,0,0,1
40809,0,1,0,0,1
40810,0,1,0,0,1
40811,0,1,0,0,1
40812,1,0,0,0,1
40813,0,1,0,0,1
40814,0,1,0,0,1
40815,0,1,0,0,1
40816,0,1,0,0,1
40817,0,1,0,0,1
40818,0,1,0,0,1
40819,0,1,0,0,1
40820,0,1,0,0,1
40821,0,1,0,0,1
40822,0,1,0,0,1
40823,0,1,0,0,1
40824,0,0,0,1,1
40825,0,0,0,1,1
40826,0,1,0,0,1
40827,0,1,0,0,1
40828,0,0,0,1,1
40829,0,1,0,0,1
40830,1,0,0,0,1
40831,0,1,0,0,1
40832,0,1,0,0,1
40833,0,1,0,0,1
40834,0,1,0,0,1
40835,0,1,0,0,1
40836,0,1,0,0,1
40837,1,0,0,0,1
40838,0,1,0,0,1
40839,1,0,0,0,1
40840,0,0,0,1,1
40841,0,1,0,0,1
40842,0,1,0,0,1
40843,0,1,0,0,1
40844,0,1,0,0,1
40845,0,1,0,0,1
40846,0,1,0,0,1
40847,0,1,0,0,1
40848,0,1,0,0,1
40849,0,1,0,0,1
40850,0,1,0,0,1
40851,0,1,0,0,1
40852,1,0,0,0,1
40853,0,1,0,0,1
40854,0,1,0,0,1
40855,0,1,0,0,1
40856,0,1,0,0,1
40857,0,1,0,0,1
40858,1,0,0,0,1
40859,0,1,0,0,1
40860,0,1,0,0,1
40861,0,1,0,0,1
40862,0,1,0,0,1
40863,0,1,0,0,1
40864,0,1,0,0,1
40865,1,0,0,0,1
40866,0,1,0,0,1
40867,1,0,0,0,1
40868,0,1,0,0,1
40869,1,0,0,0,1
40870,0,1,0,0,1
40871,0,1,0,0,1
40872,0,1,0,0,1
40873,1,0,0,0,1
40874,0,1,0,0,1
40875,0,1,0,0,1
40876,0,1,0,0,1
40877,0,1,0,0,1
40878,0,1,0,0,1
40879,0,0,1,0,1
40880,0,1,0,0,1
40881,0,1,0,0,1
40882,0,1,0,0,1
40883,0,1,0,0,1
40884,0,1,0,0,1
40885,0,1,0,0,1
40886,0,1,0,0,1
40887,0,1,0,0,1
40888,0,1,0,0,1
40889,0,1,0,0,1
40890,0,1,0,0,1
40891,0,1,0,0,1
40892,1,0,0,0,1
40893,0,1,0,0,1
40894,0,1,0,0,1
40895,0,1,0,0,1
40896,1,0,0,0,1
40897,0,0,0,1,1
40898,0,1,0,0,1
40899,0,1,0,0,1
40900,0,1,0,0,1
40901,0,1,0,0,1
40902,0,1,0,0,1
40903,0,1,0,0,1
40904,1,0,0,0,1
40905,0,1,0,0,1
40906,0,1,0,0,1
40907,0,1,0,0,1
40908,0,1,0,0,1
40909,1,0,0,0,1
40910,0,1,0,0,1
40911,0,1,0,0,1
40912,0,1,0,0,1
40913,1,0,0,0,1
40914,0,0,0,1,1
40915,0,1,0,0,1
40916,0,1,0,0,1
40917,0,1,0,0,1
40918,1,0,0,0,1
40919,0,1,0,0,1
40920,0,1,0,0,1
40921,0,1,0,0,1
40922,1,0,0,0,1
40923,0,1,0,0,1
40924,0,1,0,0,1
40925,0,1,0,0,1
40926,0,1,0,0,1
40927,0,1,0,0,1
40928,0,1,0,0,1
40929,0,1,0,0,1
40930,0,1,0,0,1
40931,0,1,0,0,1
40932,0,1,0,0,1
40933,0,1,0,0,1
40934,0,1,0,0,1
40935,0,1,0,0,1
40936,0,1,0,0,1
40937,0,0,0,1,1
40938,0,1,0,0,1
40939,0,1,0,0,1
40940,0,1,0,0,1
40941,0,1,0,0,1
40942,0,1,0,0,1
40943,0,1,0,0,1
40944,0,1,0,0,1
40945,0,1,0,0,1
40946,0,1,0,0,1
40947,0,1,0,0,1
40948,0,1,0,0,1
40949,0,1,0,0,1
40950,0,1,0,0,1
40951,0,1,0,0,1
40952,1,0,0,0,1
40953,1,0,0,0,1
40954,0,1,0,0,1
40955,0,1,0,0,1
40956,0,1,0,0,1
40957,0,0,0,1,1
40958,0,1,0,0,1
40959,0,1,0,0,1
40960,0,1,0,0,1
40961,1,0,0,0,1
40962,0,1,0,0,1
40963,0,1,0,0,1
40964,0,1,0,0,1
40965,0,1,0,0,1
40966,0,1,0,0,1
40967,0,1,0,0,1
40968,0,1,0,0,1
40969,0,0,1,0,1
40970,1,0,0,0,1
40971,1,0,0,0,1
40972,0,1,0,0,1
40973,1,0,0,0,1
40974,0,1,0,0,1
40975,1,0,0,0,1
40976,0,1,0,0,1
40977,1,0,0,0,1
40978,0,1,0,0,1
40979,1,0,0,0,1
40980,0,1,0,0,1
40981,0,1,0,0,1
40982,0,1,0,0,1
40983,0,1,0,0,1
40984,0,1,0,0,1
40985,0,1,0,0,1
40986,0,1,0,0,1
40987,0,1,0,0,1
40988,0,1,0,0,1
40989,0,1,0,0,1
40990,1,0,0,0,1
40991,0,1,0,0,1
40992,0,1,0,0,1
40993,0,1,0,0,1
40994,0,1,0,0,1
40995,0,1,0,0,1
40996,0,1,0,0,1
40997,0,1,0,0,1
40998,0,0,1,0,1
40999,0,1,0,0,1
41000,0,1,0,0,1
41001,0,1,0,0,1
41002,0,1,0,0,1
41003,0,1,0,0,1
41004,0,1,0,0,1
41005,0,1,0,0,1
41006,1,0,0,0,1
41007,0,1,0,0,1
41008,0,1,0,0,1
41009,0,1,0,0,1
41010,1,0,0,0,1
41011,0,1,0,0,1
41012,0,1,0,0,1
41013,0,1,0,0,1
41014,0,1,0,0,1
41015,0,1,0,0,1
41016,0,1,0,0,1
41017,0,1,0,0,1
41018,0,1,0,0,1
41019,0,1,0,0,1
41020,0,0,0,1,1
41021,0,1,0,0,1
41022,0,1,0,0,1
41023,0,1,0,0,1
41024,0,1,0,0,1
41025,1,0,0,0,1
41026,0,0,1,0,1
41027,0,1,0,0,1
41028,0,1,0,0,1
41029,0,1,0,0,1
41030,0,1,0,0,1
41031,0,1,0,0,1
41032,0,1,0,0,1
41033,0,1,0,0,1
41034,0,0,0,1,1
41035,0,1,0,0,1
41036,0,1,0,0,1
41037,0,1,0,0,1
41038,0,1,0,0,1
41039,0,1,0,0,1
41040,0,0,1,0,1
41041,0,1,0,0,1
41042,0,0,1,0,1
41043,0,1,0,0,1
41044,0,1,0,0,1
41045,0,1,0,0,1
41046,1,0,0,0,1
41047,0,1,0,0,1
41048,1,0,0,0,1
41049,0,1,0,0,1
41050,1,0,0,0,1
41051,0,1,0,0,1
41052,0,1,0,0,1
41053,0,1,0,0,1
41054,0,1,0,0,1
41055,0,0,0,1,1
41056,0,1,0,0,1
41057,0,1,0,0,1
41058,0,1,0,0,1
41059,0,1,0,0,1
41060,0,1,0,0,1
41061,0,1,0,0,1
41062,0,1,0,0,1
41063,0,1,0,0,1
41064,0,1,0,0,1
41065,0,1,0,0,1
41066,0,1,0,0,1
41067,0,1,0,0,1
41068,1,0,0,0,1
41069,0,1,0,0,1
41070,0,1,0,0,1
41071,0,1,0,0,1
41072,1,0,0,0,1
41073,0,1,0,0,1
41074,0,1,0,0,1
41075,0,1,0,0,1
41076,0,1,0,0,1
41077,1,0,0,0,1
41078,0,1,0,0,1
41079,0,1,0,0,1
41080,0,0,1,0,1
41081,1,0,0,0,1
41082,0,1,0,0,1
41083,0,1,0,0,1
41084,0,1,0,0,1
41085,0,1,0,0,1
41086,0,0,1,0,1
41087,0,1,0,0,1
41088,0,1,0,0,1
41089,1,0,0,0,1
41090,0,0,0,1,1
41091,0,1,0,0,1
41092,0,1,0,0,1
41093,1,0,0,0,1
41094,0,1,0,0,1
41095,1,0,0,0,1
41096,0,1,0,0,1
41097,1,0,0,0,1
41098,0,1,0,0,1
41099,0,1,0,0,1
41100,0,1,0,0,1
41101,0,1,0,0,1
41102,0,1,0,0,1
41103,1,0,0,0,1
41104,0,1,0,0,1
41105,1,0,0,0,1
41106,0,1,0,0,1
41107,0,1,0,0,1
41108,1,0,0,0,1
41109,0,1,0,0,1
41110,0,1,0,0,1
41111,0,1,0,0,1
41112,0,1,0,0,1
41113,0,1,0,0,1
41114,0,1,0,0,1
41115,0,1,0,0,1
41116,0,1,0,0,1
41117,0,1,0,0,1
41118,0,1,0,0,1
41119,1,0,0,0,1
41120,0,1,0,0,1
41121,0,1,0,0,1
41122,1,0,0,0,1
41123,0,1,0,0,1
41124,0,1,0,0,1
41125,0,1,0,0,1
41126,0,1,0,0,1
41127,1,0,0,0,1
41128,0,1,0,0,1
41129,1,0,0,0,1
41130,0,1,0,0,1
41131,0,1,0,0,1
41132,0,1,0,0,1
41133,0,1,0,0,1
41134,0,1,0,0,1
41135,0,1,0,0,1
41136,0,1,0,0,1
41137,0,1,0,0,1
41138,0,1,0,0,1
41139,0,1,0,0,1
41140,0,1,0,0,1
41141,0,0,0,1,1
41142,0,1,0,0,1
41143,0,1,0,0,1
41144,0,1,0,0,1
41145,0,1,0,0,1
41146,0,1,0,0,1
41147,0,1,0,0,1
41148,0,1,0,0,1
41149,0,1,0,0,1
41150,0,1,0,0,1
41151,0,1,0,0,1
41152,0,1,0,0,1
41153,0,1,0,0,1
41154,0,1,0,0,1
41155,0,0,1,0,1
41156,0,1,0,0,1
41157,0,1,0,0,1
41158,0,1,0,0,1
41159,0,1,0,0,1
41160,0,1,0,0,1
41161,0,1,0,0,1
41162,0,1,0,0,1
41163,0,1,0,0,1
41164,0,1,0,0,1
41165,0,1,0,0,1
41166,0,1,0,0,1
41167,1,0,0,0,1
41168,0,1,0,0,1
41169,0,1,0,0,1
41170,0,1,0,0,1
41171,0,1,0,0,1
41172,0,1,0,0,1
41173,1,0,0,0,1
41174,1,0,0,0,1
41175,0,0,0,1,1
41176,1,0,0,0,1
41177,0,1,0,0,1
41178,0,1,0,0,1
41179,0,1,0,0,1
41180,0,1,0,0,1
41181,0,0,0,1,1
41182,0,1,0,0,1
41183,0,1,0,0,1
41184,0,1,0,0,1
41185,0,1,0,0,1
41186,0,1,0,0,1
41187,0,1,0,0,1
41188,0,1,0,0,1
41189,1,0,0,0,1
41190,0,0,1,0,1
41191,0,1,0,0,1
41192,0,0,1,0,1
41193,0,1,0,0,1
41194,1,0,0,0,1
41195,0,1,0,0,1
41196,0,1,0,0,1
41197,1,0,0,0,1
41198,0,1,0,0,1
41199,0,1,0,0,1
41200,0,1,0,0,1
41201,0,1,0,0,1
41202,0,1,0,0,1
41203,0,1,0,0,1
41204,0,1,0,0,1
41205,1,0,0,0,1
41206,1,0,0,0,1
41207,0,1,0,0,1
41208,0,1,0,0,1
41209,0,1,0,0,1
41210,0,0,0,1,1
41211,0,0,0,1,1
41212,0,1,0,0,1
41213,0,1,0,0,1
41214,0,1,0,0,1
41215,0,1,0,0,1
41216,0,1,0,0,1
41217,0,1,0,0,1
41218,0,1,0,0,1
41219,0,1,0,0,1
41220,0,1,0,0,1
41221,1,0,0,0,1
41222,0,1,0,0,1
41223,0,1,0,0,1
41224,0,1,0,0,1
41225,1,0,0,0,1
41226,0,1,0,0,1
41227,0,1,0,0,1
41228,0,1,0,0,1
41229,0,1,0,0,1
41230,0,1,0,0,1
41231,0,1,0,0,1
41232,1,0,0,0,1
41233,0,1,0,0,1
41234,1,0,0,0,1
41235,0,1,0,0,1
41236,0,0,0,1,1
41237,0,1,0,0,1
41238,1,0,0,0,1
41239,0,1,0,0,1
41240,0,1,0,0,1
41241,0,1,0,0,1
41242,0,1,0,0,1
41243,0,1,0,0,1
41244,1,0,0,0,1
41245,0,1,0,0,1
41246,0,1,0,0,1
41247,0,1,0,0,1
41248,0,1,0,0,1
41249,0,1,0,0,1
41250,1,0,0,0,1
41251,0,1,0,0,1
41252,1,0,0,0,1
41253,1,0,0,0,1
41254,0,1,0,0,1
41255,0,1,0,0,1
41256,0,1,0,0,1
41257,0,1,0,0,1
41258,1,0,0,0,1
41259,0,1,0,0,1
41260,0,1,0,0,1
41261,0,1,0,0,1
41262,0,1,0,0,1
41263,0,1,0,0,1
41264,0,1,0,0,1
41265,0,1,0,0,1
41266,0,1,0,0,1
41267,0,1,0,0,1
41268,0,1,0,0,1
41269,0,1,0,0,1
41270,0,1,0,0,1
41271,1,0,0,0,1
41272,0,1,0,0,1
41273,0,1,0,0,1
41274,0,1,0,0,1
41275,1,0,0,0,1
41276,1,0,0,0,1
41277,0,1,0,0,1
41278,0,0,1,0,1
41279,0,1,0,0,1
41280,0,1,0,0,1
41281,0,0,0,1,1
41282,1,0,0,0,1
41283,0,1,0,0,1
41284,0,1,0,0,1
41285,0,1,0,0,1
41286,0,1,0,0,1
41287,0,1,0,0,1
41288,0,1,0,0,1
41289,1,0,0,0,1
41290,0,1,0,0,1
41291,0,1,0,0,1
41292,0,1,0,0,1
41293,0,1,0,0,1
41294,1,0,0,0,1
41295,0,1,0,0,1
41296,0,1,0,0,1
41297,0,1,0,0,1
41298,0,1,0,0,1
41299,0,1,0,0,1
41300,0,1,0,0,1
41301,0,1,0,0,1
41302,0,1,0,0,1
41303,0,1,0,0,1
41304,0,1,0,0,1
41305,0,1,0,0,1
41306,0,0,1,0,1
41307,0,1,0,0,1
41308,0,1,0,0,1
41309,0,1,0,0,1
41310,1,0,0,0,1
41311,0,1,0,0,1
41312,0,1,0,0,1
41313,0,1,0,0,1
41314,0,1,0,0,1
41315,0,1,0,0,1
41316,0,1,0,0,1
41317,0,1,0,0,1
41318,0,1,0,0,1
41319,0,1,0,0,1
41320,0,1,0,0,1
41321,0,1,0,0,1
41322,0,1,0,0,1
41323,0,1,0,0,1
41324,0,1,0,0,1
41325,1,0,0,0,1
41326,0,1,0,0,1
41327,0,1,0,0,1
41328,0,1,0,0,1
41329,0,1,0,0,1
41330,0,1,0,0,1
41331,0,0,0,1,1
41332,0,1,0,0,1
41333,0,1,0,0,1
41334,0,1,0,0,1
41335,1,0,0,0,1
41336,0,1,0,0,1
41337,0,1,0,0,1
41338,0,1,0,0,1
41339,0,0,1,0,1
41340,0,1,0,0,1
41341,0,1,0,0,1
41342,0,1,0,0,1
41343,0,0,0,1,1
41344,0,1,0,0,1
41345,0,1,0,0,1
41346,1,0,0,0,1
41347,0,1,0,0,1
41348,0,0,0,1,1
41349,0,0,0,1,1
41350,1,0,0,0,1
41351,1,0,0,0,1
41352,0,1,0,0,1
41353,0,1,0,0,1
41354,0,1,0,0,1
41355,0,1,0,0,1
41356,0,1,0,0,1
41357,0,1,0,0,1
41358,0,1,0,0,1
41359,0,1,0,0,1
41360,0,1,0,0,1
41361,0,1,0,0,1
41362,0,1,0,0,1
41363,0,1,0,0,1
41364,1,0,0,0,1
41365,0,1,0,0,1
41366,0,1,0,0,1
41367,0,1,0,0,1
41368,0,1,0,0,1
41369,0,1,0,0,1
41370,0,1,0,0,1
41371,0,1,0,0,1
41372,0,1,0,0,1
41373,0,1,0,0,1
41374,0,1,0,0,1
41375,0,1,0,0,1
41376,0,1,0,0,1
41377,0,1,0,0,1
41378,0,1,0,0,1
41379,0,1,0,0,1
41380,0,1,0,0,1
41381,0,1,0,0,1
41382,0,1,0,0,1
41383,0,1,0,0,1
41384,0,1,0,0,1
41385,0,1,0,0,1
41386,0,1,0,0,1
41387,0,1,0,0,1
41388,0,1,0,0,1
41389,0,1,0,0,1
41390,0,1,0,0,1
41391,0,1,0,0,1
41392,0,1,0,0,1
41393,0,1,0,0,1
41394,1,0,0,0,1
41395,0,1,0,0,1
41396,0,1,0,0,1
41397,0,1,0,0,1
41398,0,1,0,0,1
41399,0,1,0,0,1
41400,0,1,0,0,1
41401,0,1,0,0,1
41402,0,1,0,0,1
41403,0,1,0,0,1
41404,0,0,0,1,1
41405,0,1,0,0,1
41406,0,1,0,0,1
41407,0,1,0,0,1
41408,0,1,0,0,1
41409,0,1,0,0,1
41410,0,1,0,0,1
41411,0,1,0,0,1
41412,0,1,0,0,1
41413,1,0,0,0,1
41414,0,1,0,0,1
41415,0,1,0,0,1
41416,0,1,0,0,1
41417,0,1,0,0,1
41418,1,0,0,0,1
41419,1,0,0,0,1
41420,0,1,0,0,1
41421,0,1,0,0,1
41422,0,1,0,0,1
41423,0,1,0,0,1
41424,0,1,0,0,1
41425,0,1,0,0,1
41426,0,1,0,0,1
41427,0,1,0,0,1
41428,0,1,0,0,1
41429,0,1,0,0,1
41430,0,1,0,0,1
41431,0,1,0,0,1
41432,0,1,0,0,1
41433,1,0,0,0,1
41434,0,1,0,0,1
41435,0,1,0,0,1
41436,0,1,0,0,1
41437,0,0,0,1,1
41438,0,1,0,0,1
41439,1,0,0,0,1
41440,0,1,0,0,1
41441,0,1,0,0,1
41442,1,0,0,0,1
41443,1,0,0,0,1
41444,0,1,0,0,1
41445,0,1,0,0,1
41446,0,1,0,0,1
41447,0,1,0,0,1
41448,1,0,0,0,1
41449,0,1,0,0,1
41450,1,0,0,0,1
41451,0,1,0,0,1
41452,1,0,0,0,1
41453,0,1,0,0,1
41454,1,0,0,0,1
41455,0,1,0,0,1
41456,1,0,0,0,1
41457,0,1,0,0,1
41458,0,1,0,0,1
41459,0,1,0,0,1
41460,0,1,0,0,1
41461,0,1,0,0,1
41462,1,0,0,0,1
41463,0,1,0,0,1
41464,0,1,0,0,1
41465,0,1,0,0,1
41466,0,1,0,0,1
41467,0,1,0,0,1
41468,0,1,0,0,1
41469,0,1,0,0,1
41470,1,0,0,0,1
41471,1,0,0,0,1
41472,0,1,0,0,1
41473,1,0,0,0,1
41474,1,0,0,0,1
41475,0,1,0,0,1
41476,0,0,1,0,1
41477,0,1,0,0,1
41478,0,1,0,0,1
41479,0,1,0,0,1
41480,0,1,0,0,1
41481,0,1,0,0,1
41482,0,1,0,0,1
41483,0,1,0,0,1
41484,0,1,0,0,1
41485,0,1,0,0,1
41486,0,1,0,0,1
41487,0,1,0,0,1
41488,0,1,0,0,1
41489,0,1,0,0,1
41490,0,1,0,0,1
41491,0,1,0,0,1
41492,0,1,0,0,1
41493,0,1,0,0,1
41494,0,1,0,0,1
41495,0,1,0,0,1
41496,0,1,0,0,1
41497,0,1,0,0,1
41498,0,1,0,0,1
41499,0,1,0,0,1
41500,0,1,0,0,1
41501,0,1,0,0,1
41502,0,1,0,0,1
41503,0,0,0,1,1
41504,0,1,0,0,1
41505,0,1,0,0,1
41506,0,1,0,0,1
41507,1,0,0,0,1
41508,0,1,0,0,1
41509,0,1,0,0,1
41510,0,1,0,0,1
41511,0,1,0,0,1
41512,0,1,0,0,1
41513,0,0,0,1,1
41514,0,1,0,0,1
41515,1,0,0,0,1
41516,0,1,0,0,1
41517,0,1,0,0,1
41518,0,1,0,0,1
41519,0,0,1,0,1
41520,0,1,0,0,1
41521,0,1,0,0,1
41522,0,1,0,0,1
41523,0,1,0,0,1
41524,0,1,0,0,1
41525,0,1,0,0,1
41526,0,0,0,1,1
41527,0,1,0,0,1
41528,0,1,0,0,1
41529,1,0,0,0,1
41530,0,1,0,0,1
41531,0,0,1,0,1
41532,0,1,0,0,1
41533,0,1,0,0,1
41534,0,1,0,0,1
41535,0,1,0,0,1
41536,0,1,0,0,1
41537,0,1,0,0,1
41538,0,1,0,0,1
41539,1,0,0,0,1
41540,0,1,0,0,1
41541,0,1,0,0,1
41542,0,1,0,0,1
41543,0,1,0,0,1
41544,1,0,0,0,1
41545,0,1,0,0,1
41546,1,0,0,0,1
41547,0,1,0,0,1
41548,0,1,0,0,1
41549,0,1,0,0,1
41550,0,1,0,0,1
41551,0,1,0,0,1
41552,0,1,0,0,1
41553,0,1,0,0,1
41554,0,1,0,0,1
41555,0,1,0,0,1
41556,0,1,0,0,1
41557,0,1,0,0,1
41558,0,1,0,0,1
41559,0,1,0,0,1
41560,0,1,0,0,1
41561,0,1,0,0,1
41562,0,1,0,0,1
41563,0,1,0,0,1
41564,0,1,0,0,1
41565,0,1,0,0,1
41566,0,1,0,0,1
41567,0,1,0,0,1
41568,0,1,0,0,1
41569,0,1,0,0,1
41570,1,0,0,0,1
41571,0,0,0,1,1
41572,0,1,0,0,1
41573,0,0,1,0,1
41574,0,1,0,0,1
41575,0,1,0,0,1
41576,0,1,0,0,1
41577,0,1,0,0,1
41578,0,1,0,0,1
41579,0,1,0,0,1
41580,0,1,0,0,1
41581,1,0,0,0,1
41582,1,0,0,0,1
41583,0,1,0,0,1
41584,0,1,0,0,1
41585,0,1,0,0,1
41586,1,0,0,0,1
41587,0,1,0,0,1
41588,0,1,0,0,1
41589,0,1,0,0,1
41590,0,1,0,0,1
41591,0,1,0,0,1
41592,0,1,0,0,1
41593,0,1,0,0,1
41594,0,1,0,0,1
41595,1,0,0,0,1
41596,0,1,0,0,1
41597,0,1,0,0,1
41598,0,1,0,0,1
41599,0,1,0,0,1
41600,1,0,0,0,1
41601,0,1,0,0,1
41602,0,1,0,0,1
41603,1,0,0,0,1
41604,0,1,0,0,1
41605,0,1,0,0,1
41606,1,0,0,0,1
41607,0,1,0,0,1
41608,1,0,0,0,1
41609,0,1,0,0,1
41610,0,1,0,0,1
41611,0,1,0,0,1
41612,0,1,0,0,1
41613,0,1,0,0,1
41614,0,1,0,0,1
41615,0,1,0,0,1
41616,0,1,0,0,1
41617,0,1,0,0,1
41618,0,1,0,0,1
41619,0,1,0,0,1
41620,0,1,0,0,1
41621,0,1,0,0,1
41622,0,1,0,0,1
41623,0,1,0,0,1
41624,0,1,0,0,1
41625,0,1,0,0,1
41626,0,1,0,0,1
41627,0,1,0,0,1
41628,1,0,0,0,1
41629,0,1,0,0,1
41630,1,0,0,0,1
41631,0,1,0,0,1
41632,0,1,0,0,1
41633,0,1,0,0,1
41634,0,1,0,0,1
41635,0,1,0,0,1
41636,0,1,0,0,1
41637,0,1,0,0,1
41638,0,1,0,0,1
41639,0,1,0,0,1
41640,0,1,0,0,1
41641,1,0,0,0,1
41642,0,1,0,0,1
41643,0,1,0,0,1
41644,0,1,0,0,1
41645,1,0,0,0,1
41646,0,1,0,0,1
41647,0,1,0,0,1
41648,0,1,0,0,1
41649,0,1,0,0,1
41650,1,0,0,0,1
41651,0,1,0,0,1
41652,1,0,0,0,1
41653,0,1,0,0,1
41654,0,1,0,0,1
41655,0,1,0,0,1
41656,0,0,0,1,1
41657,0,1,0,0,1
41658,1,0,0,0,1
41659,0,1,0,0,1
41660,0,1,0,0,1
41661,1,0,0,0,1
41662,0,1,0,0,1
41663,0,1,0,0,1
41664,0,1,0,0,1
41665,0,1,0,0,1
41666,0,1,0,0,1
41667,0,1,0,0,1
41668,0,1,0,0,1
41669,1,0,0,0,1
41670,0,1,0,0,1
41671,0,1,0,0,1
41672,0,1,0,0,1
41673,0,1,0,0,1
41674,0,1,0,0,1
41675,1,0,0,0,1
41676,0,1,0,0,1
41677,0,1,0,0,1
41678,0,1,0,0,1
41679,0,1,0,0,1
41680,0,1,0,0,1
41681,0,1,0,0,1
41682,1,0,0,0,1
41683,0,1,0,0,1
41684,1,0,0,0,1
41685,0,1,0,0,1
41686,0,1,0,0,1
41687,1,0,0,0,1
41688,0,1,0,0,1
41689,0,1,0,0,1
41690,0,1,0,0,1
41691,0,1,0,0,1
41692,0,1,0,0,1
41693,1,0,0,0,1
41694,0,1,0,0,1
41695,0,1,0,0,1
41696,0,1,0,0,1
41697,0,1,0,0,1
41698,0,0,0,1,1
41699,0,1,0,0,1
41700,1,0,0,0,1
41701,1,0,0,0,1
41702,0,1,0,0,1
41703,0,1,0,0,1
41704,0,1,0,0,1
41705,1,0,0,0,1
41706,0,1,0,0,1
41707,0,1,0,0,1
41708,0,1,0,0,1
41709,0,1,0,0,1
41710,0,1,0,0,1
41711,0,1,0,0,1
41712,0,1,0,0,1
41713,0,1,0,0,1
41714,0,1,0,0,1
41715,0,1,0,0,1
41716,0,0,0,1,1
41717,0,1,0,0,1
41718,0,0,0,1,1
41719,0,1,0,0,1
41720,0,1,0,0,1
41721,0,1,0,0,1
41722,0,1,0,0,1
41723,0,1,0,0,1
41724,0,1,0,0,1
41725,0,1,0,0,1
41726,0,1,0,0,1
41727,0,1,0,0,1
41728,0,1,0,0,1
41729,0,1,0,0,1
41730,0,1,0,0,1
41731,0,1,0,0,1
41732,0,1,0,0,1
41733,0,1,0,0,1
41734,0,1,0,0,1
41735,0,1,0,0,1
41736,0,1,0,0,1
41737,0,1,0,0,1
41738,0,1,0,0,1
41739,0,1,0,0,1
41740,0,1,0,0,1
41741,0,1,0,0,1
41742,0,1,0,0,1
41743,0,1,0,0,1
41744,0,1,0,0,1
41745,0,0,1,0,1
41746,0,1,0,0,1
41747,0,1,0,0,1
41748,0,1,0,0,1
41749,0,0,1,0,1
41750,1,0,0,0,1
41751,0,1,0,0,1
41752,1,0,0,0,1
41753,0,1,0,0,1
41754,0,1,0,0,1
41755,0,1,0,0,1
41756,0,1,0,0,1
41757,0,1,0,0,1
41758,0,1,0,0,1
41759,0,1,0,0,1
41760,0,1,0,0,1
41761,0,1,0,0,1
41762,0,1,0,0,1
41763,0,1,0,0,1
41764,0,1,0,0,1
41765,0,1,0,0,1
41766,0,1,0,0,1
41767,0,1,0,0,1
41768,0,1,0,0,1
41769,0,1,0,0,1
41770,0,1,0,0,1
41771,1,0,0,0,1
41772,0,1,0,0,1
41773,0,1,0,0,1
41774,0,1,0,0,1
41775,0,1,0,0,1
41776,0,1,0,0,1
41777,0,1,0,0,1
41778,1,0,0,0,1
41779,0,1,0,0,1
41780,0,1,0,0,1
41781,0,1,0,0,1
41782,0,1,0,0,1
41783,0,1,0,0,1
41784,0,1,0,0,1
41785,0,0,0,1,1
41786,0,1,0,0,1
41787,1,0,0,0,1
41788,0,1,0,0,1
41789,0,1,0,0,1
41790,0,1,0,0,1
41791,1,0,0,0,1
41792,1,0,0,0,1
41793,0,1,0,0,1
41794,0,1,0,0,1
41795,0,1,0,0,1
41796,0,1,0,0,1
41797,0,1,0,0,1
41798,0,1,0,0,1
41799,0,1,0,0,1
41800,0,1,0,0,1
41801,0,1,0,0,1
41802,0,1,0,0,1
41803,1,0,0,0,1
41804,0,1,0,0,1
41805,0,1,0,0,1
41806,0,1,0,0,1
41807,0,1,0,0,1
41808,0,1,0,0,1
41809,0,1,0,0,1
41810,0,1,0,0,1
41811,0,1,0,0,1
41812,0,1,0,0,1
41813,0,1,0,0,1
41814,0,1,0,0,1
41815,0,1,0,0,1
41816,0,1,0,0,1
41817,0,0,0,1,1
41818,0,1,0,0,1
41819,0,1,0,0,1
41820,0,1,0,0,1
41821,0,1,0,0,1
41822,0,1,0,0,1
41823,0,1,0,0,1
41824,0,1,0,0,1
41825,0,1,0,0,1
41826,0,1,0,0,1
41827,0,1,0,0,1
41828,0,1,0,0,1
41829,1,0,0,0,1
41830,0,1,0,0,1
41831,0,1,0,0,1
41832,1,0,0,0,1
41833,0,1,0,0,1
41834,0,1,0,0,1
41835,1,0,0,0,1
41836,0,1,0,0,1
41837,0,1,0,0,1
41838,1,0,0,0,1
41839,0,0,1,0,1
41840,0,1,0,0,1
41841,0,1,0,0,1
41842,0,0,1,0,1
41843,0,1,0,0,1
41844,0,1,0,0,1
41845,0,1,0,0,1
41846,1,0,0,0,1
41847,0,1,0,0,1
41848,1,0,0,0,1
41849,1,0,0,0,1
41850,0,1,0,0,1
41851,0,1,0,0,1
41852,0,1,0,0,1
41853,0,1,0,0,1
41854,0,1,0,0,1
41855,0,1,0,0,1
41856,0,1,0,0,1
41857,0,1,0,0,1
41858,0,1,0,0,1
41859,0,1,0,0,1
41860,0,1,0,0,1
41861,0,1,0,0,1
41862,0,1,0,0,1
41863,0,0,0,1,1
41864,0,1,0,0,1
41865,0,1,0,0,1
41866,0,0,0,1,1
41867,0,1,0,0,1
41868,0,1,0,0,1
41869,0,1,0,0,1
41870,0,1,0,0,1
41871,1,0,0,0,1
41872,0,1,0,0,1
41873,0,0,0,1,1
41874,0,1,0,0,1
41875,0,1,0,0,1
41876,0,1,0,0,1
41877,0,1,0,0,1
41878,0,1,0,0,1
41879,0,1,0,0,1
41880,0,1,0,0,1
41881,0,1,0,0,1
41882,0,1,0,0,1
41883,0,1,0,0,1
41884,0,1,0,0,1
41885,0,1,0,0,1
41886,0,1,0,0,1
41887,1,0,0,0,1
41888,0,1,0,0,1
41889,0,1,0,0,1
41890,0,1,0,0,1
41891,0,1,0,0,1
41892,0,1,0,0,1
41893,0,1,0,0,1
41894,0,1,0,0,1
41895,1,0,0,0,1
41896,0,0,0,1,1
41897,0,1,0,0,1
41898,0,1,0,0,1
41899,1,0,0,0,1
41900,1,0,0,0,1
41901,0,1,0,0,1
41902,0,1,0,0,1
41903,0,1,0,0,1
41904,0,1,0,0,1
41905,1,0,0,0,1
41906,0,1,0,0,1
41907,0,1,0,0,1
41908,0,1,0,0,1
41909,0,1,0,0,1
41910,0,1,0,0,1
41911,0,1,0,0,1
41912,0,1,0,0,1
41913,0,1,0,0,1
41914,0,1,0,0,1
41915,0,1,0,0,1
41916,0,1,0,0,1
41917,0,1,0,0,1
41918,1,0,0,0,1
41919,0,1,0,0,1
41920,0,1,0,0,1
41921,0,1,0,0,1
41922,0,0,1,0,1
41923,1,0,0,0,1
41924,0,1,0,0,1
41925,0,1,0,0,1
41926,0,1,0,0,1
41927,0,1,0,0,1
41928,0,1,0,0,1
41929,0,0,0,1,1
41930,0,1,0,0,1
41931,0,1,0,0,1
41932,0,1,0,0,1
41933,0,1,0,0,1
41934,0,0,1,0,1
41935,0,1,0,0,1
41936,0,1,0,0,1
41937,1,0,0,0,1
41938,0,0,1,0,1
41939,0,1,0,0,1
41940,1,0,0,0,1
41941,0,1,0,0,1
41942,0,1,0,0,1
41943,0,1,0,0,1
41944,0,1,0,0,1
41945,0,1,0,0,1
41946,0,1,0,0,1
41947,0,1,0,0,1
41948,1,0,0,0,1
41949,0,1,0,0,1
41950,0,1,0,0,1
41951,0,1,0,0,1
41952,0,0,0,1,1
41953,0,1,0,0,1
41954,0,1,0,0,1
41955,0,1,0,0,1
41956,0,1,0,0,1
41957,0,1,0,0,1
41958,0,1,0,0,1
41959,0,1,0,0,1
41960,0,1,0,0,1
41961,0,0,0,1,1
41962,0,0,0,1,1
41963,0,1,0,0,1
41964,0,1,0,0,1
41965,1,0,0,0,1
41966,1,0,0,0,1
41967,0,1,0,0,1
41968,1,0,0,0,1
41969,0,1,0,0,1
41970,0,1,0,0,1
41971,0,1,0,0,1
41972,1,0,0,0,1
41973,0,1,0,0,1
41974,1,0,0,0,1
41975,0,1,0,0,1
41976,0,1,0,0,1
41977,0,1,0,0,1
41978,1,0,0,0,1
41979,0,1,0,0,1
41980,0,1,0,0,1
41981,1,0,0,0,1
41982,0,1,0,0,1
41983,0,1,0,0,1
41984,0,1,0,0,1
41985,0,1,0,0,1
41986,0,1,0,0,1
41987,0,1,0,0,1
41988,0,1,0,0,1
41989,0,1,0,0,1
41990,0,1,0,0,1
41991,1,0,0,0,1
41992,0,1,0,0,1
41993,0,1,0,0,1
41994,0,1,0,0,1
41995,0,1,0,0,1
41996,0,1,0,0,1
41997,0,1,0,0,1
41998,0,1,0,0,1
41999,0,1,0,0,1
42000,0,1,0,0,1
42001,0,1,0,0,1
42002,0,1,0,0,1
42003,0,1,0,0,1
42004,0,1,0,0,1
42005,0,1,0,0,1
42006,0,1,0,0,1
42007,0,1,0,0,1
42008,0,1,0,0,1
42009,0,1,0,0,1
42010,1,0,0,0,1
42011,1,0,0,0,1
42012,0,1,0,0,1
42013,0,1,0,0,1
42014,0,1,0,0,1
42015,0,1,0,0,1
42016,0,1,0,0,1
42017,0,1,0,0,1
42018,0,1,0,0,1
42019,0,1,0,0,1
42020,0,1,0,0,1
42021,0,1,0,0,1
42022,0,1,0,0,1
42023,0,1,0,0,1
42024,1,0,0,0,1
42025,0,1,0,0,1
42026,1,0,0,0,1
42027,1,0,0,0,1
42028,0,1,0,0,1
42029,0,1,0,0,1
42030,0,1,0,0,1
42031,0,1,0,0,1
42032,0,1,0,0,1
42033,0,1,0,0,1
42034,0,1,0,0,1
42035,0,1,0,0,1
42036,0,1,0,0,1
42037,0,1,0,0,1
42038,0,1,0,0,1
42039,1,0,0,0,1
42040,0,1,0,0,1
42041,0,1,0,0,1
42042,0,1,0,0,1
42043,0,1,0,0,1
42044,0,1,0,0,1
42045,0,1,0,0,1
42046,0,1,0,0,1
42047,0,1,0,0,1
42048,0,1,0,0,1
42049,0,1,0,0,1
42050,0,1,0,0,1
42051,0,1,0,0,1
42052,0,1,0,0,1
42053,0,1,0,0,1
42054,0,1,0,0,1
42055,0,1,0,0,1
42056,0,1,0,0,1
42057,0,1,0,0,1
42058,1,0,0,0,1
42059,0,1,0,0,1
42060,0,1,0,0,1
42061,1,0,0,0,1
42062,0,1,0,0,1
42063,0,1,0,0,1
42064,0,1,0,0,1
42065,0,1,0,0,1
42066,0,1,0,0,1
42067,0,1,0,0,1
42068,0,1,0,0,1
42069,1,0,0,0,1
42070,0,1,0,0,1
42071,0,1,0,0,1
42072,0,1,0,0,1
42073,1,0,0,0,1
42074,0,1,0,0,1
42075,1,0,0,0,1
42076,0,0,0,1,1
42077,0,1,0,0,1
42078,0,1,0,0,1
42079,1,0,0,0,1
42080,0,1,0,0,1
42081,0,1,0,0,1
42082,0,1,0,0,1
42083,0,1,0,0,1
42084,0,1,0,0,1
42085,0,1,0,0,1
42086,0,1,0,0,1
42087,0,1,0,0,1
42088,0,1,0,0,1
42089,0,1,0,0,1
42090,0,1,0,0,1
42091,0,1,0,0,1
42092,0,1,0,0,1
42093,0,1,0,0,1
42094,0,1,0,0,1
42095,0,1,0,0,1
42096,0,1,0,0,1
42097,0,1,0,0,1
42098,1,0,0,0,1
42099,0,1,0,0,1
42100,0,1,0,0,1
42101,0,1,0,0,1
42102,0,1,0,0,1
42103,0,1,0,0,1
42104,0,1,0,0,1
42105,0,1,0,0,1
42106,0,0,1,0,1
42107,0,1,0,0,1
42108,0,1,0,0,1
42109,0,1,0,0,1
42110,0,1,0,0,1
42111,0,1,0,0,1
42112,0,1,0,0,1
42113,0,1,0,0,1
42114,0,1,0,0,1
42115,0,1,0,0,1
42116,1,0,0,0,1
42117,0,1,0,0,1
42118,0,1,0,0,1
42119,0,1,0,0,1
42120,1,0,0,0,1
42121,0,1,0,0,1
42122,0,1,0,0,1
42123,0,1,0,0,1
42124,0,1,0,0,1
42125,0,1,0,0,1
42126,0,1,0,0,1
42127,0,1,0,0,1
42128,0,1,0,0,1
42129,0,1,0,0,1
42130,0,0,0,1,1
42131,0,1,0,0,1
42132,0,1,0,0,1
42133,0,1,0,0,1
42134,0,1,0,0,1
42135,0,1,0,0,1
42136,0,1,0,0,1
42137,0,1,0,0,1
42138,0,1,0,0,1
42139,0,1,0,0,1
42140,0,1,0,0,1
42141,0,1,0,0,1
42142,0,1,0,0,1
42143,0,1,0,0,1
42144,1,0,0,0,1
42145,0,1,0,0,1
42146,0,1,0,0,1
42147,0,1,0,0,1
42148,0,1,0,0,1
42149,0,1,0,0,1
42150,0,0,0,1,1
42151,0,1,0,0,1
42152,0,1,0,0,1
42153,0,1,0,0,1
42154,1,0,0,0,1
42155,0,1,0,0,1
42156,0,1,0,0,1
42157,1,0,0,0,1
42158,0,1,0,0,1
42159,0,1,0,0,1
42160,0,1,0,0,1
42161,0,1,0,0,1
42162,1,0,0,0,1
42163,1,0,0,0,1
42164,0,1,0,0,1
42165,0,1,0,0,1
42166,0,1,0,0,1
42167,0,1,0,0,1
42168,0,1,0,0,1
42169,0,0,0,1,1
42170,0,1,0,0,1
42171,1,0,0,0,1
42172,0,1,0,0,1
42173,0,1,0,0,1
42174,0,1,0,0,1
42175,0,1,0,0,1
42176,0,1,0,0,1
42177,0,1,0,0,1
42178,1,0,0,0,1
42179,1,0,0,0,1
42180,0,1,0,0,1
42181,0,1,0,0,1
42182,1,0,0,0,1
42183,1,0,0,0,1
42184,1,0,0,0,1
42185,0,1,0,0,1
42186,0,1,0,0,1
42187,0,0,0,1,1
42188,0,1,0,0,1
42189,0,1,0,0,1
42190,0,1,0,0,1
42191,0,1,0,0,1
42192,0,1,0,0,1
42193,1,0,0,0,1
42194,0,1,0,0,1
42195,0,1,0,0,1
42196,0,1,0,0,1
42197,0,1,0,0,1
42198,1,0,0,0,1
42199,0,0,0,1,1
42200,0,1,0,0,1
42201,0,1,0,0,1
42202,1,0,0,0,1
42203,0,1,0,0,1
42204,0,1,0,0,1
42205,0,1,0,0,1
42206,0,1,0,0,1
42207,0,1,0,0,1
42208,0,1,0,0,1
42209,0,1,0,0,1
42210,0,1,0,0,1
42211,0,1,0,0,1
42212,0,1,0,0,1
42213,0,1,0,0,1
42214,0,1,0,0,1
42215,0,1,0,0,1
42216,0,0,0,1,1
42217,0,1,0,0,1
42218,1,0,0,0,1
42219,0,1,0,0,1
42220,0,1,0,0,1
42221,1,0,0,0,1
42222,0,1,0,0,1
42223,0,1,0,0,1
42224,0,1,0,0,1
42225,0,1,0,0,1
42226,1,0,0,0,1
42227,0,1,0,0,1
42228,1,0,0,0,1
42229,0,1,0,0,1
42230,0,1,0,0,1
42231,0,1,0,0,1
42232,0,1,0,0,1
42233,0,1,0,0,1
42234,0,1,0,0,1
42235,1,0,0,0,1
42236,0,1,0,0,1
42237,0,0,0,1,1
42238,0,1,0,0,1
42239,0,0,1,0,1
42240,1,0,0,0,1
42241,0,1,0,0,1
42242,0,1,0,0,1
42243,1,0,0,0,1
42244,0,1,0,0,1
42245,0,1,0,0,1
42246,0,0,0,1,1
42247,0,1,0,0,1
42248,0,1,0,0,1
42249,1,0,0,0,1
42250,0,0,0,1,1
42251,0,1,0,0,1
42252,0,1,0,0,1
42253,0,1,0,0,1
42254,0,1,0,0,1
42255,0,1,0,0,1
42256,0,1,0,0,1
42257,0,1,0,0,1
42258,0,1,0,0,1
42259,0,1,0,0,1
42260,0,1,0,0,1
42261,0,1,0,0,1
42262,0,1,0,0,1
42263,0,1,0,0,1
42264,0,1,0,0,1
42265,0,1,0,0,1
42266,0,1,0,0,1
42267,0,1,0,0,1
42268,0,1,0,0,1
42269,0,1,0,0,1
42270,0,1,0,0,1
42271,0,1,0,0,1
42272,0,1,0,0,1
42273,0,1,0,0,1
42274,1,0,0,0,1
42275,0,1,0,0,1
42276,0,1,0,0,1
42277,0,1,0,0,1
42278,0,1,0,0,1
42279,0,1,0,0,1
42280,0,1,0,0,1
42281,0,1,0,0,1
42282,0,1,0,0,1
42283,0,1,0,0,1
42284,0,1,0,0,1
42285,0,1,0,0,1
42286,0,1,0,0,1
42287,0,1,0,0,1
42288,0,1,0,0,1
42289,0,1,0,0,1
42290,0,1,0,0,1
42291,1,0,0,0,1
42292,0,1,0,0,1
42293,0,0,0,1,1
42294,0,1,0,0,1
42295,0,1,0,0,1
42296,0,0,1,0,1
42297,0,1,0,0,1
42298,1,0,0,0,1
42299,0,1,0,0,1
42300,1,0,0,0,1
42301,0,0,1,0,1
42302,0,1,0,0,1
42303,0,1,0,0,1
42304,0,1,0,0,1
42305,0,1,0,0,1
42306,1,0,0,0,1
42307,0,1,0,0,1
42308,1,0,0,0,1
42309,0,1,0,0,1
42310,0,1,0,0,1
42311,0,1,0,0,1
42312,1,0,0,0,1
42313,0,1,0,0,1
42314,0,1,0,0,1
42315,0,1,0,0,1
42316,0,1,0,0,1
42317,0,1,0,0,1
42318,0,1,0,0,1
42319,1,0,0,0,1
42320,0,1,0,0,1
42321,0,1,0,0,1
42322,0,1,0,0,1
42323,0,1,0,0,1
42324,0,1,0,0,1
42325,0,1,0,0,1
42326,0,1,0,0,1
42327,0,1,0,0,1
42328,0,1,0,0,1
42329,0,1,0,0,1
42330,0,1,0,0,1
42331,0,1,0,0,1
42332,1,0,0,0,1
42333,1,0,0,0,1
42334,0,1,0,0,1
42335,0,1,0,0,1
42336,0,1,0,0,1
42337,1,0,0,0,1
42338,0,1,0,0,1
42339,0,1,0,0,1
42340,0,1,0,0,1
42341,1,0,0,0,1
42342,1,0,0,0,1
42343,0,1,0,0,1
42344,1,0,0,0,1
42345,0,0,0,1,1
42346,0,1,0,0,1
42347,0,1,0,0,1
42348,0,1,0,0,1
42349,0,1,0,0,1
42350,1,0,0,0,1
42351,0,1,0,0,1
42352,0,1,0,0,1
42353,0,1,0,0,1
42354,1,0,0,0,1
42355,0,1,0,0,1
42356,0,1,0,0,1
42357,0,1,0,0,1
42358,1,0,0,0,1
42359,0,1,0,0,1
42360,0,1,0,0,1
42361,0,1,0,0,1
42362,0,1,0,0,1
42363,0,1,0,0,1
42364,0,1,0,0,1
42365,1,0,0,0,1
42366,0,0,0,1,1
42367,1,0,0,0,1
42368,0,1,0,0,1
42369,0,1,0,0,1
42370,0,1,0,0,1
42371,0,1,0,0,1
42372,1,0,0,0,1
42373,0,1,0,0,1
42374,0,1,0,0,1
42375,0,1,0,0,1
42376,0,1,0,0,1
42377,0,1,0,0,1
42378,0,1,0,0,1
42379,0,1,0,0,1
42380,1,0,0,0,1
42381,0,1,0,0,1
42382,1,0,0,0,1
42383,0,1,0,0,1
42384,0,1,0,0,1
42385,0,1,0,0,1
42386,0,1,0,0,1
42387,0,1,0,0,1
42388,0,1,0,0,1
42389,0,1,0,0,1
42390,0,1,0,0,1
42391,0,1,0,0,1
42392,1,0,0,0,1
42393,0,1,0,0,1
42394,0,1,0,0,1
42395,0,0,0,1,1
42396,0,1,0,0,1
42397,0,1,0,0,1
42398,0,1,0,0,1
42399,0,1,0,0,1
42400,1,0,0,0,1
42401,0,1,0,0,1
42402,0,1,0,0,1
42403,0,1,0,0,1
42404,0,1,0,0,1
42405,1,0,0,0,1
42406,0,1,0,0,1
42407,0,1,0,0,1
42408,0,0,0,1,1
42409,0,1,0,0,1
42410,0,1,0,0,1
42411,0,1,0,0,1
42412,0,1,0,0,1
42413,0,1,0,0,1
42414,0,1,0,0,1
42415,0,1,0,0,1
42416,0,1,0,0,1
42417,0,1,0,0,1
42418,0,1,0,0,1
42419,0,1,0,0,1
42420,1,0,0,0,1
42421,0,1,0,0,1
42422,0,1,0,0,1
42423,0,1,0,0,1
42424,0,1,0,0,1
42425,0,1,0,0,1
42426,0,1,0,0,1
42427,0,1,0,0,1
42428,0,1,0,0,1
42429,0,1,0,0,1
42430,1,0,0,0,1
42431,0,0,0,1,1
42432,0,1,0,0,1
42433,0,1,0,0,1
42434,0,1,0,0,1
42435,0,1,0,0,1
42436,0,1,0,0,1
42437,0,1,0,0,1
42438,0,1,0,0,1
42439,0,1,0,0,1
42440,1,0,0,0,1
42441,0,1,0,0,1
42442,0,1,0,0,1
42443,1,0,0,0,1
42444,0,1,0,0,1
42445,0,1,0,0,1
42446,0,1,0,0,1
42447,1,0,0,0,1
42448,0,0,1,0,1
42449,0,1,0,0,1
42450,0,1,0,0,1
42451,1,0,0,0,1
42452,1,0,0,0,1
42453,0,1,0,0,1
42454,1,0,0,0,1
42455,0,1,0,0,1
42456,0,1,0,0,1
42457,0,1,0,0,1
42458,1,0,0,0,1
42459,0,1,0,0,1
42460,0,1,0,0,1
42461,0,1,0,0,1
42462,0,1,0,0,1
42463,0,1,0,0,1
42464,0,1,0,0,1
42465,0,1,0,0,1
42466,0,1,0,0,1
42467,0,1,0,0,1
42468,0,1,0,0,1
42469,1,0,0,0,1
42470,0,1,0,0,1
42471,0,1,0,0,1
42472,0,1,0,0,1
42473,1,0,0,0,1
42474,0,1,0,0,1
42475,0,1,0,0,1
42476,0,1,0,0,1
42477,0,1,0,0,1
42478,0,0,1,0,1
42479,0,1,0,0,1
42480,0,1,0,0,1
42481,0,1,0,0,1
42482,0,1,0,0,1
42483,0,1,0,0,1
42484,0,1,0,0,1
42485,1,0,0,0,1
42486,1,0,0,0,1
42487,0,0,0,1,1
42488,0,1,0,0,1
42489,0,1,0,0,1
42490,0,1,0,0,1
42491,0,1,0,0,1
42492,0,1,0,0,1
42493,0,1,0,0,1
42494,0,1,0,0,1
42495,0,1,0,0,1
42496,0,1,0,0,1
42497,0,1,0,0,1
42498,0,1,0,0,1
42499,1,0,0,0,1
42500,0,1,0,0,1
42501,0,1,0,0,1
42502,0,1,0,0,1
42503,0,1,0,0,1
42504,0,1,0,0,1
42505,0,1,0,0,1
42506,0,0,0,1,1
42507,0,1,0,0,1
42508,0,1,0,0,1
42509,0,1,0,0,1
42510,0,1,0,0,1
42511,0,1,0,0,1
42512,0,1,0,0,1
42513,0,1,0,0,1
42514,0,1,0,0,1
42515,0,1,0,0,1
42516,0,1,0,0,1
42517,0,1,0,0,1
42518,0,1,0,0,1
42519,0,1,0,0,1
42520,0,1,0,0,1
42521,0,1,0,0,1
42522,0,0,0,1,1
42523,0,1,0,0,1
42524,1,0,0,0,1
42525,0,1,0,0,1
42526,0,1,0,0,1
42527,1,0,0,0,1
42528,0,1,0,0,1
42529,0,1,0,0,1
42530,0,1,0,0,1
42531,0,1,0,0,1
42532,0,1,0,0,1
42533,1,0,0,0,1
42534,1,0,0,0,1
42535,0,1,0,0,1
42536,0,1,0,0,1
42537,0,1,0,0,1
42538,0,1,0,0,1
42539,0,1,0,0,1
42540,1,0,0,0,1
42541,0,1,0,0,1
42542,1,0,0,0,1
42543,1,0,0,0,1
42544,1,0,0,0,1
42545,0,1,0,0,1
42546,0,1,0,0,1
42547,0,1,0,0,1
42548,0,0,1,0,1
42549,1,0,0,0,1
42550,0,1,0,0,1
42551,0,1,0,0,1
42552,0,1,0,0,1
42553,0,1,0,0,1
42554,0,1,0,0,1
42555,1,0,0,0,1
42556,0,1,0,0,1
42557,0,1,0,0,1
42558,0,1,0,0,1
42559,0,1,0,0,1
42560,1,0,0,0,1
42561,1,0,0,0,1
42562,0,1,0,0,1
42563,0,1,0,0,1
42564,0,1,0,0,1
42565,0,1,0,0,1
42566,0,1,0,0,1
42567,0,1,0,0,1
42568,0,1,0,0,1
42569,0,0,0,1,1
42570,0,1,0,0,1
42571,0,1,0,0,1
42572,0,1,0,0,1
42573,0,1,0,0,1
42574,0,1,0,0,1
42575,0,1,0,0,1
42576,0,1,0,0,1
42577,0,1,0,0,1
42578,1,0,0,0,1
42579,0,1,0,0,1
42580,0,1,0,0,1
42581,0,1,0,0,1
42582,0,1,0,0,1
42583,0,1,0,0,1
42584,0,0,1,0,1
42585,0,1,0,0,1
42586,0,1,0,0,1
42587,1,0,0,0,1
42588,0,1,0,0,1
42589,0,1,0,0,1
42590,1,0,0,0,1
42591,0,1,0,0,1
42592,0,1,0,0,1
42593,1,0,0,0,1
42594,0,1,0,0,1
42595,0,1,0,0,1
42596,0,1,0,0,1
42597,0,1,0,0,1
42598,0,1,0,0,1
42599,0,1,0,0,1
42600,0,1,0,0,1
42601,0,1,0,0,1
42602,1,0,0,0,1
42603,0,1,0,0,1
42604,0,1,0,0,1
42605,0,1,0,0,1
42606,0,1,0,0,1
42607,0,0,1,0,1
42608,0,1,0,0,1
42609,0,1,0,0,1
42610,0,1,0,0,1
42611,1,0,0,0,1
42612,0,0,0,1,1
42613,0,1,0,0,1
42614,0,1,0,0,1
42615,0,1,0,0,1
42616,0,1,0,0,1
42617,1,0,0,0,1
42618,0,1,0,0,1
42619,0,1,0,0,1
42620,0,1,0,0,1
42621,1,0,0,0,1
42622,0,1,0,0,1
42623,0,1,0,0,1
42624,0,1,0,0,1
42625,0,1,0,0,1
42626,0,1,0,0,1
42627,0,1,0,0,1
42628,0,1,0,0,1
42629,1,0,0,0,1
42630,0,1,0,0,1
42631,0,1,0,0,1
42632,0,1,0,0,1
42633,0,1,0,0,1
42634,0,1,0,0,1
42635,0,1,0,0,1
42636,0,1,0,0,1
42637,0,1,0,0,1
42638,0,1,0,0,1
42639,0,1,0,0,1
42640,1,0,0,0,1
42641,0,1,0,0,1
42642,0,1,0,0,1
42643,0,1,0,0,1
42644,0,1,0,0,1
42645,0,1,0,0,1
42646,0,1,0,0,1
42647,0,1,0,0,1
42648,0,1,0,0,1
42649,0,1,0,0,1
42650,0,1,0,0,1
42651,0,1,0,0,1
42652,1,0,0,0,1
42653,0,1,0,0,1
42654,0,1,0,0,1
42655,0,1,0,0,1
42656,0,1,0,0,1
42657,0,1,0,0,1
42658,0,1,0,0,1
42659,0,0,0,1,1
42660,1,0,0,0,1
42661,0,1,0,0,1
42662,1,0,0,0,1
42663,0,1,0,0,1
42664,0,1,0,0,1
42665,0,1,0,0,1
42666,0,1,0,0,1
42667,0,1,0,0,1
42668,1,0,0,0,1
42669,0,1,0,0,1
42670,0,1,0,0,1
42671,0,1,0,0,1
42672,0,0,0,1,1
42673,0,1,0,0,1
42674,0,1,0,0,1
42675,0,1,0,0,1
42676,0,1,0,0,1
42677,0,1,0,0,1
42678,1,0,0,0,1
42679,0,1,0,0,1
42680,0,1,0,0,1
42681,0,1,0,0,1
42682,0,1,0,0,1
42683,0,1,0,0,1
42684,0,1,0,0,1
42685,0,1,0,0,1
42686,0,1,0,0,1
42687,0,1,0,0,1
42688,0,1,0,0,1
42689,1,0,0,0,1
42690,0,1,0,0,1
42691,0,1,0,0,1
42692,0,1,0,0,1
42693,0,1,0,0,1
42694,0,1,0,0,1
42695,0,1,0,0,1
42696,0,1,0,0,1
42697,0,1,0,0,1
42698,0,1,0,0,1
42699,0,1,0,0,1
42700,0,1,0,0,1
42701,0,1,0,0,1
42702,0,1,0,0,1
42703,0,1,0,0,1
42704,0,0,1,0,1
42705,1,0,0,0,1
42706,0,1,0,0,1
42707,0,1,0,0,1
42708,1,0,0,0,1
42709,0,1,0,0,1
42710,0,1,0,0,1
42711,0,1,0,0,1
42712,0,1,0,0,1
42713,1,0,0,0,1
42714,0,1,0,0,1
42715,0,1,0,0,1
42716,0,1,0,0,1
42717,0,1,0,0,1
42718,0,1,0,0,1
42719,0,0,0,1,1
42720,0,1,0,0,1
42721,0,1,0,0,1
42722,0,1,0,0,1
42723,0,1,0,0,1
42724,0,1,0,0,1
42725,0,1,0,0,1
42726,0,1,0,0,1
42727,0,1,0,0,1
42728,0,1,0,0,1
42729,0,1,0,0,1
42730,0,1,0,0,1
42731,0,1,0,0,1
42732,0,1,0,0,1
42733,0,1,0,0,1
42734,0,1,0,0,1
42735,0,1,0,0,1
42736,0,1,0,0,1
42737,0,1,0,0,1
42738,0,1,0,0,1
42739,0,1,0,0,1
42740,0,1,0,0,1
42741,0,1,0,0,1
42742,0,1,0,0,1
42743,0,1,0,0,1
42744,1,0,0,0,1
42745,1,0,0,0,1
42746,0,1,0,0,1
42747,0,0,0,1,1
42748,0,1,0,0,1
42749,0,1,0,0,1
42750,0,1,0,0,1
42751,0,1,0,0,1
42752,0,1,0,0,1
42753,0,1,0,0,1
42754,0,1,0,0,1
42755,0,1,0,0,1
42756,0,1,0,0,1
42757,0,1,0,0,1
42758,0,1,0,0,1
42759,0,0,0,1,1
42760,0,1,0,0,1
42761,0,1,0,0,1
42762,0,1,0,0,1
42763,0,1,0,0,1
42764,0,1,0,0,1
42765,0,1,0,0,1
42766,0,1,0,0,1
42767,0,1,0,0,1
42768,0,1,0,0,1
42769,0,0,1,0,1
42770,0,1,0,0,1
42771,0,1,0,0,1
42772,0,1,0,0,1
42773,1,0,0,0,1
42774,0,0,1,0,1
42775,0,1,0,0,1
42776,0,0,1,0,1
42777,0,1,0,0,1
42778,0,1,0,0,1
42779,0,1,0,0,1
42780,0,1,0,0,1
42781,0,1,0,0,1
42782,0,1,0,0,1
42783,0,1,0,0,1
42784,0,1,0,0,1
42785,0,1,0,0,1
42786,0,1,0,0,1
42787,0,1,0,0,1
42788,0,1,0,0,1
42789,0,1,0,0,1
42790,1,0,0,0,1
42791,0,1,0,0,1
42792,0,1,0,0,1
42793,0,1,0,0,1
42794,0,1,0,0,1
42795,0,1,0,0,1
42796,1,0,0,0,1
42797,0,1,0,0,1
42798,0,1,0,0,1
42799,0,0,1,0,1
42800,1,0,0,0,1
42801,0,1,0,0,1
42802,0,1,0,0,1
42803,0,0,0,1,1
42804,0,1,0,0,1
42805,0,1,0,0,1
42806,0,1,0,0,1
42807,0,1,0,0,1
42808,0,1,0,0,1
42809,0,1,0,0,1
42810,1,0,0,0,1
42811,0,1,0,0,1
42812,0,1,0,0,1
42813,0,1,0,0,1
42814,0,1,0,0,1
42815,0,1,0,0,1
42816,0,1,0,0,1
42817,0,1,0,0,1
42818,0,1,0,0,1
42819,0,1,0,0,1
42820,0,1,0,0,1
42821,1,0,0,0,1
42822,1,0,0,0,1
42823,0,1,0,0,1
42824,0,1,0,0,1
42825,0,1,0,0,1
42826,0,1,0,0,1
42827,0,1,0,0,1
42828,0,1,0,0,1
42829,0,1,0,0,1
42830,0,0,1,0,1
42831,0,1,0,0,1
42832,0,1,0,0,1
42833,0,1,0,0,1
42834,0,1,0,0,1
42835,0,1,0,0,1
42836,0,1,0,0,1
42837,0,1,0,0,1
42838,0,1,0,0,1
42839,1,0,0,0,1
42840,0,1,0,0,1
42841,0,1,0,0,1
42842,0,1,0,0,1
42843,0,1,0,0,1
42844,0,1,0,0,1
42845,0,1,0,0,1
42846,0,1,0,0,1
42847,0,1,0,0,1
42848,0,1,0,0,1
42849,0,1,0,0,1
42850,0,1,0,0,1
42851,0,1,0,0,1
42852,0,1,0,0,1
42853,0,1,0,0,1
42854,0,1,0,0,1
42855,0,1,0,0,1
42856,0,1,0,0,1
42857,0,1,0,0,1
42858,0,1,0,0,1
42859,0,1,0,0,1
42860,0,1,0,0,1
42861,0,1,0,0,1
42862,0,1,0,0,1
42863,0,1,0,0,1
42864,0,1,0,0,1
42865,0,1,0,0,1
42866,0,1,0,0,1
42867,0,1,0,0,1
42868,0,1,0,0,1
42869,1,0,0,0,1
42870,0,1,0,0,1
42871,0,1,0,0,1
42872,0,1,0,0,1
42873,0,1,0,0,1
42874,0,1,0,0,1
42875,0,1,0,0,1
42876,1,0,0,0,1
42877,0,1,0,0,1
42878,0,0,0,1,1
42879,1,0,0,0,1
42880,0,1,0,0,1
42881,0,1,0,0,1
42882,0,1,0,0,1
42883,0,1,0,0,1
42884,0,1,0,0,1
42885,0,1,0,0,1
42886,0,1,0,0,1
42887,0,1,0,0,1
42888,1,0,0,0,1
42889,0,1,0,0,1
42890,0,1,0,0,1
42891,0,1,0,0,1
42892,1,0,0,0,1
42893,0,0,0,1,1
42894,1,0,0,0,1
42895,0,1,0,0,1
42896,0,1,0,0,1
42897,0,1,0,0,1
42898,0,1,0,0,1
42899,0,1,0,0,1
42900,0,1,0,0,1
42901,0,1,0,0,1
42902,0,1,0,0,1
42903,0,1,0,0,1
42904,0,1,0,0,1
42905,0,1,0,0,1
42906,0,1,0,0,1
42907,0,1,0,0,1
42908,0,1,0,0,1
42909,0,1,0,0,1
42910,1,0,0,0,1
42911,0,1,0,0,1
42912,0,1,0,0,1
42913,0,1,0,0,1
42914,0,1,0,0,1
42915,0,1,0,0,1
42916,1,0,0,0,1
42917,0,1,0,0,1
42918,0,1,0,0,1
42919,0,1,0,0,1
42920,0,1,0,0,1
42921,0,1,0,0,1
42922,0,1,0,0,1
42923,1,0,0,0,1
42924,0,1,0,0,1
42925,0,1,0,0,1
42926,1,0,0,0,1
42927,0,1,0,0,1
42928,0,1,0,0,1
42929,0,1,0,0,1
42930,0,1,0,0,1
42931,0,1,0,0,1
42932,1,0,0,0,1
42933,0,1,0,0,1
42934,0,1,0,0,1
42935,0,1,0,0,1
42936,0,1,0,0,1
42937,0,1,0,0,1
42938,0,1,0,0,1
42939,0,1,0,0,1
42940,0,1,0,0,1
42941,1,0,0,0,1
42942,1,0,0,0,1
42943,0,1,0,0,1
42944,0,1,0,0,1
42945,0,1,0,0,1
42946,0,1,0,0,1
42947,1,0,0,0,1
42948,0,0,0,1,1
42949,0,1,0,0,1
42950,0,1,0,0,1
42951,0,0,0,1,1
42952,0,1,0,0,1
42953,1,0,0,0,1
42954,0,1,0,0,1
42955,0,1,0,0,1
42956,0,1,0,0,1
42957,0,1,0,0,1
42958,0,1,0,0,1
42959,0,1,0,0,1
42960,0,1,0,0,1
42961,0,1,0,0,1
42962,1,0,0,0,1
42963,0,1,0,0,1
42964,0,1,0,0,1
42965,0,1,0,0,1
42966,1,0,0,0,1
42967,0,1,0,0,1
42968,0,1,0,0,1
42969,0,1,0,0,1
42970,0,1,0,0,1
42971,0,1,0,0,1
42972,0,1,0,0,1
42973,0,1,0,0,1
42974,1,0,0,0,1
42975,0,1,0,0,1
42976,0,1,0,0,1
42977,0,0,0,1,1
42978,0,1,0,0,1
42979,0,1,0,0,1
42980,0,1,0,0,1
42981,0,1,0,0,1
42982,0,1,0,0,1
42983,0,1,0,0,1
42984,0,1,0,0,1
42985,0,1,0,0,1
42986,0,1,0,0,1
42987,0,1,0,0,1
42988,0,1,0,0,1
42989,0,1,0,0,1
42990,0,0,0,1,1
42991,0,1,0,0,1
42992,0,1,0,0,1
42993,0,1,0,0,1
42994,0,1,0,0,1
42995,0,0,0,1,1
42996,0,1,0,0,1
42997,0,1,0,0,1
42998,0,1,0,0,1
42999,0,1,0,0,1
43000,0,1,0,0,1
43001,0,1,0,0,1
43002,0,1,0,0,1
43003,1,0,0,0,1
43004,0,1,0,0,1
43005,0,1,0,0,1
43006,0,1,0,0,1
43007,0,1,0,0,1
43008,0,1,0,0,1
43009,0,0,0,1,1
43010,0,1,0,0,1
43011,0,1,0,0,1
43012,0,1,0,0,1
43013,0,1,0,0,1
43014,0,1,0,0,1
43015,0,1,0,0,1
43016,0,1,0,0,1
43017,0,1,0,0,1
43018,1,0,0,0,1
43019,0,0,0,1,1
43020,0,1,0,0,1
43021,0,1,0,0,1
43022,0,1,0,0,1
43023,0,1,0,0,1
43024,0,1,0,0,1
43025,0,1,0,0,1
43026,0,1,0,0,1
43027,0,1,0,0,1
43028,0,1,0,0,1
43029,0,1,0,0,1
43030,0,1,0,0,1
43031,1,0,0,0,1
43032,0,1,0,0,1
43033,0,1,0,0,1
43034,0,1,0,0,1
43035,0,1,0,0,1
43036,1,0,0,0,1
43037,0,1,0,0,1
43038,0,1,0,0,1
43039,0,1,0,0,1
43040,0,1,0,0,1
43041,1,0,0,0,1
43042,0,1,0,0,1
43043,0,1,0,0,1
43044,1,0,0,0,1
43045,0,1,0,0,1
43046,0,1,0,0,1
43047,1,0,0,0,1
43048,0,1,0,0,1
43049,0,1,0,0,1
43050,0,1,0,0,1
43051,0,0,0,1,1
43052,1,0,0,0,1
43053,1,0,0,0,1
43054,0,1,0,0,1
43055,0,1,0,0,1
43056,0,0,1,0,1
43057,0,1,0,0,1
43058,0,1,0,0,1
43059,0,1,0,0,1
43060,0,1,0,0,1
43061,1,0,0,0,1
43062,1,0,0,0,1
43063,0,1,0,0,1
43064,0,1,0,0,1
43065,1,0,0,0,1
43066,0,1,0,0,1
43067,0,1,0,0,1
43068,0,1,0,0,1
43069,0,1,0,0,1
43070,1,0,0,0,1
43071,0,0,1,0,1
43072,0,1,0,0,1
43073,1,0,0,0,1
43074,0,1,0,0,1
43075,1,0,0,0,1
43076,1,0,0,0,1
43077,0,1,0,0,1
43078,0,1,0,0,1
43079,0,0,1,0,1
43080,1,0,0,0,1
43081,0,1,0,0,1
43082,0,1,0,0,1
43083,0,1,0,0,1
43084,0,1,0,0,1
43085,0,1,0,0,1
43086,0,1,0,0,1
43087,0,1,0,0,1
43088,0,1,0,0,1
43089,0,1,0,0,1
43090,0,1,0,0,1
43091,0,1,0,0,1
43092,0,1,0,0,1
43093,0,1,0,0,1
43094,1,0,0,0,1
43095,0,1,0,0,1
43096,0,1,0,0,1
43097,0,1,0,0,1
43098,0,1,0,0,1
43099,0,1,0,0,1
43100,0,1,0,0,1
43101,0,1,0,0,1
43102,0,1,0,0,1
43103,0,1,0,0,1
43104,0,1,0,0,1
43105,0,1,0,0,1
43106,0,1,0,0,1
43107,0,1,0,0,1
43108,0,1,0,0,1
43109,0,1,0,0,1
43110,0,1,0,0,1
43111,0,1,0,0,1
43112,0,1,0,0,1
43113,0,1,0,0,1
43114,0,1,0,0,1
43115,1,0,0,0,1
43116,0,1,0,0,1
43117,0,1,0,0,1
43118,0,1,0,0,1
43119,0,1,0,0,1
43120,0,1,0,0,1
43121,0,1,0,0,1
43122,0,1,0,0,1
43123,0,1,0,0,1
43124,0,1,0,0,1
43125,0,1,0,0,1
43126,0,1,0,0,1
43127,0,0,0,1,1
43128,0,1,0,0,1
43129,0,0,0,1,1
43130,0,1,0,0,1
43131,0,1,0,0,1
43132,0,1,0,0,1
43133,0,1,0,0,1
43134,0,1,0,0,1
43135,1,0,0,0,1
43136,0,1,0,0,1
43137,0,1,0,0,1
43138,1,0,0,0,1
43139,1,0,0,0,1
43140,0,1,0,0,1
43141,0,1,0,0,1
43142,0,1,0,0,1
43143,0,1,0,0,1
43144,0,1,0,0,1
43145,0,1,0,0,1
43146,0,1,0,0,1
43147,0,1,0,0,1
43148,0,1,0,0,1
43149,0,1,0,0,1
43150,1,0,0,0,1
43151,0,1,0,0,1
43152,0,1,0,0,1
43153,0,1,0,0,1
43154,0,1,0,0,1
43155,0,1,0,0,1
43156,0,1,0,0,1
43157,0,1,0,0,1
43158,0,1,0,0,1
43159,1,0,0,0,1
43160,0,1,0,0,1
43161,0,1,0,0,1
43162,0,1,0,0,1
43163,0,1,0,0,1
43164,0,0,1,0,1
43165,0,1,0,0,1
43166,0,1,0,0,1
43167,0,1,0,0,1
43168,0,1,0,0,1
43169,0,1,0,0,1
43170,1,0,0,0,1
43171,0,1,0,0,1
43172,0,1,0,0,1
43173,0,1,0,0,1
43174,0,1,0,0,1
43175,0,1,0,0,1
43176,0,1,0,0,1
43177,0,1,0,0,1
43178,1,0,0,0,1
43179,0,1,0,0,1
43180,0,1,0,0,1
43181,0,1,0,0,1
43182,0,1,0,0,1
43183,0,1,0,0,1
43184,0,1,0,0,1
43185,0,1,0,0,1
43186,0,1,0,0,1
43187,0,1,0,0,1
43188,1,0,0,0,1
43189,0,1,0,0,1
43190,0,1,0,0,1
43191,0,1,0,0,1
43192,1,0,0,0,1
43193,0,1,0,0,1
43194,0,1,0,0,1
43195,0,1,0,0,1
43196,0,1,0,0,1
43197,0,1,0,0,1
43198,0,0,0,1,1
43199,0,1,0,0,1
43200,0,1,0,0,1
43201,0,1,0,0,1
43202,0,1,0,0,1
43203,0,1,0,0,1
43204,0,1,0,0,1
43205,0,1,0,0,1
43206,1,0,0,0,1
43207,0,1,0,0,1
43208,0,1,0,0,1
43209,0,1,0,0,1
43210,0,1,0,0,1
43211,0,0,0,1,1
43212,0,1,0,0,1
43213,0,1,0,0,1
43214,0,1,0,0,1
43215,1,0,0,0,1
43216,0,1,0,0,1
43217,0,1,0,0,1
43218,0,1,0,0,1
43219,0,1,0,0,1
43220,0,1,0,0,1
43221,0,1,0,0,1
43222,0,1,0,0,1
43223,0,1,0,0,1
43224,0,1,0,0,1
43225,0,0,0,1,1
43226,0,1,0,0,1
43227,0,1,0,0,1
43228,0,1,0,0,1
43229,1,0,0,0,1
43230,0,1,0,0,1
43231,0,1,0,0,1
43232,0,1,0,0,1
43233,0,1,0,0,1
43234,0,0,0,1,1
43235,0,1,0,0,1
43236,0,1,0,0,1
43237,0,1,0,0,1
43238,0,1,0,0,1
43239,0,1,0,0,1
43240,0,1,0,0,1
43241,0,1,0,0,1
43242,0,1,0,0,1
43243,1,0,0,0,1
43244,0,1,0,0,1
43245,0,1,0,0,1
43246,0,1,0,0,1
43247,0,1,0,0,1
43248,0,1,0,0,1
43249,0,1,0,0,1
43250,0,1,0,0,1
43251,0,1,0,0,1
43252,0,0,0,1,1
43253,0,1,0,0,1
43254,0,1,0,0,1
43255,0,1,0,0,1
43256,0,1,0,0,1
43257,0,1,0,0,1
43258,0,1,0,0,1
43259,0,1,0,0,1
43260,0,1,0,0,1
43261,0,1,0,0,1
43262,0,1,0,0,1
43263,0,1,0,0,1
43264,0,1,0,0,1
43265,1,0,0,0,1
43266,0,1,0,0,1
43267,0,0,0,1,1
43268,0,1,0,0,1
43269,1,0,0,0,1
43270,0,0,0,1,1
43271,0,1,0,0,1
43272,0,1,0,0,1
43273,0,0,0,1,1
43274,0,1,0,0,1
43275,0,0,1,0,1
43276,0,1,0,0,1
43277,1,0,0,0,1
43278,0,1,0,0,1
43279,0,1,0,0,1
43280,1,0,0,0,1
43281,0,1,0,0,1
43282,1,0,0,0,1
43283,1,0,0,0,1
43284,0,1,0,0,1
43285,0,1,0,0,1
43286,0,1,0,0,1
43287,0,1,0,0,1
43288,0,1,0,0,1
43289,0,1,0,0,1
43290,0,1,0,0,1
43291,1,0,0,0,1
43292,0,1,0,0,1
43293,0,1,0,0,1
43294,0,1,0,0,1
43295,0,1,0,0,1
43296,0,1,0,0,1
43297,0,1,0,0,1
43298,0,1,0,0,1
43299,1,0,0,0,1
43300,0,1,0,0,1
43301,0,1,0,0,1
43302,0,1,0,0,1
43303,0,1,0,0,1
43304,0,1,0,0,1
43305,0,1,0,0,1
43306,0,0,0,1,1
43307,0,1,0,0,1
43308,0,0,0,1,1
43309,0,1,0,0,1
43310,0,1,0,0,1
43311,1,0,0,0,1
43312,1,0,0,0,1
43313,0,1,0,0,1
43314,0,1,0,0,1
43315,0,1,0,0,1
43316,0,1,0,0,1
43317,0,1,0,0,1
43318,0,1,0,0,1
43319,0,1,0,0,1
43320,0,0,0,1,1
43321,0,1,0,0,1
43322,1,0,0,0,1
43323,0,1,0,0,1
43324,0,1,0,0,1
43325,0,1,0,0,1
43326,0,1,0,0,1
43327,0,1,0,0,1
43328,0,1,0,0,1
43329,0,1,0,0,1
43330,0,1,0,0,1
43331,0,0,1,0,1
43332,0,1,0,0,1
43333,0,1,0,0,1
43334,0,1,0,0,1
43335,0,1,0,0,1
43336,0,1,0,0,1
43337,0,1,0,0,1
43338,0,1,0,0,1
43339,1,0,0,0,1
43340,0,1,0,0,1
43341,0,1,0,0,1
43342,0,1,0,0,1
43343,0,1,0,0,1
43344,0,1,0,0,1
43345,0,1,0,0,1
43346,0,1,0,0,1
43347,0,1,0,0,1
43348,0,1,0,0,1
43349,0,1,0,0,1
43350,0,1,0,0,1
43351,0,1,0,0,1
43352,0,1,0,0,1
43353,0,1,0,0,1
43354,0,1,0,0,1
43355,1,0,0,0,1
43356,1,0,0,0,1
43357,0,1,0,0,1
43358,0,1,0,0,1
43359,0,1,0,0,1
43360,0,1,0,0,1
43361,1,0,0,0,1
43362,0,1,0,0,1
43363,0,1,0,0,1
43364,1,0,0,0,1
43365,0,0,0,1,1
43366,1,0,0,0,1
43367,1,0,0,0,1
43368,0,1,0,0,1
43369,0,1,0,0,1
43370,0,1,0,0,1
43371,1,0,0,0,1
43372,0,1,0,0,1
43373,0,1,0,0,1
43374,0,1,0,0,1
43375,0,1,0,0,1
43376,0,1,0,0,1
43377,0,1,0,0,1
43378,1,0,0,0,1
43379,0,1,0,0,1
43380,0,0,1,0,1
43381,0,1,0,0,1
43382,0,1,0,0,1
43383,0,1,0,0,1
43384,1,0,0,0,1
43385,0,1,0,0,1
43386,0,1,0,0,1
43387,0,1,0,0,1
43388,0,0,1,0,1
43389,0,1,0,0,1
43390,0,1,0,0,1
43391,0,1,0,0,1
43392,0,1,0,0,1
43393,0,1,0,0,1
43394,0,1,0,0,1
43395,0,0,1,0,1
43396,0,1,0,0,1
43397,0,1,0,0,1
43398,0,1,0,0,1
43399,0,1,0,0,1
43400,0,1,0,0,1
43401,0,1,0,0,1
43402,0,1,0,0,1
43403,0,1,0,0,1
43404,0,1,0,0,1
43405,0,1,0,0,1
43406,1,0,0,0,1
43407,0,1,0,0,1
43408,0,1,0,0,1
43409,0,1,0,0,1
43410,0,1,0,0,1
43411,0,1,0,0,1
43412,0,1,0,0,1
43413,0,1,0,0,1
43414,1,0,0,0,1
43415,0,1,0,0,1
43416,0,1,0,0,1
43417,0,1,0,0,1
43418,0,1,0,0,1
43419,0,1,0,0,1
43420,0,1,0,0,1
43421,0,1,0,0,1
43422,0,1,0,0,1
43423,1,0,0,0,1
43424,0,1,0,0,1
43425,1,0,0,0,1
43426,1,0,0,0,1
43427,0,1,0,0,1
43428,0,1,0,0,1
43429,0,1,0,0,1
43430,0,1,0,0,1
43431,0,1,0,0,1
43432,0,1,0,0,1
43433,0,1,0,0,1
43434,0,0,0,1,1
43435,0,1,0,0,1
43436,0,1,0,0,1
43437,0,1,0,0,1
43438,0,1,0,0,1
43439,0,1,0,0,1
43440,0,0,0,1,1
43441,0,1,0,0,1
43442,1,0,0,0,1
43443,0,1,0,0,1
43444,0,1,0,0,1
43445,1,0,0,0,1
43446,0,1,0,0,1
43447,0,1,0,0,1
43448,0,1,0,0,1
43449,0,1,0,0,1
43450,0,1,0,0,1
43451,0,1,0,0,1
43452,0,1,0,0,1
43453,1,0,0,0,1
43454,0,1,0,0,1
43455,0,1,0,0,1
43456,0,1,0,0,1
43457,0,1,0,0,1
43458,0,0,0,1,1
43459,0,1,0,0,1
43460,0,1,0,0,1
43461,0,1,0,0,1
43462,0,1,0,0,1
43463,0,0,0,1,1
43464,1,0,0,0,1
43465,0,1,0,0,1
43466,0,1,0,0,1
43467,0,1,0,0,1
43468,0,0,1,0,1
43469,0,1,0,0,1
43470,0,0,0,1,1
43471,0,0,1,0,1
43472,0,1,0,0,1
43473,0,0,0,1,1
43474,0,1,0,0,1
43475,0,1,0,0,1
43476,0,1,0,0,1
43477,0,1,0,0,1
43478,0,1,0,0,1
43479,1,0,0,0,1
43480,0,1,0,0,1
43481,0,1,0,0,1
43482,0,1,0,0,1
43483,0,1,0,0,1
43484,0,1,0,0,1
43485,0,1,0,0,1
43486,0,1,0,0,1
43487,0,1,0,0,1
43488,0,1,0,0,1
43489,0,1,0,0,1
43490,0,1,0,0,1
43491,0,1,0,0,1
43492,0,1,0,0,1
43493,0,1,0,0,1
43494,0,1,0,0,1
43495,0,1,0,0,1
43496,0,1,0,0,1
43497,0,1,0,0,1
43498,0,1,0,0,1
43499,0,1,0,0,1
43500,0,1,0,0,1
43501,0,1,0,0,1
43502,0,1,0,0,1
43503,0,1,0,0,1
43504,0,1,0,0,1
43505,0,1,0,0,1
43506,0,1,0,0,1
43507,0,1,0,0,1
43508,1,0,0,0,1
43509,0,1,0,0,1
43510,0,1,0,0,1
43511,0,1,0,0,1
43512,0,1,0,0,1
43513,0,1,0,0,1
43514,0,1,0,0,1
43515,0,1,0,0,1
43516,0,1,0,0,1
43517,0,1,0,0,1
43518,1,0,0,0,1
43519,0,1,0,0,1
43520,1,0,0,0,1
43521,0,1,0,0,1
43522,0,1,0,0,1
43523,0,1,0,0,1
43524,1,0,0,0,1
43525,0,1,0,0,1
43526,0,1,0,0,1
43527,0,1,0,0,1
43528,0,1,0,0,1
43529,0,1,0,0,1
43530,0,1,0,0,1
43531,0,1,0,0,1
43532,0,1,0,0,1
43533,0,1,0,0,1
43534,1,0,0,0,1
43535,0,1,0,0,1
43536,0,1,0,0,1
43537,0,1,0,0,1
43538,0,1,0,0,1
43539,0,1,0,0,1
43540,1,0,0,0,1
43541,1,0,0,0,1
43542,0,1,0,0,1
43543,1,0,0,0,1
43544,0,0,0,1,1
43545,0,0,0,1,1
43546,0,1,0,0,1
43547,0,1,0,0,1
43548,1,0,0,0,1
43549,0,1,0,0,1
43550,0,1,0,0,1
43551,0,1,0,0,1
43552,0,1,0,0,1
43553,0,1,0,0,1
43554,0,1,0,0,1
43555,0,1,0,0,1
43556,0,1,0,0,1
43557,0,1,0,0,1
43558,0,1,0,0,1
43559,0,1,0,0,1
43560,0,1,0,0,1
43561,0,1,0,0,1
43562,0,1,0,0,1
43563,0,1,0,0,1
43564,0,1,0,0,1
43565,0,0,0,1,1
43566,0,1,0,0,1
43567,0,1,0,0,1
43568,0,1,0,0,1
43569,0,1,0,0,1
43570,0,1,0,0,1
43571,0,1,0,0,1
43572,0,1,0,0,1
43573,0,1,0,0,1
43574,0,1,0,0,1
43575,0,1,0,0,1
43576,0,1,0,0,1
43577,0,1,0,0,1
43578,1,0,0,0,1
43579,0,1,0,0,1
43580,0,1,0,0,1
43581,0,1,0,0,1
43582,0,0,0,1,1
43583,0,1,0,0,1
43584,0,1,0,0,1
43585,0,1,0,0,1
43586,0,1,0,0,1
43587,1,0,0,0,1
43588,0,1,0,0,1
43589,0,1,0,0,1
43590,0,1,0,0,1
43591,0,1,0,0,1
43592,0,1,0,0,1
43593,0,1,0,0,1
43594,0,1,0,0,1
43595,0,1,0,0,1
43596,0,1,0,0,1
43597,0,1,0,0,1
43598,0,1,0,0,1
43599,0,1,0,0,1
43600,0,1,0,0,1
43601,0,1,0,0,1
43602,0,1,0,0,1
43603,0,1,0,0,1
43604,0,0,0,1,1
43605,0,0,0,1,1
43606,1,0,0,0,1
43607,0,1,0,0,1
43608,0,1,0,0,1
43609,0,1,0,0,1
43610,0,1,0,0,1
43611,0,1,0,0,1
43612,0,1,0,0,1
43613,0,1,0,0,1
43614,0,1,0,0,1
43615,1,0,0,0,1
43616,0,1,0,0,1
43617,0,1,0,0,1
43618,0,1,0,0,1
43619,1,0,0,0,1
43620,0,1,0,0,1
43621,0,1,0,0,1
43622,0,1,0,0,1
43623,0,1,0,0,1
43624,0,1,0,0,1
43625,0,1,0,0,1
43626,0,1,0,0,1
43627,0,1,0,0,1
43628,0,1,0,0,1
43629,1,0,0,0,1
43630,1,0,0,0,1
43631,0,1,0,0,1
43632,0,1,0,0,1
43633,0,1,0,0,1
43634,0,1,0,0,1
43635,0,1,0,0,1
43636,0,1,0,0,1
43637,0,0,0,1,1
43638,1,0,0,0,1
43639,0,1,0,0,1
43640,0,1,0,0,1
43641,0,1,0,0,1
43642,0,1,0,0,1
43643,0,1,0,0,1
43644,0,1,0,0,1
43645,0,1,0,0,1
43646,0,1,0,0,1
43647,0,1,0,0,1
43648,0,1,0,0,1
43649,1,0,0,0,1
43650,0,1,0,0,1
43651,0,1,0,0,1
43652,0,1,0,0,1
43653,0,1,0,0,1
43654,1,0,0,0,1
43655,0,1,0,0,1
43656,0,1,0,0,1
43657,0,1,0,0,1
43658,0,1,0,0,1
43659,0,1,0,0,1
43660,0,1,0,0,1
43661,0,1,0,0,1
43662,0,1,0,0,1
43663,0,1,0,0,1
43664,0,1,0,0,1
43665,0,1,0,0,1
43666,0,1,0,0,1
43667,0,1,0,0,1
43668,0,1,0,0,1
43669,0,1,0,0,1
43670,1,0,0,0,1
43671,0,1,0,0,1
43672,0,1,0,0,1
43673,0,1,0,0,1
43674,0,1,0,0,1
43675,1,0,0,0,1
43676,0,1,0,0,1
43677,0,1,0,0,1
43678,0,1,0,0,1
43679,0,1,0,0,1
43680,1,0,0,0,1
43681,0,1,0,0,1
43682,0,1,0,0,1
43683,0,1,0,0,1
43684,0,1,0,0,1
43685,0,1,0,0,1
43686,0,1,0,0,1
43687,1,0,0,0,1
43688,0,1,0,0,1
43689,0,1,0,0,1
43690,0,1,0,0,1
43691,0,1,0,0,1
43692,0,1,0,0,1
43693,1,0,0,0,1
43694,1,0,0,0,1
43695,0,1,0,0,1
43696,0,1,0,0,1
43697,0,1,0,0,1
43698,0,1,0,0,1
43699,0,1,0,0,1
43700,0,1,0,0,1
43701,0,1,0,0,1
43702,0,1,0,0,1
43703,0,1,0,0,1
43704,0,1,0,0,1
43705,1,0,0,0,1
43706,0,1,0,0,1
43707,0,1,0,0,1
43708,0,1,0,0,1
43709,0,0,1,0,1
43710,1,0,0,0,1
43711,0,1,0,0,1
43712,1,0,0,0,1
43713,0,1,0,0,1
43714,0,1,0,0,1
43715,0,1,0,0,1
43716,0,1,0,0,1
43717,0,1,0,0,1
43718,0,1,0,0,1
43719,1,0,0,0,1
43720,1,0,0,0,1
43721,0,1,0,0,1
43722,0,1,0,0,1
43723,0,1,0,0,1
43724,0,1,0,0,1
43725,1,0,0,0,1
43726,0,1,0,0,1
43727,0,1,0,0,1
43728,0,1,0,0,1
43729,0,1,0,0,1
43730,0,1,0,0,1
43731,0,1,0,0,1
43732,0,1,0,0,1
43733,0,1,0,0,1
43734,1,0,0,0,1
43735,0,1,0,0,1
43736,0,1,0,0,1
43737,0,1,0,0,1
43738,0,1,0,0,1
43739,0,1,0,0,1
43740,0,1,0,0,1
43741,1,0,0,0,1
43742,0,1,0,0,1
43743,0,1,0,0,1
43744,0,1,0,0,1
43745,0,1,0,0,1
43746,0,1,0,0,1
43747,0,1,0,0,1
43748,0,1,0,0,1
43749,0,1,0,0,1
43750,0,1,0,0,1
43751,0,1,0,0,1
43752,0,1,0,0,1
43753,0,1,0,0,1
43754,0,1,0,0,1
43755,0,1,0,0,1
43756,0,1,0,0,1
43757,0,1,0,0,1
43758,0,1,0,0,1
43759,0,1,0,0,1
43760,0,1,0,0,1
43761,0,1,0,0,1
43762,0,1,0,0,1
43763,0,1,0,0,1
43764,0,1,0,0,1
43765,0,1,0,0,1
43766,0,1,0,0,1
43767,0,1,0,0,1
43768,0,1,0,0,1
43769,0,1,0,0,1
43770,0,1,0,0,1
43771,1,0,0,0,1
43772,0,1,0,0,1
43773,0,1,0,0,1
43774,0,1,0,0,1
43775,0,1,0,0,1
43776,0,1,0,0,1
43777,0,1,0,0,1
43778,0,1,0,0,1
43779,0,1,0,0,1
43780,0,1,0,0,1
43781,0,1,0,0,1
43782,0,1,0,0,1
43783,0,1,0,0,1
43784,1,0,0,0,1
43785,0,1,0,0,1
43786,0,1,0,0,1
43787,0,1,0,0,1
43788,1,0,0,0,1
43789,0,1,0,0,1
43790,0,1,0,0,1
43791,0,1,0,0,1
43792,0,1,0,0,1
43793,0,1,0,0,1
43794,0,1,0,0,1
43795,0,1,0,0,1
43796,0,1,0,0,1
43797,0,1,0,0,1
43798,0,1,0,0,1
43799,0,1,0,0,1
43800,0,1,0,0,1
43801,0,1,0,0,1
43802,0,1,0,0,1
43803,0,1,0,0,1
43804,0,1,0,0,1
43805,0,1,0,0,1
43806,1,0,0,0,1
43807,0,1,0,0,1
43808,0,1,0,0,1
43809,0,1,0,0,1
43810,0,1,0,0,1
43811,0,1,0,0,1
43812,0,1,0,0,1
43813,0,1,0,0,1
43814,0,1,0,0,1
43815,0,1,0,0,1
43816,0,1,0,0,1
43817,0,1,0,0,1
43818,0,1,0,0,1
43819,1,0,0,0,1
43820,0,1,0,0,1
43821,0,1,0,0,1
43822,0,1,0,0,1
43823,0,1,0,0,1
43824,0,1,0,0,1
43825,0,1,0,0,1
43826,0,1,0,0,1
43827,0,1,0,0,1
43828,1,0,0,0,1
43829,0,1,0,0,1
43830,0,1,0,0,1
43831,0,1,0,0,1
43832,0,0,0,1,1
43833,0,1,0,0,1
43834,0,1,0,0,1
43835,1,0,0,0,1
43836,1,0,0,0,1
43837,0,1,0,0,1
43838,1,0,0,0,1
43839,0,1,0,0,1
43840,0,1,0,0,1
43841,1,0,0,0,1
43842,0,1,0,0,1
43843,0,1,0,0,1
43844,0,1,0,0,1
43845,0,1,0,0,1
43846,0,1,0,0,1
43847,0,1,0,0,1
43848,0,1,0,0,1
43849,1,0,0,0,1
43850,0,1,0,0,1
43851,0,1,0,0,1
43852,1,0,0,0,1
43853,0,1,0,0,1
43854,0,0,0,1,1
43855,0,1,0,0,1
43856,0,1,0,0,1
43857,0,1,0,0,1
43858,1,0,0,0,1
43859,0,1,0,0,1
43860,0,1,0,0,1
43861,1,0,0,0,1
43862,0,1,0,0,1
43863,0,1,0,0,1
43864,0,1,0,0,1
43865,0,1,0,0,1
43866,0,1,0,0,1
43867,0,1,0,0,1
43868,1,0,0,0,1
43869,0,1,0,0,1
43870,0,1,0,0,1
43871,1,0,0,0,1
43872,0,1,0,0,1
43873,0,1,0,0,1
43874,0,1,0,0,1
43875,0,1,0,0,1
43876,0,1,0,0,1
43877,0,1,0,0,1
43878,0,1,0,0,1
43879,0,1,0,0,1
43880,0,1,0,0,1
43881,1,0,0,0,1
43882,1,0,0,0,1
43883,0,1,0,0,1
43884,0,1,0,0,1
43885,1,0,0,0,1
43886,1,0,0,0,1
43887,0,1,0,0,1
43888,0,1,0,0,1
43889,0,0,1,0,1
43890,1,0,0,0,1
43891,0,1,0,0,1
43892,0,1,0,0,1
43893,0,0,0,1,1
43894,0,1,0,0,1
43895,0,1,0,0,1
43896,0,1,0,0,1
43897,0,1,0,0,1
43898,0,1,0,0,1
43899,0,1,0,0,1
43900,0,1,0,0,1
43901,0,1,0,0,1
43902,0,1,0,0,1
43903,0,1,0,0,1
43904,0,1,0,0,1
43905,1,0,0,0,1
43906,0,1,0,0,1
43907,0,1,0,0,1
43908,0,1,0,0,1
43909,0,1,0,0,1
43910,0,1,0,0,1
43911,0,1,0,0,1
43912,0,1,0,0,1
43913,1,0,0,0,1
43914,1,0,0,0,1
43915,0,1,0,0,1
43916,0,1,0,0,1
43917,0,1,0,0,1
43918,0,1,0,0,1
43919,0,1,0,0,1
43920,0,1,0,0,1
43921,0,1,0,0,1
43922,0,1,0,0,1
43923,0,1,0,0,1
43924,0,1,0,0,1
43925,1,0,0,0,1
43926,0,1,0,0,1
43927,0,1,0,0,1
43928,0,1,0,0,1
43929,0,1,0,0,1
43930,0,1,0,0,1
43931,0,1,0,0,1
43932,0,1,0,0,1
43933,0,1,0,0,1
43934,0,1,0,0,1
43935,0,1,0,0,1
43936,1,0,0,0,1
43937,0,1,0,0,1
43938,0,1,0,0,1
43939,0,1,0,0,1
43940,1,0,0,0,1
43941,0,0,0,1,1
43942,0,1,0,0,1
43943,0,1,0,0,1
43944,0,1,0,0,1
43945,0,1,0,0,1
43946,0,0,0,1,1
43947,0,1,0,0,1
43948,0,1,0,0,1
43949,0,1,0,0,1
43950,0,1,0,0,1
43951,0,1,0,0,1
43952,0,1,0,0,1
43953,0,1,0,0,1
43954,1,0,0,0,1
43955,0,0,0,1,1
43956,0,1,0,0,1
43957,0,1,0,0,1
43958,0,1,0,0,1
43959,0,1,0,0,1
43960,0,1,0,0,1
43961,0,1,0,0,1
43962,0,1,0,0,1
43963,0,1,0,0,1
43964,1,0,0,0,1
43965,0,1,0,0,1
43966,0,1,0,0,1
43967,0,0,0,1,1
43968,0,1,0,0,1
43969,0,1,0,0,1
43970,0,1,0,0,1
43971,1,0,0,0,1
43972,0,1,0,0,1
43973,0,1,0,0,1
43974,0,1,0,0,1
43975,0,1,0,0,1
43976,0,1,0,0,1
43977,0,1,0,0,1
43978,0,1,0,0,1
43979,0,1,0,0,1
43980,0,1,0,0,1
43981,0,1,0,0,1
43982,1,0,0,0,1
43983,0,1,0,0,1
43984,0,1,0,0,1
43985,0,1,0,0,1
43986,1,0,0,0,1
43987,1,0,0,0,1
43988,0,1,0,0,1
43989,0,1,0,0,1
43990,0,1,0,0,1
43991,0,1,0,0,1
43992,0,1,0,0,1
43993,0,1,0,0,1
43994,0,1,0,0,1
43995,0,1,0,0,1
43996,1,0,0,0,1
43997,0,0,0,1,1
43998,0,1,0,0,1
43999,0,1,0,0,1
44000,0,1,0,0,1
44001,0,1,0,0,1
44002,0,1,0,0,1
44003,0,1,0,0,1
44004,0,1,0,0,1
44005,0,1,0,0,1
44006,0,1,0,0,1
44007,0,1,0,0,1
44008,0,1,0,0,1
44009,0,1,0,0,1
44010,0,1,0,0,1
44011,0,1,0,0,1
44012,0,0,1,0,1
44013,0,1,0,0,1
44014,0,1,0,0,1
44015,0,1,0,0,1
44016,0,1,0,0,1
44017,0,0,0,1,1
44018,0,1,0,0,1
44019,0,1,0,0,1
44020,0,1,0,0,1
44021,1,0,0,0,1
44022,0,1,0,0,1
44023,0,1,0,0,1
44024,0,1,0,0,1
44025,0,1,0,0,1
44026,0,1,0,0,1
44027,0,1,0,0,1
44028,0,1,0,0,1
44029,0,1,0,0,1
44030,0,1,0,0,1
44031,0,1,0,0,1
44032,0,1,0,0,1
44033,0,1,0,0,1
44034,0,1,0,0,1
44035,0,1,0,0,1
44036,0,1,0,0,1
44037,0,1,0,0,1
44038,0,1,0,0,1
44039,1,0,0,0,1
44040,1,0,0,0,1
44041,0,1,0,0,1
44042,0,1,0,0,1
44043,0,1,0,0,1
44044,0,0,1,0,1
44045,0,1,0,0,1
44046,0,1,0,0,1
44047,0,1,0,0,1
44048,0,1,0,0,1
44049,0,1,0,0,1
44050,0,1,0,0,1
44051,0,1,0,0,1
44052,0,1,0,0,1
44053,0,1,0,0,1
44054,1,0,0,0,1
44055,0,1,0,0,1
44056,0,1,0,0,1
44057,0,1,0,0,1
44058,0,1,0,0,1
44059,0,1,0,0,1
44060,0,1,0,0,1
44061,0,1,0,0,1
44062,0,1,0,0,1
44063,0,1,0,0,1
44064,0,1,0,0,1
44065,0,1,0,0,1
44066,0,1,0,0,1
44067,0,1,0,0,1
44068,0,1,0,0,1
44069,0,1,0,0,1
44070,0,1,0,0,1
44071,0,0,0,1,1
44072,0,1,0,0,1
44073,0,1,0,0,1
44074,0,1,0,0,1
44075,0,1,0,0,1
44076,0,1,0,0,1
44077,0,1,0,0,1
44078,0,1,0,0,1
44079,0,0,1,0,1
44080,0,1,0,0,1
44081,0,1,0,0,1
44082,0,1,0,0,1
44083,0,1,0,0,1
44084,0,1,0,0,1
44085,0,1,0,0,1
44086,0,1,0,0,1
44087,0,1,0,0,1
44088,0,1,0,0,1
44089,0,1,0,0,1
44090,0,1,0,0,1
44091,1,0,0,0,1
44092,0,1,0,0,1
44093,0,1,0,0,1
44094,0,1,0,0,1
44095,0,1,0,0,1
44096,0,1,0,0,1
44097,0,1,0,0,1
44098,0,1,0,0,1
44099,1,0,0,0,1
44100,1,0,0,0,1
44101,0,1,0,0,1
44102,0,1,0,0,1
44103,0,1,0,0,1
44104,0,1,0,0,1
44105,0,1,0,0,1
44106,0,1,0,0,1
44107,0,1,0,0,1
44108,1,0,0,0,1
44109,0,1,0,0,1
44110,0,1,0,0,1
44111,0,1,0,0,1
44112,0,1,0,0,1
44113,1,0,0,0,1
44114,0,1,0,0,1
44115,0,1,0,0,1
44116,1,0,0,0,1
44117,0,1,0,0,1
44118,0,1,0,0,1
44119,1,0,0,0,1
44120,0,1,0,0,1
44121,0,1,0,0,1
44122,0,1,0,0,1
44123,0,1,0,0,1
44124,0,1,0,0,1
44125,0,1,0,0,1
44126,0,1,0,0,1
44127,0,1,0,0,1
44128,0,1,0,0,1
44129,0,1,0,0,1
44130,0,1,0,0,1
44131,0,1,0,0,1
44132,0,1,0,0,1
44133,1,0,0,0,1
44134,0,1,0,0,1
44135,0,1,0,0,1
44136,0,1,0,0,1
44137,1,0,0,0,1
44138,0,1,0,0,1
44139,0,0,0,1,1
44140,1,0,0,0,1
44141,1,0,0,0,1
44142,0,1,0,0,1
44143,0,1,0,0,1
44144,0,1,0,0,1
44145,0,1,0,0,1
44146,1,0,0,0,1
44147,0,0,0,1,1
44148,0,1,0,0,1
44149,0,1,0,0,1
44150,0,1,0,0,1
44151,0,1,0,0,1
44152,0,1,0,0,1
44153,0,1,0,0,1
44154,0,0,0,1,1
44155,1,0,0,0,1
44156,0,0,1,0,1
44157,0,1,0,0,1
44158,0,1,0,0,1
44159,0,1,0,0,1
44160,0,0,0,1,1
44161,0,1,0,0,1
44162,0,0,1,0,1
44163,0,1,0,0,1
44164,0,1,0,0,1
44165,1,0,0,0,1
44166,1,0,0,0,1
44167,0,1,0,0,1
44168,0,1,0,0,1
44169,0,1,0,0,1
44170,0,1,0,0,1
44171,0,1,0,0,1
44172,0,1,0,0,1
44173,0,1,0,0,1
44174,1,0,0,0,1
44175,0,1,0,0,1
44176,0,1,0,0,1
44177,1,0,0,0,1
44178,0,1,0,0,1
44179,1,0,0,0,1
44180,0,0,1,0,1
44181,0,1,0,0,1
44182,1,0,0,0,1
44183,0,1,0,0,1
44184,0,1,0,0,1
44185,0,1,0,0,1
44186,0,1,0,0,1
44187,0,1,0,0,1
44188,0,1,0,0,1
44189,0,1,0,0,1
44190,0,1,0,0,1
44191,0,1,0,0,1
44192,0,1,0,0,1
44193,0,1,0,0,1
44194,0,1,0,0,1
44195,1,0,0,0,1
44196,0,1,0,0,1
44197,0,1,0,0,1
44198,0,1,0,0,1
44199,0,1,0,0,1
44200,0,1,0,0,1
44201,0,1,0,0,1
44202,0,1,0,0,1
44203,0,1,0,0,1
44204,0,1,0,0,1
44205,0,1,0,0,1
44206,0,1,0,0,1
44207,0,1,0,0,1
44208,0,1,0,0,1
44209,0,1,0,0,1
44210,0,1,0,0,1
44211,0,1,0,0,1
44212,0,1,0,0,1
44213,0,1,0,0,1
44214,0,1,0,0,1
44215,0,1,0,0,1
44216,1,0,0,0,1
44217,0,1,0,0,1
44218,0,0,1,0,1
44219,0,1,0,0,1
44220,0,1,0,0,1
44221,0,1,0,0,1
44222,1,0,0,0,1
44223,1,0,0,0,1
44224,1,0,0,0,1
44225,1,0,0,0,1
44226,0,1,0,0,1
44227,0,1,0,0,1
44228,0,1,0,0,1
44229,0,1,0,0,1
44230,0,1,0,0,1
44231,0,1,0,0,1
44232,1,0,0,0,1
44233,0,1,0,0,1
44234,0,1,0,0,1
44235,0,1,0,0,1
44236,1,0,0,0,1
44237,0,1,0,0,1
44238,0,1,0,0,1
44239,0,1,0,0,1
44240,0,1,0,0,1
44241,0,1,0,0,1
44242,0,1,0,0,1
44243,0,1,0,0,1
44244,1,0,0,0,1
44245,0,1,0,0,1
44246,0,1,0,0,1
44247,0,1,0,0,1
44248,0,1,0,0,1
44249,0,1,0,0,1
44250,0,1,0,0,1
44251,0,1,0,0,1
44252,0,1,0,0,1
44253,0,1,0,0,1
44254,0,1,0,0,1
44255,0,1,0,0,1
44256,0,1,0,0,1
44257,1,0,0,0,1
44258,0,1,0,0,1
44259,0,1,0,0,1
44260,0,1,0,0,1
44261,0,1,0,0,1
44262,1,0,0,0,1
44263,0,1,0,0,1
44264,0,1,0,0,1
44265,0,1,0,0,1
44266,1,0,0,0,1
44267,0,1,0,0,1
44268,0,1,0,0,1
44269,0,1,0,0,1
44270,0,1,0,0,1
44271,0,1,0,0,1
44272,0,1,0,0,1
44273,0,1,0,0,1
44274,0,1,0,0,1
44275,0,1,0,0,1
44276,0,1,0,0,1
44277,0,1,0,0,1
44278,0,1,0,0,1
44279,0,0,1,0,1
44280,0,1,0,0,1
44281,1,0,0,0,1
44282,0,1,0,0,1
44283,0,1,0,0,1
44284,0,1,0,0,1
44285,0,1,0,0,1
44286,0,1,0,0,1
44287,0,1,0,0,1
44288,0,1,0,0,1
44289,0,1,0,0,1
44290,0,1,0,0,1
44291,0,1,0,0,1
44292,0,1,0,0,1
44293,0,1,0,0,1
44294,0,1,0,0,1
44295,0,1,0,0,1
44296,0,1,0,0,1
44297,0,1,0,0,1
44298,1,0,0,0,1
44299,0,1,0,0,1
44300,1,0,0,0,1
44301,0,1,0,0,1
44302,0,1,0,0,1
44303,0,1,0,0,1
44304,0,1,0,0,1
44305,1,0,0,0,1
44306,1,0,0,0,1
44307,0,1,0,0,1
44308,1,0,0,0,1
44309,0,1,0,0,1
44310,0,1,0,0,1
44311,0,1,0,0,1
44312,1,0,0,0,1
44313,0,1,0,0,1
44314,0,1,0,0,1
44315,0,1,0,0,1
44316,0,1,0,0,1
44317,0,1,0,0,1
44318,0,1,0,0,1
44319,0,1,0,0,1
44320,1,0,0,0,1
44321,0,1,0,0,1
44322,0,1,0,0,1
44323,0,1,0,0,1
44324,0,1,0,0,1
44325,0,1,0,0,1
44326,0,1,0,0,1
44327,1,0,0,0,1
44328,0,1,0,0,1
44329,0,1,0,0,1
44330,0,1,0,0,1
44331,0,0,0,1,1
44332,1,0,0,0,1
44333,0,1,0,0,1
44334,0,1,0,0,1
44335,0,1,0,0,1
44336,0,1,0,0,1
44337,0,1,0,0,1
44338,0,1,0,0,1
44339,0,1,0,0,1
44340,0,1,0,0,1
44341,0,1,0,0,1
44342,0,1,0,0,1
44343,0,1,0,0,1
44344,0,1,0,0,1
44345,0,1,0,0,1
44346,1,0,0,0,1
44347,0,1,0,0,1
44348,0,0,1,0,1
44349,0,1,0,0,1
44350,0,1,0,0,1
44351,1,0,0,0,1
44352,0,1,0,0,1
44353,0,1,0,0,1
44354,0,0,0,1,1
44355,0,1,0,0,1
44356,0,1,0,0,1
44357,0,1,0,0,1
44358,0,1,0,0,1
44359,0,1,0,0,1
44360,0,1,0,0,1
44361,0,1,0,0,1
44362,0,1,0,0,1
44363,0,1,0,0,1
44364,0,1,0,0,1
44365,0,1,0,0,1
44366,1,0,0,0,1
44367,0,1,0,0,1
44368,0,0,0,1,1
44369,0,1,0,0,1
44370,0,1,0,0,1
44371,0,0,0,1,1
44372,0,1,0,0,1
44373,0,1,0,0,1
44374,0,1,0,0,1
44375,0,1,0,0,1
44376,0,0,0,1,1
44377,1,0,0,0,1
44378,0,1,0,0,1
44379,0,0,0,1,1
44380,0,1,0,0,1
44381,0,1,0,0,1
44382,0,1,0,0,1
44383,0,1,0,0,1
44384,0,1,0,0,1
44385,0,1,0,0,1
44386,0,1,0,0,1
44387,0,1,0,0,1
44388,0,0,0,1,1
44389,0,1,0,0,1
44390,0,1,0,0,1
44391,0,1,0,0,1
44392,0,1,0,0,1
44393,0,1,0,0,1
44394,0,1,0,0,1
44395,0,1,0,0,1
44396,0,0,1,0,1
44397,0,1,0,0,1
44398,0,1,0,0,1
44399,0,1,0,0,1
44400,0,1,0,0,1
44401,0,1,0,0,1
44402,0,1,0,0,1
44403,0,1,0,0,1
44404,0,1,0,0,1
44405,0,1,0,0,1
44406,0,1,0,0,1
44407,0,1,0,0,1
44408,0,1,0,0,1
44409,0,1,0,0,1
44410,1,0,0,0,1
44411,0,1,0,0,1
44412,1,0,0,0,1
44413,0,1,0,0,1
44414,0,1,0,0,1
44415,1,0,0,0,1
44416,0,1,0,0,1
44417,0,1,0,0,1
44418,0,1,0,0,1
44419,0,1,0,0,1
44420,0,1,0,0,1
44421,0,1,0,0,1
44422,0,1,0,0,1
44423,0,1,0,0,1
44424,0,1,0,0,1
44425,0,1,0,0,1
44426,0,1,0,0,1
44427,0,1,0,0,1
44428,1,0,0,0,1
44429,0,1,0,0,1
44430,0,1,0,0,1
44431,0,1,0,0,1
44432,1,0,0,0,1
44433,0,1,0,0,1
44434,0,1,0,0,1
44435,0,1,0,0,1
44436,1,0,0,0,1
44437,0,1,0,0,1
44438,0,1,0,0,1
44439,0,1,0,0,1
44440,0,1,0,0,1
44441,1,0,0,0,1
44442,0,1,0,0,1
44443,0,1,0,0,1
44444,0,1,0,0,1
44445,1,0,0,0,1
44446,1,0,0,0,1
44447,0,1,0,0,1
44448,0,1,0,0,1
44449,1,0,0,0,1
44450,0,1,0,0,1
44451,1,0,0,0,1
44452,1,0,0,0,1
44453,0,1,0,0,1
44454,0,1,0,0,1
44455,0,1,0,0,1
44456,1,0,0,0,1
44457,0,1,0,0,1
44458,0,1,0,0,1
44459,0,1,0,0,1
44460,0,1,0,0,1
44461,0,1,0,0,1
44462,0,1,0,0,1
44463,0,1,0,0,1
44464,0,1,0,0,1
44465,0,1,0,0,1
44466,0,1,0,0,1
44467,0,1,0,0,1
44468,0,1,0,0,1
44469,1,0,0,0,1
44470,0,1,0,0,1
44471,0,1,0,0,1
44472,0,1,0,0,1
44473,0,1,0,0,1
44474,0,1,0,0,1
44475,1,0,0,0,1
44476,0,1,0,0,1
44477,0,1,0,0,1
44478,0,1,0,0,1
44479,0,1,0,0,1
44480,0,1,0,0,1
44481,0,1,0,0,1
44482,0,1,0,0,1
44483,0,1,0,0,1
44484,0,1,0,0,1
44485,0,1,0,0,1
44486,1,0,0,0,1
44487,0,1,0,0,1
44488,1,0,0,0,1
44489,0,1,0,0,1
44490,0,1,0,0,1
44491,0,0,1,0,1
44492,1,0,0,0,1
44493,0,1,0,0,1
44494,0,1,0,0,1
44495,1,0,0,0,1
44496,0,1,0,0,1
44497,0,1,0,0,1
44498,1,0,0,0,1
44499,0,1,0,0,1
44500,0,1,0,0,1
44501,0,1,0,0,1
44502,0,1,0,0,1
44503,0,1,0,0,1
44504,1,0,0,0,1
44505,0,1,0,0,1
44506,0,1,0,0,1
44507,0,1,0,0,1
44508,0,1,0,0,1
44509,1,0,0,0,1
44510,0,1,0,0,1
44511,0,1,0,0,1
44512,0,0,1,0,1
44513,0,1,0,0,1
44514,0,1,0,0,1
44515,0,1,0,0,1
44516,0,1,0,0,1
44517,0,1,0,0,1
44518,0,1,0,0,1
44519,0,1,0,0,1
44520,0,1,0,0,1
44521,0,1,0,0,1
44522,0,1,0,0,1
44523,0,1,0,0,1
44524,0,0,1,0,1
44525,0,1,0,0,1
44526,0,1,0,0,1
44527,0,1,0,0,1
44528,1,0,0,0,1
44529,0,1,0,0,1
44530,1,0,0,0,1
44531,0,0,0,1,1
44532,0,1,0,0,1
44533,0,1,0,0,1
44534,0,1,0,0,1
44535,1,0,0,0,1
44536,1,0,0,0,1
44537,0,1,0,0,1
44538,0,1,0,0,1
44539,1,0,0,0,1
44540,1,0,0,0,1
44541,0,1,0,0,1
44542,0,0,0,1,1
44543,0,1,0,0,1
44544,0,1,0,0,1
44545,0,1,0,0,1
44546,0,1,0,0,1
44547,0,1,0,0,1
44548,0,1,0,0,1
44549,1,0,0,0,1
44550,0,1,0,0,1
44551,0,1,0,0,1
44552,1,0,0,0,1
44553,0,1,0,0,1
44554,0,1,0,0,1
44555,0,0,1,0,1
44556,0,1,0,0,1
44557,0,1,0,0,1
44558,0,1,0,0,1
44559,0,1,0,0,1
44560,0,1,0,0,1
44561,1,0,0,0,1
44562,0,1,0,0,1
44563,0,1,0,0,1
44564,0,1,0,0,1
44565,0,1,0,0,1
44566,0,1,0,0,1
44567,0,1,0,0,1
44568,0,1,0,0,1
44569,0,0,0,1,1
44570,0,1,0,0,1
44571,0,1,0,0,1
44572,0,1,0,0,1
44573,0,1,0,0,1
44574,0,1,0,0,1
44575,0,1,0,0,1
44576,0,1,0,0,1
44577,0,1,0,0,1
44578,0,1,0,0,1
44579,0,1,0,0,1
44580,0,1,0,0,1
44581,0,1,0,0,1
44582,0,1,0,0,1
44583,1,0,0,0,1
44584,0,1,0,0,1
44585,0,0,0,1,1
44586,1,0,0,0,1
44587,0,1,0,0,1
44588,0,0,0,1,1
44589,0,1,0,0,1
44590,1,0,0,0,1
44591,0,1,0,0,1
44592,0,0,0,1,1
44593,0,1,0,0,1
44594,0,1,0,0,1
44595,0,1,0,0,1
44596,0,1,0,0,1
44597,0,1,0,0,1
44598,0,1,0,0,1
44599,0,1,0,0,1
44600,0,1,0,0,1
44601,0,1,0,0,1
44602,0,1,0,0,1
44603,0,1,0,0,1
44604,0,1,0,0,1
44605,0,1,0,0,1
44606,0,1,0,0,1
44607,0,1,0,0,1
44608,0,1,0,0,1
44609,1,0,0,0,1
44610,0,1,0,0,1
44611,0,0,0,1,1
44612,0,1,0,0,1
44613,0,1,0,0,1
44614,0,1,0,0,1
44615,0,1,0,0,1
44616,1,0,0,0,1
44617,0,1,0,0,1
44618,1,0,0,0,1
44619,0,1,0,0,1
44620,0,1,0,0,1
44621,0,1,0,0,1
44622,0,1,0,0,1
44623,0,1,0,0,1
44624,0,1,0,0,1
44625,0,0,0,1,1
44626,0,1,0,0,1
44627,1,0,0,0,1
44628,0,0,1,0,1
44629,0,0,0,1,1
44630,0,1,0,0,1
44631,1,0,0,0,1
44632,0,1,0,0,1
44633,0,1,0,0,1
44634,0,1,0,0,1
44635,0,0,1,0,1
44636,1,0,0,0,1
44637,0,1,0,0,1
44638,0,0,0,1,1
44639,0,1,0,0,1
44640,0,1,0,0,1
44641,0,1,0,0,1
44642,0,1,0,0,1
44643,0,1,0,0,1
44644,0,1,0,0,1
44645,0,0,0,1,1
44646,1,0,0,0,1
44647,1,0,0,0,1
44648,0,1,0,0,1
44649,0,1,0,0,1
44650,0,1,0,0,1
44651,0,1,0,0,1
44652,1,0,0,0,1
44653,0,1,0,0,1
44654,0,1,0,0,1
44655,0,1,0,0,1
44656,0,1,0,0,1
44657,0,1,0,0,1
44658,0,1,0,0,1
44659,1,0,0,0,1
44660,0,1,0,0,1
44661,0,1,0,0,1
44662,0,1,0,0,1
44663,0,1,0,0,1
44664,0,1,0,0,1
44665,0,1,0,0,1
44666,0,1,0,0,1
44667,0,1,0,0,1
44668,1,0,0,0,1
44669,0,1,0,0,1
44670,0,1,0,0,1
44671,0,1,0,0,1
44672,0,1,0,0,1
44673,0,0,0,1,1
44674,0,1,0,0,1
44675,1,0,0,0,1
44676,0,1,0,0,1
44677,0,0,1,0,1
44678,0,1,0,0,1
44679,0,1,0,0,1
44680,1,0,0,0,1
44681,0,1,0,0,1
44682,0,1,0,0,1
44683,0,1,0,0,1
44684,0,1,0,0,1
44685,0,1,0,0,1
44686,0,1,0,0,1
44687,0,1,0,0,1
44688,0,1,0,0,1
44689,0,1,0,0,1
44690,0,1,0,0,1
44691,1,0,0,0,1
44692,1,0,0,0,1
44693,0,1,0,0,1
44694,0,1,0,0,1
44695,0,1,0,0,1
44696,0,1,0,0,1
44697,0,1,0,0,1
44698,0,1,0,0,1
44699,0,1,0,0,1
44700,0,1,0,0,1
44701,0,1,0,0,1
44702,0,1,0,0,1
44703,0,1,0,0,1
44704,0,1,0,0,1
44705,0,1,0,0,1
44706,0,1,0,0,1
44707,0,1,0,0,1
44708,1,0,0,0,1
44709,0,1,0,0,1
44710,0,1,0,0,1
44711,0,1,0,0,1
44712,0,0,0,1,1
44713,0,1,0,0,1
44714,0,1,0,0,1
44715,0,1,0,0,1
44716,0,1,0,0,1
44717,0,1,0,0,1
44718,0,1,0,0,1
44719,0,1,0,0,1
44720,0,1,0,0,1
44721,1,0,0,0,1
44722,0,1,0,0,1
44723,1,0,0,0,1
44724,0,1,0,0,1
44725,0,1,0,0,1
44726,0,1,0,0,1
44727,1,0,0,0,1
44728,0,1,0,0,1
44729,0,0,1,0,1
44730,0,1,0,0,1
44731,0,1,0,0,1
44732,0,0,1,0,1
44733,0,1,0,0,1
44734,0,1,0,0,1
44735,0,1,0,0,1
44736,0,1,0,0,1
44737,0,1,0,0,1
44738,0,1,0,0,1
44739,0,0,1,0,1
44740,0,1,0,0,1
44741,0,1,0,0,1
44742,1,0,0,0,1
44743,1,0,0,0,1
44744,0,1,0,0,1
44745,0,1,0,0,1
44746,1,0,0,0,1
44747,0,1,0,0,1
44748,0,1,0,0,1
44749,0,1,0,0,1
44750,0,1,0,0,1
44751,0,1,0,0,1
44752,0,1,0,0,1
44753,0,1,0,0,1
44754,0,1,0,0,1
44755,1,0,0,0,1
44756,0,1,0,0,1
44757,0,1,0,0,1
44758,0,1,0,0,1
44759,0,1,0,0,1
44760,0,1,0,0,1
44761,0,1,0,0,1
44762,0,0,0,1,1
44763,0,1,0,0,1
44764,0,1,0,0,1
44765,0,1,0,0,1
44766,0,1,0,0,1
44767,0,1,0,0,1
44768,0,1,0,0,1
44769,0,1,0,0,1
44770,0,1,0,0,1
44771,0,1,0,0,1
44772,0,1,0,0,1
44773,0,1,0,0,1
44774,0,1,0,0,1
44775,0,1,0,0,1
44776,0,1,0,0,1
44777,0,0,0,1,1
44778,0,0,1,0,1
44779,0,1,0,0,1
44780,0,1,0,0,1
44781,1,0,0,0,1
44782,0,1,0,0,1
44783,0,1,0,0,1
44784,0,1,0,0,1
44785,0,1,0,0,1
44786,1,0,0,0,1
44787,0,1,0,0,1
44788,0,1,0,0,1
44789,0,0,0,1,1
44790,0,1,0,0,1
44791,0,1,0,0,1
44792,0,1,0,0,1
44793,0,1,0,0,1
44794,1,0,0,0,1
44795,0,1,0,0,1
44796,0,1,0,0,1
44797,0,1,0,0,1
44798,0,1,0,0,1
44799,0,1,0,0,1
44800,0,1,0,0,1
44801,0,1,0,0,1
44802,0,1,0,0,1
44803,0,1,0,0,1
44804,0,1,0,0,1
44805,0,1,0,0,1
44806,0,1,0,0,1
44807,0,1,0,0,1
44808,0,1,0,0,1
44809,0,1,0,0,1
44810,0,1,0,0,1
44811,0,1,0,0,1
44812,0,1,0,0,1
44813,0,0,1,0,1
44814,1,0,0,0,1
44815,0,1,0,0,1
44816,1,0,0,0,1
44817,0,1,0,0,1
44818,0,0,1,0,1
44819,0,1,0,0,1
44820,0,1,0,0,1
44821,0,1,0,0,1
44822,0,1,0,0,1
44823,0,1,0,0,1
44824,0,1,0,0,1
44825,1,0,0,0,1
44826,0,1,0,0,1
44827,0,1,0,0,1
44828,0,1,0,0,1
44829,0,0,0,1,1
44830,0,1,0,0,1
44831,0,1,0,0,1
44832,0,1,0,0,1
44833,0,1,0,0,1
44834,0,1,0,0,1
44835,0,1,0,0,1
44836,0,1,0,0,1
44837,0,1,0,0,1
44838,0,1,0,0,1
44839,0,1,0,0,1
44840,0,0,1,0,1
44841,1,0,0,0,1
44842,0,0,1,0,1
44843,0,1,0,0,1
44844,0,1,0,0,1
44845,0,1,0,0,1
44846,0,1,0,0,1
44847,0,1,0,0,1
44848,0,1,0,0,1
44849,1,0,0,0,1
44850,0,1,0,0,1
44851,0,1,0,0,1
44852,0,1,0,0,1
44853,0,1,0,0,1
44854,0,1,0,0,1
44855,1,0,0,0,1
44856,0,1,0,0,1
44857,0,1,0,0,1
44858,1,0,0,0,1
44859,0,1,0,0,1
44860,1,0,0,0,1
44861,0,1,0,0,1
44862,1,0,0,0,1
44863,0,1,0,0,1
44864,0,1,0,0,1
44865,0,1,0,0,1
44866,0,0,0,1,1
44867,0,1,0,0,1
44868,0,1,0,0,1
44869,0,1,0,0,1
44870,0,1,0,0,1
44871,0,1,0,0,1
44872,0,1,0,0,1
44873,0,1,0,0,1
44874,1,0,0,0,1
44875,0,1,0,0,1
44876,1,0,0,0,1
44877,0,1,0,0,1
44878,0,1,0,0,1
44879,0,1,0,0,1
44880,0,1,0,0,1
44881,0,1,0,0,1
44882,0,1,0,0,1
44883,0,0,0,1,1
44884,0,1,0,0,1
44885,0,1,0,0,1
44886,0,1,0,0,1
44887,1,0,0,0,1
44888,1,0,0,0,1
44889,0,1,0,0,1
44890,0,1,0,0,1
44891,1,0,0,0,1
44892,0,1,0,0,1
44893,0,1,0,0,1
44894,0,1,0,0,1
44895,0,1,0,0,1
44896,0,1,0,0,1
44897,0,1,0,0,1
44898,0,1,0,0,1
44899,0,1,0,0,1
44900,0,1,0,0,1
44901,0,1,0,0,1
44902,0,1,0,0,1
44903,0,1,0,0,1
44904,0,1,0,0,1
44905,0,1,0,0,1
44906,0,1,0,0,1
44907,0,1,0,0,1
44908,0,1,0,0,1
44909,0,1,0,0,1
44910,0,1,0,0,1
44911,0,1,0,0,1
44912,1,0,0,0,1
44913,0,1,0,0,1
44914,0,1,0,0,1
44915,0,1,0,0,1
44916,1,0,0,0,1
44917,0,1,0,0,1
44918,0,0,1,0,1
44919,0,1,0,0,1
44920,0,1,0,0,1
44921,0,0,1,0,1
44922,0,1,0,0,1
44923,0,1,0,0,1
44924,0,1,0,0,1
44925,1,0,0,0,1
44926,0,1,0,0,1
44927,0,1,0,0,1
44928,0,1,0,0,1
44929,0,1,0,0,1
44930,0,1,0,0,1
44931,0,1,0,0,1
44932,0,1,0,0,1
44933,0,1,0,0,1
44934,0,1,0,0,1
44935,1,0,0,0,1
44936,0,1,0,0,1
44937,0,1,0,0,1
44938,0,0,0,1,1
44939,1,0,0,0,1
44940,0,1,0,0,1
44941,0,1,0,0,1
44942,0,1,0,0,1
44943,0,1,0,0,1
44944,0,1,0,0,1
44945,0,1,0,0,1
44946,0,1,0,0,1
44947,0,1,0,0,1
44948,0,1,0,0,1
44949,0,1,0,0,1
44950,0,1,0,0,1
44951,0,1,0,0,1
44952,0,1,0,0,1
44953,0,0,0,1,1
44954,0,1,0,0,1
44955,0,1,0,0,1
44956,0,1,0,0,1
44957,0,1,0,0,1
44958,0,1,0,0,1
44959,0,1,0,0,1
44960,0,1,0,0,1
44961,0,1,0,0,1
44962,0,1,0,0,1
44963,1,0,0,0,1
44964,0,1,0,0,1
44965,0,1,0,0,1
44966,0,1,0,0,1
44967,0,1,0,0,1
44968,0,1,0,0,1
44969,0,1,0,0,1
44970,0,1,0,0,1
44971,0,1,0,0,1
44972,1,0,0,0,1
44973,0,1,0,0,1
44974,0,1,0,0,1
44975,0,1,0,0,1
44976,0,1,0,0,1
44977,0,1,0,0,1
44978,0,1,0,0,1
44979,1,0,0,0,1
44980,1,0,0,0,1
44981,1,0,0,0,1
44982,0,1,0,0,1
44983,0,1,0,0,1
44984,0,1,0,0,1
44985,0,1,0,0,1
44986,0,1,0,0,1
44987,0,1,0,0,1
44988,0,0,1,0,1
44989,0,1,0,0,1
44990,0,1,0,0,1
44991,1,0,0,0,1
44992,0,1,0,0,1
44993,0,1,0,0,1
44994,0,1,0,0,1
44995,1,0,0,0,1
44996,0,0,1,0,1
44997,0,1,0,0,1
44998,0,1,0,0,1
44999,0,1,0,0,1
45000,0,1,0,0,1
45001,0,1,0,0,1
45002,0,0,0,1,1
45003,0,1,0,0,1
45004,0,1,0,0,1
45005,0,1,0,0,1
45006,0,1,0,0,1
45007,0,1,0,0,1
45008,0,1,0,0,1
45009,0,1,0,0,1
45010,0,1,0,0,1
45011,0,1,0,0,1
45012,0,1,0,0,1
45013,0,1,0,0,1
45014,0,1,0,0,1
45015,0,1,0,0,1
45016,0,1,0,0,1
45017,0,0,0,1,1
45018,0,1,0,0,1
45019,0,1,0,0,1
45020,0,1,0,0,1
45021,1,0,0,0,1
45022,0,0,1,0,1
45023,0,1,0,0,1
45024,1,0,0,0,1
45025,0,1,0,0,1
45026,0,1,0,0,1
45027,1,0,0,0,1
45028,0,1,0,0,1
45029,0,1,0,0,1
45030,0,1,0,0,1
45031,0,1,0,0,1
45032,1,0,0,0,1
45033,0,1,0,0,1
45034,0,1,0,0,1
45035,0,1,0,0,1
45036,0,1,0,0,1
45037,0,1,0,0,1
45038,0,1,0,0,1
45039,0,1,0,0,1
45040,1,0,0,0,1
45041,0,1,0,0,1
45042,0,1,0,0,1
45043,1,0,0,0,1
45044,0,1,0,0,1
45045,0,1,0,0,1
45046,0,1,0,0,1
45047,0,1,0,0,1
45048,0,1,0,0,1
45049,0,1,0,0,1
45050,1,0,0,0,1
45051,0,1,0,0,1
45052,0,1,0,0,1
45053,0,1,0,0,1
45054,1,0,0,0,1
45055,0,1,0,0,1
45056,0,1,0,0,1
45057,0,1,0,0,1
45058,0,1,0,0,1
45059,0,1,0,0,1
45060,0,0,1,0,1
45061,0,1,0,0,1
45062,0,1,0,0,1
45063,0,0,1,0,1
45064,0,1,0,0,1
45065,0,0,0,1,1
45066,0,1,0,0,1
45067,1,0,0,0,1
45068,0,1,0,0,1
45069,1,0,0,0,1
45070,0,1,0,0,1
45071,1,0,0,0,1
45072,0,1,0,0,1
45073,0,1,0,0,1
45074,0,1,0,0,1
45075,0,1,0,0,1
45076,0,1,0,0,1
45077,0,1,0,0,1
45078,0,1,0,0,1
45079,0,1,0,0,1
45080,0,1,0,0,1
45081,1,0,0,0,1
45082,0,1,0,0,1
45083,0,1,0,0,1
45084,0,1,0,0,1
45085,0,1,0,0,1
45086,0,1,0,0,1
45087,1,0,0,0,1
45088,0,0,0,1,1
45089,0,0,0,1,1
45090,0,1,0,0,1
45091,0,1,0,0,1
45092,0,1,0,0,1
45093,0,1,0,0,1
45094,0,1,0,0,1
45095,0,1,0,0,1
45096,1,0,0,0,1
45097,0,1,0,0,1
45098,0,1,0,0,1
45099,1,0,0,0,1
45100,1,0,0,0,1
45101,0,1,0,0,1
45102,1,0,0,0,1
45103,0,1,0,0,1
45104,0,1,0,0,1
45105,0,1,0,0,1
45106,0,1,0,0,1
45107,0,1,0,0,1
45108,0,1,0,0,1
45109,0,1,0,0,1
45110,0,1,0,0,1
45111,0,1,0,0,1
45112,0,1,0,0,1
45113,0,1,0,0,1
45114,0,1,0,0,1
45115,0,1,0,0,1
45116,0,0,0,1,1
45117,0,1,0,0,1
45118,1,0,0,0,1
45119,1,0,0,0,1
45120,0,1,0,0,1
45121,0,1,0,0,1
45122,0,1,0,0,1
45123,0,1,0,0,1
45124,0,1,0,0,1
45125,0,1,0,0,1
45126,0,1,0,0,1
45127,1,0,0,0,1
45128,0,1,0,0,1
45129,0,1,0,0,1
45130,0,1,0,0,1
45131,0,0,1,0,1
45132,1,0,0,0,1
45133,0,1,0,0,1
45134,1,0,0,0,1
45135,0,1,0,0,1
45136,0,1,0,0,1
45137,0,1,0,0,1
45138,0,1,0,0,1
45139,0,1,0,0,1
45140,0,1,0,0,1
45141,0,1,0,0,1
45142,0,1,0,0,1
45143,0,1,0,0,1
45144,1,0,0,0,1
45145,1,0,0,0,1
45146,0,1,0,0,1
45147,0,1,0,0,1
45148,0,0,1,0,1
45149,0,1,0,0,1
45150,0,1,0,0,1
45151,0,1,0,0,1
45152,1,0,0,0,1
45153,0,1,0,0,1
45154,0,1,0,0,1
45155,0,1,0,0,1
45156,0,1,0,0,1
45157,1,0,0,0,1
45158,0,1,0,0,1
45159,0,1,0,0,1
45160,0,1,0,0,1
45161,0,1,0,0,1
45162,0,1,0,0,1
45163,0,1,0,0,1
45164,0,1,0,0,1
45165,0,1,0,0,1
45166,0,1,0,0,1
45167,0,1,0,0,1
45168,0,1,0,0,1
45169,1,0,0,0,1
45170,0,1,0,0,1
45171,1,0,0,0,1
45172,0,1,0,0,1
45173,0,1,0,0,1
45174,1,0,0,0,1
45175,0,1,0,0,1
45176,0,1,0,0,1
45177,0,1,0,0,1
45178,0,0,0,1,1
45179,1,0,0,0,1
45180,0,1,0,0,1
45181,0,1,0,0,1
45182,0,0,1,0,1
45183,0,1,0,0,1
45184,0,1,0,0,1
45185,1,0,0,0,1
45186,0,1,0,0,1
45187,0,0,1,0,1
45188,0,1,0,0,1
45189,0,1,0,0,1
45190,1,0,0,0,1
45191,0,1,0,0,1
45192,0,1,0,0,1
45193,0,1,0,0,1
45194,0,1,0,0,1
45195,0,1,0,0,1
45196,0,1,0,0,1
45197,1,0,0,0,1
45198,0,0,1,0,1
45199,0,0,1,0,1
45200,0,1,0,0,1
45201,0,1,0,0,1
45202,0,1,0,0,1
45203,0,1,0,0,1
45204,1,0,0,0,1
45205,0,1,0,0,1
45206,0,1,0,0,1
45207,1,0,0,0,1
45208,0,1,0,0,1
45209,0,1,0,0,1
45210,0,1,0,0,1
45211,0,1,0,0,1
45212,1,0,0,0,1
45213,0,1,0,0,1
45214,0,1,0,0,1
45215,0,1,0,0,1
45216,0,1,0,0,1
45217,0,1,0,0,1
45218,0,1,0,0,1
45219,0,1,0,0,1
45220,0,1,0,0,1
45221,0,1,0,0,1
45222,0,0,0,1,1
45223,0,1,0,0,1
45224,0,1,0,0,1
45225,0,1,0,0,1
45226,0,1,0,0,1
45227,0,1,0,0,1
45228,0,0,1,0,1
45229,0,1,0,0,1
45230,1,0,0,0,1
45231,0,1,0,0,1
45232,0,1,0,0,1
45233,0,1,0,0,1
45234,1,0,0,0,1
45235,0,1,0,0,1
45236,0,1,0,0,1
45237,0,1,0,0,1
45238,0,1,0,0,1
45239,0,1,0,0,1
45240,0,1,0,0,1
45241,0,0,0,1,1
45242,0,1,0,0,1
45243,0,1,0,0,1
45244,0,1,0,0,1
45245,0,1,0,0,1
45246,0,1,0,0,1
45247,0,1,0,0,1
45248,0,1,0,0,1
45249,0,1,0,0,1
45250,0,0,1,0,1
45251,0,1,0,0,1
45252,1,0,0,0,1
45253,0,1,0,0,1
45254,0,1,0,0,1
45255,0,1,0,0,1
45256,0,1,0,0,1
45257,0,1,0,0,1
45258,0,1,0,0,1
45259,1,0,0,0,1
45260,0,1,0,0,1
45261,0,1,0,0,1
45262,0,1,0,0,1
45263,0,1,0,0,1
45264,0,1,0,0,1
45265,0,1,0,0,1
45266,0,1,0,0,1
45267,0,1,0,0,1
45268,0,1,0,0,1
45269,0,0,0,1,1
45270,1,0,0,0,1
45271,0,1,0,0,1
45272,0,1,0,0,1
45273,0,1,0,0,1
45274,0,1,0,0,1
45275,0,1,0,0,1
45276,0,0,1,0,1
45277,0,1,0,0,1
45278,0,1,0,0,1
45279,0,1,0,0,1
45280,0,1,0,0,1
45281,0,1,0,0,1
45282,0,1,0,0,1
45283,0,1,0,0,1
45284,0,1,0,0,1
45285,0,1,0,0,1
45286,0,1,0,0,1
45287,0,1,0,0,1
45288,0,1,0,0,1
45289,0,1,0,0,1
45290,0,1,0,0,1
45291,0,1,0,0,1
45292,0,1,0,0,1
45293,1,0,0,0,1
45294,1,0,0,0,1
45295,0,1,0,0,1
45296,0,1,0,0,1
45297,0,1,0,0,1
45298,0,1,0,0,1
45299,0,1,0,0,1
45300,0,1,0,0,1
45301,0,1,0,0,1
45302,0,1,0,0,1
45303,0,1,0,0,1
45304,0,0,0,1,1
45305,0,1,0,0,1
45306,1,0,0,0,1
45307,1,0,0,0,1
45308,0,1,0,0,1
45309,0,1,0,0,1
45310,0,1,0,0,1
45311,0,1,0,0,1
45312,0,1,0,0,1
45313,0,1,0,0,1
45314,0,1,0,0,1
45315,0,1,0,0,1
45316,0,1,0,0,1
45317,1,0,0,0,1
45318,0,1,0,0,1
45319,0,1,0,0,1
45320,0,1,0,0,1
45321,0,1,0,0,1
45322,0,1,0,0,1
45323,0,1,0,0,1
45324,0,1,0,0,1
45325,0,1,0,0,1
45326,0,1,0,0,1
45327,0,1,0,0,1
45328,0,1,0,0,1
45329,0,1,0,0,1
45330,0,1,0,0,1
45331,0,0,1,0,1
45332,0,1,0,0,1
45333,0,1,0,0,1
45334,1,0,0,0,1
45335,0,1,0,0,1
45336,0,1,0,0,1
45337,0,1,0,0,1
45338,0,1,0,0,1
45339,0,1,0,0,1
45340,0,1,0,0,1
45341,0,0,1,0,1
45342,0,1,0,0,1
45343,0,1,0,0,1
45344,1,0,0,0,1
45345,0,1,0,0,1
45346,1,0,0,0,1
45347,0,1,0,0,1
45348,1,0,0,0,1
45349,0,1,0,0,1
45350,0,1,0,0,1
45351,0,1,0,0,1
45352,0,1,0,0,1
45353,0,1,0,0,1
45354,1,0,0,0,1
45355,0,1,0,0,1
45356,0,1,0,0,1
45357,0,1,0,0,1
45358,1,0,0,0,1
45359,0,1,0,0,1
45360,1,0,0,0,1
45361,0,1,0,0,1
45362,1,0,0,0,1
45363,0,1,0,0,1
45364,0,1,0,0,1
45365,0,1,0,0,1
45366,1,0,0,0,1
45367,0,1,0,0,1
45368,0,1,0,0,1
45369,0,1,0,0,1
45370,0,1,0,0,1
45371,0,1,0,0,1
45372,0,1,0,0,1
45373,0,1,0,0,1
45374,0,1,0,0,1
45375,0,1,0,0,1
45376,0,0,1,0,1
45377,0,1,0,0,1
45378,0,1,0,0,1
45379,0,0,0,1,1
45380,0,1,0,0,1
45381,0,1,0,0,1
45382,0,1,0,0,1
45383,0,1,0,0,1
45384,0,1,0,0,1
45385,0,1,0,0,1
45386,0,1,0,0,1
45387,0,1,0,0,1
45388,1,0,0,0,1
45389,0,1,0,0,1
45390,0,1,0,0,1
45391,0,1,0,0,1
45392,0,1,0,0,1
45393,0,1,0,0,1
45394,0,1,0,0,1
45395,0,1,0,0,1
45396,0,1,0,0,1
45397,0,1,0,0,1
45398,0,1,0,0,1
45399,0,1,0,0,1
45400,0,1,0,0,1
45401,1,0,0,0,1
45402,0,1,0,0,1
45403,0,1,0,0,1
45404,0,0,1,0,1
45405,0,0,1,0,1
45406,0,1,0,0,1
45407,0,1,0,0,1
45408,0,1,0,0,1
45409,0,1,0,0,1
45410,0,1,0,0,1
45411,0,1,0,0,1
45412,0,1,0,0,1
45413,0,1,0,0,1
45414,0,0,1,0,1
45415,0,1,0,0,1
45416,0,1,0,0,1
45417,0,1,0,0,1
45418,0,1,0,0,1
45419,1,0,0,0,1
45420,0,1,0,0,1
45421,0,1,0,0,1
45422,1,0,0,0,1
45423,0,0,1,0,1
45424,1,0,0,0,1
45425,0,1,0,0,1
45426,1,0,0,0,1
45427,0,1,0,0,1
45428,0,0,0,1,1
45429,0,1,0,0,1
45430,1,0,0,0,1
45431,1,0,0,0,1
45432,0,1,0,0,1
45433,0,1,0,0,1
45434,0,1,0,0,1
45435,0,1,0,0,1
45436,0,1,0,0,1
45437,0,1,0,0,1
45438,0,1,0,0,1
45439,1,0,0,0,1
45440,0,1,0,0,1
45441,0,1,0,0,1
45442,0,1,0,0,1
45443,0,1,0,0,1
45444,0,1,0,0,1
45445,0,1,0,0,1
45446,0,1,0,0,1
45447,0,1,0,0,1
45448,0,1,0,0,1
45449,1,0,0,0,1
45450,0,1,0,0,1
45451,0,1,0,0,1
45452,1,0,0,0,1
45453,0,1,0,0,1
45454,0,1,0,0,1
45455,0,1,0,0,1
45456,0,1,0,0,1
45457,0,1,0,0,1
45458,0,1,0,0,1
45459,0,1,0,0,1
45460,0,1,0,0,1
45461,0,1,0,0,1
45462,1,0,0,0,1
45463,1,0,0,0,1
45464,0,0,0,1,1
45465,1,0,0,0,1
45466,1,0,0,0,1
45467,0,1,0,0,1
45468,0,1,0,0,1
45469,0,1,0,0,1
45470,0,1,0,0,1
45471,1,0,0,0,1
45472,0,1,0,0,1
45473,0,1,0,0,1
45474,1,0,0,0,1
45475,0,1,0,0,1
45476,0,1,0,0,1
45477,0,1,0,0,1
45478,0,1,0,0,1
45479,0,1,0,0,1
45480,0,1,0,0,1
45481,0,1,0,0,1
45482,0,1,0,0,1
45483,0,1,0,0,1
45484,0,1,0,0,1
45485,0,0,1,0,1
45486,0,1,0,0,1
45487,0,1,0,0,1
45488,1,0,0,0,1
45489,0,1,0,0,1
45490,0,1,0,0,1
45491,0,1,0,0,1
45492,0,0,0,1,1
45493,0,1,0,0,1
45494,1,0,0,0,1
45495,0,1,0,0,1
45496,0,1,0,0,1
45497,0,1,0,0,1
45498,0,1,0,0,1
45499,0,1,0,0,1
45500,0,1,0,0,1
45501,0,1,0,0,1
45502,0,0,1,0,1
45503,0,1,0,0,1
45504,0,1,0,0,1
45505,1,0,0,0,1
45506,0,0,0,1,1
45507,0,1,0,0,1
45508,0,1,0,0,1
45509,0,1,0,0,1
45510,0,1,0,0,1
45511,0,1,0,0,1
45512,1,0,0,0,1
45513,0,1,0,0,1
45514,1,0,0,0,1
45515,0,1,0,0,1
45516,0,1,0,0,1
45517,0,1,0,0,1
45518,0,1,0,0,1
45519,0,1,0,0,1
45520,0,1,0,0,1
45521,0,1,0,0,1
45522,0,1,0,0,1
45523,0,1,0,0,1
45524,1,0,0,0,1
45525,0,1,0,0,1
45526,0,1,0,0,1
45527,0,0,1,0,1
45528,1,0,0,0,1
45529,1,0,0,0,1
45530,0,1,0,0,1
45531,0,1,0,0,1
45532,1,0,0,0,1
45533,0,1,0,0,1
45534,0,1,0,0,1
45535,0,1,0,0,1
45536,0,1,0,0,1
45537,0,1,0,0,1
45538,0,1,0,0,1
45539,0,1,0,0,1
45540,1,0,0,0,1
45541,0,1,0,0,1
45542,0,1,0,0,1
45543,0,1,0,0,1
45544,0,1,0,0,1
45545,0,1,0,0,1
45546,0,1,0,0,1
45547,0,1,0,0,1
45548,0,1,0,0,1
45549,0,1,0,0,1
45550,0,1,0,0,1
45551,1,0,0,0,1
45552,0,1,0,0,1
45553,0,1,0,0,1
45554,0,1,0,0,1
45555,0,1,0,0,1
45556,1,0,0,0,1
45557,0,1,0,0,1
45558,1,0,0,0,1
45559,0,1,0,0,1
45560,0,1,0,0,1
45561,0,1,0,0,1
45562,0,1,0,0,1
45563,0,1,0,0,1
45564,1,0,0,0,1
45565,1,0,0,0,1
45566,0,1,0,0,1
45567,0,1,0,0,1
45568,1,0,0,0,1
45569,0,1,0,0,1
45570,0,0,0,1,1
45571,0,1,0,0,1
45572,0,1,0,0,1
45573,0,1,0,0,1
45574,0,1,0,0,1
45575,0,1,0,0,1
45576,0,1,0,0,1
45577,0,1,0,0,1
45578,0,1,0,0,1
45579,0,1,0,0,1
45580,0,1,0,0,1
45581,1,0,0,0,1
45582,1,0,0,0,1
45583,0,1,0,0,1
45584,0,1,0,0,1
45585,0,1,0,0,1
45586,0,1,0,0,1
45587,0,0,1,0,1
45588,0,1,0,0,1
45589,0,1,0,0,1
45590,0,1,0,0,1
45591,0,1,0,0,1
45592,0,1,0,0,1
45593,0,1,0,0,1
45594,0,1,0,0,1
45595,0,1,0,0,1
45596,0,1,0,0,1
45597,0,1,0,0,1
45598,0,1,0,0,1
45599,0,1,0,0,1
45600,0,0,1,0,1
45601,0,1,0,0,1
45602,0,1,0,0,1
45603,0,0,0,1,1
45604,0,1,0,0,1
45605,0,1,0,0,1
45606,0,1,0,0,1
45607,0,1,0,0,1
45608,0,1,0,0,1
45609,0,1,0,0,1
45610,0,1,0,0,1
45611,0,1,0,0,1
45612,0,1,0,0,1
45613,0,1,0,0,1
45614,0,1,0,0,1
45615,0,1,0,0,1
45616,0,1,0,0,1
45617,0,1,0,0,1
45618,0,1,0,0,1
45619,1,0,0,0,1
45620,0,1,0,0,1
45621,0,1,0,0,1
45622,0,1,0,0,1
45623,1,0,0,0,1
45624,0,1,0,0,1
45625,0,1,0,0,1
45626,0,1,0,0,1
45627,0,1,0,0,1
45628,0,1,0,0,1
45629,0,1,0,0,1
45630,0,1,0,0,1
45631,0,1,0,0,1
45632,1,0,0,0,1
45633,1,0,0,0,1
45634,0,0,1,0,1
45635,0,1,0,0,1
45636,0,1,0,0,1
45637,0,1,0,0,1
45638,0,1,0,0,1
45639,0,1,0,0,1
45640,0,1,0,0,1
45641,0,1,0,0,1
45642,0,1,0,0,1
45643,0,1,0,0,1
45644,0,1,0,0,1
45645,0,1,0,0,1
45646,0,1,0,0,1
45647,0,1,0,0,1
45648,0,1,0,0,1
45649,0,1,0,0,1
45650,0,1,0,0,1
45651,0,1,0,0,1
45652,0,1,0,0,1
45653,0,1,0,0,1
45654,0,1,0,0,1
45655,0,1,0,0,1
45656,0,1,0,0,1
45657,1,0,0,0,1
45658,0,1,0,0,1
45659,0,1,0,0,1
45660,0,1,0,0,1
45661,0,1,0,0,1
45662,0,0,0,1,1
45663,0,1,0,0,1
45664,0,1,0,0,1
45665,1,0,0,0,1
45666,0,1,0,0,1
45667,0,0,1,0,1
45668,0,1,0,0,1
45669,0,1,0,0,1
45670,0,1,0,0,1
45671,0,1,0,0,1
45672,0,1,0,0,1
45673,0,1,0,0,1
45674,0,1,0,0,1
45675,0,1,0,0,1
45676,0,1,0,0,1
45677,0,1,0,0,1
45678,0,1,0,0,1
45679,0,1,0,0,1
45680,0,1,0,0,1
45681,0,1,0,0,1
45682,0,1,0,0,1
45683,0,1,0,0,1
45684,0,1,0,0,1
45685,0,1,0,0,1
45686,0,1,0,0,1
45687,0,1,0,0,1
45688,0,1,0,0,1
45689,0,1,0,0,1
45690,0,1,0,0,1
45691,0,1,0,0,1
45692,0,1,0,0,1
45693,0,1,0,0,1
45694,0,1,0,0,1
45695,0,1,0,0,1
45696,0,1,0,0,1
45697,0,1,0,0,1
45698,0,0,1,0,1
45699,0,1,0,0,1
45700,0,0,0,1,1
45701,0,1,0,0,1
45702,0,1,0,0,1
45703,0,1,0,0,1
45704,0,1,0,0,1
45705,0,1,0,0,1
45706,1,0,0,0,1
45707,0,1,0,0,1
45708,0,1,0,0,1
45709,1,0,0,0,1
45710,0,1,0,0,1
45711,1,0,0,0,1
45712,0,1,0,0,1
45713,0,1,0,0,1
45714,0,1,0,0,1
45715,0,1,0,0,1
45716,1,0,0,0,1
45717,1,0,0,0,1
45718,1,0,0,0,1
45719,0,1,0,0,1
45720,0,1,0,0,1
45721,0,1,0,0,1
45722,0,1,0,0,1
45723,1,0,0,0,1
45724,0,1,0,0,1
45725,0,1,0,0,1
45726,0,1,0,0,1
45727,1,0,0,0,1
45728,0,1,0,0,1
45729,1,0,0,0,1
45730,0,1,0,0,1
45731,0,1,0,0,1
45732,0,1,0,0,1
45733,1,0,0,0,1
45734,0,1,0,0,1
45735,0,1,0,0,1
45736,1,0,0,0,1
45737,0,1,0,0,1
45738,0,1,0,0,1
45739,1,0,0,0,1
45740,0,1,0,0,1
45741,1,0,0,0,1
45742,0,1,0,0,1
45743,1,0,0,0,1
45744,0,1,0,0,1
45745,0,1,0,0,1
45746,0,1,0,0,1
45747,0,1,0,0,1
45748,0,1,0,0,1
45749,0,1,0,0,1
45750,0,1,0,0,1
45751,0,1,0,0,1
45752,0,1,0,0,1
45753,0,1,0,0,1
45754,0,1,0,0,1
45755,0,1,0,0,1
45756,0,1,0,0,1
45757,0,1,0,0,1
45758,0,1,0,0,1
45759,0,1,0,0,1
45760,0,1,0,0,1
45761,0,0,1,0,1
45762,0,1,0,0,1
45763,0,1,0,0,1
45764,0,1,0,0,1
45765,0,1,0,0,1
45766,0,0,0,1,1
45767,0,1,0,0,1
45768,1,0,0,0,1
45769,0,1,0,0,1
45770,0,1,0,0,1
45771,0,1,0,0,1
45772,1,0,0,0,1
45773,0,1,0,0,1
45774,0,1,0,0,1
45775,0,1,0,0,1
45776,0,1,0,0,1
45777,0,0,0,1,1
45778,0,1,0,0,1
45779,0,1,0,0,1
45780,0,1,0,0,1
45781,0,1,0,0,1
45782,0,1,0,0,1
45783,0,1,0,0,1
45784,0,1,0,0,1
45785,0,1,0,0,1
45786,0,1,0,0,1
45787,0,1,0,0,1
45788,0,1,0,0,1
45789,0,1,0,0,1
45790,1,0,0,0,1
45791,0,1,0,0,1
45792,0,1,0,0,1
45793,0,1,0,0,1
45794,0,1,0,0,1
45795,0,0,0,1,1
45796,0,1,0,0,1
45797,0,1,0,0,1
45798,0,1,0,0,1
45799,0,1,0,0,1
45800,0,1,0,0,1
45801,0,1,0,0,1
45802,1,0,0,0,1
45803,0,1,0,0,1
45804,0,1,0,0,1
45805,0,1,0,0,1
45806,0,1,0,0,1
45807,0,1,0,0,1
45808,0,1,0,0,1
45809,1,0,0,0,1
45810,0,1,0,0,1
45811,0,1,0,0,1
45812,1,0,0,0,1
45813,1,0,0,0,1
45814,0,1,0,0,1
45815,0,1,0,0,1
45816,0,1,0,0,1
45817,1,0,0,0,1
45818,0,1,0,0,1
45819,0,1,0,0,1
45820,0,1,0,0,1
45821,0,1,0,0,1
45822,1,0,0,0,1
45823,0,1,0,0,1
45824,1,0,0,0,1
45825,0,1,0,0,1
45826,0,1,0,0,1
45827,0,1,0,0,1
45828,1,0,0,0,1
45829,1,0,0,0,1
45830,0,1,0,0,1
45831,0,1,0,0,1
45832,0,1,0,0,1
45833,0,1,0,0,1
45834,0,1,0,0,1
45835,0,1,0,0,1
45836,0,0,0,1,1
45837,0,1,0,0,1
45838,0,1,0,0,1
45839,0,1,0,0,1
45840,0,1,0,0,1
45841,0,1,0,0,1
45842,1,0,0,0,1
45843,1,0,0,0,1
45844,0,1,0,0,1
45845,0,1,0,0,1
45846,0,1,0,0,1
45847,0,1,0,0,1
45848,0,1,0,0,1
45849,0,1,0,0,1
45850,0,1,0,0,1
45851,0,1,0,0,1
45852,0,1,0,0,1
45853,0,0,1,0,1
45854,0,1,0,0,1
45855,0,1,0,0,1
45856,1,0,0,0,1
45857,0,1,0,0,1
45858,0,1,0,0,1
45859,0,1,0,0,1
45860,0,1,0,0,1
45861,0,1,0,0,1
45862,0,1,0,0,1
45863,0,1,0,0,1
45864,0,1,0,0,1
45865,0,1,0,0,1
45866,1,0,0,0,1
45867,0,1,0,0,1
45868,0,1,0,0,1
45869,0,1,0,0,1
45870,0,1,0,0,1
45871,0,1,0,0,1
45872,0,1,0,0,1
45873,0,1,0,0,1
45874,0,1,0,0,1
45875,1,0,0,0,1
45876,0,1,0,0,1
45877,0,1,0,0,1
45878,0,1,0,0,1
45879,0,1,0,0,1
45880,0,1,0,0,1
45881,0,1,0,0,1
45882,0,1,0,0,1
45883,0,1,0,0,1
45884,0,1,0,0,1
45885,0,1,0,0,1
45886,0,1,0,0,1
45887,0,1,0,0,1
45888,1,0,0,0,1
45889,0,1,0,0,1
45890,0,1,0,0,1
45891,0,1,0,0,1
45892,0,1,0,0,1
45893,0,1,0,0,1
45894,0,1,0,0,1
45895,0,1,0,0,1
45896,0,1,0,0,1
45897,1,0,0,0,1
45898,0,1,0,0,1
45899,0,0,1,0,1
45900,0,1,0,0,1
45901,0,1,0,0,1
45902,1,0,0,0,1
45903,0,1,0,0,1
45904,0,1,0,0,1
45905,0,1,0,0,1
45906,0,1,0,0,1
45907,0,1,0,0,1
45908,0,1,0,0,1
45909,0,1,0,0,1
45910,0,0,1,0,1
45911,0,1,0,0,1
45912,0,1,0,0,1
45913,0,1,0,0,1
45914,0,1,0,0,1
45915,1,0,0,0,1
45916,0,1,0,0,1
45917,0,1,0,0,1
45918,0,1,0,0,1
45919,0,1,0,0,1
45920,0,1,0,0,1
45921,0,1,0,0,1
45922,0,1,0,0,1
45923,0,1,0,0,1
45924,0,1,0,0,1
45925,0,1,0,0,1
45926,0,1,0,0,1
45927,1,0,0,0,1
45928,0,1,0,0,1
45929,0,1,0,0,1
45930,0,1,0,0,1
45931,1,0,0,0,1
45932,0,1,0,0,1
45933,0,1,0,0,1
45934,0,1,0,0,1
45935,0,1,0,0,1
45936,0,1,0,0,1
45937,0,1,0,0,1
45938,0,1,0,0,1
45939,0,1,0,0,1
45940,0,1,0,0,1
45941,1,0,0,0,1
45942,0,1,0,0,1
45943,0,1,0,0,1
45944,0,1,0,0,1
45945,1,0,0,0,1
45946,0,1,0,0,1
45947,0,1,0,0,1
45948,0,1,0,0,1
45949,0,1,0,0,1
45950,0,1,0,0,1
45951,0,1,0,0,1
45952,0,1,0,0,1
45953,0,1,0,0,1
45954,0,1,0,0,1
45955,0,1,0,0,1
45956,0,1,0,0,1
45957,0,1,0,0,1
45958,0,1,0,0,1
45959,0,1,0,0,1
45960,0,1,0,0,1
45961,0,1,0,0,1
45962,0,1,0,0,1
45963,0,1,0,0,1
45964,0,0,0,1,1
45965,0,1,0,0,1
45966,0,1,0,0,1
45967,0,1,0,0,1
45968,0,0,0,1,1
45969,0,1,0,0,1
45970,1,0,0,0,1
45971,0,1,0,0,1
45972,0,1,0,0,1
45973,0,1,0,0,1
45974,0,1,0,0,1
45975,0,1,0,0,1
45976,0,1,0,0,1
45977,1,0,0,0,1
45978,1,0,0,0,1
45979,0,1,0,0,1
45980,0,1,0,0,1
45981,0,1,0,0,1
45982,0,1,0,0,1
45983,0,1,0,0,1
45984,0,1,0,0,1
45985,1,0,0,0,1
45986,0,1,0,0,1
45987,0,1,0,0,1
45988,0,1,0,0,1
45989,0,1,0,0,1
45990,0,1,0,0,1
45991,0,1,0,0,1
45992,0,1,0,0,1
45993,0,1,0,0,1
45994,0,1,0,0,1
45995,0,1,0,0,1
45996,0,1,0,0,1
45997,0,1,0,0,1
45998,0,1,0,0,1
45999,0,1,0,0,1
46000,0,1,0,0,1
46001,0,1,0,0,1
46002,0,1,0,0,1
46003,0,1,0,0,1
46004,0,1,0,0,1
46005,0,1,0,0,1
46006,0,1,0,0,1
46007,0,1,0,0,1
46008,1,0,0,0,1
46009,1,0,0,0,1
46010,0,1,0,0,1
46011,0,1,0,0,1
46012,0,1,0,0,1
46013,0,1,0,0,1
46014,0,1,0,0,1
46015,0,1,0,0,1
46016,0,0,1,0,1
46017,0,1,0,0,1
46018,0,1,0,0,1
46019,0,1,0,0,1
46020,0,1,0,0,1
46021,0,1,0,0,1
46022,0,1,0,0,1
46023,0,1,0,0,1
46024,0,0,1,0,1
46025,1,0,0,0,1
46026,1,0,0,0,1
46027,1,0,0,0,1
46028,0,1,0,0,1
46029,0,1,0,0,1
46030,0,1,0,0,1
46031,0,1,0,0,1
46032,0,1,0,0,1
46033,0,1,0,0,1
46034,0,1,0,0,1
46035,0,1,0,0,1
46036,0,1,0,0,1
46037,0,1,0,0,1
46038,0,1,0,0,1
46039,0,1,0,0,1
46040,1,0,0,0,1
46041,0,1,0,0,1
46042,0,1,0,0,1
46043,0,1,0,0,1
46044,0,1,0,0,1
46045,0,1,0,0,1
46046,0,1,0,0,1
46047,0,1,0,0,1
46048,0,1,0,0,1
46049,0,1,0,0,1
46050,0,0,1,0,1
46051,0,1,0,0,1
46052,0,1,0,0,1
46053,0,1,0,0,1
46054,1,0,0,0,1
46055,0,1,0,0,1
46056,1,0,0,0,1
46057,1,0,0,0,1
46058,0,1,0,0,1
46059,0,1,0,0,1
46060,0,1,0,0,1
46061,0,0,1,0,1
46062,0,1,0,0,1
46063,0,1,0,0,1
46064,0,1,0,0,1
46065,1,0,0,0,1
46066,1,0,0,0,1
46067,1,0,0,0,1
46068,0,1,0,0,1
46069,0,1,0,0,1
46070,0,1,0,0,1
46071,0,1,0,0,1
46072,0,1,0,0,1
46073,0,1,0,0,1
46074,0,1,0,0,1
46075,0,1,0,0,1
46076,0,1,0,0,1
46077,0,1,0,0,1
46078,0,1,0,0,1
46079,0,1,0,0,1
46080,0,0,1,0,1
46081,0,0,1,0,1
46082,0,1,0,0,1
46083,0,1,0,0,1
46084,0,1,0,0,1
46085,0,1,0,0,1
46086,0,1,0,0,1
46087,0,1,0,0,1
46088,1,0,0,0,1
46089,0,1,0,0,1
46090,0,1,0,0,1
46091,0,1,0,0,1
46092,0,1,0,0,1
46093,1,0,0,0,1
46094,0,1,0,0,1
46095,0,1,0,0,1
46096,0,1,0,0,1
46097,1,0,0,0,1
46098,1,0,0,0,1
46099,0,1,0,0,1
46100,0,1,0,0,1
46101,1,0,0,0,1
46102,0,1,0,0,1
46103,0,0,0,1,1
46104,0,1,0,0,1
46105,0,1,0,0,1
46106,0,1,0,0,1
46107,0,1,0,0,1
46108,0,1,0,0,1
46109,1,0,0,0,1
46110,0,1,0,0,1
46111,0,1,0,0,1
46112,0,0,1,0,1
46113,0,0,0,1,1
46114,0,1,0,0,1
46115,0,1,0,0,1
46116,0,1,0,0,1
46117,0,1,0,0,1
46118,0,1,0,0,1
46119,1,0,0,0,1
46120,0,1,0,0,1
46121,0,1,0,0,1
46122,1,0,0,0,1
46123,0,1,0,0,1
46124,1,0,0,0,1
46125,0,1,0,0,1
46126,0,1,0,0,1
46127,0,1,0,0,1
46128,0,1,0,0,1
46129,0,1,0,0,1
46130,0,1,0,0,1
46131,0,1,0,0,1
46132,0,1,0,0,1
46133,0,1,0,0,1
46134,0,1,0,0,1
46135,0,1,0,0,1
46136,1,0,0,0,1
46137,0,1,0,0,1
46138,0,1,0,0,1
46139,0,1,0,0,1
46140,1,0,0,0,1
46141,1,0,0,0,1
46142,0,1,0,0,1
46143,0,1,0,0,1
46144,1,0,0,0,1
46145,0,1,0,0,1
46146,0,1,0,0,1
46147,0,1,0,0,1
46148,0,1,0,0,1
46149,0,1,0,0,1
46150,0,1,0,0,1
46151,0,1,0,0,1
46152,0,1,0,0,1
46153,0,1,0,0,1
46154,0,1,0,0,1
46155,0,1,0,0,1
46156,0,1,0,0,1
46157,0,1,0,0,1
46158,0,1,0,0,1
46159,0,1,0,0,1
46160,0,1,0,0,1
46161,0,1,0,0,1
46162,0,1,0,0,1
46163,0,1,0,0,1
46164,0,1,0,0,1
46165,0,1,0,0,1
46166,0,1,0,0,1
46167,0,1,0,0,1
46168,0,1,0,0,1
46169,0,1,0,0,1
46170,0,1,0,0,1
46171,0,1,0,0,1
46172,0,1,0,0,1
46173,0,1,0,0,1
46174,0,1,0,0,1
46175,0,1,0,0,1
46176,0,1,0,0,1
46177,0,1,0,0,1
46178,0,1,0,0,1
46179,1,0,0,0,1
46180,0,1,0,0,1
46181,0,1,0,0,1
46182,0,1,0,0,1
46183,0,1,0,0,1
46184,0,1,0,0,1
46185,0,1,0,0,1
46186,1,0,0,0,1
46187,0,1,0,0,1
46188,0,1,0,0,1
46189,0,1,0,0,1
46190,1,0,0,0,1
46191,0,1,0,0,1
46192,0,1,0,0,1
46193,0,1,0,0,1
46194,0,0,0,1,1
46195,0,1,0,0,1
46196,1,0,0,0,1
46197,0,1,0,0,1
46198,0,1,0,0,1
46199,0,1,0,0,1
46200,1,0,0,0,1
46201,0,1,0,0,1
46202,0,1,0,0,1
46203,0,1,0,0,1
46204,0,1,0,0,1
46205,0,1,0,0,1
46206,0,1,0,0,1
46207,0,1,0,0,1
46208,1,0,0,0,1
46209,0,1,0,0,1
46210,0,1,0,0,1
46211,0,1,0,0,1
46212,0,0,0,1,1
46213,0,1,0,0,1
46214,0,1,0,0,1
46215,0,1,0,0,1
46216,0,1,0,0,1
46217,0,1,0,0,1
46218,0,1,0,0,1
46219,0,1,0,0,1
46220,0,1,0,0,1
46221,0,1,0,0,1
46222,0,1,0,0,1
46223,0,1,0,0,1
46224,0,1,0,0,1
46225,0,1,0,0,1
46226,0,1,0,0,1
46227,0,1,0,0,1
46228,0,1,0,0,1
46229,0,1,0,0,1
46230,0,1,0,0,1
46231,1,0,0,0,1
46232,0,1,0,0,1
46233,0,0,0,1,1
46234,1,0,0,0,1
46235,0,1,0,0,1
46236,0,1,0,0,1
46237,0,1,0,0,1
46238,0,1,0,0,1
46239,1,0,0,0,1
46240,0,1,0,0,1
46241,0,1,0,0,1
46242,0,1,0,0,1
46243,0,1,0,0,1
46244,0,1,0,0,1
46245,0,1,0,0,1
46246,0,1,0,0,1
46247,0,1,0,0,1
46248,1,0,0,0,1
46249,0,0,0,1,1
46250,0,1,0,0,1
46251,0,1,0,0,1
46252,0,1,0,0,1
46253,0,1,0,0,1
46254,0,1,0,0,1
46255,0,1,0,0,1
46256,0,1,0,0,1
46257,0,1,0,0,1
46258,0,1,0,0,1
46259,1,0,0,0,1
46260,0,1,0,0,1
46261,1,0,0,0,1
46262,0,1,0,0,1
46263,0,1,0,0,1
46264,0,1,0,0,1
46265,0,1,0,0,1
46266,0,1,0,0,1
46267,0,1,0,0,1
46268,0,1,0,0,1
46269,0,1,0,0,1
46270,0,1,0,0,1
46271,0,1,0,0,1
46272,0,1,0,0,1
46273,1,0,0,0,1
46274,0,1,0,0,1
46275,0,1,0,0,1
46276,0,1,0,0,1
46277,0,1,0,0,1
46278,0,1,0,0,1
46279,0,1,0,0,1
46280,0,1,0,0,1
46281,0,1,0,0,1
46282,0,0,1,0,1
46283,0,1,0,0,1
46284,0,1,0,0,1
46285,0,1,0,0,1
46286,0,1,0,0,1
46287,0,1,0,0,1
46288,0,1,0,0,1
46289,1,0,0,0,1
46290,0,1,0,0,1
46291,0,1,0,0,1
46292,0,1,0,0,1
46293,0,1,0,0,1
46294,0,1,0,0,1
46295,0,1,0,0,1
46296,0,1,0,0,1
46297,0,0,0,1,1
46298,0,1,0,0,1
46299,0,1,0,0,1
46300,0,0,1,0,1
46301,0,1,0,0,1
46302,0,1,0,0,1
46303,0,1,0,0,1
46304,1,0,0,0,1
46305,0,1,0,0,1
46306,0,1,0,0,1
46307,0,1,0,0,1
46308,0,1,0,0,1
46309,0,1,0,0,1
46310,0,0,0,1,1
46311,0,1,0,0,1
46312,0,1,0,0,1
46313,0,1,0,0,1
46314,0,1,0,0,1
46315,0,1,0,0,1
46316,0,1,0,0,1
46317,0,1,0,0,1
46318,0,1,0,0,1
46319,0,1,0,0,1
46320,0,1,0,0,1
46321,0,1,0,0,1
46322,0,0,1,0,1
46323,0,1,0,0,1
46324,0,1,0,0,1
46325,0,1,0,0,1
46326,0,1,0,0,1
46327,0,1,0,0,1
46328,1,0,0,0,1
46329,0,1,0,0,1
46330,0,1,0,0,1
46331,0,1,0,0,1
46332,0,1,0,0,1
46333,0,1,0,0,1
46334,0,1,0,0,1
46335,0,1,0,0,1
46336,1,0,0,0,1
46337,0,1,0,0,1
46338,0,1,0,0,1
46339,0,1,0,0,1
46340,0,1,0,0,1
46341,0,1,0,0,1
46342,1,0,0,0,1
46343,0,1,0,0,1
46344,0,1,0,0,1
46345,0,1,0,0,1
46346,0,1,0,0,1
46347,0,1,0,0,1
46348,0,1,0,0,1
46349,0,1,0,0,1
46350,1,0,0,0,1
46351,0,1,0,0,1
46352,0,1,0,0,1
46353,1,0,0,0,1
46354,0,1,0,0,1
46355,0,1,0,0,1
46356,1,0,0,0,1
46357,0,1,0,0,1
46358,0,1,0,0,1
46359,0,1,0,0,1
46360,0,1,0,0,1
46361,0,1,0,0,1
46362,0,1,0,0,1
46363,0,1,0,0,1
46364,0,1,0,0,1
46365,0,1,0,0,1
46366,0,1,0,0,1
46367,1,0,0,0,1
46368,0,0,1,0,1
46369,0,1,0,0,1
46370,0,1,0,0,1
46371,0,1,0,0,1
46372,1,0,0,0,1
46373,0,1,0,0,1
46374,0,1,0,0,1
46375,0,1,0,0,1
46376,1,0,0,0,1
46377,0,1,0,0,1
46378,0,0,1,0,1
46379,0,1,0,0,1
46380,0,1,0,0,1
46381,0,1,0,0,1
46382,0,1,0,0,1
46383,0,1,0,0,1
46384,0,1,0,0,1
46385,0,1,0,0,1
46386,1,0,0,0,1
46387,0,1,0,0,1
46388,0,1,0,0,1
46389,0,1,0,0,1
46390,0,1,0,0,1
46391,0,1,0,0,1
46392,0,1,0,0,1
46393,0,1,0,0,1
46394,0,1,0,0,1
46395,0,1,0,0,1
46396,0,1,0,0,1
46397,0,1,0,0,1
46398,0,0,0,1,1
46399,0,1,0,0,1
46400,0,1,0,0,1
46401,0,1,0,0,1
46402,0,1,0,0,1
46403,1,0,0,0,1
46404,0,1,0,0,1
46405,0,1,0,0,1
46406,0,1,0,0,1
46407,0,1,0,0,1
46408,0,1,0,0,1
46409,0,1,0,0,1
46410,0,1,0,0,1
46411,0,1,0,0,1
46412,0,1,0,0,1
46413,1,0,0,0,1
46414,0,1,0,0,1
46415,0,1,0,0,1
46416,0,1,0,0,1
46417,0,1,0,0,1
46418,0,1,0,0,1
46419,0,1,0,0,1
46420,0,1,0,0,1
46421,0,1,0,0,1
46422,0,1,0,0,1
46423,0,1,0,0,1
46424,1,0,0,0,1
46425,1,0,0,0,1
46426,0,1,0,0,1
46427,0,1,0,0,1
46428,1,0,0,0,1
46429,1,0,0,0,1
46430,0,1,0,0,1
46431,0,1,0,0,1
46432,0,1,0,0,1
46433,0,1,0,0,1
46434,0,0,0,1,1
46435,0,1,0,0,1
46436,0,1,0,0,1
46437,0,1,0,0,1
46438,0,1,0,0,1
46439,0,1,0,0,1
46440,0,1,0,0,1
46441,0,1,0,0,1
46442,0,1,0,0,1
46443,0,1,0,0,1
46444,0,1,0,0,1
46445,0,1,0,0,1
46446,0,1,0,0,1
46447,0,1,0,0,1
46448,0,1,0,0,1
46449,0,0,0,1,1
46450,0,1,0,0,1
46451,0,1,0,0,1
46452,0,1,0,0,1
46453,0,1,0,0,1
46454,0,1,0,0,1
46455,0,1,0,0,1
46456,0,1,0,0,1
46457,1,0,0,0,1
46458,1,0,0,0,1
46459,0,1,0,0,1
46460,0,0,1,0,1
46461,0,1,0,0,1
46462,0,1,0,0,1
46463,0,1,0,0,1
46464,0,1,0,0,1
46465,0,1,0,0,1
46466,0,0,0,1,1
46467,0,1,0,0,1
46468,0,1,0,0,1
46469,0,1,0,0,1
46470,0,1,0,0,1
46471,0,1,0,0,1
46472,0,1,0,0,1
46473,0,1,0,0,1
46474,0,1,0,0,1
46475,0,1,0,0,1
46476,1,0,0,0,1
46477,0,1,0,0,1
46478,0,1,0,0,1
46479,0,1,0,0,1
46480,0,1,0,0,1
46481,0,1,0,0,1
46482,0,1,0,0,1
46483,0,1,0,0,1
46484,0,1,0,0,1
46485,0,1,0,0,1
46486,0,1,0,0,1
46487,0,1,0,0,1
46488,0,1,0,0,1
46489,0,1,0,0,1
46490,0,1,0,0,1
46491,0,1,0,0,1
46492,0,1,0,0,1
46493,0,1,0,0,1
46494,0,1,0,0,1
46495,0,1,0,0,1
46496,0,1,0,0,1
46497,0,1,0,0,1
46498,0,1,0,0,1
46499,0,1,0,0,1
46500,0,1,0,0,1
46501,1,0,0,0,1
46502,0,1,0,0,1
46503,0,1,0,0,1
46504,0,1,0,0,1
46505,0,1,0,0,1
46506,0,1,0,0,1
46507,0,1,0,0,1
46508,0,1,0,0,1
46509,0,1,0,0,1
46510,0,1,0,0,1
46511,0,1,0,0,1
46512,0,1,0,0,1
46513,0,1,0,0,1
46514,0,1,0,0,1
46515,0,1,0,0,1
46516,0,1,0,0,1
46517,0,1,0,0,1
46518,0,1,0,0,1
46519,1,0,0,0,1
46520,1,0,0,0,1
46521,0,1,0,0,1
46522,0,1,0,0,1
46523,0,1,0,0,1
46524,0,1,0,0,1
46525,0,1,0,0,1
46526,0,1,0,0,1
46527,1,0,0,0,1
46528,0,1,0,0,1
46529,0,1,0,0,1
46530,0,1,0,0,1
46531,1,0,0,0,1
46532,0,0,0,1,1
46533,0,1,0,0,1
46534,0,1,0,0,1
46535,0,0,1,0,1
46536,0,1,0,0,1
46537,0,1,0,0,1
46538,0,1,0,0,1
46539,0,1,0,0,1
46540,0,1,0,0,1
46541,0,1,0,0,1
46542,0,1,0,0,1
46543,0,1,0,0,1
46544,0,1,0,0,1
46545,1,0,0,0,1
46546,0,1,0,0,1
46547,1,0,0,0,1
46548,0,1,0,0,1
46549,0,1,0,0,1
46550,0,1,0,0,1
46551,0,1,0,0,1
46552,0,1,0,0,1
46553,0,1,0,0,1
46554,0,1,0,0,1
46555,0,1,0,0,1
46556,1,0,0,0,1
46557,0,1,0,0,1
46558,0,0,0,1,1
46559,1,0,0,0,1
46560,0,0,0,1,1
46561,0,1,0,0,1
46562,0,1,0,0,1
46563,0,1,0,0,1
46564,0,0,1,0,1
46565,1,0,0,0,1
46566,0,1,0,0,1
46567,0,1,0,0,1
46568,0,1,0,0,1
46569,0,1,0,0,1
46570,0,1,0,0,1
46571,0,1,0,0,1
46572,1,0,0,0,1
46573,0,1,0,0,1
46574,0,1,0,0,1
46575,1,0,0,0,1
46576,0,1,0,0,1
46577,0,1,0,0,1
46578,0,1,0,0,1
46579,0,1,0,0,1
46580,0,0,1,0,1
46581,1,0,0,0,1
46582,1,0,0,0,1
46583,0,1,0,0,1
46584,0,1,0,0,1
46585,0,1,0,0,1
46586,0,1,0,0,1
46587,0,1,0,0,1
46588,0,1,0,0,1
46589,0,1,0,0,1
46590,0,1,0,0,1
46591,1,0,0,0,1
46592,0,1,0,0,1
46593,0,0,0,1,1
46594,1,0,0,0,1
46595,1,0,0,0,1
46596,0,1,0,0,1
46597,1,0,0,0,1
46598,0,1,0,0,1
46599,0,0,0,1,1
46600,0,1,0,0,1
46601,0,1,0,0,1
46602,0,1,0,0,1
46603,0,1,0,0,1
46604,0,1,0,0,1
46605,0,1,0,0,1
46606,0,1,0,0,1
46607,0,1,0,0,1
46608,0,1,0,0,1
46609,0,1,0,0,1
46610,0,1,0,0,1
46611,0,1,0,0,1
46612,0,1,0,0,1
46613,0,1,0,0,1
46614,0,1,0,0,1
46615,0,1,0,0,1
46616,0,1,0,0,1
46617,0,1,0,0,1
46618,0,1,0,0,1
46619,0,1,0,0,1
46620,0,1,0,0,1
46621,0,1,0,0,1
46622,0,1,0,0,1
46623,0,1,0,0,1
46624,1,0,0,0,1
46625,1,0,0,0,1
46626,0,1,0,0,1
46627,0,1,0,0,1
46628,0,1,0,0,1
46629,0,0,0,1,1
46630,1,0,0,0,1
46631,0,1,0,0,1
46632,1,0,0,0,1
46633,0,1,0,0,1
46634,0,1,0,0,1
46635,0,1,0,0,1
46636,0,1,0,0,1
46637,0,1,0,0,1
46638,0,1,0,0,1
46639,0,1,0,0,1
46640,0,1,0,0,1
46641,0,1,0,0,1
46642,0,1,0,0,1
46643,1,0,0,0,1
46644,0,1,0,0,1
46645,0,1,0,0,1
46646,0,1,0,0,1
46647,0,1,0,0,1
46648,0,0,0,1,1
46649,0,1,0,0,1
46650,0,1,0,0,1
46651,0,1,0,0,1
46652,1,0,0,0,1
46653,0,1,0,0,1
46654,0,1,0,0,1
46655,0,1,0,0,1
46656,0,1,0,0,1
46657,0,1,0,0,1
46658,1,0,0,0,1
46659,0,1,0,0,1
46660,1,0,0,0,1
46661,0,1,0,0,1
46662,0,1,0,0,1
46663,1,0,0,0,1
46664,1,0,0,0,1
46665,0,1,0,0,1
46666,0,1,0,0,1
46667,0,1,0,0,1
46668,0,1,0,0,1
46669,0,1,0,0,1
46670,0,1,0,0,1
46671,0,1,0,0,1
46672,0,1,0,0,1
46673,1,0,0,0,1
46674,0,1,0,0,1
46675,0,1,0,0,1
46676,0,1,0,0,1
46677,1,0,0,0,1
46678,0,1,0,0,1
46679,0,1,0,0,1
46680,0,1,0,0,1
46681,1,0,0,0,1
46682,0,1,0,0,1
46683,0,1,0,0,1
46684,0,1,0,0,1
46685,0,1,0,0,1
46686,0,1,0,0,1
46687,0,1,0,0,1
46688,1,0,0,0,1
46689,0,1,0,0,1
46690,0,1,0,0,1
46691,0,1,0,0,1
46692,0,1,0,0,1
46693,0,1,0,0,1
46694,0,0,1,0,1
46695,0,1,0,0,1
46696,0,1,0,0,1
46697,1,0,0,0,1
46698,0,1,0,0,1
46699,1,0,0,0,1
46700,1,0,0,0,1
46701,0,1,0,0,1
46702,0,1,0,0,1
46703,0,1,0,0,1
46704,0,1,0,0,1
46705,0,1,0,0,1
46706,1,0,0,0,1
46707,0,1,0,0,1
46708,0,1,0,0,1
46709,0,1,0,0,1
46710,0,0,1,0,1
46711,0,1,0,0,1
46712,0,1,0,0,1
46713,0,1,0,0,1
46714,0,1,0,0,1
46715,0,1,0,0,1
46716,0,1,0,0,1
46717,0,1,0,0,1
46718,0,1,0,0,1
46719,0,1,0,0,1
46720,0,1,0,0,1
46721,0,1,0,0,1
46722,0,1,0,0,1
46723,0,1,0,0,1
46724,0,1,0,0,1
46725,0,1,0,0,1
46726,0,1,0,0,1
46727,0,1,0,0,1
46728,0,1,0,0,1
46729,0,1,0,0,1
46730,0,1,0,0,1
46731,1,0,0,0,1
46732,0,0,1,0,1
46733,0,1,0,0,1
46734,0,1,0,0,1
46735,0,1,0,0,1
46736,0,1,0,0,1
46737,0,1,0,0,1
46738,0,1,0,0,1
46739,0,1,0,0,1
46740,0,1,0,0,1
46741,0,1,0,0,1
46742,0,1,0,0,1
46743,0,1,0,0,1
46744,0,1,0,0,1
46745,0,1,0,0,1
46746,0,1,0,0,1
46747,0,1,0,0,1
46748,0,1,0,0,1
46749,0,1,0,0,1
46750,1,0,0,0,1
46751,0,1,0,0,1
46752,0,1,0,0,1
46753,0,1,0,0,1
46754,0,1,0,0,1
46755,0,1,0,0,1
46756,0,1,0,0,1
46757,0,1,0,0,1
46758,0,1,0,0,1
46759,0,1,0,0,1
46760,0,1,0,0,1
46761,0,1,0,0,1
46762,0,1,0,0,1
46763,0,1,0,0,1
46764,0,1,0,0,1
46765,0,1,0,0,1
46766,0,0,1,0,1
46767,0,1,0,0,1
46768,0,1,0,0,1
46769,0,1,0,0,1
46770,0,1,0,0,1
46771,0,1,0,0,1
46772,0,1,0,0,1
46773,0,1,0,0,1
46774,0,1,0,0,1
46775,1,0,0,0,1
46776,0,1,0,0,1
46777,0,1,0,0,1
46778,0,1,0,0,1
46779,1,0,0,0,1
46780,0,1,0,0,1
46781,0,1,0,0,1
46782,0,1,0,0,1
46783,0,1,0,0,1
46784,0,1,0,0,1
46785,0,1,0,0,1
46786,0,1,0,0,1
46787,0,1,0,0,1
46788,0,1,0,0,1
46789,1,0,0,0,1
46790,0,1,0,0,1
46791,0,1,0,0,1
46792,1,0,0,0,1
46793,0,1,0,0,1
46794,0,1,0,0,1
46795,1,0,0,0,1
46796,0,1,0,0,1
46797,0,1,0,0,1
46798,0,1,0,0,1
46799,0,1,0,0,1
46800,1,0,0,0,1
46801,0,1,0,0,1
46802,0,1,0,0,1
46803,0,1,0,0,1
46804,0,1,0,0,1
46805,0,1,0,0,1
46806,0,1,0,0,1
46807,0,1,0,0,1
46808,0,1,0,0,1
46809,0,1,0,0,1
46810,0,1,0,0,1
46811,0,1,0,0,1
46812,0,1,0,0,1
46813,0,1,0,0,1
46814,0,1,0,0,1
46815,0,1,0,0,1
46816,0,0,1,0,1
46817,0,0,1,0,1
46818,0,1,0,0,1
46819,0,1,0,0,1
46820,0,1,0,0,1
46821,0,1,0,0,1
46822,0,1,0,0,1
46823,0,1,0,0,1
46824,1,0,0,0,1
46825,0,1,0,0,1
46826,0,1,0,0,1
46827,0,1,0,0,1
46828,0,1,0,0,1
46829,0,1,0,0,1
46830,1,0,0,0,1
46831,0,1,0,0,1
46832,0,1,0,0,1
46833,0,1,0,0,1
46834,0,1,0,0,1
46835,0,1,0,0,1
46836,1,0,0,0,1
46837,1,0,0,0,1
46838,0,1,0,0,1
46839,0,1,0,0,1
46840,0,1,0,0,1
46841,0,1,0,0,1
46842,0,1,0,0,1
46843,0,0,0,1,1
46844,0,1,0,0,1
46845,0,1,0,0,1
46846,0,1,0,0,1
46847,0,1,0,0,1
46848,1,0,0,0,1
46849,0,1,0,0,1
46850,0,1,0,0,1
46851,1,0,0,0,1
46852,0,1,0,0,1
46853,1,0,0,0,1
46854,0,1,0,0,1
46855,0,1,0,0,1
46856,0,1,0,0,1
46857,0,0,1,0,1
46858,0,1,0,0,1
46859,0,1,0,0,1
46860,1,0,0,0,1
46861,0,1,0,0,1
46862,0,1,0,0,1
46863,0,1,0,0,1
46864,0,1,0,0,1
46865,0,1,0,0,1
46866,0,1,0,0,1
46867,0,1,0,0,1
46868,0,1,0,0,1
46869,0,1,0,0,1
46870,1,0,0,0,1
46871,0,1,0,0,1
46872,0,1,0,0,1
46873,0,1,0,0,1
46874,1,0,0,0,1
46875,0,1,0,0,1
46876,0,1,0,0,1
46877,0,1,0,0,1
46878,0,1,0,0,1
46879,0,1,0,0,1
46880,0,1,0,0,1
46881,0,1,0,0,1
46882,0,1,0,0,1
46883,0,1,0,0,1
46884,0,1,0,0,1
46885,0,1,0,0,1
46886,0,1,0,0,1
46887,0,1,0,0,1
46888,1,0,0,0,1
46889,0,1,0,0,1
46890,0,1,0,0,1
46891,0,1,0,0,1
46892,1,0,0,0,1
46893,0,1,0,0,1
46894,0,1,0,0,1
46895,0,1,0,0,1
46896,0,1,0,0,1
46897,0,1,0,0,1
46898,1,0,0,0,1
46899,0,1,0,0,1
46900,0,1,0,0,1
46901,0,1,0,0,1
46902,0,1,0,0,1
46903,1,0,0,0,1
46904,0,1,0,0,1
46905,0,1,0,0,1
46906,0,1,0,0,1
46907,1,0,0,0,1
46908,0,1,0,0,1
46909,0,1,0,0,1
46910,0,1,0,0,1
46911,0,1,0,0,1
46912,0,1,0,0,1
46913,0,1,0,0,1
46914,0,1,0,0,1
46915,1,0,0,0,1
46916,0,1,0,0,1
46917,0,1,0,0,1
46918,1,0,0,0,1
46919,0,1,0,0,1
46920,0,1,0,0,1
46921,0,1,0,0,1
46922,0,0,1,0,1
46923,0,1,0,0,1
46924,1,0,0,0,1
46925,0,1,0,0,1
46926,1,0,0,0,1
46927,0,1,0,0,1
46928,1,0,0,0,1
46929,0,1,0,0,1
46930,0,1,0,0,1
46931,0,1,0,0,1
46932,0,1,0,0,1
46933,0,1,0,0,1
46934,0,1,0,0,1
46935,0,1,0,0,1
46936,0,1,0,0,1
46937,0,1,0,0,1
46938,0,1,0,0,1
46939,0,1,0,0,1
46940,0,1,0,0,1
46941,0,1,0,0,1
46942,0,1,0,0,1
46943,0,1,0,0,1
46944,0,1,0,0,1
46945,0,1,0,0,1
46946,1,0,0,0,1
46947,0,1,0,0,1
46948,0,1,0,0,1
46949,0,1,0,0,1
46950,0,1,0,0,1
46951,0,1,0,0,1
46952,0,1,0,0,1
46953,0,1,0,0,1
46954,0,1,0,0,1
46955,0,1,0,0,1
46956,0,1,0,0,1
46957,0,0,1,0,1
46958,0,1,0,0,1
46959,0,1,0,0,1
46960,1,0,0,0,1
46961,0,1,0,0,1
46962,0,1,0,0,1
46963,0,1,0,0,1
46964,1,0,0,0,1
46965,0,1,0,0,1
46966,0,1,0,0,1
46967,0,1,0,0,1
46968,0,1,0,0,1
46969,0,1,0,0,1
46970,0,1,0,0,1
46971,0,1,0,0,1
46972,0,1,0,0,1
46973,1,0,0,0,1
46974,0,1,0,0,1
46975,0,1,0,0,1
46976,0,1,0,0,1
46977,0,1,0,0,1
46978,0,1,0,0,1
46979,0,1,0,0,1
46980,0,1,0,0,1
46981,0,1,0,0,1
46982,0,1,0,0,1
46983,0,1,0,0,1
46984,0,1,0,0,1
46985,0,1,0,0,1
46986,1,0,0,0,1
46987,0,1,0,0,1
46988,0,1,0,0,1
46989,0,1,0,0,1
46990,0,1,0,0,1
46991,0,1,0,0,1
46992,0,1,0,0,1
46993,0,1,0,0,1
46994,1,0,0,0,1
46995,0,1,0,0,1
46996,0,1,0,0,1
46997,0,1,0,0,1
46998,1,0,0,0,1
46999,0,1,0,0,1
47000,0,1,0,0,1
47001,0,1,0,0,1
47002,0,1,0,0,1
47003,1,0,0,0,1
47004,0,1,0,0,1
47005,0,1,0,0,1
47006,0,1,0,0,1
47007,0,1,0,0,1
47008,0,1,0,0,1
47009,1,0,0,0,1
47010,0,1,0,0,1
47011,0,1,0,0,1
47012,1,0,0,0,1
47013,0,1,0,0,1
47014,0,1,0,0,1
47015,0,1,0,0,1
47016,0,1,0,0,1
47017,1,0,0,0,1
47018,0,1,0,0,1
47019,0,0,0,1,1
47020,0,0,1,0,1
47021,1,0,0,0,1
47022,1,0,0,0,1
47023,0,1,0,0,1
47024,0,1,0,0,1
47025,0,1,0,0,1
47026,1,0,0,0,1
47027,0,1,0,0,1
47028,0,1,0,0,1
47029,0,1,0,0,1
47030,1,0,0,0,1
47031,0,1,0,0,1
47032,0,1,0,0,1
47033,0,1,0,0,1
47034,0,1,0,0,1
47035,0,1,0,0,1
47036,0,1,0,0,1
47037,0,0,1,0,1
47038,0,1,0,0,1
47039,0,1,0,0,1
47040,0,1,0,0,1
47041,0,1,0,0,1
47042,0,1,0,0,1
47043,0,1,0,0,1
47044,0,1,0,0,1
47045,0,1,0,0,1
47046,0,0,0,1,1
47047,0,1,0,0,1
47048,0,1,0,0,1
47049,0,1,0,0,1
47050,0,1,0,0,1
47051,0,1,0,0,1
47052,0,1,0,0,1
47053,0,1,0,0,1
47054,0,1,0,0,1
47055,0,1,0,0,1
47056,0,1,0,0,1
47057,0,1,0,0,1
47058,0,1,0,0,1
47059,0,1,0,0,1
47060,0,1,0,0,1
47061,0,1,0,0,1
47062,0,1,0,0,1
47063,0,0,0,1,1
47064,0,1,0,0,1
47065,0,1,0,0,1
47066,0,1,0,0,1
47067,1,0,0,0,1
47068,0,1,0,0,1
47069,0,1,0,0,1
47070,0,1,0,0,1
47071,0,1,0,0,1
47072,0,1,0,0,1
47073,0,1,0,0,1
47074,1,0,0,0,1
47075,0,1,0,0,1
47076,1,0,0,0,1
47077,0,0,0,1,1
47078,0,1,0,0,1
47079,0,1,0,0,1
47080,0,1,0,0,1
47081,0,1,0,0,1
47082,0,1,0,0,1
47083,0,1,0,0,1
47084,0,1,0,0,1
47085,0,1,0,0,1
47086,0,1,0,0,1
47087,0,0,1,0,1
47088,0,1,0,0,1
47089,0,1,0,0,1
47090,1,0,0,0,1
47091,0,1,0,0,1
47092,0,1,0,0,1
47093,0,1,0,0,1
47094,0,1,0,0,1
47095,0,1,0,0,1
47096,0,1,0,0,1
47097,0,1,0,0,1
47098,1,0,0,0,1
47099,0,1,0,0,1
47100,0,1,0,0,1
47101,0,1,0,0,1
47102,0,1,0,0,1
47103,0,1,0,0,1
47104,0,1,0,0,1
47105,1,0,0,0,1
47106,0,1,0,0,1
47107,0,1,0,0,1
47108,1,0,0,0,1
47109,0,1,0,0,1
47110,0,1,0,0,1
47111,0,1,0,0,1
47112,0,1,0,0,1
47113,0,1,0,0,1
47114,0,1,0,0,1
47115,0,1,0,0,1
47116,0,1,0,0,1
47117,0,1,0,0,1
47118,0,1,0,0,1
47119,0,1,0,0,1
47120,0,1,0,0,1
47121,0,1,0,0,1
47122,0,1,0,0,1
47123,0,1,0,0,1
47124,0,1,0,0,1
47125,0,1,0,0,1
47126,0,1,0,0,1
47127,0,1,0,0,1
47128,0,1,0,0,1
47129,0,1,0,0,1
47130,0,1,0,0,1
47131,0,1,0,0,1
47132,0,1,0,0,1
47133,0,1,0,0,1
47134,0,1,0,0,1
47135,0,1,0,0,1
47136,0,1,0,0,1
47137,0,1,0,0,1
47138,0,1,0,0,1
47139,0,1,0,0,1
47140,0,1,0,0,1
47141,0,1,0,0,1
47142,0,1,0,0,1
47143,0,1,0,0,1
47144,1,0,0,0,1
47145,0,1,0,0,1
47146,0,1,0,0,1
47147,0,1,0,0,1
47148,0,1,0,0,1
47149,0,1,0,0,1
47150,0,1,0,0,1
47151,0,1,0,0,1
47152,0,1,0,0,1
47153,0,1,0,0,1
47154,0,1,0,0,1
47155,0,1,0,0,1
47156,0,1,0,0,1
47157,0,1,0,0,1
47158,0,1,0,0,1
47159,0,1,0,0,1
47160,0,1,0,0,1
47161,0,1,0,0,1
47162,0,0,0,1,1
47163,0,1,0,0,1
47164,1,0,0,0,1
47165,0,1,0,0,1
47166,0,1,0,0,1
47167,0,1,0,0,1
47168,0,0,0,1,1
47169,1,0,0,0,1
47170,0,1,0,0,1
47171,0,1,0,0,1
47172,0,1,0,0,1
47173,0,0,0,1,1
47174,0,1,0,0,1
47175,0,1,0,0,1
47176,1,0,0,0,1
47177,1,0,0,0,1
47178,1,0,0,0,1
47179,0,1,0,0,1
47180,0,1,0,0,1
47181,1,0,0,0,1
47182,0,1,0,0,1
47183,0,0,1,0,1
47184,0,1,0,0,1
47185,0,0,1,0,1
47186,0,1,0,0,1
47187,0,1,0,0,1
47188,1,0,0,0,1
47189,0,1,0,0,1
47190,0,1,0,0,1
47191,0,1,0,0,1
47192,0,1,0,0,1
47193,0,0,1,0,1
47194,0,0,0,1,1
47195,0,1,0,0,1
47196,1,0,0,0,1
47197,1,0,0,0,1
47198,0,1,0,0,1
47199,1,0,0,0,1
47200,0,1,0,0,1
47201,1,0,0,0,1
47202,1,0,0,0,1
47203,0,1,0,0,1
47204,1,0,0,0,1
47205,0,1,0,0,1
47206,0,1,0,0,1
47207,0,1,0,0,1
47208,0,1,0,0,1
47209,0,1,0,0,1
47210,0,1,0,0,1
47211,0,1,0,0,1
47212,0,1,0,0,1
47213,0,1,0,0,1
47214,0,0,1,0,1
47215,0,1,0,0,1
47216,0,1,0,0,1
47217,0,0,0,1,1
47218,0,1,0,0,1
47219,0,1,0,0,1
47220,0,1,0,0,1
47221,0,1,0,0,1
47222,0,1,0,0,1
47223,0,1,0,0,1
47224,0,1,0,0,1
47225,0,1,0,0,1
47226,0,1,0,0,1
47227,0,1,0,0,1
47228,1,0,0,0,1
47229,0,1,0,0,1
47230,0,1,0,0,1
47231,0,1,0,0,1
47232,1,0,0,0,1
47233,1,0,0,0,1
47234,0,1,0,0,1
47235,0,1,0,0,1
47236,0,1,0,0,1
47237,0,1,0,0,1
47238,1,0,0,0,1
47239,0,1,0,0,1
47240,0,1,0,0,1
47241,0,1,0,0,1
47242,1,0,0,0,1
47243,1,0,0,0,1
47244,0,1,0,0,1
47245,0,1,0,0,1
47246,0,1,0,0,1
47247,0,1,0,0,1
47248,0,1,0,0,1
47249,0,0,1,0,1
47250,0,1,0,0,1
47251,0,1,0,0,1
47252,0,1,0,0,1
47253,0,1,0,0,1
47254,1,0,0,0,1
47255,0,1,0,0,1
47256,1,0,0,0,1
47257,1,0,0,0,1
47258,0,1,0,0,1
47259,0,1,0,0,1
47260,1,0,0,0,1
47261,0,1,0,0,1
47262,0,1,0,0,1
47263,1,0,0,0,1
47264,1,0,0,0,1
47265,0,1,0,0,1
47266,0,1,0,0,1
47267,0,1,0,0,1
47268,0,1,0,0,1
47269,0,1,0,0,1
47270,1,0,0,0,1
47271,0,1,0,0,1
47272,0,1,0,0,1
47273,0,1,0,0,1
47274,0,1,0,0,1
47275,0,1,0,0,1
47276,0,1,0,0,1
47277,1,0,0,0,1
47278,0,0,0,1,1
47279,0,1,0,0,1
47280,0,1,0,0,1
47281,0,0,0,1,1
47282,0,0,0,1,1
47283,0,1,0,0,1
47284,0,1,0,0,1
47285,0,1,0,0,1
47286,0,1,0,0,1
47287,0,1,0,0,1
47288,0,1,0,0,1
47289,0,1,0,0,1
47290,0,1,0,0,1
47291,0,1,0,0,1
47292,0,1,0,0,1
47293,0,1,0,0,1
47294,0,1,0,0,1
47295,0,1,0,0,1
47296,0,1,0,0,1
47297,0,0,0,1,1
47298,0,0,0,1,1
47299,0,1,0,0,1
47300,0,1,0,0,1
47301,0,1,0,0,1
47302,1,0,0,0,1
47303,1,0,0,0,1
47304,0,1,0,0,1
47305,0,1,0,0,1
47306,0,0,1,0,1
47307,0,1,0,0,1
47308,0,1,0,0,1
47309,0,1,0,0,1
47310,0,1,0,0,1
47311,0,1,0,0,1
47312,0,1,0,0,1
47313,0,1,0,0,1
47314,0,1,0,0,1
47315,0,1,0,0,1
47316,0,1,0,0,1
47317,0,1,0,0,1
47318,0,1,0,0,1
47319,0,1,0,0,1
47320,0,1,0,0,1
47321,0,1,0,0,1
47322,0,1,0,0,1
47323,0,1,0,0,1
47324,0,1,0,0,1
47325,0,1,0,0,1
47326,0,1,0,0,1
47327,0,1,0,0,1
47328,0,1,0,0,1
47329,1,0,0,0,1
47330,0,1,0,0,1
47331,1,0,0,0,1
47332,0,1,0,0,1
47333,1,0,0,0,1
47334,0,1,0,0,1
47335,0,1,0,0,1
47336,0,1,0,0,1
47337,0,1,0,0,1
47338,0,1,0,0,1
47339,0,1,0,0,1
47340,0,1,0,0,1
47341,0,1,0,0,1
47342,0,1,0,0,1
47343,0,1,0,0,1
47344,0,1,0,0,1
47345,0,0,0,1,1
47346,0,1,0,0,1
47347,0,1,0,0,1
47348,0,1,0,0,1
47349,0,0,0,1,1
47350,0,1,0,0,1
47351,0,1,0,0,1
47352,1,0,0,0,1
47353,0,1,0,0,1
47354,1,0,0,0,1
47355,0,1,0,0,1
47356,0,1,0,0,1
47357,0,1,0,0,1
47358,0,1,0,0,1
47359,0,0,0,1,1
47360,0,1,0,0,1
47361,0,1,0,0,1
47362,0,1,0,0,1
47363,0,0,1,0,1
47364,0,1,0,0,1
47365,1,0,0,0,1
47366,0,1,0,0,1
47367,0,1,0,0,1
47368,0,1,0,0,1
47369,0,1,0,0,1
47370,0,1,0,0,1
47371,0,1,0,0,1
47372,0,1,0,0,1
47373,1,0,0,0,1
47374,0,1,0,0,1
47375,0,1,0,0,1
47376,0,1,0,0,1
47377,0,1,0,0,1
47378,0,1,0,0,1
47379,0,1,0,0,1
47380,0,1,0,0,1
47381,1,0,0,0,1
47382,0,1,0,0,1
47383,0,1,0,0,1
47384,0,1,0,0,1
47385,0,1,0,0,1
47386,0,1,0,0,1
47387,0,1,0,0,1
47388,0,1,0,0,1
47389,1,0,0,0,1
47390,0,1,0,0,1
47391,0,1,0,0,1
47392,0,1,0,0,1
47393,0,1,0,0,1
47394,0,1,0,0,1
47395,1,0,0,0,1
47396,0,1,0,0,1
47397,1,0,0,0,1
47398,0,1,0,0,1
47399,0,1,0,0,1
47400,1,0,0,0,1
47401,0,1,0,0,1
47402,0,1,0,0,1
47403,0,1,0,0,1
47404,0,1,0,0,1
47405,0,1,0,0,1
47406,0,1,0,0,1
47407,0,0,0,1,1
47408,1,0,0,0,1
47409,0,0,0,1,1
47410,0,1,0,0,1
47411,0,1,0,0,1
47412,0,1,0,0,1
47413,0,1,0,0,1
47414,0,0,0,1,1
47415,0,1,0,0,1
47416,0,1,0,0,1
47417,0,1,0,0,1
47418,0,1,0,0,1
47419,0,1,0,0,1
47420,1,0,0,0,1
47421,1,0,0,0,1
47422,0,1,0,0,1
47423,0,0,1,0,1
47424,0,1,0,0,1
47425,1,0,0,0,1
47426,0,1,0,0,1
47427,0,1,0,0,1
47428,0,1,0,0,1
47429,0,1,0,0,1
47430,1,0,0,0,1
47431,0,1,0,0,1
47432,0,1,0,0,1
47433,0,1,0,0,1
47434,0,1,0,0,1
47435,0,1,0,0,1
47436,0,1,0,0,1
47437,1,0,0,0,1
47438,0,1,0,0,1
47439,1,0,0,0,1
47440,0,0,1,0,1
47441,0,1,0,0,1
47442,0,1,0,0,1
47443,0,1,0,0,1
47444,0,1,0,0,1
47445,0,1,0,0,1
47446,1,0,0,0,1
47447,0,1,0,0,1
47448,0,1,0,0,1
47449,0,1,0,0,1
47450,0,1,0,0,1
47451,1,0,0,0,1
47452,0,1,0,0,1
47453,0,1,0,0,1
47454,0,1,0,0,1
47455,0,1,0,0,1
47456,0,1,0,0,1
47457,1,0,0,0,1
47458,0,1,0,0,1
47459,1,0,0,0,1
47460,0,1,0,0,1
47461,0,1,0,0,1
47462,1,0,0,0,1
47463,0,1,0,0,1
47464,0,1,0,0,1
47465,0,1,0,0,1
47466,0,1,0,0,1
47467,0,1,0,0,1
47468,0,1,0,0,1
47469,1,0,0,0,1
47470,1,0,0,0,1
47471,0,1,0,0,1
47472,0,1,0,0,1
47473,0,1,0,0,1
47474,0,0,0,1,1
47475,0,1,0,0,1
47476,0,1,0,0,1
47477,0,1,0,0,1
47478,0,1,0,0,1
47479,0,1,0,0,1
47480,1,0,0,0,1
47481,0,1,0,0,1
47482,1,0,0,0,1
47483,0,1,0,0,1
47484,0,1,0,0,1
47485,0,1,0,0,1
47486,0,1,0,0,1
47487,0,1,0,0,1
47488,0,1,0,0,1
47489,0,1,0,0,1
47490,0,1,0,0,1
47491,0,1,0,0,1
47492,0,1,0,0,1
47493,0,1,0,0,1
47494,0,1,0,0,1
47495,1,0,0,0,1
47496,0,1,0,0,1
47497,0,1,0,0,1
47498,1,0,0,0,1
47499,0,1,0,0,1
47500,0,1,0,0,1
47501,0,1,0,0,1
47502,0,1,0,0,1
47503,1,0,0,0,1
47504,0,1,0,0,1
47505,0,1,0,0,1
47506,0,0,1,0,1
47507,0,0,1,0,1
47508,0,1,0,0,1
47509,0,1,0,0,1
47510,0,1,0,0,1
47511,0,0,1,0,1
47512,0,1,0,0,1
47513,0,1,0,0,1
47514,1,0,0,0,1
47515,0,1,0,0,1
47516,0,1,0,0,1
47517,0,1,0,0,1
47518,0,1,0,0,1
47519,0,1,0,0,1
47520,0,1,0,0,1
47521,0,1,0,0,1
47522,1,0,0,0,1
47523,0,0,0,1,1
47524,0,1,0,0,1
47525,1,0,0,0,1
47526,1,0,0,0,1
47527,0,1,0,0,1
47528,0,1,0,0,1
47529,0,1,0,0,1
47530,0,1,0,0,1
47531,0,1,0,0,1
47532,0,1,0,0,1
47533,0,1,0,0,1
47534,0,1,0,0,1
47535,0,0,0,1,1
47536,0,1,0,0,1
47537,0,0,1,0,1
47538,1,0,0,0,1
47539,0,1,0,0,1
47540,0,1,0,0,1
47541,0,1,0,0,1
47542,1,0,0,0,1
47543,0,1,0,0,1
47544,0,1,0,0,1
47545,0,1,0,0,1
47546,1,0,0,0,1
47547,0,1,0,0,1
47548,0,1,0,0,1
47549,0,1,0,0,1
47550,0,1,0,0,1
47551,0,1,0,0,1
47552,0,1,0,0,1
47553,0,1,0,0,1
47554,0,1,0,0,1
47555,0,1,0,0,1
47556,0,1,0,0,1
47557,0,1,0,0,1
47558,1,0,0,0,1
47559,0,1,0,0,1
47560,0,1,0,0,1
47561,0,1,0,0,1
47562,1,0,0,0,1
47563,0,1,0,0,1
47564,0,1,0,0,1
47565,0,1,0,0,1
47566,0,1,0,0,1
47567,0,1,0,0,1
47568,1,0,0,0,1
47569,0,1,0,0,1
47570,0,1,0,0,1
47571,1,0,0,0,1
47572,0,1,0,0,1
47573,0,1,0,0,1
47574,0,1,0,0,1
47575,1,0,0,0,1
47576,0,1,0,0,1
47577,0,0,1,0,1
47578,0,1,0,0,1
47579,1,0,0,0,1
47580,0,1,0,0,1
47581,0,1,0,0,1
47582,1,0,0,0,1
47583,0,1,0,0,1
47584,1,0,0,0,1
47585,0,0,1,0,1
47586,0,1,0,0,1
47587,0,1,0,0,1
47588,1,0,0,0,1
47589,0,1,0,0,1
47590,0,1,0,0,1
47591,0,1,0,0,1
47592,0,1,0,0,1
47593,1,0,0,0,1
47594,0,1,0,0,1
47595,0,1,0,0,1
47596,0,1,0,0,1
47597,1,0,0,0,1
47598,0,1,0,0,1
47599,1,0,0,0,1
47600,0,1,0,0,1
47601,0,1,0,0,1
47602,0,1,0,0,1
47603,0,1,0,0,1
47604,0,1,0,0,1
47605,0,1,0,0,1
47606,0,1,0,0,1
47607,0,1,0,0,1
47608,0,1,0,0,1
47609,0,1,0,0,1
47610,0,1,0,0,1
47611,1,0,0,0,1
47612,0,1,0,0,1
47613,0,1,0,0,1
47614,0,1,0,0,1
47615,0,1,0,0,1
47616,0,1,0,0,1
47617,0,1,0,0,1
47618,0,1,0,0,1
47619,0,1,0,0,1
47620,0,1,0,0,1
47621,0,1,0,0,1
47622,0,1,0,0,1
47623,0,1,0,0,1
47624,0,1,0,0,1
47625,0,1,0,0,1
47626,1,0,0,0,1
47627,0,1,0,0,1
47628,0,1,0,0,1
47629,1,0,0,0,1
47630,0,1,0,0,1
47631,0,1,0,0,1
47632,1,0,0,0,1
47633,0,1,0,0,1
47634,0,1,0,0,1
47635,1,0,0,0,1
47636,0,1,0,0,1
47637,0,1,0,0,1
47638,0,1,0,0,1
47639,0,1,0,0,1
47640,0,1,0,0,1
47641,0,1,0,0,1
47642,1,0,0,0,1
47643,0,1,0,0,1
47644,0,1,0,0,1
47645,1,0,0,0,1
47646,0,1,0,0,1
47647,0,1,0,0,1
47648,0,1,0,0,1
47649,1,0,0,0,1
47650,1,0,0,0,1
47651,0,1,0,0,1
47652,0,1,0,0,1
47653,0,1,0,0,1
47654,0,1,0,0,1
47655,0,1,0,0,1
47656,0,1,0,0,1
47657,1,0,0,0,1
47658,0,1,0,0,1
47659,0,1,0,0,1
47660,0,1,0,0,1
47661,0,1,0,0,1
47662,0,1,0,0,1
47663,0,1,0,0,1
47664,0,1,0,0,1
47665,1,0,0,0,1
47666,0,1,0,0,1
47667,0,1,0,0,1
47668,0,1,0,0,1
47669,0,1,0,0,1
47670,0,1,0,0,1
47671,0,1,0,0,1
47672,0,1,0,0,1
47673,0,0,1,0,1
47674,0,1,0,0,1
47675,0,1,0,0,1
47676,0,0,1,0,1
47677,0,1,0,0,1
47678,0,1,0,0,1
47679,0,1,0,0,1
47680,0,1,0,0,1
47681,1,0,0,0,1
47682,0,1,0,0,1
47683,1,0,0,0,1
47684,1,0,0,0,1
47685,0,1,0,0,1
47686,0,1,0,0,1
47687,1,0,0,0,1
47688,1,0,0,0,1
47689,1,0,0,0,1
47690,0,1,0,0,1
47691,0,1,0,0,1
47692,0,0,1,0,1
47693,1,0,0,0,1
47694,0,1,0,0,1
47695,0,1,0,0,1
47696,0,1,0,0,1
47697,0,1,0,0,1
47698,0,1,0,0,1
47699,0,1,0,0,1
47700,0,0,1,0,1
47701,0,1,0,0,1
47702,0,1,0,0,1
47703,0,1,0,0,1
47704,0,1,0,0,1
47705,0,1,0,0,1
47706,0,1,0,0,1
47707,0,1,0,0,1
47708,0,0,1,0,1
47709,0,1,0,0,1
47710,0,1,0,0,1
47711,0,1,0,0,1
47712,0,1,0,0,1
47713,0,0,0,1,1
47714,0,1,0,0,1
47715,0,1,0,0,1
47716,1,0,0,0,1
47717,0,1,0,0,1
47718,1,0,0,0,1
47719,1,0,0,0,1
47720,0,1,0,0,1
47721,0,0,1,0,1
47722,1,0,0,0,1
47723,0,1,0,0,1
47724,0,1,0,0,1
47725,0,1,0,0,1
47726,0,1,0,0,1
47727,1,0,0,0,1
47728,1,0,0,0,1
47729,0,1,0,0,1
47730,0,1,0,0,1
47731,0,1,0,0,1
47732,0,1,0,0,1
47733,0,1,0,0,1
47734,0,1,0,0,1
47735,0,1,0,0,1
47736,1,0,0,0,1
47737,0,1,0,0,1
47738,0,1,0,0,1
47739,0,1,0,0,1
47740,0,1,0,0,1
47741,0,0,1,0,1
47742,0,1,0,0,1
47743,0,1,0,0,1
47744,0,1,0,0,1
47745,0,1,0,0,1
47746,0,1,0,0,1
47747,0,1,0,0,1
47748,0,1,0,0,1
47749,0,0,0,1,1
47750,0,1,0,0,1
47751,0,1,0,0,1
47752,0,1,0,0,1
47753,0,1,0,0,1
47754,0,1,0,0,1
47755,0,1,0,0,1
47756,0,1,0,0,1
47757,0,1,0,0,1
47758,0,1,0,0,1
47759,1,0,0,0,1
47760,0,1,0,0,1
47761,0,1,0,0,1
47762,0,1,0,0,1
47763,0,1,0,0,1
47764,0,1,0,0,1
47765,1,0,0,0,1
47766,0,1,0,0,1
47767,0,1,0,0,1
47768,0,1,0,0,1
47769,0,1,0,0,1
47770,1,0,0,0,1
47771,1,0,0,0,1
47772,0,1,0,0,1
47773,0,1,0,0,1
47774,0,1,0,0,1
47775,0,1,0,0,1
47776,0,1,0,0,1
47777,1,0,0,0,1
47778,0,1,0,0,1
47779,0,1,0,0,1
47780,0,1,0,0,1
47781,0,1,0,0,1
47782,0,1,0,0,1
47783,0,1,0,0,1
47784,0,1,0,0,1
47785,0,1,0,0,1
47786,0,1,0,0,1
47787,0,1,0,0,1
47788,0,1,0,0,1
47789,0,1,0,0,1
47790,0,1,0,0,1
47791,0,1,0,0,1
47792,0,1,0,0,1
47793,1,0,0,0,1
47794,0,1,0,0,1
47795,1,0,0,0,1
47796,0,1,0,0,1
47797,0,1,0,0,1
47798,0,1,0,0,1
47799,0,1,0,0,1
47800,0,0,1,0,1
47801,1,0,0,0,1
47802,1,0,0,0,1
47803,0,1,0,0,1
47804,0,1,0,0,1
47805,0,1,0,0,1
47806,0,1,0,0,1
47807,0,1,0,0,1
47808,0,1,0,0,1
47809,0,1,0,0,1
47810,0,0,0,1,1
47811,0,1,0,0,1
47812,1,0,0,0,1
47813,1,0,0,0,1
47814,1,0,0,0,1
47815,0,1,0,0,1
47816,0,1,0,0,1
47817,0,1,0,0,1
47818,0,1,0,0,1
47819,1,0,0,0,1
47820,0,1,0,0,1
47821,0,0,1,0,1
47822,0,1,0,0,1
47823,0,1,0,0,1
47824,0,0,0,1,1
47825,1,0,0,0,1
47826,1,0,0,0,1
47827,0,1,0,0,1
47828,0,1,0,0,1
47829,0,1,0,0,1
47830,0,0,0,1,1
47831,0,1,0,0,1
47832,0,1,0,0,1
47833,0,1,0,0,1
47834,1,0,0,0,1
47835,0,1,0,0,1
47836,0,0,0,1,1
47837,0,1,0,0,1
47838,0,1,0,0,1
47839,0,1,0,0,1
47840,0,1,0,0,1
47841,0,1,0,0,1
47842,1,0,0,0,1
47843,0,1,0,0,1
47844,0,1,0,0,1
47845,0,1,0,0,1
47846,0,1,0,0,1
47847,0,1,0,0,1
47848,0,1,0,0,1
47849,0,1,0,0,1
47850,0,1,0,0,1
47851,0,1,0,0,1
47852,0,1,0,0,1
47853,0,1,0,0,1
47854,0,1,0,0,1
47855,1,0,0,0,1
47856,0,1,0,0,1
47857,0,1,0,0,1
47858,0,1,0,0,1
47859,0,1,0,0,1
47860,1,0,0,0,1
47861,1,0,0,0,1
47862,0,1,0,0,1
47863,1,0,0,0,1
47864,0,1,0,0,1
47865,1,0,0,0,1
47866,0,1,0,0,1
47867,0,1,0,0,1
47868,1,0,0,0,1
47869,0,1,0,0,1
47870,0,1,0,0,1
47871,0,1,0,0,1
47872,0,1,0,0,1
47873,1,0,0,0,1
47874,0,1,0,0,1
47875,1,0,0,0,1
47876,1,0,0,0,1
47877,0,1,0,0,1
47878,0,1,0,0,1
47879,0,1,0,0,1
47880,0,1,0,0,1
47881,1,0,0,0,1
47882,1,0,0,0,1
47883,0,1,0,0,1
47884,0,1,0,0,1
47885,0,1,0,0,1
47886,0,1,0,0,1
47887,0,1,0,0,1
47888,0,1,0,0,1
47889,0,1,0,0,1
47890,1,0,0,0,1
47891,1,0,0,0,1
47892,1,0,0,0,1
47893,0,1,0,0,1
47894,0,1,0,0,1
47895,0,1,0,0,1
47896,0,1,0,0,1
47897,1,0,0,0,1
47898,0,1,0,0,1
47899,1,0,0,0,1
47900,0,1,0,0,1
47901,1,0,0,0,1
47902,0,1,0,0,1
47903,0,1,0,0,1
47904,0,1,0,0,1
47905,1,0,0,0,1
47906,0,1,0,0,1
47907,0,1,0,0,1
47908,0,1,0,0,1
47909,0,0,0,1,1
47910,0,1,0,0,1
47911,0,1,0,0,1
47912,1,0,0,0,1
47913,0,1,0,0,1
47914,0,1,0,0,1
47915,0,1,0,0,1
47916,0,1,0,0,1
47917,0,1,0,0,1
47918,0,1,0,0,1
47919,0,1,0,0,1
47920,0,1,0,0,1
47921,0,1,0,0,1
47922,0,1,0,0,1
47923,0,1,0,0,1
47924,0,1,0,0,1
47925,0,1,0,0,1
47926,0,1,0,0,1
47927,0,1,0,0,1
47928,0,0,1,0,1
47929,1,0,0,0,1
47930,0,1,0,0,1
47931,1,0,0,0,1
47932,0,1,0,0,1
47933,1,0,0,0,1
47934,0,1,0,0,1
47935,0,1,0,0,1
47936,0,1,0,0,1
47937,0,1,0,0,1
47938,0,1,0,0,1
47939,0,1,0,0,1
47940,0,1,0,0,1
47941,1,0,0,0,1
47942,1,0,0,0,1
47943,0,1,0,0,1
47944,0,1,0,0,1
47945,0,1,0,0,1
47946,0,1,0,0,1
47947,0,1,0,0,1
47948,0,1,0,0,1
47949,1,0,0,0,1
47950,0,1,0,0,1
47951,0,1,0,0,1
47952,0,1,0,0,1
47953,0,1,0,0,1
47954,0,1,0,0,1
47955,0,1,0,0,1
47956,0,1,0,0,1
47957,0,1,0,0,1
47958,0,1,0,0,1
47959,0,1,0,0,1
47960,0,1,0,0,1
47961,0,1,0,0,1
47962,1,0,0,0,1
47963,0,1,0,0,1
47964,0,1,0,0,1
47965,1,0,0,0,1
47966,0,1,0,0,1
47967,0,1,0,0,1
47968,1,0,0,0,1
47969,0,1,0,0,1
47970,0,1,0,0,1
47971,1,0,0,0,1
47972,0,1,0,0,1
47973,0,1,0,0,1
47974,0,1,0,0,1
47975,0,1,0,0,1
47976,0,1,0,0,1
47977,0,1,0,0,1
47978,0,1,0,0,1
47979,0,1,0,0,1
47980,1,0,0,0,1
47981,0,1,0,0,1
47982,0,1,0,0,1
47983,0,1,0,0,1
47984,0,1,0,0,1
47985,0,1,0,0,1
47986,0,1,0,0,1
47987,0,1,0,0,1
47988,0,1,0,0,1
47989,0,1,0,0,1
47990,0,1,0,0,1
47991,0,1,0,0,1
47992,0,1,0,0,1
47993,0,1,0,0,1
47994,0,1,0,0,1
47995,0,1,0,0,1
47996,0,1,0,0,1
47997,0,1,0,0,1
47998,0,1,0,0,1
47999,0,1,0,0,1
48000,0,1,0,0,1
48001,0,1,0,0,1
48002,0,1,0,0,1
48003,1,0,0,0,1
48004,0,1,0,0,1
48005,0,1,0,0,1
48006,0,1,0,0,1
48007,1,0,0,0,1
48008,0,1,0,0,1
48009,0,1,0,0,1
48010,0,1,0,0,1
48011,0,1,0,0,1
48012,0,1,0,0,1
48013,1,0,0,0,1
48014,0,1,0,0,1
48015,0,1,0,0,1
48016,1,0,0,0,1
48017,0,1,0,0,1
48018,0,1,0,0,1
48019,1,0,0,0,1
48020,1,0,0,0,1
48021,0,1,0,0,1
48022,0,1,0,0,1
48023,1,0,0,0,1
48024,0,1,0,0,1
48025,0,1,0,0,1
48026,1,0,0,0,1
48027,0,1,0,0,1
48028,0,1,0,0,1
48029,0,1,0,0,1
48030,1,0,0,0,1
48031,0,1,0,0,1
48032,0,1,0,0,1
48033,0,1,0,0,1
48034,0,1,0,0,1
48035,0,1,0,0,1
48036,0,1,0,0,1
48037,0,1,0,0,1
48038,0,1,0,0,1
48039,0,0,1,0,1
48040,0,1,0,0,1
48041,0,1,0,0,1
48042,0,1,0,0,1
48043,0,1,0,0,1
48044,0,0,1,0,1
48045,0,1,0,0,1
48046,0,1,0,0,1
48047,0,1,0,0,1
48048,0,1,0,0,1
48049,0,1,0,0,1
48050,1,0,0,0,1
48051,1,0,0,0,1
48052,0,1,0,0,1
48053,0,1,0,0,1
48054,0,1,0,0,1
48055,0,1,0,0,1
48056,0,1,0,0,1
48057,0,1,0,0,1
48058,0,0,1,0,1
48059,0,1,0,0,1
48060,0,1,0,0,1
48061,0,0,0,1,1
48062,0,1,0,0,1
48063,0,1,0,0,1
48064,0,1,0,0,1
48065,1,0,0,0,1
48066,0,1,0,0,1
48067,0,1,0,0,1
48068,0,1,0,0,1
48069,0,1,0,0,1
48070,0,1,0,0,1
48071,0,1,0,0,1
48072,0,1,0,0,1
48073,0,1,0,0,1
48074,0,1,0,0,1
48075,0,1,0,0,1
48076,0,1,0,0,1
48077,1,0,0,0,1
48078,0,1,0,0,1
48079,0,1,0,0,1
48080,0,0,0,1,1
48081,0,1,0,0,1
48082,0,1,0,0,1
48083,0,1,0,0,1
48084,0,1,0,0,1
48085,0,1,0,0,1
48086,0,1,0,0,1
48087,0,1,0,0,1
48088,0,1,0,0,1
48089,0,1,0,0,1
48090,0,1,0,0,1
48091,0,1,0,0,1
48092,0,1,0,0,1
48093,0,1,0,0,1
48094,0,1,0,0,1
48095,0,1,0,0,1
48096,0,1,0,0,1
48097,0,0,0,1,1
48098,0,0,1,0,1
48099,0,1,0,0,1
48100,1,0,0,0,1
48101,0,1,0,0,1
48102,0,1,0,0,1
48103,0,1,0,0,1
48104,0,1,0,0,1
48105,0,1,0,0,1
48106,0,1,0,0,1
48107,0,1,0,0,1
48108,0,1,0,0,1
48109,0,1,0,0,1
48110,1,0,0,0,1
48111,0,1,0,0,1
48112,0,1,0,0,1
48113,1,0,0,0,1
48114,0,1,0,0,1
48115,0,1,0,0,1
48116,0,1,0,0,1
48117,0,1,0,0,1
48118,0,1,0,0,1
48119,0,1,0,0,1
48120,0,1,0,0,1
48121,0,1,0,0,1
48122,1,0,0,0,1
48123,0,1,0,0,1
48124,1,0,0,0,1
48125,0,1,0,0,1
48126,0,1,0,0,1
48127,0,1,0,0,1
48128,0,1,0,0,1
48129,0,1,0,0,1
48130,1,0,0,0,1
48131,0,1,0,0,1
48132,0,1,0,0,1
48133,0,1,0,0,1
48134,0,1,0,0,1
48135,0,1,0,0,1
48136,0,0,1,0,1
48137,0,1,0,0,1
48138,0,1,0,0,1
48139,0,1,0,0,1
48140,0,1,0,0,1
48141,0,1,0,0,1
48142,0,1,0,0,1
48143,0,1,0,0,1
48144,0,1,0,0,1
48145,1,0,0,0,1
48146,0,1,0,0,1
48147,0,1,0,0,1
48148,0,1,0,0,1
48149,0,1,0,0,1
48150,1,0,0,0,1
48151,0,1,0,0,1
48152,0,1,0,0,1
48153,0,1,0,0,1
48154,0,1,0,0,1
48155,0,1,0,0,1
48156,0,1,0,0,1
48157,0,1,0,0,1
48158,0,1,0,0,1
48159,0,1,0,0,1
48160,0,0,0,1,1
48161,0,1,0,0,1
48162,0,1,0,0,1
48163,0,1,0,0,1
48164,0,1,0,0,1
48165,0,1,0,0,1
48166,0,1,0,0,1
48167,1,0,0,0,1
48168,0,1,0,0,1
48169,1,0,0,0,1
48170,0,1,0,0,1
48171,0,0,1,0,1
48172,0,1,0,0,1
48173,0,1,0,0,1
48174,0,1,0,0,1
48175,0,1,0,0,1
48176,0,1,0,0,1
48177,0,1,0,0,1
48178,0,1,0,0,1
48179,0,1,0,0,1
48180,0,1,0,0,1
48181,0,1,0,0,1
48182,0,1,0,0,1
48183,0,1,0,0,1
48184,0,1,0,0,1
48185,0,1,0,0,1
48186,0,1,0,0,1
48187,1,0,0,0,1
48188,0,1,0,0,1
48189,0,1,0,0,1
48190,0,1,0,0,1
48191,0,1,0,0,1
48192,0,1,0,0,1
48193,0,1,0,0,1
48194,0,1,0,0,1
48195,1,0,0,0,1
48196,0,1,0,0,1
48197,0,1,0,0,1
48198,0,1,0,0,1
48199,0,1,0,0,1
48200,0,1,0,0,1
48201,0,1,0,0,1
48202,1,0,0,0,1
48203,1,0,0,0,1
48204,0,1,0,0,1
48205,0,1,0,0,1
48206,0,1,0,0,1
48207,0,1,0,0,1
48208,0,1,0,0,1
48209,0,1,0,0,1
48210,0,1,0,0,1
48211,1,0,0,0,1
48212,0,1,0,0,1
48213,0,1,0,0,1
48214,1,0,0,0,1
48215,0,1,0,0,1
48216,0,1,0,0,1
48217,0,1,0,0,1
48218,0,1,0,0,1
48219,0,1,0,0,1
48220,0,1,0,0,1
48221,1,0,0,0,1
48222,0,1,0,0,1
48223,0,1,0,0,1
48224,0,1,0,0,1
48225,0,1,0,0,1
48226,0,1,0,0,1
48227,0,1,0,0,1
48228,1,0,0,0,1
48229,0,1,0,0,1
48230,0,1,0,0,1
48231,0,1,0,0,1
48232,1,0,0,0,1
48233,0,1,0,0,1
48234,0,1,0,0,1
48235,0,1,0,0,1
48236,0,1,0,0,1
48237,0,1,0,0,1
48238,1,0,0,0,1
48239,0,1,0,0,1
48240,0,0,1,0,1
48241,0,1,0,0,1
48242,0,0,0,1,1
48243,1,0,0,0,1
48244,0,1,0,0,1
48245,0,1,0,0,1
48246,0,1,0,0,1
48247,1,0,0,0,1
48248,0,1,0,0,1
48249,0,1,0,0,1
48250,0,1,0,0,1
48251,0,1,0,0,1
48252,0,1,0,0,1
48253,0,1,0,0,1
48254,0,1,0,0,1
48255,0,1,0,0,1
48256,0,1,0,0,1
48257,0,1,0,0,1
48258,0,1,0,0,1
48259,0,1,0,0,1
48260,1,0,0,0,1
48261,0,1,0,0,1
48262,0,1,0,0,1
48263,0,1,0,0,1
48264,0,1,0,0,1
48265,0,1,0,0,1
48266,0,1,0,0,1
48267,0,1,0,0,1
48268,0,1,0,0,1
48269,0,1,0,0,1
48270,0,1,0,0,1
48271,0,1,0,0,1
48272,0,1,0,0,1
48273,1,0,0,0,1
48274,0,1,0,0,1
48275,0,1,0,0,1
48276,0,1,0,0,1
48277,0,1,0,0,1
48278,0,1,0,0,1
48279,0,1,0,0,1
48280,1,0,0,0,1
48281,1,0,0,0,1
48282,0,1,0,0,1
48283,0,1,0,0,1
48284,0,1,0,0,1
48285,0,1,0,0,1
48286,0,1,0,0,1
48287,1,0,0,0,1
48288,0,1,0,0,1
48289,1,0,0,0,1
48290,0,1,0,0,1
48291,0,1,0,0,1
48292,1,0,0,0,1
48293,0,1,0,0,1
48294,0,1,0,0,1
48295,1,0,0,0,1
48296,0,1,0,0,1
48297,0,1,0,0,1
48298,0,1,0,0,1
48299,0,1,0,0,1
48300,0,1,0,0,1
48301,0,1,0,0,1
48302,0,1,0,0,1
48303,1,0,0,0,1
48304,0,1,0,0,1
48305,0,1,0,0,1
48306,0,1,0,0,1
48307,0,1,0,0,1
48308,0,0,1,0,1
48309,0,1,0,0,1
48310,0,1,0,0,1
48311,0,1,0,0,1
48312,0,1,0,0,1
48313,0,1,0,0,1
48314,0,0,1,0,1
48315,0,1,0,0,1
48316,0,1,0,0,1
48317,0,1,0,0,1
48318,0,1,0,0,1
48319,1,0,0,0,1
48320,0,1,0,0,1
48321,0,1,0,0,1
48322,1,0,0,0,1
48323,0,1,0,0,1
48324,0,1,0,0,1
48325,0,1,0,0,1
48326,0,1,0,0,1
48327,0,1,0,0,1
48328,0,1,0,0,1
48329,0,1,0,0,1
48330,0,1,0,0,1
48331,0,1,0,0,1
48332,0,1,0,0,1
48333,0,1,0,0,1
48334,0,1,0,0,1
48335,0,1,0,0,1
48336,0,1,0,0,1
48337,0,0,0,1,1
48338,0,1,0,0,1
48339,0,1,0,0,1
48340,0,1,0,0,1
48341,1,0,0,0,1
48342,0,1,0,0,1
48343,1,0,0,0,1
48344,1,0,0,0,1
48345,0,1,0,0,1
48346,1,0,0,0,1
48347,0,1,0,0,1
48348,0,1,0,0,1
48349,0,1,0,0,1
48350,1,0,0,0,1
48351,0,1,0,0,1
48352,0,1,0,0,1
48353,0,1,0,0,1
48354,0,1,0,0,1
48355,0,1,0,0,1
48356,1,0,0,0,1
48357,1,0,0,0,1
48358,0,1,0,0,1
48359,0,1,0,0,1
48360,0,1,0,0,1
48361,0,1,0,0,1
48362,1,0,0,0,1
48363,0,1,0,0,1
48364,0,1,0,0,1
48365,0,1,0,0,1
48366,0,0,0,1,1
48367,0,1,0,0,1
48368,1,0,0,0,1
48369,1,0,0,0,1
48370,0,1,0,0,1
48371,0,1,0,0,1
48372,1,0,0,0,1
48373,0,1,0,0,1
48374,1,0,0,0,1
48375,0,0,0,1,1
48376,0,1,0,0,1
48377,0,1,0,0,1
48378,0,1,0,0,1
48379,0,1,0,0,1
48380,1,0,0,0,1
48381,0,1,0,0,1
48382,1,0,0,0,1
48383,1,0,0,0,1
48384,0,1,0,0,1
48385,1,0,0,0,1
48386,1,0,0,0,1
48387,0,1,0,0,1
48388,1,0,0,0,1
48389,1,0,0,0,1
48390,0,1,0,0,1
48391,0,1,0,0,1
48392,0,1,0,0,1
48393,1,0,0,0,1
48394,1,0,0,0,1
48395,0,1,0,0,1
48396,0,1,0,0,1
48397,0,1,0,0,1
48398,0,1,0,0,1
48399,0,1,0,0,1
48400,1,0,0,0,1
48401,0,1,0,0,1
48402,1,0,0,0,1
48403,0,1,0,0,1
48404,0,1,0,0,1
48405,0,1,0,0,1
48406,0,1,0,0,1
48407,0,1,0,0,1
48408,0,1,0,0,1
48409,1,0,0,0,1
48410,0,0,0,1,1
48411,0,1,0,0,1
48412,0,1,0,0,1
48413,1,0,0,0,1
48414,0,1,0,0,1
48415,0,1,0,0,1
48416,0,1,0,0,1
48417,0,1,0,0,1
48418,0,1,0,0,1
48419,0,0,0,1,1
48420,0,1,0,0,1
48421,0,1,0,0,1
48422,0,1,0,0,1
48423,0,1,0,0,1
48424,0,1,0,0,1
48425,0,1,0,0,1
48426,1,0,0,0,1
48427,0,0,0,1,1
48428,1,0,0,0,1
48429,0,1,0,0,1
48430,1,0,0,0,1
48431,0,1,0,0,1
48432,0,0,1,0,1
48433,0,1,0,0,1
48434,0,1,0,0,1
48435,0,1,0,0,1
48436,0,1,0,0,1
48437,0,1,0,0,1
48438,0,1,0,0,1
48439,0,1,0,0,1
48440,0,1,0,0,1
48441,0,0,1,0,1
48442,0,1,0,0,1
48443,0,1,0,0,1
48444,0,1,0,0,1
48445,0,1,0,0,1
48446,0,1,0,0,1
48447,0,1,0,0,1
48448,0,1,0,0,1
48449,0,1,0,0,1
48450,0,1,0,0,1
48451,0,1,0,0,1
48452,1,0,0,0,1
48453,0,1,0,0,1
48454,0,1,0,0,1
48455,0,1,0,0,1
48456,0,1,0,0,1
48457,0,1,0,0,1
48458,0,1,0,0,1
48459,0,1,0,0,1
48460,0,1,0,0,1
48461,0,1,0,0,1
48462,0,1,0,0,1
48463,0,1,0,0,1
48464,0,0,1,0,1
48465,1,0,0,0,1
48466,0,1,0,0,1
48467,1,0,0,0,1
48468,0,1,0,0,1
48469,0,1,0,0,1
48470,0,1,0,0,1
48471,0,1,0,0,1
48472,1,0,0,0,1
48473,0,1,0,0,1
48474,0,1,0,0,1
48475,0,1,0,0,1
48476,0,1,0,0,1
48477,1,0,0,0,1
48478,0,1,0,0,1
48479,0,1,0,0,1
48480,0,1,0,0,1
48481,0,1,0,0,1
48482,1,0,0,0,1
48483,0,1,0,0,1
48484,0,1,0,0,1
48485,0,1,0,0,1
48486,0,0,1,0,1
48487,0,1,0,0,1
48488,0,1,0,0,1
48489,0,1,0,0,1
48490,0,0,0,1,1
48491,0,1,0,0,1
48492,0,1,0,0,1
48493,0,1,0,0,1
48494,0,1,0,0,1
48495,0,1,0,0,1
48496,1,0,0,0,1
48497,0,1,0,0,1
48498,0,1,0,0,1
48499,0,1,0,0,1
48500,0,1,0,0,1
48501,0,1,0,0,1
48502,0,1,0,0,1
48503,0,1,0,0,1
48504,0,1,0,0,1
48505,0,1,0,0,1
48506,0,1,0,0,1
48507,0,1,0,0,1
48508,0,1,0,0,1
48509,0,1,0,0,1
48510,0,0,0,1,1
48511,1,0,0,0,1
48512,0,1,0,0,1
48513,0,1,0,0,1
48514,0,1,0,0,1
48515,0,1,0,0,1
48516,0,0,1,0,1
48517,0,1,0,0,1
48518,0,1,0,0,1
48519,0,1,0,0,1
48520,0,1,0,0,1
48521,0,1,0,0,1
48522,0,1,0,0,1
48523,0,1,0,0,1
48524,0,1,0,0,1
48525,0,1,0,0,1
48526,0,1,0,0,1
48527,0,1,0,0,1
48528,0,1,0,0,1
48529,0,1,0,0,1
48530,0,1,0,0,1
48531,0,0,0,1,1
48532,0,1,0,0,1
48533,0,1,0,0,1
48534,0,1,0,0,1
48535,0,1,0,0,1
48536,0,1,0,0,1
48537,0,1,0,0,1
48538,0,1,0,0,1
48539,0,1,0,0,1
48540,0,1,0,0,1
48541,0,1,0,0,1
48542,0,1,0,0,1
48543,0,1,0,0,1
48544,0,1,0,0,1
48545,0,1,0,0,1
48546,0,1,0,0,1
48547,0,1,0,0,1
48548,0,1,0,0,1
48549,0,1,0,0,1
48550,0,1,0,0,1
48551,0,1,0,0,1
48552,0,1,0,0,1
48553,1,0,0,0,1
48554,1,0,0,0,1
48555,0,0,0,1,1
48556,0,1,0,0,1
48557,0,1,0,0,1
48558,0,1,0,0,1
48559,0,0,0,1,1
48560,0,1,0,0,1
48561,0,1,0,0,1
48562,1,0,0,0,1
48563,0,1,0,0,1
48564,0,1,0,0,1
48565,1,0,0,0,1
48566,0,1,0,0,1
48567,1,0,0,0,1
48568,0,1,0,0,1
48569,0,1,0,0,1
48570,0,1,0,0,1
48571,1,0,0,0,1
48572,0,1,0,0,1
48573,0,0,1,0,1
48574,0,1,0,0,1
48575,0,1,0,0,1
48576,0,1,0,0,1
48577,0,1,0,0,1
48578,1,0,0,0,1
48579,0,1,0,0,1
48580,0,1,0,0,1
48581,0,1,0,0,1
48582,1,0,0,0,1
48583,0,0,0,1,1
48584,0,0,1,0,1
48585,0,1,0,0,1
48586,0,1,0,0,1
48587,0,1,0,0,1
48588,0,1,0,0,1
48589,0,1,0,0,1
48590,1,0,0,0,1
48591,1,0,0,0,1
48592,0,1,0,0,1
48593,0,1,0,0,1
48594,0,1,0,0,1
48595,0,1,0,0,1
48596,0,1,0,0,1
48597,0,1,0,0,1
48598,0,1,0,0,1
48599,1,0,0,0,1
48600,1,0,0,0,1
48601,0,1,0,0,1
48602,0,1,0,0,1
48603,1,0,0,0,1
48604,1,0,0,0,1
48605,0,0,1,0,1
48606,0,1,0,0,1
48607,0,1,0,0,1
48608,0,1,0,0,1
48609,1,0,0,0,1
48610,0,0,1,0,1
48611,0,1,0,0,1
48612,0,1,0,0,1
48613,0,1,0,0,1
48614,0,1,0,0,1
48615,0,1,0,0,1
48616,0,1,0,0,1
48617,1,0,0,0,1
48618,0,1,0,0,1
48619,0,1,0,0,1
48620,0,1,0,0,1
48621,0,1,0,0,1
48622,0,1,0,0,1
48623,0,1,0,0,1
48624,0,1,0,0,1
48625,0,1,0,0,1
48626,0,1,0,0,1
48627,0,1,0,0,1
48628,0,1,0,0,1
48629,1,0,0,0,1
48630,0,1,0,0,1
48631,0,0,1,0,1
48632,0,0,1,0,1
48633,0,1,0,0,1
48634,0,1,0,0,1
48635,0,1,0,0,1
48636,0,1,0,0,1
48637,0,1,0,0,1
48638,0,1,0,0,1
48639,0,1,0,0,1
48640,0,1,0,0,1
48641,0,0,1,0,1
48642,0,1,0,0,1
48643,0,1,0,0,1
48644,0,1,0,0,1
48645,1,0,0,0,1
48646,0,0,1,0,1
48647,0,1,0,0,1
48648,0,1,0,0,1
48649,0,1,0,0,1
48650,0,1,0,0,1
48651,0,1,0,0,1
48652,0,1,0,0,1
48653,0,0,0,1,1
48654,0,1,0,0,1
48655,0,1,0,0,1
48656,0,1,0,0,1
48657,0,1,0,0,1
48658,0,1,0,0,1
48659,0,1,0,0,1
48660,0,1,0,0,1
48661,0,1,0,0,1
48662,0,1,0,0,1
48663,0,1,0,0,1
48664,0,1,0,0,1
48665,0,1,0,0,1
48666,0,1,0,0,1
48667,0,1,0,0,1
48668,0,1,0,0,1
48669,0,1,0,0,1
48670,0,1,0,0,1
48671,0,1,0,0,1
48672,0,1,0,0,1
48673,0,1,0,0,1
48674,0,1,0,0,1
48675,0,1,0,0,1
48676,0,1,0,0,1
48677,0,1,0,0,1
48678,0,1,0,0,1
48679,0,1,0,0,1
48680,0,1,0,0,1
48681,0,1,0,0,1
48682,0,1,0,0,1
48683,0,1,0,0,1
48684,0,1,0,0,1
48685,0,1,0,0,1
48686,0,1,0,0,1
48687,0,1,0,0,1
48688,0,1,0,0,1
48689,0,1,0,0,1
48690,0,1,0,0,1
48691,0,1,0,0,1
48692,0,1,0,0,1
48693,0,1,0,0,1
48694,0,1,0,0,1
48695,0,1,0,0,1
48696,1,0,0,0,1
48697,0,1,0,0,1
48698,0,1,0,0,1
48699,0,1,0,0,1
48700,0,1,0,0,1
48701,0,1,0,0,1
48702,0,1,0,0,1
48703,0,1,0,0,1
48704,0,1,0,0,1
48705,0,1,0,0,1
48706,1,0,0,0,1
48707,1,0,0,0,1
48708,0,1,0,0,1
48709,0,1,0,0,1
48710,0,1,0,0,1
48711,0,1,0,0,1
48712,1,0,0,0,1
48713,1,0,0,0,1
48714,1,0,0,0,1
48715,0,1,0,0,1
48716,1,0,0,0,1
48717,0,1,0,0,1
48718,0,1,0,0,1
48719,1,0,0,0,1
48720,0,1,0,0,1
48721,0,0,1,0,1
48722,1,0,0,0,1
48723,0,1,0,0,1
48724,1,0,0,0,1
48725,0,0,0,1,1
48726,0,1,0,0,1
48727,0,0,1,0,1
48728,1,0,0,0,1
48729,1,0,0,0,1
48730,0,1,0,0,1
48731,0,1,0,0,1
48732,0,1,0,0,1
48733,0,1,0,0,1
48734,0,1,0,0,1
48735,1,0,0,0,1
48736,1,0,0,0,1
48737,0,1,0,0,1
48738,1,0,0,0,1
48739,1,0,0,0,1
48740,1,0,0,0,1
48741,1,0,0,0,1
48742,0,1,0,0,1
48743,1,0,0,0,1
48744,0,1,0,0,1
48745,0,0,1,0,1
48746,0,1,0,0,1
48747,1,0,0,0,1
48748,0,1,0,0,1
48749,0,1,0,0,1
48750,1,0,0,0,1
48751,1,0,0,0,1
48752,0,1,0,0,1
48753,0,1,0,0,1
48754,0,1,0,0,1
48755,0,1,0,0,1
48756,1,0,0,0,1
48757,0,1,0,0,1
48758,0,0,0,1,1
48759,0,1,0,0,1
48760,0,1,0,0,1
48761,0,1,0,0,1
48762,0,0,1,0,1
48763,0,1,0,0,1
48764,0,1,0,0,1
48765,0,1,0,0,1
48766,0,1,0,0,1
48767,1,0,0,0,1
48768,1,0,0,0,1
48769,0,1,0,0,1
48770,0,1,0,0,1
48771,0,1,0,0,1
48772,0,1,0,0,1
48773,0,1,0,0,1
48774,0,1,0,0,1
48775,0,1,0,0,1
48776,0,1,0,0,1
48777,0,1,0,0,1
48778,0,1,0,0,1
48779,1,0,0,0,1
48780,0,0,0,1,1
48781,0,1,0,0,1
48782,0,1,0,0,1
48783,0,1,0,0,1
48784,1,0,0,0,1
48785,0,1,0,0,1
48786,0,1,0,0,1
48787,0,1,0,0,1
48788,0,1,0,0,1
48789,0,1,0,0,1
48790,0,1,0,0,1
48791,0,1,0,0,1
48792,0,1,0,0,1
48793,1,0,0,0,1
48794,0,1,0,0,1
48795,1,0,0,0,1
48796,0,1,0,0,1
48797,1,0,0,0,1
48798,0,1,0,0,1
48799,0,1,0,0,1
48800,0,1,0,0,1
48801,0,1,0,0,1
48802,0,1,0,0,1
48803,0,1,0,0,1
48804,0,1,0,0,1
48805,0,1,0,0,1
48806,1,0,0,0,1
48807,0,1,0,0,1
48808,0,1,0,0,1
48809,0,1,0,0,1
48810,1,0,0,0,1
48811,1,0,0,0,1
48812,0,1,0,0,1
48813,1,0,0,0,1
48814,1,0,0,0,1
48815,0,1,0,0,1
48816,1,0,0,0,1
48817,0,1,0,0,1
48818,0,1,0,0,1
48819,1,0,0,0,1
48820,1,0,0,0,1
48821,0,0,0,1,1
48822,0,1,0,0,1
48823,0,1,0,0,1
48824,0,1,0,0,1
48825,0,1,0,0,1
48826,0,1,0,0,1
48827,0,1,0,0,1
48828,0,1,0,0,1
48829,0,0,1,0,1
48830,1,0,0,0,1
48831,0,1,0,0,1
48832,0,1,0,0,1
48833,0,1,0,0,1
48834,0,1,0,0,1
48835,0,1,0,0,1
48836,0,1,0,0,1
48837,0,1,0,0,1
48838,0,1,0,0,1
48839,0,1,0,0,1
48840,0,0,1,0,1
48841,0,1,0,0,1
48842,0,1,0,0,1
48843,1,0,0,0,1
48844,0,1,0,0,1
48845,0,1,0,0,1
48846,0,1,0,0,1
48847,0,1,0,0,1
48848,0,1,0,0,1
48849,0,1,0,0,1
48850,0,1,0,0,1
48851,0,1,0,0,1
48852,0,1,0,0,1
48853,0,1,0,0,1
48854,0,1,0,0,1
48855,0,1,0,0,1
48856,1,0,0,0,1
48857,1,0,0,0,1
48858,0,1,0,0,1
48859,1,0,0,0,1
48860,0,1,0,0,1
48861,0,1,0,0,1
48862,0,1,0,0,1
48863,0,1,0,0,1
48864,0,1,0,0,1
48865,0,1,0,0,1
48866,0,1,0,0,1
48867,0,1,0,0,1
48868,0,1,0,0,1
48869,1,0,0,0,1
48870,0,1,0,0,1
48871,1,0,0,0,1
48872,0,1,0,0,1
48873,0,1,0,0,1
48874,0,1,0,0,1
48875,0,1,0,0,1
48876,0,1,0,0,1
48877,0,0,1,0,1
48878,0,1,0,0,1
48879,1,0,0,0,1
48880,0,1,0,0,1
48881,0,1,0,0,1
48882,0,1,0,0,1
48883,0,1,0,0,1
48884,0,1,0,0,1
48885,0,1,0,0,1
48886,0,1,0,0,1
48887,0,0,1,0,1
48888,0,0,1,0,1
48889,1,0,0,0,1
48890,0,0,0,1,1
48891,0,1,0,0,1
48892,1,0,0,0,1
48893,0,1,0,0,1
48894,0,1,0,0,1
48895,1,0,0,0,1
48896,0,0,1,0,1
48897,0,1,0,0,1
48898,0,0,1,0,1
48899,0,1,0,0,1
48900,1,0,0,0,1
48901,1,0,0,0,1
48902,0,1,0,0,1
48903,0,1,0,0,1
48904,0,1,0,0,1
48905,0,1,0,0,1
48906,0,1,0,0,1
48907,1,0,0,0,1
48908,0,1,0,0,1
48909,0,1,0,0,1
48910,0,1,0,0,1
48911,1,0,0,0,1
48912,1,0,0,0,1
48913,0,1,0,0,1
48914,0,1,0,0,1
48915,0,1,0,0,1
48916,0,1,0,0,1
48917,0,1,0,0,1
48918,0,1,0,0,1
48919,0,1,0,0,1
48920,0,1,0,0,1
48921,0,1,0,0,1
48922,0,1,0,0,1
48923,0,1,0,0,1
48924,0,1,0,0,1
48925,0,1,0,0,1
48926,0,1,0,0,1
48927,0,1,0,0,1
48928,0,1,0,0,1
48929,1,0,0,0,1
48930,0,1,0,0,1
48931,0,0,1,0,1
48932,0,1,0,0,1
48933,0,1,0,0,1
48934,0,1,0,0,1
48935,0,1,0,0,1
48936,1,0,0,0,1
48937,0,1,0,0,1
48938,0,0,0,1,1
48939,0,1,0,0,1
48940,0,1,0,0,1
48941,0,1,0,0,1
48942,0,1,0,0,1
48943,1,0,0,0,1
48944,0,1,0,0,1
48945,1,0,0,0,1
48946,1,0,0,0,1
48947,1,0,0,0,1
48948,0,1,0,0,1
48949,0,1,0,0,1
48950,0,1,0,0,1
48951,0,1,0,0,1
48952,0,1,0,0,1
48953,0,1,0,0,1
48954,1,0,0,0,1
48955,0,1,0,0,1
48956,0,1,0,0,1
48957,1,0,0,0,1
48958,0,0,1,0,1
48959,0,1,0,0,1
48960,0,1,0,0,1
48961,1,0,0,0,1
48962,0,1,0,0,1
48963,0,1,0,0,1
48964,0,1,0,0,1
48965,0,1,0,0,1
48966,0,1,0,0,1
48967,0,1,0,0,1
48968,0,1,0,0,1
48969,0,1,0,0,1
48970,0,1,0,0,1
48971,0,1,0,0,1
48972,0,1,0,0,1
48973,0,1,0,0,1
48974,1,0,0,0,1
48975,1,0,0,0,1
48976,1,0,0,0,1
48977,0,1,0,0,1
48978,0,1,0,0,1
48979,0,1,0,0,1
48980,0,1,0,0,1
48981,1,0,0,0,1
48982,0,1,0,0,1
48983,0,1,0,0,1
48984,1,0,0,0,1
48985,0,1,0,0,1
48986,0,1,0,0,1
48987,0,1,0,0,1
48988,0,1,0,0,1
48989,1,0,0,0,1
48990,0,1,0,0,1
48991,0,1,0,0,1
48992,0,1,0,0,1
48993,0,1,0,0,1
48994,0,1,0,0,1
48995,0,1,0,0,1
48996,0,1,0,0,1
48997,0,1,0,0,1
48998,0,1,0,0,1
48999,0,1,0,0,1
49000,0,1,0,0,1
49001,0,1,0,0,1
49002,0,1,0,0,1
49003,0,1,0,0,1
49004,0,1,0,0,1
49005,0,1,0,0,1
49006,0,1,0,0,1
49007,0,1,0,0,1
49008,0,1,0,0,1
49009,0,1,0,0,1
49010,0,1,0,0,1
49011,0,1,0,0,1
49012,0,1,0,0,1
49013,0,1,0,0,1
49014,0,1,0,0,1
49015,0,0,1,0,1
49016,0,1,0,0,1
49017,0,1,0,0,1
49018,0,1,0,0,1
49019,0,1,0,0,1
49020,0,1,0,0,1
49021,0,1,0,0,1
49022,0,1,0,0,1
49023,0,1,0,0,1
49024,0,1,0,0,1
49025,0,1,0,0,1
49026,0,1,0,0,1
49027,0,0,0,1,1
49028,0,0,0,1,1
49029,0,1,0,0,1
49030,0,1,0,0,1
49031,0,1,0,0,1
49032,0,1,0,0,1
49033,0,1,0,0,1
49034,1,0,0,0,1
49035,0,1,0,0,1
49036,0,1,0,0,1
49037,1,0,0,0,1
49038,0,1,0,0,1
49039,0,1,0,0,1
49040,0,1,0,0,1
49041,0,1,0,0,1
49042,0,1,0,0,1
49043,0,1,0,0,1
49044,0,0,0,1,1
49045,1,0,0,0,1
49046,0,1,0,0,1
49047,0,1,0,0,1
49048,0,1,0,0,1
49049,1,0,0,0,1
49050,0,1,0,0,1
49051,0,0,0,1,1
49052,1,0,0,0,1
49053,0,1,0,0,1
49054,1,0,0,0,1
49055,0,1,0,0,1
49056,0,1,0,0,1
49057,0,1,0,0,1
49058,0,1,0,0,1
49059,0,1,0,0,1
49060,0,1,0,0,1
49061,0,1,0,0,1
49062,0,1,0,0,1
49063,0,1,0,0,1
49064,0,1,0,0,1
49065,0,1,0,0,1
49066,0,1,0,0,1
49067,0,1,0,0,1
49068,1,0,0,0,1
49069,1,0,0,0,1
49070,1,0,0,0,1
49071,0,1,0,0,1
49072,0,1,0,0,1
49073,1,0,0,0,1
49074,0,1,0,0,1
49075,0,1,0,0,1
49076,1,0,0,0,1
49077,0,1,0,0,1
49078,0,1,0,0,1
49079,0,1,0,0,1
49080,0,1,0,0,1
49081,0,1,0,0,1
49082,0,1,0,0,1
49083,0,1,0,0,1
49084,0,0,0,1,1
49085,0,1,0,0,1
49086,0,1,0,0,1
49087,0,1,0,0,1
49088,0,1,0,0,1
49089,0,1,0,0,1
49090,0,1,0,0,1
49091,0,1,0,0,1
49092,0,1,0,0,1
49093,0,1,0,0,1
49094,0,1,0,0,1
49095,0,1,0,0,1
49096,0,1,0,0,1
49097,0,1,0,0,1
49098,0,1,0,0,1
49099,1,0,0,0,1
49100,1,0,0,0,1
49101,0,1,0,0,1
49102,0,1,0,0,1
49103,0,1,0,0,1
49104,0,1,0,0,1
49105,1,0,0,0,1
49106,0,1,0,0,1
49107,0,1,0,0,1
49108,1,0,0,0,1
49109,0,1,0,0,1
49110,0,1,0,0,1
49111,0,1,0,0,1
49112,0,1,0,0,1
49113,0,1,0,0,1
49114,0,1,0,0,1
49115,0,1,0,0,1
49116,0,1,0,0,1
49117,0,1,0,0,1
49118,0,1,0,0,1
49119,0,1,0,0,1
49120,0,1,0,0,1
49121,0,1,0,0,1
49122,0,1,0,0,1
49123,0,1,0,0,1
49124,0,1,0,0,1
49125,0,1,0,0,1
49126,0,1,0,0,1
49127,0,1,0,0,1
49128,0,1,0,0,1
49129,0,0,1,0,1
49130,1,0,0,0,1
49131,0,1,0,0,1
49132,0,1,0,0,1
49133,1,0,0,0,1
49134,0,1,0,0,1
49135,0,1,0,0,1
49136,1,0,0,0,1
49137,0,1,0,0,1
49138,0,1,0,0,1
49139,0,1,0,0,1
49140,0,1,0,0,1
49141,0,1,0,0,1
49142,1,0,0,0,1
49143,0,1,0,0,1
49144,1,0,0,0,1
49145,0,1,0,0,1
49146,0,1,0,0,1
49147,0,1,0,0,1
49148,0,1,0,0,1
49149,1,0,0,0,1
49150,0,1,0,0,1
49151,0,1,0,0,1
49152,0,1,0,0,1
49153,0,1,0,0,1
49154,1,0,0,0,1
49155,0,1,0,0,1
49156,0,1,0,0,1
49157,0,1,0,0,1
49158,0,0,0,1,1
49159,0,1,0,0,1
49160,0,1,0,0,1
49161,0,1,0,0,1
49162,0,1,0,0,1
49163,0,1,0,0,1
49164,0,1,0,0,1
49165,0,1,0,0,1
49166,0,1,0,0,1
49167,0,1,0,0,1
49168,0,1,0,0,1
49169,0,1,0,0,1
49170,0,1,0,0,1
49171,0,1,0,0,1
49172,0,1,0,0,1
49173,1,0,0,0,1
49174,0,1,0,0,1
49175,0,1,0,0,1
49176,0,1,0,0,1
49177,0,1,0,0,1
49178,0,1,0,0,1
49179,0,1,0,0,1
49180,0,1,0,0,1
49181,0,1,0,0,1
49182,0,1,0,0,1
49183,0,1,0,0,1
49184,0,1,0,0,1
49185,0,1,0,0,1
49186,0,1,0,0,1
49187,0,1,0,0,1
49188,0,1,0,0,1
49189,0,1,0,0,1
49190,0,1,0,0,1
49191,0,1,0,0,1
49192,1,0,0,0,1
49193,1,0,0,0,1
49194,1,0,0,0,1
49195,0,0,1,0,1
49196,0,1,0,0,1
49197,0,1,0,0,1
49198,1,0,0,0,1
49199,0,1,0,0,1
49200,0,1,0,0,1
49201,0,1,0,0,1
49202,0,1,0,0,1
49203,1,0,0,0,1
49204,1,0,0,0,1
49205,0,1,0,0,1
49206,0,1,0,0,1
49207,1,0,0,0,1
49208,1,0,0,0,1
49209,0,1,0,0,1
49210,0,1,0,0,1
49211,0,1,0,0,1
49212,0,1,0,0,1
49213,0,1,0,0,1
49214,0,1,0,0,1
49215,0,1,0,0,1
49216,0,1,0,0,1
49217,1,0,0,0,1
49218,1,0,0,0,1
49219,1,0,0,0,1
49220,0,1,0,0,1
49221,0,1,0,0,1
49222,0,1,0,0,1
49223,1,0,0,0,1
49224,0,1,0,0,1
49225,0,1,0,0,1
49226,0,1,0,0,1
49227,0,1,0,0,1
49228,0,1,0,0,1
49229,1,0,0,0,1
49230,0,1,0,0,1
49231,1,0,0,0,1
49232,0,0,1,0,1
49233,0,1,0,0,1
49234,0,1,0,0,1
49235,0,1,0,0,1
49236,0,1,0,0,1
49237,0,1,0,0,1
49238,0,1,0,0,1
49239,0,1,0,0,1
49240,0,1,0,0,1
49241,1,0,0,0,1
49242,0,1,0,0,1
49243,0,1,0,0,1
49244,0,1,0,0,1
49245,0,1,0,0,1
49246,0,1,0,0,1
49247,0,1,0,0,1
49248,0,1,0,0,1
49249,0,1,0,0,1
49250,1,0,0,0,1
49251,0,1,0,0,1
49252,0,1,0,0,1
49253,0,1,0,0,1
49254,0,1,0,0,1
49255,0,1,0,0,1
49256,0,1,0,0,1
49257,0,1,0,0,1
49258,1,0,0,0,1
49259,0,1,0,0,1
49260,0,1,0,0,1
49261,0,1,0,0,1
49262,1,0,0,0,1
49263,0,1,0,0,1
49264,0,1,0,0,1
49265,0,1,0,0,1
49266,0,1,0,0,1
49267,0,1,0,0,1
49268,0,1,0,0,1
49269,0,1,0,0,1
49270,0,0,1,0,1
49271,0,1,0,0,1
49272,1,0,0,0,1
49273,0,1,0,0,1
49274,0,1,0,0,1
49275,0,1,0,0,1
49276,0,1,0,0,1
49277,0,1,0,0,1
49278,0,1,0,0,1
49279,0,1,0,0,1
49280,1,0,0,0,1
49281,0,1,0,0,1
49282,0,1,0,0,1
49283,0,1,0,0,1
49284,0,1,0,0,1
49285,0,1,0,0,1
49286,0,1,0,0,1
49287,0,0,1,0,1
49288,0,1,0,0,1
49289,1,0,0,0,1
49290,0,1,0,0,1
49291,0,1,0,0,1
49292,0,1,0,0,1
49293,0,1,0,0,1
49294,0,0,0,1,1
49295,0,1,0,0,1
49296,0,1,0,0,1
49297,1,0,0,0,1
49298,1,0,0,0,1
49299,1,0,0,0,1
49300,0,1,0,0,1
49301,0,0,0,1,1
49302,1,0,0,0,1
49303,1,0,0,0,1
49304,0,1,0,0,1
49305,0,1,0,0,1
49306,0,1,0,0,1
49307,1,0,0,0,1
49308,0,1,0,0,1
49309,1,0,0,0,1
49310,0,1,0,0,1
49311,0,1,0,0,1
49312,0,1,0,0,1
49313,0,1,0,0,1
49314,0,1,0,0,1
49315,0,1,0,0,1
49316,1,0,0,0,1
49317,0,1,0,0,1
49318,0,1,0,0,1
49319,0,1,0,0,1
49320,0,1,0,0,1
49321,0,1,0,0,1
49322,1,0,0,0,1
49323,0,1,0,0,1
49324,0,1,0,0,1
49325,1,0,0,0,1
49326,1,0,0,0,1
49327,0,1,0,0,1
49328,0,1,0,0,1
49329,0,1,0,0,1
49330,0,1,0,0,1
49331,0,0,0,1,1
49332,0,1,0,0,1
49333,0,0,0,1,1
49334,0,1,0,0,1
49335,0,1,0,0,1
49336,0,1,0,0,1
49337,0,1,0,0,1
49338,0,1,0,0,1
49339,0,1,0,0,1
49340,0,1,0,0,1
49341,0,1,0,0,1
49342,0,1,0,0,1
49343,0,1,0,0,1
49344,0,1,0,0,1
49345,0,1,0,0,1
49346,1,0,0,0,1
49347,0,1,0,0,1
49348,0,1,0,0,1
49349,0,1,0,0,1
49350,0,1,0,0,1
49351,0,0,1,0,1
49352,1,0,0,0,1
49353,0,1,0,0,1
49354,1,0,0,0,1
49355,0,1,0,0,1
49356,0,1,0,0,1
49357,1,0,0,0,1
49358,0,1,0,0,1
49359,0,1,0,0,1
49360,0,1,0,0,1
49361,0,1,0,0,1
49362,0,1,0,0,1
49363,0,1,0,0,1
49364,0,1,0,0,1
49365,1,0,0,0,1
49366,0,0,0,1,1
49367,0,1,0,0,1
49368,0,1,0,0,1
49369,1,0,0,0,1
49370,0,1,0,0,1
49371,0,1,0,0,1
49372,0,1,0,0,1
49373,0,1,0,0,1
49374,0,1,0,0,1
49375,0,1,0,0,1
49376,0,1,0,0,1
49377,0,0,0,1,1
49378,0,1,0,0,1
49379,0,1,0,0,1
49380,1,0,0,0,1
49381,0,1,0,0,1
49382,0,1,0,0,1
49383,0,1,0,0,1
49384,0,1,0,0,1
49385,0,1,0,0,1
49386,0,1,0,0,1
49387,1,0,0,0,1
49388,1,0,0,0,1
49389,0,1,0,0,1
49390,1,0,0,0,1
49391,0,1,0,0,1
49392,0,1,0,0,1
49393,0,1,0,0,1
49394,0,1,0,0,1
49395,1,0,0,0,1
49396,0,1,0,0,1
49397,0,1,0,0,1
49398,0,1,0,0,1
49399,0,1,0,0,1
49400,0,1,0,0,1
49401,0,1,0,0,1
49402,0,1,0,0,1
49403,0,1,0,0,1
49404,0,0,0,1,1
49405,0,1,0,0,1
49406,0,1,0,0,1
49407,0,1,0,0,1
49408,0,0,0,1,1
49409,0,1,0,0,1
49410,0,1,0,0,1
49411,0,1,0,0,1
49412,0,1,0,0,1
49413,1,0,0,0,1
49414,0,1,0,0,1
49415,0,1,0,0,1
49416,0,1,0,0,1
49417,1,0,0,0,1
49418,0,1,0,0,1
49419,0,1,0,0,1
49420,0,1,0,0,1
49421,0,1,0,0,1
49422,1,0,0,0,1
49423,0,1,0,0,1
49424,0,0,1,0,1
49425,0,1,0,0,1
49426,1,0,0,0,1
49427,0,1,0,0,1
49428,1,0,0,0,1
49429,1,0,0,0,1
49430,0,1,0,0,1
49431,1,0,0,0,1
49432,0,0,0,1,1
49433,1,0,0,0,1
49434,0,1,0,0,1
49435,0,1,0,0,1
49436,0,1,0,0,1
49437,0,1,0,0,1
49438,0,1,0,0,1
49439,0,1,0,0,1
49440,0,1,0,0,1
49441,1,0,0,0,1
49442,0,1,0,0,1
49443,0,0,1,0,1
49444,1,0,0,0,1
49445,0,1,0,0,1
49446,0,1,0,0,1
49447,0,0,0,1,1
49448,0,1,0,0,1
49449,0,1,0,0,1
49450,0,1,0,0,1
49451,0,1,0,0,1
49452,0,1,0,0,1
49453,0,1,0,0,1
49454,0,1,0,0,1
49455,1,0,0,0,1
49456,0,0,1,0,1
49457,0,1,0,0,1
49458,0,1,0,0,1
49459,0,1,0,0,1
49460,0,1,0,0,1
49461,0,1,0,0,1
49462,1,0,0,0,1
49463,0,1,0,0,1
49464,0,1,0,0,1
49465,0,1,0,0,1
49466,0,1,0,0,1
49467,0,1,0,0,1
49468,0,1,0,0,1
49469,0,1,0,0,1
49470,0,1,0,0,1
49471,0,1,0,0,1
49472,0,1,0,0,1
49473,0,1,0,0,1
49474,0,1,0,0,1
49475,1,0,0,0,1
49476,1,0,0,0,1
49477,0,1,0,0,1
49478,1,0,0,0,1
49479,0,1,0,0,1
49480,0,1,0,0,1
49481,0,1,0,0,1
49482,0,1,0,0,1
49483,0,1,0,0,1
49484,0,1,0,0,1
49485,0,1,0,0,1
49486,0,1,0,0,1
49487,0,1,0,0,1
49488,0,1,0,0,1
49489,0,1,0,0,1
49490,0,1,0,0,1
49491,0,1,0,0,1
49492,0,1,0,0,1
49493,0,1,0,0,1
49494,0,1,0,0,1
49495,0,1,0,0,1
49496,0,1,0,0,1
49497,0,1,0,0,1
49498,0,0,0,1,1
49499,0,1,0,0,1
49500,0,1,0,0,1
49501,0,1,0,0,1
49502,0,1,0,0,1
49503,0,1,0,0,1
49504,0,1,0,0,1
49505,0,1,0,0,1
49506,1,0,0,0,1
49507,0,1,0,0,1
49508,0,1,0,0,1
49509,0,1,0,0,1
49510,0,0,0,1,1
49511,0,1,0,0,1
49512,0,1,0,0,1
49513,0,1,0,0,1
49514,0,1,0,0,1
49515,0,1,0,0,1
49516,0,1,0,0,1
49517,0,1,0,0,1
49518,0,1,0,0,1
49519,0,1,0,0,1
49520,0,1,0,0,1
49521,0,1,0,0,1
49522,0,1,0,0,1
49523,0,1,0,0,1
49524,0,1,0,0,1
49525,0,1,0,0,1
49526,0,1,0,0,1
49527,1,0,0,0,1
49528,0,1,0,0,1
49529,0,1,0,0,1
49530,0,1,0,0,1
49531,0,1,0,0,1
49532,0,1,0,0,1
49533,0,1,0,0,1
49534,1,0,0,0,1
49535,0,1,0,0,1
49536,0,1,0,0,1
49537,0,1,0,0,1
49538,0,1,0,0,1
49539,1,0,0,0,1
49540,0,1,0,0,1
49541,0,1,0,0,1
49542,0,1,0,0,1
49543,0,1,0,0,1
49544,0,1,0,0,1
49545,0,1,0,0,1
49546,0,0,0,1,1
49547,0,1,0,0,1
49548,0,1,0,0,1
49549,0,1,0,0,1
49550,0,1,0,0,1
49551,1,0,0,0,1
49552,0,1,0,0,1
49553,0,1,0,0,1
49554,0,1,0,0,1
49555,0,1,0,0,1
49556,0,1,0,0,1
49557,0,1,0,0,1
49558,0,1,0,0,1
49559,0,1,0,0,1
49560,0,1,0,0,1
49561,0,1,0,0,1
49562,0,1,0,0,1
49563,0,1,0,0,1
49564,0,1,0,0,1
49565,1,0,0,0,1
49566,0,0,0,1,1
49567,0,1,0,0,1
49568,0,0,1,0,1
49569,0,1,0,0,1
49570,0,1,0,0,1
49571,1,0,0,0,1
49572,0,1,0,0,1
49573,0,1,0,0,1
49574,0,1,0,0,1
49575,0,1,0,0,1
49576,0,1,0,0,1
49577,0,1,0,0,1
49578,0,1,0,0,1
49579,1,0,0,0,1
49580,0,1,0,0,1
49581,0,1,0,0,1
49582,0,1,0,0,1
49583,1,0,0,0,1
49584,0,1,0,0,1
49585,0,1,0,0,1
49586,0,1,0,0,1
49587,0,1,0,0,1
49588,0,0,1,0,1
49589,0,1,0,0,1
49590,0,1,0,0,1
49591,0,1,0,0,1
49592,0,1,0,0,1
49593,0,1,0,0,1
49594,0,0,1,0,1
49595,0,1,0,0,1
49596,0,1,0,0,1
49597,0,1,0,0,1
49598,0,1,0,0,1
49599,0,1,0,0,1
49600,0,1,0,0,1
49601,0,1,0,0,1
49602,0,0,1,0,1
49603,0,1,0,0,1
49604,0,1,0,0,1
49605,0,1,0,0,1
49606,0,1,0,0,1
49607,1,0,0,0,1
49608,1,0,0,0,1
49609,0,1,0,0,1
49610,0,1,0,0,1
49611,0,1,0,0,1
49612,0,1,0,0,1
49613,1,0,0,0,1
49614,1,0,0,0,1
49615,0,1,0,0,1
49616,0,0,1,0,1
49617,0,1,0,0,1
49618,0,1,0,0,1
49619,0,1,0,0,1
49620,0,1,0,0,1
49621,0,1,0,0,1
49622,0,1,0,0,1
49623,0,1,0,0,1
49624,1,0,0,0,1
49625,0,1,0,0,1
49626,0,1,0,0,1
49627,0,1,0,0,1
49628,0,1,0,0,1
49629,0,1,0,0,1
49630,0,1,0,0,1
49631,0,1,0,0,1
49632,0,1,0,0,1
49633,0,1,0,0,1
49634,0,1,0,0,1
49635,0,1,0,0,1
49636,0,1,0,0,1
49637,0,1,0,0,1
49638,0,1,0,0,1
49639,0,1,0,0,1
49640,1,0,0,0,1
49641,0,1,0,0,1
49642,0,0,1,0,1
49643,0,1,0,0,1
49644,0,1,0,0,1
49645,0,1,0,0,1
49646,0,1,0,0,1
49647,1,0,0,0,1
49648,0,1,0,0,1
49649,0,1,0,0,1
49650,1,0,0,0,1
49651,1,0,0,0,1
49652,0,1,0,0,1
49653,0,1,0,0,1
49654,0,0,0,1,1
49655,0,1,0,0,1
49656,0,1,0,0,1
49657,1,0,0,0,1
49658,0,1,0,0,1
49659,1,0,0,0,1
49660,0,1,0,0,1
49661,0,1,0,0,1
49662,0,1,0,0,1
49663,0,1,0,0,1
49664,0,1,0,0,1
49665,0,1,0,0,1
49666,0,1,0,0,1
49667,0,1,0,0,1
49668,0,1,0,0,1
49669,0,1,0,0,1
49670,0,1,0,0,1
49671,0,1,0,0,1
49672,0,1,0,0,1
49673,0,1,0,0,1
49674,0,1,0,0,1
49675,1,0,0,0,1
49676,0,1,0,0,1
49677,1,0,0,0,1
49678,1,0,0,0,1
49679,0,1,0,0,1
49680,0,1,0,0,1
49681,0,0,0,1,1
49682,0,1,0,0,1
49683,1,0,0,0,1
49684,0,1,0,0,1
49685,1,0,0,0,1
49686,1,0,0,0,1
49687,1,0,0,0,1
49688,0,1,0,0,1
49689,1,0,0,0,1
49690,0,0,0,1,1
49691,0,1,0,0,1
49692,0,1,0,0,1
49693,0,1,0,0,1
49694,1,0,0,0,1
49695,1,0,0,0,1
49696,0,0,0,1,1
49697,0,1,0,0,1
49698,0,1,0,0,1
49699,0,1,0,0,1
49700,0,1,0,0,1
49701,1,0,0,0,1
49702,0,1,0,0,1
49703,1,0,0,0,1
49704,0,1,0,0,1
49705,0,1,0,0,1
49706,0,1,0,0,1
49707,0,0,1,0,1
49708,0,1,0,0,1
49709,0,0,0,1,1
49710,1,0,0,0,1
49711,0,0,1,0,1
49712,0,1,0,0,1
49713,0,1,0,0,1
49714,0,1,0,0,1
49715,0,1,0,0,1
49716,0,1,0,0,1
49717,0,1,0,0,1
49718,0,1,0,0,1
49719,0,1,0,0,1
49720,1,0,0,0,1
49721,0,1,0,0,1
49722,0,1,0,0,1
49723,0,1,0,0,1
49724,0,1,0,0,1
49725,1,0,0,0,1
49726,0,1,0,0,1
49727,0,1,0,0,1
49728,0,1,0,0,1
49729,0,1,0,0,1
49730,0,0,0,1,1
49731,0,1,0,0,1
49732,0,1,0,0,1
49733,1,0,0,0,1
49734,0,1,0,0,1
49735,0,1,0,0,1
49736,0,1,0,0,1
49737,0,1,0,0,1
49738,0,1,0,0,1
49739,0,1,0,0,1
49740,0,1,0,0,1
49741,0,1,0,0,1
49742,0,1,0,0,1
49743,0,1,0,0,1
49744,1,0,0,0,1
49745,0,1,0,0,1
49746,0,1,0,0,1
49747,0,1,0,0,1
49748,1,0,0,0,1
49749,0,1,0,0,1
49750,0,1,0,0,1
49751,0,1,0,0,1
49752,0,1,0,0,1
49753,0,1,0,0,1
49754,0,1,0,0,1
49755,0,1,0,0,1
49756,0,1,0,0,1
49757,0,1,0,0,1
49758,0,1,0,0,1
49759,0,1,0,0,1
49760,0,1,0,0,1
49761,0,1,0,0,1
49762,0,1,0,0,1
49763,0,1,0,0,1
49764,0,1,0,0,1
49765,0,1,0,0,1
49766,0,1,0,0,1
49767,0,1,0,0,1
49768,0,1,0,0,1
49769,0,1,0,0,1
49770,1,0,0,0,1
49771,0,1,0,0,1
49772,0,1,0,0,1
49773,0,1,0,0,1
49774,0,1,0,0,1
49775,0,0,0,1,1
49776,0,1,0,0,1
49777,0,1,0,0,1
49778,0,1,0,0,1
49779,0,1,0,0,1
49780,0,1,0,0,1
49781,0,1,0,0,1
49782,0,1,0,0,1
49783,0,1,0,0,1
49784,0,0,1,0,1
49785,0,1,0,0,1
49786,0,0,0,1,1
49787,0,1,0,0,1
49788,1,0,0,0,1
49789,0,1,0,0,1
49790,0,1,0,0,1
49791,0,1,0,0,1
49792,0,0,0,1,1
49793,1,0,0,0,1
49794,0,1,0,0,1
49795,0,1,0,0,1
49796,0,1,0,0,1
49797,0,1,0,0,1
49798,0,1,0,0,1
49799,0,1,0,0,1
49800,0,1,0,0,1
49801,0,1,0,0,1
49802,0,1,0,0,1
49803,0,1,0,0,1
49804,0,0,1,0,1
49805,0,0,1,0,1
49806,0,1,0,0,1
49807,1,0,0,0,1
49808,0,0,1,0,1
49809,0,1,0,0,1
49810,0,1,0,0,1
49811,0,1,0,0,1
49812,1,0,0,0,1
49813,0,1,0,0,1
49814,0,1,0,0,1
49815,1,0,0,0,1
49816,0,1,0,0,1
49817,0,1,0,0,1
49818,0,1,0,0,1
49819,1,0,0,0,1
49820,0,1,0,0,1
49821,0,1,0,0,1
49822,1,0,0,0,1
49823,0,1,0,0,1
49824,1,0,0,0,1
49825,0,1,0,0,1
49826,0,1,0,0,1
49827,0,1,0,0,1
49828,0,1,0,0,1
49829,0,1,0,0,1
49830,0,1,0,0,1
49831,0,1,0,0,1
49832,1,0,0,0,1
49833,0,1,0,0,1
49834,0,0,0,1,1
49835,1,0,0,0,1
49836,0,1,0,0,1
49837,0,1,0,0,1
49838,0,1,0,0,1
49839,0,1,0,0,1
49840,0,1,0,0,1
49841,0,1,0,0,1
49842,0,1,0,0,1
49843,0,1,0,0,1
49844,0,1,0,0,1
49845,1,0,0,0,1
49846,0,1,0,0,1
49847,0,1,0,0,1
49848,0,1,0,0,1
49849,1,0,0,0,1
49850,0,1,0,0,1
49851,0,1,0,0,1
49852,0,1,0,0,1
49853,0,1,0,0,1
49854,1,0,0,0,1
49855,1,0,0,0,1
49856,0,1,0,0,1
49857,1,0,0,0,1
49858,0,1,0,0,1
49859,0,1,0,0,1
49860,0,1,0,0,1
49861,0,1,0,0,1
49862,0,1,0,0,1
49863,0,1,0,0,1
49864,0,1,0,0,1
49865,0,1,0,0,1
49866,1,0,0,0,1
49867,0,1,0,0,1
49868,1,0,0,0,1
49869,0,1,0,0,1
49870,0,1,0,0,1
49871,0,1,0,0,1
49872,0,1,0,0,1
49873,1,0,0,0,1
49874,0,1,0,0,1
49875,1,0,0,0,1
49876,0,1,0,0,1
49877,0,1,0,0,1
49878,0,0,0,1,1
49879,0,1,0,0,1
49880,0,1,0,0,1
49881,0,1,0,0,1
49882,0,1,0,0,1
49883,0,1,0,0,1
49884,0,1,0,0,1
49885,0,1,0,0,1
49886,1,0,0,0,1
49887,0,1,0,0,1
49888,1,0,0,0,1
49889,0,1,0,0,1
49890,0,1,0,0,1
49891,0,1,0,0,1
49892,0,1,0,0,1
49893,0,1,0,0,1
49894,1,0,0,0,1
49895,0,1,0,0,1
49896,1,0,0,0,1
49897,0,1,0,0,1
49898,0,1,0,0,1
49899,1,0,0,0,1
49900,0,1,0,0,1
49901,0,1,0,0,1
49902,0,0,1,0,1
49903,0,1,0,0,1
49904,0,1,0,0,1
49905,0,1,0,0,1
49906,0,1,0,0,1
49907,0,1,0,0,1
49908,0,1,0,0,1
49909,0,1,0,0,1
49910,0,1,0,0,1
49911,0,0,0,1,1
49912,1,0,0,0,1
49913,0,1,0,0,1
49914,0,1,0,0,1
49915,0,0,0,1,1
49916,0,1,0,0,1
49917,0,1,0,0,1
49918,0,1,0,0,1
49919,0,1,0,0,1
49920,0,1,0,0,1
49921,0,1,0,0,1
49922,0,0,0,1,1
49923,0,1,0,0,1
49924,1,0,0,0,1
49925,0,1,0,0,1
49926,0,1,0,0,1
49927,0,1,0,0,1
49928,0,1,0,0,1
49929,1,0,0,0,1
49930,0,1,0,0,1
49931,0,1,0,0,1
49932,0,1,0,0,1
49933,0,1,0,0,1
49934,1,0,0,0,1
49935,1,0,0,0,1
49936,0,1,0,0,1
49937,0,1,0,0,1
49938,0,1,0,0,1
49939,0,1,0,0,1
49940,0,1,0,0,1
49941,0,1,0,0,1
49942,0,1,0,0,1
49943,0,1,0,0,1
49944,0,1,0,0,1
49945,0,1,0,0,1
49946,0,1,0,0,1
49947,0,1,0,0,1
49948,0,1,0,0,1
49949,0,1,0,0,1
49950,0,1,0,0,1
49951,0,0,1,0,1
49952,0,0,1,0,1
49953,0,1,0,0,1
49954,0,1,0,0,1
49955,0,1,0,0,1
49956,0,0,1,0,1
49957,0,1,0,0,1
49958,0,1,0,0,1
49959,0,1,0,0,1
49960,0,1,0,0,1
49961,0,1,0,0,1
49962,0,1,0,0,1
49963,0,1,0,0,1
49964,0,1,0,0,1
49965,1,0,0,0,1
49966,0,1,0,0,1
49967,1,0,0,0,1
49968,0,1,0,0,1
49969,0,1,0,0,1
49970,0,1,0,0,1
49971,1,0,0,0,1
49972,0,1,0,0,1
49973,0,1,0,0,1
49974,0,1,0,0,1
49975,0,1,0,0,1
49976,1,0,0,0,1
49977,0,1,0,0,1
49978,0,1,0,0,1
49979,0,1,0,0,1
49980,0,1,0,0,1
49981,1,0,0,0,1
49982,0,1,0,0,1
49983,1,0,0,0,1
49984,0,1,0,0,1
49985,0,1,0,0,1
49986,0,1,0,0,1
49987,0,1,0,0,1
49988,0,1,0,0,1
49989,0,1,0,0,1
49990,0,1,0,0,1
49991,1,0,0,0,1
49992,0,1,0,0,1
49993,0,1,0,0,1
49994,0,1,0,0,1
49995,0,1,0,0,1
49996,0,1,0,0,1
49997,0,1,0,0,1
49998,0,1,0,0,1
49999,0,1,0,0,1
50000,0,0,0,1,1
50001,0,1,0,0,1
50002,0,1,0,0,1
50003,0,1,0,0,1
50004,0,1,0,0,1
50005,0,1,0,0,1
50006,0,1,0,0,1
50007,0,0,0,1,1
50008,0,1,0,0,1
50009,0,1,0,0,1
50010,0,1,0,0,1
50011,0,0,1,0,1
50012,1,0,0,0,1
50013,0,0,0,1,1
50014,0,1,0,0,1
50015,0,1,0,0,1
50016,0,1,0,0,1
50017,0,1,0,0,1
50018,0,1,0,0,1
50019,0,1,0,0,1
50020,0,1,0,0,1
50021,0,1,0,0,1
50022,0,0,1,0,1
50023,0,1,0,0,1
50024,0,1,0,0,1
50025,0,1,0,0,1
50026,0,1,0,0,1
50027,1,0,0,0,1
50028,0,1,0,0,1
50029,0,1,0,0,1
50030,1,0,0,0,1
50031,0,1,0,0,1
50032,0,1,0,0,1
50033,0,0,0,1,1
50034,1,0,0,0,1
50035,0,1,0,0,1
50036,0,1,0,0,1
50037,0,1,0,0,1
50038,0,1,0,0,1
50039,0,1,0,0,1
50040,0,1,0,0,1
50041,0,1,0,0,1
50042,0,1,0,0,1
50043,0,1,0,0,1
50044,0,1,0,0,1
50045,0,1,0,0,1
50046,0,1,0,0,1
50047,0,1,0,0,1
50048,1,0,0,0,1
50049,0,1,0,0,1
50050,0,1,0,0,1
50051,0,1,0,0,1
50052,0,1,0,0,1
50053,0,1,0,0,1
50054,0,1,0,0,1
50055,0,1,0,0,1
50056,0,1,0,0,1
50057,0,1,0,0,1
50058,0,1,0,0,1
50059,1,0,0,0,1
50060,0,1,0,0,1
50061,0,1,0,0,1
50062,0,0,0,1,1
50063,0,1,0,0,1
50064,0,1,0,0,1
50065,0,1,0,0,1
50066,0,1,0,0,1
50067,1,0,0,0,1
50068,0,1,0,0,1
50069,0,1,0,0,1
50070,0,1,0,0,1
50071,0,1,0,0,1
50072,0,1,0,0,1
50073,0,1,0,0,1
50074,0,1,0,0,1
50075,0,1,0,0,1
50076,1,0,0,0,1
50077,0,1,0,0,1
50078,1,0,0,0,1
50079,0,0,0,1,1
50080,1,0,0,0,1
50081,0,1,0,0,1
50082,0,1,0,0,1
50083,0,1,0,0,1
50084,0,1,0,0,1
50085,0,1,0,0,1
50086,0,1,0,0,1
50087,0,1,0,0,1
50088,1,0,0,0,1
50089,0,1,0,0,1
50090,0,1,0,0,1
50091,0,1,0,0,1
50092,1,0,0,0,1
50093,0,1,0,0,1
50094,0,1,0,0,1
50095,1,0,0,0,1
50096,0,1,0,0,1
50097,0,1,0,0,1
50098,0,1,0,0,1
50099,0,1,0,0,1
50100,0,1,0,0,1
50101,0,1,0,0,1
50102,0,1,0,0,1
50103,0,1,0,0,1
50104,0,1,0,0,1
50105,0,1,0,0,1
50106,0,1,0,0,1
50107,0,1,0,0,1
50108,0,1,0,0,1
50109,1,0,0,0,1
50110,1,0,0,0,1
50111,0,1,0,0,1
50112,0,1,0,0,1
50113,0,1,0,0,1
50114,0,1,0,0,1
50115,0,1,0,0,1
50116,0,1,0,0,1
50117,0,1,0,0,1
50118,0,1,0,0,1
50119,0,1,0,0,1
50120,0,1,0,0,1
50121,0,0,0,1,1
50122,0,1,0,0,1
50123,0,1,0,0,1
50124,0,1,0,0,1
50125,1,0,0,0,1
50126,0,1,0,0,1
50127,0,1,0,0,1
50128,0,1,0,0,1
50129,0,1,0,0,1
50130,0,1,0,0,1
50131,0,1,0,0,1
50132,0,1,0,0,1
50133,0,1,0,0,1
50134,0,1,0,0,1
50135,0,1,0,0,1
50136,0,1,0,0,1
50137,0,1,0,0,1
50138,0,1,0,0,1
50139,0,1,0,0,1
50140,1,0,0,0,1
50141,0,1,0,0,1
50142,0,1,0,0,1
50143,0,1,0,0,1
50144,0,1,0,0,1
50145,0,1,0,0,1
50146,0,1,0,0,1
50147,0,1,0,0,1
50148,0,1,0,0,1
50149,0,1,0,0,1
50150,0,1,0,0,1
50151,0,1,0,0,1
50152,0,1,0,0,1
50153,0,1,0,0,1
50154,0,1,0,0,1
50155,0,1,0,0,1
50156,1,0,0,0,1
50157,0,1,0,0,1
50158,1,0,0,0,1
50159,1,0,0,0,1
50160,0,1,0,0,1
50161,1,0,0,0,1
50162,0,1,0,0,1
50163,0,1,0,0,1
50164,0,1,0,0,1
50165,0,1,0,0,1
50166,0,1,0,0,1
50167,1,0,0,0,1
50168,0,1,0,0,1
50169,0,0,1,0,1
50170,0,1,0,0,1
50171,0,1,0,0,1
50172,0,1,0,0,1
50173,1,0,0,0,1
50174,0,1,0,0,1
50175,0,1,0,0,1
50176,0,1,0,0,1
50177,0,1,0,0,1
50178,0,1,0,0,1
50179,0,1,0,0,1
50180,0,1,0,0,1
50181,0,1,0,0,1
50182,0,1,0,0,1
50183,0,1,0,0,1
50184,1,0,0,0,1
50185,0,1,0,0,1
50186,1,0,0,0,1
50187,0,1,0,0,1
50188,0,1,0,0,1
50189,0,1,0,0,1
50190,0,1,0,0,1
50191,0,1,0,0,1
50192,1,0,0,0,1
50193,0,1,0,0,1
50194,0,1,0,0,1
50195,0,1,0,0,1
50196,0,1,0,0,1
50197,0,1,0,0,1
50198,0,1,0,0,1
50199,0,1,0,0,1
50200,0,1,0,0,1
50201,0,1,0,0,1
50202,0,1,0,0,1
50203,0,1,0,0,1
50204,0,1,0,0,1
50205,0,1,0,0,1
50206,0,1,0,0,1
50207,0,1,0,0,1
50208,0,1,0,0,1
50209,0,0,0,1,1
50210,0,1,0,0,1
50211,0,1,0,0,1
50212,0,1,0,0,1
50213,0,0,0,1,1
50214,1,0,0,0,1
50215,0,1,0,0,1
50216,0,1,0,0,1
50217,0,1,0,0,1
50218,0,1,0,0,1
50219,0,1,0,0,1
50220,0,1,0,0,1
50221,0,1,0,0,1
50222,0,1,0,0,1
50223,0,1,0,0,1
50224,1,0,0,0,1
50225,1,0,0,0,1
50226,0,1,0,0,1
50227,0,1,0,0,1
50228,0,1,0,0,1
50229,0,1,0,0,1
50230,0,1,0,0,1
50231,0,1,0,0,1
50232,0,1,0,0,1
50233,0,1,0,0,1
50234,0,1,0,0,1
50235,0,1,0,0,1
50236,0,1,0,0,1
50237,0,1,0,0,1
50238,0,1,0,0,1
50239,1,0,0,0,1
50240,0,1,0,0,1
50241,0,1,0,0,1
50242,0,1,0,0,1
50243,0,1,0,0,1
50244,1,0,0,0,1
50245,0,1,0,0,1
50246,0,1,0,0,1
50247,0,1,0,0,1
50248,0,1,0,0,1
50249,0,1,0,0,1
50250,1,0,0,0,1
50251,0,1,0,0,1
50252,0,1,0,0,1
50253,0,1,0,0,1
50254,0,1,0,0,1
50255,0,1,0,0,1
50256,0,1,0,0,1
50257,0,1,0,0,1
50258,0,1,0,0,1
50259,1,0,0,0,1
50260,0,1,0,0,1
50261,0,1,0,0,1
50262,0,1,0,0,1
50263,0,1,0,0,1
50264,1,0,0,0,1
50265,0,1,0,0,1
50266,0,1,0,0,1
50267,0,1,0,0,1
50268,0,1,0,0,1
50269,0,1,0,0,1
50270,1,0,0,0,1
50271,0,1,0,0,1
50272,0,1,0,0,1
50273,0,1,0,0,1
50274,0,1,0,0,1
50275,0,1,0,0,1
50276,1,0,0,0,1
50277,1,0,0,0,1
50278,0,1,0,0,1
50279,0,1,0,0,1
50280,1,0,0,0,1
50281,0,1,0,0,1
50282,0,1,0,0,1
50283,0,1,0,0,1
50284,0,1,0,0,1
50285,0,1,0,0,1
50286,1,0,0,0,1
50287,1,0,0,0,1
50288,1,0,0,0,1
50289,0,1,0,0,1
50290,0,1,0,0,1
50291,0,0,0,1,1
50292,1,0,0,0,1
50293,0,1,0,0,1
50294,0,0,1,0,1
50295,1,0,0,0,1
50296,0,1,0,0,1
50297,0,1,0,0,1
50298,0,1,0,0,1
50299,0,1,0,0,1
50300,0,1,0,0,1
50301,0,1,0,0,1
50302,0,1,0,0,1
50303,0,1,0,0,1
50304,0,1,0,0,1
50305,0,1,0,0,1
50306,0,1,0,0,1
50307,0,1,0,0,1
50308,1,0,0,0,1
50309,1,0,0,0,1
50310,0,1,0,0,1
50311,0,1,0,0,1
50312,0,1,0,0,1
50313,1,0,0,0,1
50314,0,1,0,0,1
50315,0,1,0,0,1
50316,0,1,0,0,1
50317,0,1,0,0,1
50318,1,0,0,0,1
50319,0,0,0,1,1
50320,0,1,0,0,1
50321,0,1,0,0,1
50322,0,1,0,0,1
50323,0,1,0,0,1
50324,0,1,0,0,1
50325,0,1,0,0,1
50326,0,1,0,0,1
50327,0,1,0,0,1
50328,0,1,0,0,1
50329,0,1,0,0,1
50330,0,1,0,0,1
50331,0,1,0,0,1
50332,1,0,0,0,1
50333,1,0,0,0,1
50334,0,1,0,0,1
50335,1,0,0,0,1
50336,0,1,0,0,1
50337,0,1,0,0,1
50338,0,1,0,0,1
50339,0,1,0,0,1
50340,0,1,0,0,1
50341,1,0,0,0,1
50342,0,1,0,0,1
50343,0,1,0,0,1
50344,1,0,0,0,1
50345,1,0,0,0,1
50346,0,1,0,0,1
50347,0,1,0,0,1
50348,0,0,1,0,1
50349,1,0,0,0,1
50350,0,1,0,0,1
50351,0,1,0,0,1
50352,0,1,0,0,1
50353,1,0,0,0,1
50354,0,1,0,0,1
50355,0,1,0,0,1
50356,0,1,0,0,1
50357,0,1,0,0,1
50358,0,1,0,0,1
50359,0,1,0,0,1
50360,0,1,0,0,1
50361,0,1,0,0,1
50362,0,1,0,0,1
50363,0,1,0,0,1
50364,0,1,0,0,1
50365,0,1,0,0,1
50366,1,0,0,0,1
50367,1,0,0,0,1
50368,1,0,0,0,1
50369,0,1,0,0,1
50370,0,0,0,1,1
50371,0,1,0,0,1
50372,0,0,1,0,1
50373,0,1,0,0,1
50374,0,1,0,0,1
50375,0,1,0,0,1
50376,0,1,0,0,1
50377,0,1,0,0,1
50378,0,1,0,0,1
50379,0,1,0,0,1
50380,0,1,0,0,1
50381,0,1,0,0,1
50382,0,1,0,0,1
50383,0,1,0,0,1
50384,0,1,0,0,1
50385,1,0,0,0,1
50386,0,1,0,0,1
50387,0,1,0,0,1
50388,0,1,0,0,1
50389,0,1,0,0,1
50390,0,1,0,0,1
50391,0,1,0,0,1
50392,0,1,0,0,1
50393,1,0,0,0,1
50394,0,1,0,0,1
50395,1,0,0,0,1
50396,0,1,0,0,1
50397,0,0,1,0,1
50398,0,1,0,0,1
50399,0,1,0,0,1
50400,0,1,0,0,1
50401,0,1,0,0,1
50402,0,1,0,0,1
50403,0,0,1,0,1
50404,0,1,0,0,1
50405,0,1,0,0,1
50406,0,1,0,0,1
50407,0,1,0,0,1
50408,0,1,0,0,1
50409,0,1,0,0,1
50410,0,1,0,0,1
50411,0,1,0,0,1
50412,1,0,0,0,1
50413,0,1,0,0,1
50414,0,1,0,0,1
50415,0,1,0,0,1
50416,0,1,0,0,1
50417,0,1,0,0,1
50418,1,0,0,0,1
50419,1,0,0,0,1
50420,0,1,0,0,1
50421,0,1,0,0,1
50422,0,1,0,0,1
50423,0,1,0,0,1
50424,0,1,0,0,1
50425,0,1,0,0,1
50426,0,1,0,0,1
50427,1,0,0,0,1
50428,0,1,0,0,1
50429,0,1,0,0,1
50430,0,1,0,0,1
50431,1,0,0,0,1
50432,0,1,0,0,1
50433,0,1,0,0,1
50434,1,0,0,0,1
50435,0,0,1,0,1
50436,0,1,0,0,1
50437,0,1,0,0,1
50438,0,1,0,0,1
50439,0,1,0,0,1
50440,0,1,0,0,1
50441,0,1,0,0,1
50442,0,1,0,0,1
50443,0,1,0,0,1
50444,0,1,0,0,1
50445,0,1,0,0,1
50446,0,0,0,1,1
50447,0,1,0,0,1
50448,0,1,0,0,1
50449,1,0,0,0,1
50450,0,1,0,0,1
50451,0,1,0,0,1
50452,1,0,0,0,1
50453,0,1,0,0,1
50454,0,1,0,0,1
50455,0,1,0,0,1
50456,0,1,0,0,1
50457,0,1,0,0,1
50458,0,1,0,0,1
50459,0,1,0,0,1
50460,0,1,0,0,1
50461,1,0,0,0,1
50462,0,1,0,0,1
50463,0,1,0,0,1
50464,0,1,0,0,1
50465,0,1,0,0,1
50466,0,1,0,0,1
50467,0,1,0,0,1
50468,0,1,0,0,1
50469,1,0,0,0,1
50470,0,1,0,0,1
50471,0,1,0,0,1
50472,0,1,0,0,1
50473,0,1,0,0,1
50474,0,1,0,0,1
50475,0,1,0,0,1
50476,0,1,0,0,1
50477,0,0,0,1,1
50478,0,1,0,0,1
50479,0,1,0,0,1
50480,0,1,0,0,1
50481,0,1,0,0,1
50482,1,0,0,0,1
50483,0,1,0,0,1
50484,0,1,0,0,1
50485,0,1,0,0,1
50486,1,0,0,0,1
50487,0,1,0,0,1
50488,0,1,0,0,1
50489,0,1,0,0,1
50490,0,1,0,0,1
50491,0,1,0,0,1
50492,0,1,0,0,1
50493,0,1,0,0,1
50494,0,1,0,0,1
50495,0,1,0,0,1
50496,0,1,0,0,1
50497,0,1,0,0,1
50498,0,1,0,0,1
50499,0,1,0,0,1
50500,0,1,0,0,1
50501,0,1,0,0,1
50502,0,1,0,0,1
50503,0,1,0,0,1
50504,0,1,0,0,1
50505,0,1,0,0,1
50506,0,1,0,0,1
50507,0,1,0,0,1
50508,0,1,0,0,1
50509,0,0,0,1,1
50510,0,1,0,0,1
50511,0,1,0,0,1
50512,0,1,0,0,1
50513,0,1,0,0,1
50514,1,0,0,0,1
50515,0,1,0,0,1
50516,0,1,0,0,1
50517,0,0,0,1,1
50518,0,1,0,0,1
50519,1,0,0,0,1
50520,0,1,0,0,1
50521,0,1,0,0,1
50522,0,0,1,0,1
50523,0,1,0,0,1
50524,0,1,0,0,1
50525,1,0,0,0,1
50526,1,0,0,0,1
50527,0,1,0,0,1
50528,0,1,0,0,1
50529,0,1,0,0,1
50530,1,0,0,0,1
50531,0,1,0,0,1
50532,0,1,0,0,1
50533,0,1,0,0,1
50534,0,1,0,0,1
50535,0,1,0,0,1
50536,0,1,0,0,1
50537,0,1,0,0,1
50538,0,1,0,0,1
50539,0,1,0,0,1
50540,0,1,0,0,1
50541,1,0,0,0,1
50542,0,1,0,0,1
50543,0,1,0,0,1
50544,0,1,0,0,1
50545,0,1,0,0,1
50546,0,1,0,0,1
50547,0,1,0,0,1
50548,0,1,0,0,1
50549,0,1,0,0,1
50550,0,1,0,0,1
50551,0,1,0,0,1
50552,0,1,0,0,1
50553,0,1,0,0,1
50554,0,1,0,0,1
50555,0,1,0,0,1
50556,0,1,0,0,1
50557,0,1,0,0,1
50558,0,1,0,0,1
50559,0,1,0,0,1
50560,0,1,0,0,1
50561,0,1,0,0,1
50562,0,1,0,0,1
50563,0,1,0,0,1
50564,0,1,0,0,1
50565,0,1,0,0,1
50566,0,1,0,0,1
50567,0,1,0,0,1
50568,0,0,1,0,1
50569,0,1,0,0,1
50570,0,1,0,0,1
50571,0,1,0,0,1
50572,0,1,0,0,1
50573,0,1,0,0,1
50574,0,1,0,0,1
50575,0,1,0,0,1
50576,0,1,0,0,1
50577,0,1,0,0,1
50578,0,1,0,0,1
50579,1,0,0,0,1
50580,1,0,0,0,1
50581,1,0,0,0,1
50582,0,1,0,0,1
50583,0,1,0,0,1
50584,0,1,0,0,1
50585,0,1,0,0,1
50586,0,1,0,0,1
50587,0,1,0,0,1
50588,0,1,0,0,1
50589,0,1,0,0,1
50590,0,1,0,0,1
50591,0,1,0,0,1
50592,0,1,0,0,1
50593,1,0,0,0,1
50594,0,1,0,0,1
50595,1,0,0,0,1
50596,0,1,0,0,1
50597,0,1,0,0,1
50598,0,1,0,0,1
50599,0,1,0,0,1
50600,0,0,0,1,1
50601,0,1,0,0,1
50602,0,0,1,0,1
50603,0,1,0,0,1
50604,1,0,0,0,1
50605,0,1,0,0,1
50606,0,1,0,0,1
50607,0,1,0,0,1
50608,0,1,0,0,1
50609,0,1,0,0,1
50610,0,1,0,0,1
50611,0,1,0,0,1
50612,1,0,0,0,1
50613,1,0,0,0,1
50614,0,1,0,0,1
50615,1,0,0,0,1
50616,1,0,0,0,1
50617,0,1,0,0,1
50618,0,1,0,0,1
50619,0,1,0,0,1
50620,0,1,0,0,1
50621,0,1,0,0,1
50622,0,1,0,0,1
50623,0,1,0,0,1
50624,0,1,0,0,1
50625,0,1,0,0,1
50626,0,1,0,0,1
50627,0,1,0,0,1
50628,0,1,0,0,1
50629,0,1,0,0,1
50630,0,0,1,0,1
50631,0,1,0,0,1
50632,0,1,0,0,1
50633,0,1,0,0,1
50634,1,0,0,0,1
50635,1,0,0,0,1
50636,0,1,0,0,1
50637,0,1,0,0,1
50638,1,0,0,0,1
50639,0,1,0,0,1
50640,0,1,0,0,1
50641,0,1,0,0,1
50642,0,1,0,0,1
50643,0,1,0,0,1
50644,0,1,0,0,1
50645,0,1,0,0,1
50646,0,0,0,1,1
50647,0,1,0,0,1
50648,0,1,0,0,1
50649,1,0,0,0,1
50650,0,0,0,1,1
50651,0,1,0,0,1
50652,0,1,0,0,1
50653,0,1,0,0,1
50654,0,1,0,0,1
50655,0,1,0,0,1
50656,1,0,0,0,1
50657,0,1,0,0,1
50658,1,0,0,0,1
50659,0,1,0,0,1
50660,1,0,0,0,1
50661,0,1,0,0,1
50662,0,1,0,0,1
50663,0,1,0,0,1
50664,0,1,0,0,1
50665,0,1,0,0,1
50666,0,1,0,0,1
50667,0,1,0,0,1
50668,0,1,0,0,1
50669,0,1,0,0,1
50670,0,1,0,0,1
50671,0,1,0,0,1
50672,0,0,1,0,1
50673,1,0,0,0,1
50674,0,0,1,0,1
50675,0,1,0,0,1
50676,0,1,0,0,1
50677,1,0,0,0,1
50678,0,1,0,0,1
50679,0,1,0,0,1
50680,0,1,0,0,1
50681,0,1,0,0,1
50682,0,1,0,0,1
50683,0,1,0,0,1
50684,0,1,0,0,1
50685,1,0,0,0,1
50686,0,1,0,0,1
50687,0,1,0,0,1
50688,0,1,0,0,1
50689,0,0,1,0,1
50690,0,1,0,0,1
50691,1,0,0,0,1
50692,0,1,0,0,1
50693,0,1,0,0,1
50694,0,1,0,0,1
50695,1,0,0,0,1
50696,0,1,0,0,1
50697,0,0,0,1,1
50698,1,0,0,0,1
50699,0,1,0,0,1
50700,0,1,0,0,1
50701,1,0,0,0,1
50702,0,1,0,0,1
50703,0,1,0,0,1
50704,0,1,0,0,1
50705,0,1,0,0,1
50706,0,0,0,1,1
50707,0,0,1,0,1
50708,0,1,0,0,1
50709,1,0,0,0,1
50710,0,1,0,0,1
50711,0,1,0,0,1
50712,0,1,0,0,1
50713,0,1,0,0,1
50714,1,0,0,0,1
50715,0,1,0,0,1
50716,0,1,0,0,1
50717,1,0,0,0,1
50718,0,1,0,0,1
50719,1,0,0,0,1
50720,0,1,0,0,1
50721,0,1,0,0,1
50722,0,1,0,0,1
50723,0,1,0,0,1
50724,0,1,0,0,1
50725,0,1,0,0,1
50726,0,1,0,0,1
50727,0,1,0,0,1
50728,0,1,0,0,1
50729,1,0,0,0,1
50730,0,0,0,1,1
50731,0,1,0,0,1
50732,1,0,0,0,1
50733,1,0,0,0,1
50734,0,1,0,0,1
50735,0,1,0,0,1
50736,0,1,0,0,1
50737,0,1,0,0,1
50738,0,1,0,0,1
50739,0,1,0,0,1
50740,1,0,0,0,1
50741,0,1,0,0,1
50742,0,1,0,0,1
50743,0,1,0,0,1
50744,1,0,0,0,1
50745,0,0,0,1,1
50746,0,1,0,0,1
50747,0,1,0,0,1
50748,0,1,0,0,1
50749,0,1,0,0,1
50750,0,1,0,0,1
50751,0,1,0,0,1
50752,1,0,0,0,1
50753,0,1,0,0,1
50754,0,1,0,0,1
50755,0,1,0,0,1
50756,0,1,0,0,1
50757,0,1,0,0,1
50758,0,1,0,0,1
50759,0,1,0,0,1
50760,0,0,1,0,1
50761,1,0,0,0,1
50762,0,1,0,0,1
50763,1,0,0,0,1
50764,0,1,0,0,1
50765,0,1,0,0,1
50766,0,1,0,0,1
50767,0,1,0,0,1
50768,0,1,0,0,1
50769,0,1,0,0,1
50770,0,1,0,0,1
50771,0,1,0,0,1
50772,0,1,0,0,1
50773,1,0,0,0,1
50774,1,0,0,0,1
50775,0,1,0,0,1
50776,1,0,0,0,1
50777,0,0,1,0,1
50778,0,1,0,0,1
50779,0,1,0,0,1
50780,0,1,0,0,1
50781,0,1,0,0,1
50782,0,1,0,0,1
50783,0,1,0,0,1
50784,0,1,0,0,1
50785,0,1,0,0,1
50786,0,0,1,0,1
50787,1,0,0,0,1
50788,0,1,0,0,1
50789,0,1,0,0,1
50790,0,1,0,0,1
50791,0,1,0,0,1
50792,0,1,0,0,1
50793,0,1,0,0,1
50794,0,1,0,0,1
50795,0,1,0,0,1
50796,0,0,0,1,1
50797,1,0,0,0,1
50798,0,1,0,0,1
50799,0,0,0,1,1
50800,0,1,0,0,1
50801,0,0,0,1,1
50802,0,1,0,0,1
50803,0,1,0,0,1
50804,0,1,0,0,1
50805,0,1,0,0,1
50806,0,1,0,0,1
50807,0,1,0,0,1
50808,0,1,0,0,1
50809,0,0,1,0,1
50810,0,1,0,0,1
50811,0,1,0,0,1
50812,0,1,0,0,1
50813,0,1,0,0,1
50814,0,1,0,0,1
50815,0,1,0,0,1
50816,0,1,0,0,1
50817,0,1,0,0,1
50818,0,1,0,0,1
50819,0,1,0,0,1
50820,0,1,0,0,1
50821,0,1,0,0,1
50822,0,1,0,0,1
50823,1,0,0,0,1
50824,0,1,0,0,1
50825,1,0,0,0,1
50826,0,0,1,0,1
50827,1,0,0,0,1
50828,1,0,0,0,1
50829,1,0,0,0,1
50830,0,0,0,1,1
50831,0,1,0,0,1
50832,1,0,0,0,1
50833,0,1,0,0,1
50834,1,0,0,0,1
50835,0,1,0,0,1
50836,0,1,0,0,1
50837,0,1,0,0,1
50838,0,1,0,0,1
50839,0,1,0,0,1
50840,0,1,0,0,1
50841,0,1,0,0,1
50842,0,1,0,0,1
50843,0,1,0,0,1
50844,0,1,0,0,1
50845,0,1,0,0,1
50846,0,1,0,0,1
50847,0,1,0,0,1
50848,0,1,0,0,1
50849,1,0,0,0,1
50850,0,1,0,0,1
50851,0,1,0,0,1
50852,1,0,0,0,1
50853,1,0,0,0,1
50854,0,1,0,0,1
50855,0,1,0,0,1
50856,0,1,0,0,1
50857,0,1,0,0,1
50858,0,1,0,0,1
50859,0,1,0,0,1
50860,0,1,0,0,1
50861,0,1,0,0,1
50862,0,1,0,0,1
50863,0,1,0,0,1
50864,1,0,0,0,1
50865,0,1,0,0,1
50866,1,0,0,0,1
50867,0,1,0,0,1
50868,0,1,0,0,1
50869,0,1,0,0,1
50870,0,0,0,1,1
50871,0,1,0,0,1
50872,0,1,0,0,1
50873,0,1,0,0,1
50874,0,1,0,0,1
50875,0,1,0,0,1
50876,0,1,0,0,1
50877,0,1,0,0,1
50878,0,1,0,0,1
50879,0,1,0,0,1
50880,0,1,0,0,1
50881,0,1,0,0,1
50882,0,1,0,0,1
50883,0,1,0,0,1
50884,0,1,0,0,1
50885,0,1,0,0,1
50886,0,1,0,0,1
50887,0,0,1,0,1
50888,0,1,0,0,1
50889,0,1,0,0,1
50890,0,1,0,0,1
50891,0,1,0,0,1
50892,0,1,0,0,1
50893,0,1,0,0,1
50894,0,0,0,1,1
50895,0,1,0,0,1
50896,0,0,1,0,1
50897,0,1,0,0,1
50898,0,1,0,0,1
50899,0,0,0,1,1
50900,0,1,0,0,1
50901,0,1,0,0,1
50902,0,1,0,0,1
50903,0,1,0,0,1
50904,0,1,0,0,1
50905,0,1,0,0,1
50906,0,1,0,0,1
50907,0,1,0,0,1
50908,0,1,0,0,1
50909,1,0,0,0,1
50910,0,1,0,0,1
50911,0,1,0,0,1
50912,0,1,0,0,1
50913,0,1,0,0,1
50914,0,1,0,0,1
50915,0,1,0,0,1
50916,0,1,0,0,1
50917,0,0,1,0,1
50918,0,1,0,0,1
50919,0,1,0,0,1
50920,0,1,0,0,1
50921,0,1,0,0,1
50922,1,0,0,0,1
50923,1,0,0,0,1
50924,0,1,0,0,1
50925,0,1,0,0,1
50926,1,0,0,0,1
50927,0,1,0,0,1
50928,1,0,0,0,1
50929,0,1,0,0,1
50930,0,1,0,0,1
50931,0,1,0,0,1
50932,1,0,0,0,1
50933,0,1,0,0,1
50934,0,1,0,0,1
50935,0,0,0,1,1
50936,0,1,0,0,1
50937,0,1,0,0,1
50938,0,1,0,0,1
50939,0,1,0,0,1
50940,0,1,0,0,1
50941,0,1,0,0,1
50942,0,1,0,0,1
50943,0,1,0,0,1
50944,1,0,0,0,1
50945,0,1,0,0,1
50946,0,1,0,0,1
50947,1,0,0,0,1
50948,0,1,0,0,1
50949,0,1,0,0,1
50950,1,0,0,0,1
50951,0,1,0,0,1
50952,0,1,0,0,1
50953,0,1,0,0,1
50954,0,1,0,0,1
50955,0,1,0,0,1
50956,0,1,0,0,1
50957,0,1,0,0,1
50958,0,1,0,0,1
50959,0,1,0,0,1
50960,1,0,0,0,1
50961,0,0,0,1,1
50962,0,1,0,0,1
50963,0,1,0,0,1
50964,0,1,0,0,1
50965,0,1,0,0,1
50966,0,1,0,0,1
50967,0,1,0,0,1
50968,1,0,0,0,1
50969,0,1,0,0,1
50970,1,0,0,0,1
50971,0,1,0,0,1
50972,0,1,0,0,1
50973,0,1,0,0,1
50974,0,1,0,0,1
50975,0,1,0,0,1
50976,0,0,0,1,1
50977,0,1,0,0,1
50978,0,1,0,0,1
50979,0,1,0,0,1
50980,0,1,0,0,1
50981,0,1,0,0,1
50982,0,1,0,0,1
50983,0,1,0,0,1
50984,0,1,0,0,1
50985,0,0,0,1,1
50986,0,1,0,0,1
50987,0,1,0,0,1
50988,0,1,0,0,1
50989,0,1,0,0,1
50990,0,1,0,0,1
50991,0,1,0,0,1
50992,0,1,0,0,1
50993,0,1,0,0,1
50994,0,1,0,0,1
50995,0,1,0,0,1
50996,0,1,0,0,1
50997,0,0,1,0,1
50998,0,1,0,0,1
50999,1,0,0,0,1
51000,0,1,0,0,1
51001,0,1,0,0,1
51002,0,1,0,0,1
51003,0,1,0,0,1
51004,0,1,0,0,1
51005,0,1,0,0,1
51006,0,1,0,0,1
51007,0,1,0,0,1
51008,0,1,0,0,1
51009,0,1,0,0,1
51010,0,1,0,0,1
51011,0,1,0,0,1
51012,0,1,0,0,1
51013,0,1,0,0,1
51014,0,1,0,0,1
51015,0,1,0,0,1
51016,0,1,0,0,1
51017,0,1,0,0,1
51018,0,1,0,0,1
51019,1,0,0,0,1
51020,1,0,0,0,1
51021,0,1,0,0,1
51022,1,0,0,0,1
51023,0,1,0,0,1
51024,0,1,0,0,1
51025,0,1,0,0,1
51026,1,0,0,0,1
51027,0,1,0,0,1
51028,0,1,0,0,1
51029,0,1,0,0,1
51030,0,1,0,0,1
51031,0,1,0,0,1
51032,1,0,0,0,1
51033,0,1,0,0,1
51034,0,1,0,0,1
51035,0,1,0,0,1
51036,0,1,0,0,1
51037,0,1,0,0,1
51038,1,0,0,0,1
51039,0,1,0,0,1
51040,0,1,0,0,1
51041,0,1,0,0,1
51042,0,1,0,0,1
51043,0,1,0,0,1
51044,0,0,0,1,1
51045,1,0,0,0,1
51046,0,0,1,0,1
51047,0,1,0,0,1
51048,1,0,0,0,1
51049,0,1,0,0,1
51050,0,1,0,0,1
51051,0,1,0,0,1
51052,0,1,0,0,1
51053,0,1,0,0,1
51054,0,1,0,0,1
51055,0,1,0,0,1
51056,0,1,0,0,1
51057,0,1,0,0,1
51058,0,1,0,0,1
51059,0,1,0,0,1
51060,0,1,0,0,1
51061,0,0,0,1,1
51062,0,0,1,0,1
51063,0,1,0,0,1
51064,0,1,0,0,1
51065,0,1,0,0,1
51066,0,0,1,0,1
51067,0,1,0,0,1
51068,0,1,0,0,1
51069,1,0,0,0,1
51070,0,1,0,0,1
51071,1,0,0,0,1
51072,0,1,0,0,1
51073,0,1,0,0,1
51074,0,1,0,0,1
51075,0,1,0,0,1
51076,1,0,0,0,1
51077,1,0,0,0,1
51078,0,1,0,0,1
51079,1,0,0,0,1
51080,0,1,0,0,1
51081,0,1,0,0,1
51082,0,1,0,0,1
51083,0,1,0,0,1
51084,0,1,0,0,1
51085,0,0,0,1,1
51086,0,1,0,0,1
51087,0,1,0,0,1
51088,0,1,0,0,1
51089,0,1,0,0,1
51090,1,0,0,0,1
51091,0,1,0,0,1
51092,0,1,0,0,1
51093,0,1,0,0,1
51094,0,1,0,0,1
51095,0,1,0,0,1
51096,0,1,0,0,1
51097,0,1,0,0,1
51098,0,1,0,0,1
51099,0,1,0,0,1
51100,0,1,0,0,1
51101,0,1,0,0,1
51102,0,1,0,0,1
51103,0,1,0,0,1
51104,0,1,0,0,1
51105,0,1,0,0,1
51106,0,1,0,0,1
51107,0,0,1,0,1
51108,0,1,0,0,1
51109,1,0,0,0,1
51110,0,1,0,0,1
51111,1,0,0,0,1
51112,0,1,0,0,1
51113,0,1,0,0,1
51114,0,1,0,0,1
51115,0,1,0,0,1
51116,0,1,0,0,1
51117,0,1,0,0,1
51118,0,1,0,0,1
51119,1,0,0,0,1
51120,0,1,0,0,1
51121,0,1,0,0,1
51122,0,1,0,0,1
51123,0,1,0,0,1
51124,1,0,0,0,1
51125,0,1,0,0,1
51126,0,1,0,0,1
51127,0,1,0,0,1
51128,0,1,0,0,1
51129,0,1,0,0,1
51130,1,0,0,0,1
51131,1,0,0,0,1
51132,0,1,0,0,1
51133,0,1,0,0,1
51134,0,1,0,0,1
51135,0,1,0,0,1
51136,0,1,0,0,1
51137,0,0,0,1,1
51138,0,1,0,0,1
51139,1,0,0,0,1
51140,0,0,0,1,1
51141,1,0,0,0,1
51142,0,1,0,0,1
51143,0,1,0,0,1
51144,0,1,0,0,1
51145,0,1,0,0,1
51146,1,0,0,0,1
51147,0,1,0,0,1
51148,1,0,0,0,1
51149,0,1,0,0,1
51150,1,0,0,0,1
51151,0,1,0,0,1
51152,0,1,0,0,1
51153,1,0,0,0,1
51154,0,1,0,0,1
51155,0,0,0,1,1
51156,0,1,0,0,1
51157,0,1,0,0,1
51158,0,1,0,0,1
51159,1,0,0,0,1
51160,0,1,0,0,1
51161,0,1,0,0,1
51162,0,1,0,0,1
51163,1,0,0,0,1
51164,0,1,0,0,1
51165,0,1,0,0,1
51166,0,1,0,0,1
51167,1,0,0,0,1
51168,0,1,0,0,1
51169,0,1,0,0,1
51170,0,1,0,0,1
51171,0,1,0,0,1
51172,0,1,0,0,1
51173,0,1,0,0,1
51174,0,1,0,0,1
51175,0,1,0,0,1
51176,0,1,0,0,1
51177,0,1,0,0,1
51178,0,1,0,0,1
51179,0,1,0,0,1
51180,0,1,0,0,1
51181,0,1,0,0,1
51182,0,1,0,0,1
51183,0,1,0,0,1
51184,0,1,0,0,1
51185,0,1,0,0,1
51186,0,1,0,0,1
51187,0,1,0,0,1
51188,0,1,0,0,1
51189,1,0,0,0,1
51190,0,1,0,0,1
51191,0,1,0,0,1
51192,1,0,0,0,1
51193,0,1,0,0,1
51194,0,1,0,0,1
51195,1,0,0,0,1
51196,0,1,0,0,1
51197,0,1,0,0,1
51198,0,1,0,0,1
51199,1,0,0,0,1
51200,0,1,0,0,1
51201,0,1,0,0,1
51202,0,1,0,0,1
51203,0,1,0,0,1
51204,0,1,0,0,1
51205,0,1,0,0,1
51206,0,0,1,0,1
51207,1,0,0,0,1
51208,0,1,0,0,1
51209,0,1,0,0,1
51210,1,0,0,0,1
51211,0,1,0,0,1
51212,0,1,0,0,1
51213,0,1,0,0,1
51214,0,1,0,0,1
51215,0,1,0,0,1
51216,0,1,0,0,1
51217,0,1,0,0,1
51218,0,1,0,0,1
51219,0,1,0,0,1
51220,0,1,0,0,1
51221,0,1,0,0,1
51222,0,1,0,0,1
51223,0,1,0,0,1
51224,0,1,0,0,1
51225,1,0,0,0,1
51226,0,1,0,0,1
51227,0,1,0,0,1
51228,1,0,0,0,1
51229,0,1,0,0,1
51230,0,1,0,0,1
51231,0,1,0,0,1
51232,0,1,0,0,1
51233,0,1,0,0,1
51234,0,1,0,0,1
51235,0,1,0,0,1
51236,0,0,0,1,1
51237,0,1,0,0,1
51238,0,1,0,0,1
51239,0,1,0,0,1
51240,0,1,0,0,1
51241,0,1,0,0,1
51242,0,1,0,0,1
51243,0,1,0,0,1
51244,0,1,0,0,1
51245,0,0,0,1,1
51246,0,1,0,0,1
51247,1,0,0,0,1
51248,0,1,0,0,1
51249,0,1,0,0,1
51250,0,1,0,0,1
51251,0,1,0,0,1
51252,1,0,0,0,1
51253,0,1,0,0,1
51254,0,1,0,0,1
51255,0,1,0,0,1
51256,0,1,0,0,1
51257,0,1,0,0,1
51258,0,1,0,0,1
51259,0,1,0,0,1
51260,0,1,0,0,1
51261,1,0,0,0,1
51262,1,0,0,0,1
51263,0,1,0,0,1
51264,0,1,0,0,1
51265,0,1,0,0,1
51266,1,0,0,0,1
51267,0,1,0,0,1
51268,0,1,0,0,1
51269,1,0,0,0,1
51270,0,1,0,0,1
51271,0,1,0,0,1
51272,0,1,0,0,1
51273,0,1,0,0,1
51274,0,1,0,0,1
51275,0,0,0,1,1
51276,0,1,0,0,1
51277,0,1,0,0,1
51278,0,1,0,0,1
51279,0,0,0,1,1
51280,0,1,0,0,1
51281,0,1,0,0,1
51282,0,1,0,0,1
51283,0,1,0,0,1
51284,0,1,0,0,1
51285,1,0,0,0,1
51286,0,1,0,0,1
51287,0,1,0,0,1
51288,0,1,0,0,1
51289,0,1,0,0,1
51290,0,1,0,0,1
51291,1,0,0,0,1
51292,0,1,0,0,1
51293,0,1,0,0,1
51294,1,0,0,0,1
51295,0,1,0,0,1
51296,0,1,0,0,1
51297,1,0,0,0,1
51298,1,0,0,0,1
51299,1,0,0,0,1
51300,0,1,0,0,1
51301,0,1,0,0,1
51302,0,1,0,0,1
51303,0,1,0,0,1
51304,0,1,0,0,1
51305,1,0,0,0,1
51306,0,0,1,0,1
51307,0,1,0,0,1
51308,0,1,0,0,1
51309,1,0,0,0,1
51310,0,1,0,0,1
51311,0,1,0,0,1
51312,0,1,0,0,1
51313,1,0,0,0,1
51314,0,1,0,0,1
51315,1,0,0,0,1
51316,0,1,0,0,1
51317,0,1,0,0,1
51318,1,0,0,0,1
51319,0,1,0,0,1
51320,0,1,0,0,1
51321,0,1,0,0,1
51322,0,1,0,0,1
51323,0,1,0,0,1
51324,0,0,1,0,1
51325,0,1,0,0,1
51326,0,1,0,0,1
51327,0,1,0,0,1
51328,0,1,0,0,1
51329,0,1,0,0,1
51330,0,0,0,1,1
51331,0,1,0,0,1
51332,0,1,0,0,1
51333,0,1,0,0,1
51334,0,1,0,0,1
51335,0,1,0,0,1
51336,0,1,0,0,1
51337,0,0,1,0,1
51338,0,1,0,0,1
51339,0,1,0,0,1
51340,1,0,0,0,1
51341,0,1,0,0,1
51342,0,1,0,0,1
51343,0,1,0,0,1
51344,0,1,0,0,1
51345,0,1,0,0,1
51346,0,0,0,1,1
51347,0,1,0,0,1
51348,1,0,0,0,1
51349,0,1,0,0,1
51350,0,1,0,0,1
51351,0,1,0,0,1
51352,1,0,0,0,1
51353,0,1,0,0,1
51354,0,1,0,0,1
51355,0,1,0,0,1
51356,0,1,0,0,1
51357,0,1,0,0,1
51358,0,1,0,0,1
51359,0,1,0,0,1
51360,0,1,0,0,1
51361,0,1,0,0,1
51362,0,1,0,0,1
51363,0,1,0,0,1
51364,0,1,0,0,1
51365,0,1,0,0,1
51366,0,1,0,0,1
51367,0,1,0,0,1
51368,1,0,0,0,1
51369,0,1,0,0,1
51370,1,0,0,0,1
51371,0,1,0,0,1
51372,0,1,0,0,1
51373,0,1,0,0,1
51374,1,0,0,0,1
51375,0,1,0,0,1
51376,1,0,0,0,1
51377,0,1,0,0,1
51378,1,0,0,0,1
51379,0,1,0,0,1
51380,0,1,0,0,1
51381,0,0,1,0,1
51382,1,0,0,0,1
51383,0,1,0,0,1
51384,0,1,0,0,1
51385,0,1,0,0,1
51386,0,1,0,0,1
51387,0,1,0,0,1
51388,0,1,0,0,1
51389,0,1,0,0,1
51390,1,0,0,0,1
51391,0,1,0,0,1
51392,0,1,0,0,1
51393,0,1,0,0,1
51394,0,1,0,0,1
51395,0,1,0,0,1
51396,0,1,0,0,1
51397,0,1,0,0,1
51398,0,1,0,0,1
51399,0,1,0,0,1
51400,0,1,0,0,1
51401,0,1,0,0,1
51402,0,1,0,0,1
51403,0,1,0,0,1
51404,1,0,0,0,1
51405,0,1,0,0,1
51406,0,1,0,0,1
51407,0,0,0,1,1
51408,0,1,0,0,1
51409,0,0,0,1,1
51410,0,1,0,0,1
51411,0,1,0,0,1
51412,0,1,0,0,1
51413,0,0,0,1,1
51414,1,0,0,0,1
51415,0,0,0,1,1
51416,0,1,0,0,1
51417,0,1,0,0,1
51418,0,1,0,0,1
51419,0,1,0,0,1
51420,0,1,0,0,1
51421,0,1,0,0,1
51422,1,0,0,0,1
51423,0,0,1,0,1
51424,0,1,0,0,1
51425,0,1,0,0,1
51426,1,0,0,0,1
51427,0,1,0,0,1
51428,0,0,1,0,1
51429,0,1,0,0,1
51430,0,1,0,0,1
51431,0,1,0,0,1
51432,1,0,0,0,1
51433,0,1,0,0,1
51434,0,1,0,0,1
51435,0,1,0,0,1
51436,0,0,0,1,1
51437,1,0,0,0,1
51438,1,0,0,0,1
51439,1,0,0,0,1
51440,0,1,0,0,1
51441,0,1,0,0,1
51442,0,1,0,0,1
51443,0,0,1,0,1
51444,1,0,0,0,1
51445,0,1,0,0,1
51446,1,0,0,0,1
51447,1,0,0,0,1
51448,0,1,0,0,1
51449,0,1,0,0,1
51450,0,1,0,0,1
51451,0,1,0,0,1
51452,1,0,0,0,1
51453,0,1,0,0,1
51454,0,1,0,0,1
51455,0,1,0,0,1
51456,1,0,0,0,1
51457,0,1,0,0,1
51458,0,1,0,0,1
51459,0,1,0,0,1
51460,0,1,0,0,1
51461,1,0,0,0,1
51462,0,1,0,0,1
51463,0,1,0,0,1
51464,0,1,0,0,1
51465,1,0,0,0,1
51466,0,1,0,0,1
51467,0,1,0,0,1
51468,0,0,1,0,1
51469,1,0,0,0,1
51470,1,0,0,0,1
51471,0,1,0,0,1
51472,1,0,0,0,1
51473,0,1,0,0,1
51474,0,1,0,0,1
51475,0,1,0,0,1
51476,0,1,0,0,1
51477,0,1,0,0,1
51478,0,1,0,0,1
51479,0,1,0,0,1
51480,0,1,0,0,1
51481,1,0,0,0,1
51482,0,1,0,0,1
51483,0,1,0,0,1
51484,0,0,0,1,1
51485,0,1,0,0,1
51486,1,0,0,0,1
51487,0,1,0,0,1
51488,1,0,0,0,1
51489,0,1,0,0,1
51490,0,1,0,0,1
51491,0,1,0,0,1
51492,0,1,0,0,1
51493,0,1,0,0,1
51494,0,1,0,0,1
51495,0,1,0,0,1
51496,0,1,0,0,1
51497,0,1,0,0,1
51498,0,1,0,0,1
51499,0,1,0,0,1
51500,0,1,0,0,1
51501,0,1,0,0,1
51502,0,1,0,0,1
51503,0,1,0,0,1
51504,0,0,1,0,1
51505,0,1,0,0,1
51506,1,0,0,0,1
51507,0,1,0,0,1
51508,0,1,0,0,1
51509,1,0,0,0,1
51510,0,1,0,0,1
51511,1,0,0,0,1
51512,0,1,0,0,1
51513,0,1,0,0,1
51514,0,1,0,0,1
51515,0,1,0,0,1
51516,0,1,0,0,1
51517,1,0,0,0,1
51518,0,1,0,0,1
51519,0,1,0,0,1
51520,0,1,0,0,1
51521,0,1,0,0,1
51522,0,1,0,0,1
51523,0,1,0,0,1
51524,0,1,0,0,1
51525,0,1,0,0,1
51526,0,1,0,0,1
51527,1,0,0,0,1
51528,0,1,0,0,1
51529,1,0,0,0,1
51530,0,1,0,0,1
51531,0,0,0,1,1
51532,0,1,0,0,1
51533,0,1,0,0,1
51534,0,1,0,0,1
51535,0,1,0,0,1
51536,0,1,0,0,1
51537,0,1,0,0,1
51538,0,1,0,0,1
51539,0,1,0,0,1
51540,0,1,0,0,1
51541,1,0,0,0,1
51542,1,0,0,0,1
51543,0,1,0,0,1
51544,0,1,0,0,1
51545,0,1,0,0,1
51546,0,1,0,0,1
51547,0,1,0,0,1
51548,1,0,0,0,1
51549,0,1,0,0,1
51550,0,1,0,0,1
51551,0,1,0,0,1
51552,0,1,0,0,1
51553,0,1,0,0,1
51554,0,1,0,0,1
51555,0,1,0,0,1
51556,1,0,0,0,1
51557,0,0,0,1,1
51558,1,0,0,0,1
51559,1,0,0,0,1
51560,0,1,0,0,1
51561,0,1,0,0,1
51562,0,1,0,0,1
51563,0,1,0,0,1
51564,1,0,0,0,1
51565,0,1,0,0,1
51566,0,0,0,1,1
51567,0,1,0,0,1
51568,0,1,0,0,1
51569,0,1,0,0,1
51570,0,1,0,0,1
51571,1,0,0,0,1
51572,0,1,0,0,1
51573,0,0,0,1,1
51574,0,1,0,0,1
51575,0,1,0,0,1
51576,0,1,0,0,1
51577,1,0,0,0,1
51578,0,1,0,0,1
51579,0,1,0,0,1
51580,0,1,0,0,1
51581,1,0,0,0,1
51582,0,1,0,0,1
51583,0,1,0,0,1
51584,1,0,0,0,1
51585,0,1,0,0,1
51586,0,1,0,0,1
51587,1,0,0,0,1
51588,0,1,0,0,1
51589,0,1,0,0,1
51590,0,1,0,0,1
51591,0,1,0,0,1
51592,0,1,0,0,1
51593,0,1,0,0,1
51594,0,1,0,0,1
51595,0,1,0,0,1
51596,0,1,0,0,1
51597,0,1,0,0,1
51598,0,1,0,0,1
51599,0,1,0,0,1
51600,0,1,0,0,1
51601,0,1,0,0,1
51602,0,1,0,0,1
51603,0,1,0,0,1
51604,0,1,0,0,1
51605,0,1,0,0,1
51606,1,0,0,0,1
51607,0,0,0,1,1
51608,1,0,0,0,1
51609,0,1,0,0,1
51610,0,1,0,0,1
51611,0,1,0,0,1
51612,0,1,0,0,1
51613,0,1,0,0,1
51614,0,1,0,0,1
51615,0,1,0,0,1
51616,0,1,0,0,1
51617,0,1,0,0,1
51618,1,0,0,0,1
51619,1,0,0,0,1
51620,0,0,1,0,1
51621,0,1,0,0,1
51622,0,0,1,0,1
51623,0,1,0,0,1
51624,0,1,0,0,1
51625,0,1,0,0,1
51626,0,1,0,0,1
51627,0,1,0,0,1
51628,0,0,0,1,1
51629,1,0,0,0,1
51630,0,1,0,0,1
51631,0,1,0,0,1
51632,0,1,0,0,1
51633,0,1,0,0,1
51634,0,1,0,0,1
51635,0,1,0,0,1
51636,0,0,0,1,1
51637,1,0,0,0,1
51638,0,1,0,0,1
51639,0,1,0,0,1
51640,0,1,0,0,1
51641,0,1,0,0,1
51642,0,1,0,0,1
51643,0,1,0,0,1
51644,0,1,0,0,1
51645,0,1,0,0,1
51646,0,1,0,0,1
51647,0,1,0,0,1
51648,0,1,0,0,1
51649,0,0,1,0,1
51650,0,1,0,0,1
51651,0,1,0,0,1
51652,0,1,0,0,1
51653,0,1,0,0,1
51654,0,1,0,0,1
51655,0,1,0,0,1
51656,0,1,0,0,1
51657,0,1,0,0,1
51658,0,1,0,0,1
51659,0,1,0,0,1
51660,0,1,0,0,1
51661,0,1,0,0,1
51662,0,1,0,0,1
51663,0,1,0,0,1
51664,0,0,0,1,1
51665,0,1,0,0,1
51666,0,1,0,0,1
51667,0,1,0,0,1
51668,0,1,0,0,1
51669,1,0,0,0,1
51670,1,0,0,0,1
51671,0,1,0,0,1
51672,0,1,0,0,1
51673,0,1,0,0,1
51674,0,1,0,0,1
51675,0,1,0,0,1
51676,0,1,0,0,1
51677,0,1,0,0,1
51678,0,1,0,0,1
51679,0,0,0,1,1
51680,0,1,0,0,1
51681,0,0,0,1,1
51682,1,0,0,0,1
51683,0,1,0,0,1
51684,1,0,0,0,1
51685,0,1,0,0,1
51686,0,1,0,0,1
51687,0,1,0,0,1
51688,0,0,0,1,1
51689,0,1,0,0,1
51690,0,1,0,0,1
51691,0,1,0,0,1
51692,0,1,0,0,1
51693,0,1,0,0,1
51694,1,0,0,0,1
51695,0,1,0,0,1
51696,0,1,0,0,1
51697,0,1,0,0,1
51698,0,1,0,0,1
51699,0,1,0,0,1
51700,0,1,0,0,1
51701,0,1,0,0,1
51702,0,1,0,0,1
51703,1,0,0,0,1
51704,0,1,0,0,1
51705,1,0,0,0,1
51706,0,1,0,0,1
51707,0,1,0,0,1
51708,1,0,0,0,1
51709,0,1,0,0,1
51710,0,1,0,0,1
51711,0,1,0,0,1
51712,1,0,0,0,1
51713,0,1,0,0,1
51714,0,1,0,0,1
51715,0,1,0,0,1
51716,0,1,0,0,1
51717,0,1,0,0,1
51718,0,1,0,0,1
51719,0,1,0,0,1
51720,1,0,0,0,1
51721,0,1,0,0,1
51722,0,1,0,0,1
51723,1,0,0,0,1
51724,0,1,0,0,1
51725,0,1,0,0,1
51726,0,1,0,0,1
51727,0,1,0,0,1
51728,0,1,0,0,1
51729,0,1,0,0,1
51730,0,1,0,0,1
51731,0,1,0,0,1
51732,0,1,0,0,1
51733,0,1,0,0,1
51734,0,1,0,0,1
51735,0,1,0,0,1
51736,0,1,0,0,1
51737,1,0,0,0,1
51738,0,1,0,0,1
51739,0,1,0,0,1
51740,0,1,0,0,1
51741,0,1,0,0,1
51742,0,1,0,0,1
51743,0,1,0,0,1
51744,0,1,0,0,1
51745,0,1,0,0,1
51746,0,1,0,0,1
51747,0,1,0,0,1
51748,0,1,0,0,1
51749,0,0,0,1,1
51750,0,1,0,0,1
51751,1,0,0,0,1
51752,1,0,0,0,1
51753,0,0,0,1,1
51754,0,1,0,0,1
51755,0,1,0,0,1
51756,0,1,0,0,1
51757,0,1,0,0,1
51758,0,1,0,0,1
51759,0,0,0,1,1
51760,0,0,0,1,1
51761,0,1,0,0,1
51762,1,0,0,0,1
51763,0,1,0,0,1
51764,0,1,0,0,1
51765,0,1,0,0,1
51766,0,1,0,0,1
51767,0,1,0,0,1
51768,0,1,0,0,1
51769,0,0,0,1,1
51770,0,1,0,0,1
51771,1,0,0,0,1
51772,0,1,0,0,1
51773,0,1,0,0,1
51774,1,0,0,0,1
51775,0,1,0,0,1
51776,0,1,0,0,1
51777,0,1,0,0,1
51778,0,1,0,0,1
51779,0,1,0,0,1
51780,1,0,0,0,1
51781,0,1,0,0,1
51782,0,1,0,0,1
51783,1,0,0,0,1
51784,0,1,0,0,1
51785,1,0,0,0,1
51786,1,0,0,0,1
51787,0,1,0,0,1
51788,1,0,0,0,1
51789,0,1,0,0,1
51790,0,1,0,0,1
51791,0,1,0,0,1
51792,0,0,0,1,1
51793,0,1,0,0,1
51794,0,1,0,0,1
51795,0,1,0,0,1
51796,0,1,0,0,1
51797,0,1,0,0,1
51798,0,1,0,0,1
51799,1,0,0,0,1
51800,1,0,0,0,1
51801,1,0,0,0,1
51802,0,1,0,0,1
51803,0,1,0,0,1
51804,0,0,0,1,1
51805,0,1,0,0,1
51806,0,0,0,1,1
51807,0,1,0,0,1
51808,0,1,0,0,1
51809,1,0,0,0,1
51810,0,1,0,0,1
51811,0,1,0,0,1
51812,0,1,0,0,1
51813,0,1,0,0,1
51814,0,1,0,0,1
51815,0,1,0,0,1
51816,0,1,0,0,1
51817,0,1,0,0,1
51818,0,1,0,0,1
51819,0,1,0,0,1
51820,0,1,0,0,1
51821,0,1,0,0,1
51822,0,1,0,0,1
51823,0,1,0,0,1
51824,0,1,0,0,1
51825,0,1,0,0,1
51826,0,1,0,0,1
51827,0,1,0,0,1
51828,0,1,0,0,1
51829,0,1,0,0,1
51830,0,1,0,0,1
51831,0,1,0,0,1
51832,0,1,0,0,1
51833,0,1,0,0,1
51834,0,1,0,0,1
51835,0,1,0,0,1
51836,0,1,0,0,1
51837,0,1,0,0,1
51838,0,1,0,0,1
51839,1,0,0,0,1
51840,0,1,0,0,1
51841,1,0,0,0,1
51842,1,0,0,0,1
51843,1,0,0,0,1
51844,0,1,0,0,1
51845,0,1,0,0,1
51846,0,1,0,0,1
51847,0,1,0,0,1
51848,0,1,0,0,1
51849,0,1,0,0,1
51850,0,1,0,0,1
51851,0,1,0,0,1
51852,0,1,0,0,1
51853,0,1,0,0,1
51854,0,1,0,0,1
51855,0,1,0,0,1
51856,1,0,0,0,1
51857,0,1,0,0,1
51858,1,0,0,0,1
51859,0,1,0,0,1
51860,0,1,0,0,1
51861,0,1,0,0,1
51862,0,1,0,0,1
51863,0,1,0,0,1
51864,1,0,0,0,1
51865,0,1,0,0,1
51866,0,1,0,0,1
51867,0,1,0,0,1
51868,0,1,0,0,1
51869,0,1,0,0,1
51870,0,1,0,0,1
51871,0,1,0,0,1
51872,0,0,0,1,1
51873,0,1,0,0,1
51874,0,1,0,0,1
51875,1,0,0,0,1
51876,0,1,0,0,1
51877,0,1,0,0,1
51878,0,1,0,0,1
51879,1,0,0,0,1
51880,0,1,0,0,1
51881,0,1,0,0,1
51882,0,1,0,0,1
51883,0,1,0,0,1
51884,0,1,0,0,1
51885,0,1,0,0,1
51886,0,1,0,0,1
51887,0,1,0,0,1
51888,0,1,0,0,1
51889,0,1,0,0,1
51890,0,1,0,0,1
51891,0,1,0,0,1
51892,0,1,0,0,1
51893,0,1,0,0,1
51894,0,1,0,0,1
51895,0,1,0,0,1
51896,0,1,0,0,1
51897,0,1,0,0,1
51898,0,1,0,0,1
51899,0,1,0,0,1
51900,1,0,0,0,1
51901,1,0,0,0,1
51902,0,1,0,0,1
51903,0,1,0,0,1
51904,0,1,0,0,1
51905,0,1,0,0,1
51906,0,1,0,0,1
51907,0,1,0,0,1
51908,0,1,0,0,1
51909,1,0,0,0,1
51910,0,1,0,0,1
51911,0,1,0,0,1
51912,0,1,0,0,1
51913,0,1,0,0,1
51914,0,1,0,0,1
51915,0,1,0,0,1
51916,0,1,0,0,1
51917,0,1,0,0,1
51918,0,1,0,0,1
51919,1,0,0,0,1
51920,0,1,0,0,1
51921,0,1,0,0,1
51922,0,1,0,0,1
51923,0,1,0,0,1
51924,0,1,0,0,1
51925,0,1,0,0,1
51926,0,1,0,0,1
51927,0,1,0,0,1
51928,0,1,0,0,1
51929,0,1,0,0,1
51930,0,1,0,0,1
51931,0,1,0,0,1
51932,0,1,0,0,1
51933,0,1,0,0,1
51934,0,0,0,1,1
51935,0,1,0,0,1
51936,0,1,0,0,1
51937,1,0,0,0,1
51938,0,1,0,0,1
51939,0,1,0,0,1
51940,0,1,0,0,1
51941,0,1,0,0,1
51942,0,1,0,0,1
51943,0,1,0,0,1
51944,0,1,0,0,1
51945,0,1,0,0,1
51946,0,1,0,0,1
51947,0,1,0,0,1
51948,0,1,0,0,1
51949,0,1,0,0,1
51950,0,1,0,0,1
51951,0,1,0,0,1
51952,0,1,0,0,1
51953,1,0,0,0,1
51954,0,1,0,0,1
51955,0,1,0,0,1
51956,0,1,0,0,1
51957,0,1,0,0,1
51958,0,1,0,0,1
51959,0,1,0,0,1
51960,0,1,0,0,1
51961,0,1,0,0,1
51962,0,1,0,0,1
51963,0,1,0,0,1
51964,0,1,0,0,1
51965,0,1,0,0,1
51966,0,1,0,0,1
51967,0,1,0,0,1
51968,0,1,0,0,1
51969,0,1,0,0,1
51970,1,0,0,0,1
51971,0,1,0,0,1
51972,0,1,0,0,1
51973,0,1,0,0,1
51974,0,1,0,0,1
51975,0,1,0,0,1
51976,0,1,0,0,1
51977,0,1,0,0,1
51978,1,0,0,0,1
51979,0,1,0,0,1
51980,0,1,0,0,1
51981,0,1,0,0,1
51982,0,1,0,0,1
51983,0,1,0,0,1
51984,0,1,0,0,1
51985,0,0,1,0,1
51986,0,1,0,0,1
51987,1,0,0,0,1
51988,0,1,0,0,1
51989,0,0,0,1,1
51990,1,0,0,0,1
51991,0,1,0,0,1
51992,1,0,0,0,1
51993,0,1,0,0,1
51994,0,1,0,0,1
51995,0,1,0,0,1
51996,1,0,0,0,1
51997,0,1,0,0,1
51998,1,0,0,0,1
51999,0,1,0,0,1
52000,0,1,0,0,1
52001,0,1,0,0,1
52002,0,1,0,0,1
52003,1,0,0,0,1
52004,0,0,1,0,1
52005,0,1,0,0,1
52006,0,1,0,0,1
52007,1,0,0,0,1
52008,0,1,0,0,1
52009,0,1,0,0,1
52010,0,1,0,0,1
52011,0,0,1,0,1
52012,0,1,0,0,1
52013,0,1,0,0,1
52014,0,1,0,0,1
52015,0,0,1,0,1
52016,0,1,0,0,1
52017,0,0,0,1,1
52018,1,0,0,0,1
52019,1,0,0,0,1
52020,0,1,0,0,1
52021,0,1,0,0,1
52022,1,0,0,0,1
52023,0,1,0,0,1
52024,0,1,0,0,1
52025,0,0,0,1,1
52026,1,0,0,0,1
52027,0,1,0,0,1
52028,1,0,0,0,1
52029,0,1,0,0,1
52030,0,1,0,0,1
52031,0,1,0,0,1
52032,0,1,0,0,1
52033,0,1,0,0,1
52034,0,1,0,0,1
52035,0,1,0,0,1
52036,1,0,0,0,1
52037,0,1,0,0,1
52038,1,0,0,0,1
52039,0,1,0,0,1
52040,0,1,0,0,1
52041,0,1,0,0,1
52042,0,1,0,0,1
52043,0,1,0,0,1
52044,1,0,0,0,1
52045,0,1,0,0,1
52046,0,1,0,0,1
52047,0,1,0,0,1
52048,0,1,0,0,1
52049,0,0,1,0,1
52050,0,1,0,0,1
52051,0,1,0,0,1
52052,0,1,0,0,1
52053,0,1,0,0,1
52054,0,1,0,0,1
52055,1,0,0,0,1
52056,0,1,0,0,1
52057,0,1,0,0,1
52058,0,1,0,0,1
52059,0,1,0,0,1
52060,0,1,0,0,1
52061,0,1,0,0,1
52062,0,1,0,0,1
52063,0,0,1,0,1
52064,1,0,0,0,1
52065,0,1,0,0,1
52066,0,1,0,0,1
52067,0,1,0,0,1
52068,1,0,0,0,1
52069,1,0,0,0,1
52070,0,1,0,0,1
52071,0,1,0,0,1
52072,1,0,0,0,1
52073,0,1,0,0,1
52074,0,1,0,0,1
52075,0,1,0,0,1
52076,0,1,0,0,1
52077,0,1,0,0,1
52078,0,1,0,0,1
52079,0,1,0,0,1
52080,1,0,0,0,1
52081,0,1,0,0,1
52082,0,0,0,1,1
52083,0,1,0,0,1
52084,0,1,0,0,1
52085,0,1,0,0,1
52086,0,1,0,0,1
52087,0,1,0,0,1
52088,0,1,0,0,1
52089,0,1,0,0,1
52090,0,0,1,0,1
52091,0,1,0,0,1
52092,0,1,0,0,1
52093,0,1,0,0,1
52094,0,1,0,0,1
52095,0,1,0,0,1
52096,0,1,0,0,1
52097,1,0,0,0,1
52098,0,1,0,0,1
52099,0,1,0,0,1
52100,0,1,0,0,1
52101,1,0,0,0,1
52102,0,1,0,0,1
52103,0,1,0,0,1
52104,0,1,0,0,1
52105,0,1,0,0,1
52106,0,1,0,0,1
52107,0,1,0,0,1
52108,0,1,0,0,1
52109,0,1,0,0,1
52110,1,0,0,0,1
52111,0,1,0,0,1
52112,0,1,0,0,1
52113,0,1,0,0,1
52114,0,1,0,0,1
52115,0,1,0,0,1
52116,0,1,0,0,1
52117,1,0,0,0,1
52118,1,0,0,0,1
52119,0,0,1,0,1
52120,0,1,0,0,1
52121,0,1,0,0,1
52122,1,0,0,0,1
52123,0,1,0,0,1
52124,0,0,0,1,1
52125,0,1,0,0,1
52126,0,1,0,0,1
52127,0,1,0,0,1
52128,0,1,0,0,1
52129,0,1,0,0,1
52130,0,1,0,0,1
52131,0,1,0,0,1
52132,0,1,0,0,1
52133,1,0,0,0,1
52134,0,1,0,0,1
52135,0,1,0,0,1
52136,0,1,0,0,1
52137,0,1,0,0,1
52138,0,1,0,0,1
52139,1,0,0,0,1
52140,0,1,0,0,1
52141,0,1,0,0,1
52142,0,1,0,0,1
52143,0,1,0,0,1
52144,0,0,1,0,1
52145,0,1,0,0,1
52146,0,0,1,0,1
52147,0,1,0,0,1
52148,0,0,0,1,1
52149,0,1,0,0,1
52150,0,1,0,0,1
52151,1,0,0,0,1
52152,0,1,0,0,1
52153,0,1,0,0,1
52154,1,0,0,0,1
52155,0,1,0,0,1
52156,0,1,0,0,1
52157,0,1,0,0,1
52158,0,1,0,0,1
52159,0,0,0,1,1
52160,0,1,0,0,1
52161,1,0,0,0,1
52162,1,0,0,0,1
52163,0,1,0,0,1
52164,0,1,0,0,1
52165,0,1,0,0,1
52166,0,1,0,0,1
52167,1,0,0,0,1
52168,1,0,0,0,1
52169,0,1,0,0,1
52170,0,1,0,0,1
52171,0,1,0,0,1
52172,0,1,0,0,1
52173,0,0,1,0,1
52174,0,1,0,0,1
52175,0,1,0,0,1
52176,0,1,0,0,1
52177,0,1,0,0,1
52178,0,1,0,0,1
52179,0,1,0,0,1
52180,0,1,0,0,1
52181,0,1,0,0,1
52182,0,1,0,0,1
52183,0,1,0,0,1
52184,0,1,0,0,1
52185,0,1,0,0,1
52186,0,1,0,0,1
52187,0,0,1,0,1
52188,0,1,0,0,1
52189,0,1,0,0,1
52190,0,1,0,0,1
52191,0,1,0,0,1
52192,1,0,0,0,1
52193,0,1,0,0,1
52194,0,1,0,0,1
52195,0,1,0,0,1
52196,0,1,0,0,1
52197,0,1,0,0,1
52198,0,1,0,0,1
52199,0,1,0,0,1
52200,0,1,0,0,1
52201,0,1,0,0,1
52202,0,1,0,0,1
52203,0,1,0,0,1
52204,1,0,0,0,1
52205,0,1,0,0,1
52206,1,0,0,0,1
52207,0,1,0,0,1
52208,0,1,0,0,1
52209,0,1,0,0,1
52210,1,0,0,0,1
52211,0,1,0,0,1
52212,1,0,0,0,1
52213,0,1,0,0,1
52214,0,0,0,1,1
52215,1,0,0,0,1
52216,0,1,0,0,1
52217,0,1,0,0,1
52218,0,1,0,0,1
52219,0,1,0,0,1
52220,1,0,0,0,1
52221,0,1,0,0,1
52222,1,0,0,0,1
52223,0,1,0,0,1
52224,0,1,0,0,1
52225,1,0,0,0,1
52226,0,1,0,0,1
52227,0,1,0,0,1
52228,0,1,0,0,1
52229,0,1,0,0,1
52230,0,1,0,0,1
52231,0,1,0,0,1
52232,0,1,0,0,1
52233,0,1,0,0,1
52234,0,1,0,0,1
52235,1,0,0,0,1
52236,0,1,0,0,1
52237,0,1,0,0,1
52238,0,1,0,0,1
52239,0,1,0,0,1
52240,1,0,0,0,1
52241,0,1,0,0,1
52242,1,0,0,0,1
52243,0,1,0,0,1
52244,0,1,0,0,1
52245,0,1,0,0,1
52246,1,0,0,0,1
52247,0,1,0,0,1
52248,0,1,0,0,1
52249,0,1,0,0,1
52250,0,1,0,0,1
52251,0,1,0,0,1
52252,0,1,0,0,1
52253,0,0,0,1,1
52254,0,1,0,0,1
52255,0,1,0,0,1
52256,0,1,0,0,1
52257,1,0,0,0,1
52258,1,0,0,0,1
52259,1,0,0,0,1
52260,0,1,0,0,1
52261,0,1,0,0,1
52262,1,0,0,0,1
52263,0,1,0,0,1
52264,1,0,0,0,1
52265,0,1,0,0,1
52266,0,0,0,1,1
52267,0,1,0,0,1
52268,1,0,0,0,1
52269,0,1,0,0,1
52270,0,1,0,0,1
52271,0,1,0,0,1
52272,0,1,0,0,1
52273,0,1,0,0,1
52274,0,1,0,0,1
52275,0,1,0,0,1
52276,0,1,0,0,1
52277,1,0,0,0,1
52278,0,1,0,0,1
52279,0,1,0,0,1
52280,0,1,0,0,1
52281,0,1,0,0,1
52282,1,0,0,0,1
52283,0,1,0,0,1
52284,0,1,0,0,1
52285,0,1,0,0,1
52286,0,0,1,0,1
52287,0,1,0,0,1
52288,0,1,0,0,1
52289,0,1,0,0,1
52290,1,0,0,0,1
52291,0,1,0,0,1
52292,0,1,0,0,1
52293,0,1,0,0,1
52294,0,1,0,0,1
52295,0,1,0,0,1
52296,0,1,0,0,1
52297,1,0,0,0,1
52298,0,1,0,0,1
52299,0,1,0,0,1
52300,0,1,0,0,1
52301,0,1,0,0,1
52302,0,1,0,0,1
52303,0,1,0,0,1
52304,0,1,0,0,1
52305,1,0,0,0,1
52306,0,1,0,0,1
52307,0,1,0,0,1
52308,1,0,0,0,1
52309,0,1,0,0,1
52310,0,1,0,0,1
52311,0,1,0,0,1
52312,1,0,0,0,1
52313,0,1,0,0,1
52314,0,1,0,0,1
52315,0,0,0,1,1
52316,1,0,0,0,1
52317,0,1,0,0,1
52318,0,1,0,0,1
52319,0,1,0,0,1
52320,0,1,0,0,1
52321,0,1,0,0,1
52322,1,0,0,0,1
52323,0,1,0,0,1
52324,0,1,0,0,1
52325,0,1,0,0,1
52326,0,1,0,0,1
52327,1,0,0,0,1
52328,0,1,0,0,1
52329,0,1,0,0,1
52330,1,0,0,0,1
52331,0,1,0,0,1
52332,0,1,0,0,1
52333,0,1,0,0,1
52334,0,1,0,0,1
52335,1,0,0,0,1
52336,0,1,0,0,1
52337,0,1,0,0,1
52338,0,1,0,0,1
52339,0,1,0,0,1
52340,0,1,0,0,1
52341,1,0,0,0,1
52342,0,0,0,1,1
52343,0,1,0,0,1
52344,0,1,0,0,1
52345,0,1,0,0,1
52346,0,1,0,0,1
52347,0,1,0,0,1
52348,0,1,0,0,1
52349,0,1,0,0,1
52350,0,1,0,0,1
52351,0,1,0,0,1
52352,0,1,0,0,1
52353,0,1,0,0,1
52354,0,1,0,0,1
52355,0,1,0,0,1
52356,0,1,0,0,1
52357,0,1,0,0,1
52358,0,1,0,0,1
52359,1,0,0,0,1
52360,0,1,0,0,1
52361,0,1,0,0,1
52362,0,1,0,0,1
52363,1,0,0,0,1
52364,0,1,0,0,1
52365,0,1,0,0,1
52366,0,1,0,0,1
52367,1,0,0,0,1
52368,0,1,0,0,1
52369,0,0,0,1,1
52370,0,1,0,0,1
52371,0,1,0,0,1
52372,0,1,0,0,1
52373,0,1,0,0,1
52374,0,1,0,0,1
52375,0,1,0,0,1
52376,0,0,1,0,1
52377,0,1,0,0,1
52378,0,1,0,0,1
52379,1,0,0,0,1
52380,1,0,0,0,1
52381,1,0,0,0,1
52382,0,1,0,0,1
52383,0,1,0,0,1
52384,0,1,0,0,1
52385,1,0,0,0,1
52386,1,0,0,0,1
52387,0,1,0,0,1
52388,0,1,0,0,1
52389,0,1,0,0,1
52390,0,1,0,0,1
52391,0,1,0,0,1
52392,0,1,0,0,1
52393,0,1,0,0,1
52394,1,0,0,0,1
52395,0,1,0,0,1
52396,0,1,0,0,1
52397,0,1,0,0,1
52398,0,0,0,1,1
52399,0,1,0,0,1
52400,0,1,0,0,1
52401,1,0,0,0,1
52402,0,1,0,0,1
52403,0,0,0,1,1
52404,0,1,0,0,1
52405,0,1,0,0,1
52406,0,1,0,0,1
52407,0,1,0,0,1
52408,0,1,0,0,1
52409,0,1,0,0,1
52410,0,1,0,0,1
52411,1,0,0,0,1
52412,0,1,0,0,1
52413,0,1,0,0,1
52414,0,1,0,0,1
52415,0,1,0,0,1
52416,1,0,0,0,1
52417,0,1,0,0,1
52418,1,0,0,0,1
52419,1,0,0,0,1
52420,0,1,0,0,1
52421,1,0,0,0,1
52422,1,0,0,0,1
52423,1,0,0,0,1
52424,0,1,0,0,1
52425,0,1,0,0,1
52426,0,1,0,0,1
52427,0,1,0,0,1
52428,0,1,0,0,1
52429,1,0,0,0,1
52430,1,0,0,0,1
52431,0,0,0,1,1
52432,0,1,0,0,1
52433,1,0,0,0,1
52434,0,0,0,1,1
52435,0,1,0,0,1
52436,0,1,0,0,1
52437,0,1,0,0,1
52438,0,1,0,0,1
52439,0,1,0,0,1
52440,0,1,0,0,1
52441,0,1,0,0,1
52442,0,1,0,0,1
52443,0,1,0,0,1
52444,0,1,0,0,1
52445,0,1,0,0,1
52446,1,0,0,0,1
52447,0,0,0,1,1
52448,0,1,0,0,1
52449,0,1,0,0,1
52450,1,0,0,0,1
52451,0,1,0,0,1
52452,0,1,0,0,1
52453,0,1,0,0,1
52454,0,1,0,0,1
52455,0,1,0,0,1
52456,0,1,0,0,1
52457,0,1,0,0,1
52458,0,1,0,0,1
52459,0,1,0,0,1
52460,0,1,0,0,1
52461,0,1,0,0,1
52462,0,1,0,0,1
52463,0,1,0,0,1
52464,0,1,0,0,1
52465,0,1,0,0,1
52466,0,1,0,0,1
52467,0,1,0,0,1
52468,0,1,0,0,1
52469,0,1,0,0,1
52470,0,1,0,0,1
52471,0,1,0,0,1
52472,0,1,0,0,1
52473,0,1,0,0,1
52474,0,1,0,0,1
52475,1,0,0,0,1
52476,0,1,0,0,1
52477,0,1,0,0,1
52478,0,1,0,0,1
52479,0,1,0,0,1
52480,1,0,0,0,1
52481,0,1,0,0,1
52482,0,1,0,0,1
52483,0,1,0,0,1
52484,0,1,0,0,1
52485,0,1,0,0,1
52486,0,1,0,0,1
52487,0,1,0,0,1
52488,0,1,0,0,1
52489,1,0,0,0,1
52490,0,1,0,0,1
52491,0,1,0,0,1
52492,1,0,0,0,1
52493,0,1,0,0,1
52494,0,1,0,0,1
52495,0,0,0,1,1
52496,1,0,0,0,1
52497,0,1,0,0,1
52498,0,1,0,0,1
52499,1,0,0,0,1
52500,0,1,0,0,1
52501,0,1,0,0,1
52502,1,0,0,0,1
52503,0,0,1,0,1
52504,0,1,0,0,1
52505,0,1,0,0,1
52506,0,1,0,0,1
52507,0,1,0,0,1
52508,1,0,0,0,1
52509,0,1,0,0,1
52510,0,1,0,0,1
52511,0,1,0,0,1
52512,0,1,0,0,1
52513,1,0,0,0,1
52514,0,1,0,0,1
52515,0,1,0,0,1
52516,0,1,0,0,1
52517,0,1,0,0,1
52518,0,1,0,0,1
52519,0,1,0,0,1
52520,1,0,0,0,1
52521,0,1,0,0,1
52522,0,1,0,0,1
52523,0,1,0,0,1
52524,0,1,0,0,1
52525,0,1,0,0,1
52526,0,1,0,0,1
52527,0,1,0,0,1
52528,0,1,0,0,1
52529,0,1,0,0,1
52530,1,0,0,0,1
52531,0,1,0,0,1
52532,0,1,0,0,1
52533,0,1,0,0,1
52534,0,1,0,0,1
52535,0,1,0,0,1
52536,0,1,0,0,1
52537,0,1,0,0,1
52538,0,1,0,0,1
52539,0,1,0,0,1
52540,0,1,0,0,1
52541,0,0,0,1,1
52542,0,1,0,0,1
52543,0,1,0,0,1
52544,0,1,0,0,1
52545,0,1,0,0,1
52546,0,1,0,0,1
52547,0,1,0,0,1
52548,1,0,0,0,1
52549,1,0,0,0,1
52550,0,1,0,0,1
52551,0,1,0,0,1
52552,0,1,0,0,1
52553,0,1,0,0,1
52554,0,1,0,0,1
52555,0,0,0,1,1
52556,1,0,0,0,1
52557,1,0,0,0,1
52558,0,1,0,0,1
52559,0,1,0,0,1
52560,0,1,0,0,1
52561,0,1,0,0,1
52562,0,1,0,0,1
52563,0,1,0,0,1
52564,0,1,0,0,1
52565,0,1,0,0,1
52566,0,1,0,0,1
52567,0,1,0,0,1
52568,0,1,0,0,1
52569,0,1,0,0,1
52570,0,1,0,0,1
52571,0,1,0,0,1
52572,0,1,0,0,1
52573,0,1,0,0,1
52574,0,1,0,0,1
52575,0,0,1,0,1
52576,1,0,0,0,1
52577,0,0,1,0,1
52578,0,1,0,0,1
52579,1,0,0,0,1
52580,0,0,0,1,1
52581,0,1,0,0,1
52582,0,1,0,0,1
52583,0,1,0,0,1
52584,0,1,0,0,1
52585,0,1,0,0,1
52586,1,0,0,0,1
52587,0,1,0,0,1
52588,0,1,0,0,1
52589,0,1,0,0,1
52590,0,1,0,0,1
52591,0,1,0,0,1
52592,1,0,0,0,1
52593,1,0,0,0,1
52594,0,1,0,0,1
52595,0,1,0,0,1
52596,0,1,0,0,1
52597,1,0,0,0,1
52598,0,1,0,0,1
52599,0,1,0,0,1
52600,1,0,0,0,1
52601,0,0,0,1,1
52602,0,1,0,0,1
52603,0,1,0,0,1
52604,1,0,0,0,1
52605,0,0,0,1,1
52606,0,1,0,0,1
52607,0,1,0,0,1
52608,0,1,0,0,1
52609,0,1,0,0,1
52610,0,1,0,0,1
52611,1,0,0,0,1
52612,1,0,0,0,1
52613,0,1,0,0,1
52614,0,1,0,0,1
52615,1,0,0,0,1
52616,0,1,0,0,1
52617,0,1,0,0,1
52618,1,0,0,0,1
52619,0,1,0,0,1
52620,0,1,0,0,1
52621,1,0,0,0,1
52622,0,0,0,1,1
52623,0,0,0,1,1
52624,0,1,0,0,1
52625,0,1,0,0,1
52626,0,1,0,0,1
52627,0,1,0,0,1
52628,1,0,0,0,1
52629,1,0,0,0,1
52630,0,1,0,0,1
52631,0,1,0,0,1
52632,0,1,0,0,1
52633,0,1,0,0,1
52634,0,1,0,0,1
52635,0,1,0,0,1
52636,0,1,0,0,1
52637,0,1,0,0,1
52638,0,1,0,0,1
52639,0,1,0,0,1
52640,0,0,1,0,1
52641,0,1,0,0,1
52642,0,1,0,0,1
52643,0,1,0,0,1
52644,0,1,0,0,1
52645,1,0,0,0,1
52646,0,1,0,0,1
52647,0,1,0,0,1
52648,0,1,0,0,1
52649,1,0,0,0,1
52650,0,0,0,1,1
52651,0,1,0,0,1
52652,0,1,0,0,1
52653,0,1,0,0,1
52654,0,1,0,0,1
52655,0,1,0,0,1
52656,0,1,0,0,1
52657,1,0,0,0,1
52658,0,1,0,0,1
52659,0,0,0,1,1
52660,0,1,0,0,1
52661,0,1,0,0,1
52662,0,1,0,0,1
52663,1,0,0,0,1
52664,1,0,0,0,1
52665,0,1,0,0,1
52666,0,1,0,0,1
52667,0,1,0,0,1
52668,0,1,0,0,1
52669,0,1,0,0,1
52670,0,1,0,0,1
52671,0,1,0,0,1
52672,1,0,0,0,1
52673,0,1,0,0,1
52674,0,1,0,0,1
52675,0,1,0,0,1
52676,0,1,0,0,1
52677,0,1,0,0,1
52678,0,1,0,0,1
52679,1,0,0,0,1
52680,0,1,0,0,1
52681,0,1,0,0,1
52682,0,1,0,0,1
52683,0,1,0,0,1
52684,0,1,0,0,1
52685,1,0,0,0,1
52686,0,1,0,0,1
52687,0,1,0,0,1
52688,1,0,0,0,1
52689,0,1,0,0,1
52690,0,1,0,0,1
52691,0,1,0,0,1
52692,0,1,0,0,1
52693,0,1,0,0,1
52694,1,0,0,0,1
52695,0,1,0,0,1
52696,0,1,0,0,1
52697,0,1,0,0,1
52698,0,1,0,0,1
52699,0,1,0,0,1
52700,1,0,0,0,1
52701,0,1,0,0,1
52702,0,1,0,0,1
52703,0,1,0,0,1
52704,0,1,0,0,1
52705,1,0,0,0,1
52706,0,1,0,0,1
52707,0,1,0,0,1
52708,0,1,0,0,1
52709,0,1,0,0,1
52710,0,1,0,0,1
52711,0,1,0,0,1
52712,1,0,0,0,1
52713,0,1,0,0,1
52714,0,1,0,0,1
52715,0,1,0,0,1
52716,0,1,0,0,1
52717,1,0,0,0,1
52718,0,1,0,0,1
52719,0,1,0,0,1
52720,0,1,0,0,1
52721,0,1,0,0,1
52722,0,1,0,0,1
52723,0,1,0,0,1
52724,0,1,0,0,1
52725,0,1,0,0,1
52726,0,1,0,0,1
52727,0,1,0,0,1
52728,0,1,0,0,1
52729,0,1,0,0,1
52730,1,0,0,0,1
52731,0,1,0,0,1
52732,1,0,0,0,1
52733,0,1,0,0,1
52734,0,1,0,0,1
52735,0,0,1,0,1
52736,0,1,0,0,1
52737,0,1,0,0,1
52738,0,1,0,0,1
52739,1,0,0,0,1
52740,0,1,0,0,1
52741,0,1,0,0,1
52742,0,0,0,1,1
52743,0,1,0,0,1
52744,0,1,0,0,1
52745,0,1,0,0,1
52746,0,1,0,0,1
52747,0,1,0,0,1
52748,1,0,0,0,1
52749,1,0,0,0,1
52750,0,1,0,0,1
52751,1,0,0,0,1
52752,0,1,0,0,1
52753,0,1,0,0,1
52754,0,1,0,0,1
52755,0,0,1,0,1
52756,0,1,0,0,1
52757,0,1,0,0,1
52758,1,0,0,0,1
52759,0,1,0,0,1
52760,1,0,0,0,1
52761,0,1,0,0,1
52762,0,1,0,0,1
52763,0,1,0,0,1
52764,0,1,0,0,1
52765,0,1,0,0,1
52766,0,1,0,0,1
52767,0,1,0,0,1
52768,0,1,0,0,1
52769,0,1,0,0,1
52770,0,1,0,0,1
52771,0,1,0,0,1
52772,0,0,0,1,1
52773,0,1,0,0,1
52774,0,1,0,0,1
52775,0,1,0,0,1
52776,0,1,0,0,1
52777,0,1,0,0,1
52778,0,0,0,1,1
52779,0,1,0,0,1
52780,0,1,0,0,1
52781,0,1,0,0,1
52782,0,1,0,0,1
52783,0,1,0,0,1
52784,0,1,0,0,1
52785,0,1,0,0,1
52786,0,1,0,0,1
52787,0,0,1,0,1
52788,1,0,0,0,1
52789,0,1,0,0,1
52790,0,1,0,0,1
52791,0,1,0,0,1
52792,0,1,0,0,1
52793,0,1,0,0,1
52794,1,0,0,0,1
52795,1,0,0,0,1
52796,0,1,0,0,1
52797,0,1,0,0,1
52798,0,1,0,0,1
52799,0,1,0,0,1
52800,0,1,0,0,1
52801,0,1,0,0,1
52802,0,1,0,0,1
52803,0,1,0,0,1
52804,0,1,0,0,1
52805,0,1,0,0,1
52806,0,1,0,0,1
52807,0,1,0,0,1
52808,1,0,0,0,1
52809,0,1,0,0,1
52810,0,1,0,0,1
52811,1,0,0,0,1
52812,0,1,0,0,1
52813,0,1,0,0,1
52814,0,1,0,0,1
52815,0,1,0,0,1
52816,0,1,0,0,1
52817,0,1,0,0,1
52818,0,1,0,0,1
52819,1,0,0,0,1
52820,0,1,0,0,1
52821,1,0,0,0,1
52822,1,0,0,0,1
52823,0,1,0,0,1
52824,0,1,0,0,1
52825,0,1,0,0,1
52826,0,1,0,0,1
52827,0,1,0,0,1
52828,1,0,0,0,1
52829,0,1,0,0,1
52830,0,1,0,0,1
52831,0,1,0,0,1
52832,0,1,0,0,1
52833,0,1,0,0,1
52834,1,0,0,0,1
52835,1,0,0,0,1
52836,0,1,0,0,1
52837,0,1,0,0,1
52838,0,1,0,0,1
52839,0,1,0,0,1
52840,0,1,0,0,1
52841,1,0,0,0,1
52842,1,0,0,0,1
52843,0,1,0,0,1
52844,0,0,1,0,1
52845,0,1,0,0,1
52846,0,1,0,0,1
52847,0,0,0,1,1
52848,0,1,0,0,1
52849,0,1,0,0,1
52850,0,1,0,0,1
52851,1,0,0,0,1
52852,0,1,0,0,1
52853,0,1,0,0,1
52854,0,1,0,0,1
52855,0,1,0,0,1
52856,1,0,0,0,1
52857,0,1,0,0,1
52858,0,1,0,0,1
52859,0,1,0,0,1
52860,1,0,0,0,1
52861,1,0,0,0,1
52862,0,1,0,0,1
52863,0,1,0,0,1
52864,0,1,0,0,1
52865,0,1,0,0,1
52866,0,1,0,0,1
52867,0,1,0,0,1
52868,0,1,0,0,1
52869,0,1,0,0,1
52870,0,1,0,0,1
52871,0,1,0,0,1
52872,0,1,0,0,1
52873,0,1,0,0,1
52874,0,1,0,0,1
52875,0,1,0,0,1
52876,0,1,0,0,1
52877,0,1,0,0,1
52878,1,0,0,0,1
52879,0,1,0,0,1
52880,0,1,0,0,1
52881,0,1,0,0,1
52882,0,1,0,0,1
52883,1,0,0,0,1
52884,0,1,0,0,1
52885,0,1,0,0,1
52886,0,1,0,0,1
52887,0,1,0,0,1
52888,0,1,0,0,1
52889,0,1,0,0,1
52890,0,1,0,0,1
52891,0,1,0,0,1
52892,0,1,0,0,1
52893,0,0,0,1,1
52894,0,1,0,0,1
52895,0,1,0,0,1
52896,0,1,0,0,1
52897,0,1,0,0,1
52898,1,0,0,0,1
52899,0,1,0,0,1
52900,0,1,0,0,1
52901,0,1,0,0,1
52902,0,1,0,0,1
52903,0,1,0,0,1
52904,1,0,0,0,1
52905,0,1,0,0,1
52906,0,1,0,0,1
52907,0,1,0,0,1
52908,0,1,0,0,1
52909,1,0,0,0,1
52910,0,1,0,0,1
52911,0,1,0,0,1
52912,0,1,0,0,1
52913,0,0,0,1,1
52914,1,0,0,0,1
52915,0,1,0,0,1
52916,0,1,0,0,1
52917,0,1,0,0,1
52918,0,1,0,0,1
52919,0,0,1,0,1
52920,0,1,0,0,1
52921,0,1,0,0,1
52922,1,0,0,0,1
52923,1,0,0,0,1
52924,0,1,0,0,1
52925,0,1,0,0,1
52926,0,1,0,0,1
52927,0,1,0,0,1
52928,0,1,0,0,1
52929,0,1,0,0,1
52930,0,1,0,0,1
52931,0,1,0,0,1
52932,0,1,0,0,1
52933,0,1,0,0,1
52934,0,1,0,0,1
52935,0,1,0,0,1
52936,0,1,0,0,1
52937,0,1,0,0,1
52938,1,0,0,0,1
52939,0,1,0,0,1
52940,0,1,0,0,1
52941,0,1,0,0,1
52942,0,1,0,0,1
52943,0,1,0,0,1
52944,0,1,0,0,1
52945,0,1,0,0,1
52946,0,1,0,0,1
52947,0,1,0,0,1
52948,0,1,0,0,1
52949,1,0,0,0,1
52950,0,1,0,0,1
52951,0,1,0,0,1
52952,1,0,0,0,1
52953,0,1,0,0,1
52954,0,1,0,0,1
52955,0,1,0,0,1
52956,0,1,0,0,1
52957,0,1,0,0,1
52958,0,1,0,0,1
52959,0,1,0,0,1
52960,0,1,0,0,1
52961,0,0,0,1,1
52962,0,1,0,0,1
52963,1,0,0,0,1
52964,0,1,0,0,1
52965,0,1,0,0,1
52966,1,0,0,0,1
52967,0,1,0,0,1
52968,0,1,0,0,1
52969,0,1,0,0,1
52970,0,1,0,0,1
52971,0,1,0,0,1
52972,0,1,0,0,1
52973,0,1,0,0,1
52974,0,1,0,0,1
52975,0,1,0,0,1
52976,1,0,0,0,1
52977,1,0,0,0,1
52978,0,1,0,0,1
52979,0,1,0,0,1
52980,1,0,0,0,1
52981,0,1,0,0,1
52982,0,1,0,0,1
52983,0,1,0,0,1
52984,0,1,0,0,1
52985,0,1,0,0,1
52986,0,1,0,0,1
52987,0,1,0,0,1
52988,0,1,0,0,1
52989,0,1,0,0,1
52990,0,1,0,0,1
52991,0,1,0,0,1
52992,0,1,0,0,1
52993,0,1,0,0,1
52994,0,1,0,0,1
52995,0,1,0,0,1
52996,0,1,0,0,1
52997,0,1,0,0,1
52998,0,1,0,0,1
52999,1,0,0,0,1
53000,0,1,0,0,1
53001,1,0,0,0,1
53002,0,0,1,0,1
53003,0,1,0,0,1
53004,0,1,0,0,1
53005,0,1,0,0,1
53006,0,1,0,0,1
53007,0,1,0,0,1
53008,0,1,0,0,1
53009,1,0,0,0,1
53010,0,0,1,0,1
53011,0,1,0,0,1
53012,0,1,0,0,1
53013,1,0,0,0,1
53014,0,1,0,0,1
53015,0,1,0,0,1
53016,0,1,0,0,1
53017,0,1,0,0,1
53018,0,1,0,0,1
53019,0,1,0,0,1
53020,0,1,0,0,1
53021,0,1,0,0,1
53022,0,1,0,0,1
53023,0,1,0,0,1
53024,0,0,0,1,1
53025,0,1,0,0,1
53026,0,1,0,0,1
53027,0,1,0,0,1
53028,0,1,0,0,1
53029,1,0,0,0,1
53030,0,1,0,0,1
53031,0,1,0,0,1
53032,0,1,0,0,1
53033,0,0,1,0,1
53034,0,1,0,0,1
53035,0,0,1,0,1
53036,0,1,0,0,1
53037,0,0,0,1,1
53038,0,1,0,0,1
53039,0,1,0,0,1
53040,0,1,0,0,1
53041,0,1,0,0,1
53042,0,1,0,0,1
53043,0,1,0,0,1
53044,0,1,0,0,1
53045,0,1,0,0,1
53046,0,1,0,0,1
53047,1,0,0,0,1
53048,0,1,0,0,1
53049,0,1,0,0,1
53050,1,0,0,0,1
53051,0,1,0,0,1
53052,0,1,0,0,1
53053,0,1,0,0,1
53054,0,1,0,0,1
53055,1,0,0,0,1
53056,0,1,0,0,1
53057,0,1,0,0,1
53058,0,1,0,0,1
53059,0,1,0,0,1
53060,1,0,0,0,1
53061,0,1,0,0,1
53062,0,1,0,0,1
53063,0,1,0,0,1
53064,0,1,0,0,1
53065,0,1,0,0,1
53066,0,1,0,0,1
53067,0,1,0,0,1
53068,0,1,0,0,1
53069,0,1,0,0,1
53070,0,1,0,0,1
53071,1,0,0,0,1
53072,0,1,0,0,1
53073,1,0,0,0,1
53074,0,1,0,0,1
53075,0,1,0,0,1
53076,0,1,0,0,1
53077,0,1,0,0,1
53078,0,1,0,0,1
53079,0,1,0,0,1
53080,0,1,0,0,1
53081,0,1,0,0,1
53082,0,1,0,0,1
53083,1,0,0,0,1
53084,0,1,0,0,1
53085,0,1,0,0,1
53086,0,1,0,0,1
53087,0,1,0,0,1
53088,0,1,0,0,1
53089,0,1,0,0,1
53090,0,0,0,1,1
53091,0,1,0,0,1
53092,0,1,0,0,1
53093,0,1,0,0,1
53094,0,1,0,0,1
53095,0,1,0,0,1
53096,0,1,0,0,1
53097,1,0,0,0,1
53098,0,1,0,0,1
53099,0,1,0,0,1
53100,0,1,0,0,1
53101,0,1,0,0,1
53102,0,1,0,0,1
53103,0,1,0,0,1
53104,0,1,0,0,1
53105,1,0,0,0,1
53106,0,1,0,0,1
53107,0,1,0,0,1
53108,0,1,0,0,1
53109,0,1,0,0,1
53110,0,1,0,0,1
53111,1,0,0,0,1
53112,1,0,0,0,1
53113,1,0,0,0,1
53114,0,1,0,0,1
53115,1,0,0,0,1
53116,1,0,0,0,1
53117,0,1,0,0,1
53118,0,1,0,0,1
53119,0,1,0,0,1
53120,0,1,0,0,1
53121,0,1,0,0,1
53122,0,1,0,0,1
53123,1,0,0,0,1
53124,0,1,0,0,1
53125,0,1,0,0,1
53126,0,1,0,0,1
53127,0,1,0,0,1
53128,0,1,0,0,1
53129,0,1,0,0,1
53130,0,0,0,1,1
53131,0,1,0,0,1
53132,0,1,0,0,1
53133,0,1,0,0,1
53134,0,1,0,0,1
53135,0,1,0,0,1
53136,0,1,0,0,1
53137,0,1,0,0,1
53138,0,1,0,0,1
53139,1,0,0,0,1
53140,0,1,0,0,1
53141,0,1,0,0,1
53142,0,1,0,0,1
53143,1,0,0,0,1
53144,0,1,0,0,1
53145,0,1,0,0,1
53146,0,1,0,0,1
53147,0,1,0,0,1
53148,1,0,0,0,1
53149,0,0,1,0,1
53150,1,0,0,0,1
53151,0,1,0,0,1
53152,0,1,0,0,1
53153,0,1,0,0,1
53154,0,1,0,0,1
53155,0,1,0,0,1
53156,0,1,0,0,1
53157,0,1,0,0,1
53158,0,1,0,0,1
53159,0,1,0,0,1
53160,0,0,0,1,1
53161,0,1,0,0,1
53162,0,1,0,0,1
53163,0,1,0,0,1
53164,0,1,0,0,1
53165,0,1,0,0,1
53166,0,1,0,0,1
53167,1,0,0,0,1
53168,0,1,0,0,1
53169,1,0,0,0,1
53170,1,0,0,0,1
53171,0,1,0,0,1
53172,1,0,0,0,1
53173,0,1,0,0,1
53174,0,1,0,0,1
53175,0,1,0,0,1
53176,0,1,0,0,1
53177,0,1,0,0,1
53178,1,0,0,0,1
53179,0,1,0,0,1
53180,0,1,0,0,1
53181,0,1,0,0,1
53182,0,1,0,0,1
53183,0,1,0,0,1
53184,0,1,0,0,1
53185,0,1,0,0,1
53186,0,1,0,0,1
53187,0,1,0,0,1
53188,0,0,0,1,1
53189,0,1,0,0,1
53190,0,1,0,0,1
53191,0,1,0,0,1
53192,0,1,0,0,1
53193,0,1,0,0,1
53194,0,1,0,0,1
53195,0,1,0,0,1
53196,0,1,0,0,1
53197,0,1,0,0,1
53198,0,1,0,0,1
53199,0,1,0,0,1
53200,0,1,0,0,1
53201,1,0,0,0,1
53202,0,1,0,0,1
53203,0,1,0,0,1
53204,1,0,0,0,1
53205,1,0,0,0,1
53206,1,0,0,0,1
53207,0,1,0,0,1
53208,0,1,0,0,1
53209,1,0,0,0,1
53210,0,0,1,0,1
53211,1,0,0,0,1
53212,0,1,0,0,1
53213,0,1,0,0,1
53214,0,1,0,0,1
53215,0,1,0,0,1
53216,0,1,0,0,1
53217,1,0,0,0,1
53218,0,1,0,0,1
53219,0,1,0,0,1
53220,0,1,0,0,1
53221,0,1,0,0,1
53222,0,1,0,0,1
53223,1,0,0,0,1
53224,0,1,0,0,1
53225,0,1,0,0,1
53226,0,0,0,1,1
53227,1,0,0,0,1
53228,0,1,0,0,1
53229,0,1,0,0,1
53230,0,1,0,0,1
53231,0,1,0,0,1
53232,0,1,0,0,1
53233,1,0,0,0,1
53234,0,1,0,0,1
53235,0,1,0,0,1
53236,1,0,0,0,1
53237,0,1,0,0,1
53238,1,0,0,0,1
53239,0,1,0,0,1
53240,0,1,0,0,1
53241,0,1,0,0,1
53242,0,1,0,0,1
53243,0,1,0,0,1
53244,0,1,0,0,1
53245,0,1,0,0,1
53246,0,1,0,0,1
53247,0,1,0,0,1
53248,0,1,0,0,1
53249,0,0,0,1,1
53250,0,1,0,0,1
53251,0,1,0,0,1
53252,0,1,0,0,1
53253,0,1,0,0,1
53254,0,1,0,0,1
53255,0,1,0,0,1
53256,0,1,0,0,1
53257,0,1,0,0,1
53258,0,1,0,0,1
53259,0,0,1,0,1
53260,0,1,0,0,1
53261,0,1,0,0,1
53262,0,1,0,0,1
53263,0,1,0,0,1
53264,0,1,0,0,1
53265,0,1,0,0,1
53266,1,0,0,0,1
53267,0,1,0,0,1
53268,1,0,0,0,1
53269,0,1,0,0,1
53270,0,1,0,0,1
53271,0,1,0,0,1
53272,0,1,0,0,1
53273,0,1,0,0,1
53274,0,1,0,0,1
53275,0,1,0,0,1
53276,0,1,0,0,1
53277,0,1,0,0,1
53278,1,0,0,0,1
53279,0,1,0,0,1
53280,0,1,0,0,1
53281,0,1,0,0,1
53282,0,1,0,0,1
53283,0,1,0,0,1
53284,0,1,0,0,1
53285,1,0,0,0,1
53286,0,1,0,0,1
53287,0,1,0,0,1
53288,0,0,0,1,1
53289,0,1,0,0,1
53290,1,0,0,0,1
53291,1,0,0,0,1
53292,1,0,0,0,1
53293,0,1,0,0,1
53294,0,1,0,0,1
53295,0,1,0,0,1
53296,0,1,0,0,1
53297,0,1,0,0,1
53298,0,1,0,0,1
53299,0,1,0,0,1
53300,1,0,0,0,1
53301,1,0,0,0,1
53302,0,1,0,0,1
53303,0,1,0,0,1
53304,0,1,0,0,1
53305,0,1,0,0,1
53306,0,1,0,0,1
53307,0,1,0,0,1
53308,0,1,0,0,1
53309,0,0,0,1,1
53310,1,0,0,0,1
53311,0,1,0,0,1
53312,0,1,0,0,1
53313,0,1,0,0,1
53314,0,0,1,0,1
53315,0,1,0,0,1
53316,1,0,0,0,1
53317,0,1,0,0,1
53318,0,1,0,0,1
53319,1,0,0,0,1
53320,0,1,0,0,1
53321,0,1,0,0,1
53322,0,1,0,0,1
53323,0,1,0,0,1
53324,0,0,1,0,1
53325,0,1,0,0,1
53326,0,1,0,0,1
53327,0,1,0,0,1
53328,0,1,0,0,1
53329,0,1,0,0,1
53330,0,0,0,1,1
53331,0,1,0,0,1
53332,0,1,0,0,1
53333,0,1,0,0,1
53334,0,1,0,0,1
53335,0,1,0,0,1
53336,0,1,0,0,1
53337,1,0,0,0,1
53338,0,1,0,0,1
53339,0,1,0,0,1
53340,0,1,0,0,1
53341,0,1,0,0,1
53342,0,1,0,0,1
53343,0,1,0,0,1
53344,0,1,0,0,1
53345,0,1,0,0,1
53346,0,1,0,0,1
53347,0,1,0,0,1
53348,0,1,0,0,1
53349,0,1,0,0,1
53350,0,1,0,0,1
53351,0,1,0,0,1
53352,0,1,0,0,1
53353,0,1,0,0,1
53354,0,1,0,0,1
53355,0,1,0,0,1
53356,0,1,0,0,1
53357,1,0,0,0,1
53358,0,1,0,0,1
53359,0,1,0,0,1
53360,0,0,1,0,1
53361,1,0,0,0,1
53362,0,1,0,0,1
53363,0,1,0,0,1
53364,0,1,0,0,1
53365,0,1,0,0,1
53366,0,1,0,0,1
53367,1,0,0,0,1
53368,1,0,0,0,1
53369,1,0,0,0,1
53370,0,0,0,1,1
53371,1,0,0,0,1
53372,0,1,0,0,1
53373,0,1,0,0,1
53374,1,0,0,0,1
53375,0,1,0,0,1
53376,0,1,0,0,1
53377,0,1,0,0,1
53378,1,0,0,0,1
53379,1,0,0,0,1
53380,0,1,0,0,1
53381,0,1,0,0,1
53382,1,0,0,0,1
53383,0,1,0,0,1
53384,0,1,0,0,1
53385,0,1,0,0,1
53386,1,0,0,0,1
53387,1,0,0,0,1
53388,0,1,0,0,1
53389,0,1,0,0,1
53390,1,0,0,0,1
53391,1,0,0,0,1
53392,1,0,0,0,1
53393,0,1,0,0,1
53394,1,0,0,0,1
53395,0,0,1,0,1
53396,0,1,0,0,1
53397,0,1,0,0,1
53398,0,1,0,0,1
53399,1,0,0,0,1
53400,0,1,0,0,1
53401,0,1,0,0,1
53402,0,1,0,0,1
53403,0,1,0,0,1
53404,0,1,0,0,1
53405,1,0,0,0,1
53406,0,1,0,0,1
53407,0,1,0,0,1
53408,0,0,0,1,1
53409,0,1,0,0,1
53410,0,0,0,1,1
53411,0,1,0,0,1
53412,1,0,0,0,1
53413,0,1,0,0,1
53414,0,1,0,0,1
53415,0,1,0,0,1
53416,0,1,0,0,1
53417,0,1,0,0,1
53418,0,1,0,0,1
53419,0,1,0,0,1
53420,0,1,0,0,1
53421,0,1,0,0,1
53422,0,1,0,0,1
53423,0,1,0,0,1
53424,0,1,0,0,1
53425,0,1,0,0,1
53426,1,0,0,0,1
53427,1,0,0,0,1
53428,1,0,0,0,1
53429,0,1,0,0,1
53430,1,0,0,0,1
53431,0,1,0,0,1
53432,0,1,0,0,1
53433,0,1,0,0,1
53434,1,0,0,0,1
53435,0,1,0,0,1
53436,0,1,0,0,1
53437,0,0,0,1,1
53438,0,1,0,0,1
53439,0,1,0,0,1
53440,0,1,0,0,1
53441,0,1,0,0,1
53442,0,1,0,0,1
53443,0,1,0,0,1
53444,0,1,0,0,1
53445,0,0,0,1,1
53446,0,1,0,0,1
53447,0,1,0,0,1
53448,0,1,0,0,1
53449,0,1,0,0,1
53450,0,0,0,1,1
53451,0,1,0,0,1
53452,0,0,0,1,1
53453,0,0,0,1,1
53454,1,0,0,0,1
53455,0,1,0,0,1
53456,0,1,0,0,1
53457,0,1,0,0,1
53458,0,1,0,0,1
53459,0,1,0,0,1
53460,0,1,0,0,1
53461,0,1,0,0,1
53462,0,0,0,1,1
53463,0,1,0,0,1
53464,0,1,0,0,1
53465,1,0,0,0,1
53466,0,1,0,0,1
53467,0,1,0,0,1
53468,0,1,0,0,1
53469,0,1,0,0,1
53470,0,1,0,0,1
53471,0,1,0,0,1
53472,0,1,0,0,1
53473,1,0,0,0,1
53474,1,0,0,0,1
53475,0,1,0,0,1
53476,0,1,0,0,1
53477,1,0,0,0,1
53478,0,1,0,0,1
53479,0,1,0,0,1
53480,0,1,0,0,1
53481,0,1,0,0,1
53482,0,1,0,0,1
53483,0,1,0,0,1
53484,0,1,0,0,1
53485,0,1,0,0,1
53486,0,0,0,1,1
53487,0,1,0,0,1
53488,0,1,0,0,1
53489,1,0,0,0,1
53490,1,0,0,0,1
53491,0,1,0,0,1
53492,0,1,0,0,1
53493,0,1,0,0,1
53494,0,1,0,0,1
53495,0,1,0,0,1
53496,0,1,0,0,1
53497,0,1,0,0,1
53498,0,0,0,1,1
53499,0,1,0,0,1
53500,0,1,0,0,1
53501,0,1,0,0,1
53502,1,0,0,0,1
53503,0,1,0,0,1
53504,0,0,0,1,1
53505,1,0,0,0,1
53506,0,1,0,0,1
53507,0,1,0,0,1
53508,0,1,0,0,1
53509,0,0,1,0,1
53510,0,1,0,0,1
53511,0,1,0,0,1
53512,1,0,0,0,1
53513,0,1,0,0,1
53514,0,1,0,0,1
53515,1,0,0,0,1
53516,0,1,0,0,1
53517,0,1,0,0,1
53518,1,0,0,0,1
53519,0,1,0,0,1
53520,0,1,0,0,1
53521,1,0,0,0,1
53522,1,0,0,0,1
53523,0,1,0,0,1
53524,0,1,0,0,1
53525,0,1,0,0,1
53526,0,1,0,0,1
53527,0,0,1,0,1
53528,0,1,0,0,1
53529,0,1,0,0,1
53530,0,1,0,0,1
53531,0,1,0,0,1
53532,0,1,0,0,1
53533,0,1,0,0,1
53534,0,1,0,0,1
53535,0,1,0,0,1
53536,0,1,0,0,1
53537,0,0,1,0,1
53538,0,1,0,0,1
53539,0,1,0,0,1
53540,0,1,0,0,1
53541,0,1,0,0,1
53542,0,1,0,0,1
53543,0,1,0,0,1
53544,0,1,0,0,1
53545,0,1,0,0,1
53546,0,1,0,0,1
53547,0,1,0,0,1
53548,0,1,0,0,1
53549,0,1,0,0,1
53550,0,1,0,0,1
53551,1,0,0,0,1
53552,0,1,0,0,1
53553,0,1,0,0,1
53554,0,1,0,0,1
53555,0,1,0,0,1
53556,0,1,0,0,1
53557,0,1,0,0,1
53558,0,1,0,0,1
53559,0,1,0,0,1
53560,0,1,0,0,1
53561,0,0,1,0,1
53562,0,1,0,0,1
53563,0,1,0,0,1
53564,0,0,0,1,1
53565,0,1,0,0,1
53566,0,1,0,0,1
53567,1,0,0,0,1
53568,0,1,0,0,1
53569,0,1,0,0,1
53570,0,1,0,0,1
53571,1,0,0,0,1
53572,0,1,0,0,1
53573,0,1,0,0,1
53574,0,1,0,0,1
53575,0,1,0,0,1
53576,1,0,0,0,1
53577,0,1,0,0,1
53578,0,1,0,0,1
53579,0,1,0,0,1
53580,1,0,0,0,1
53581,0,1,0,0,1
53582,0,1,0,0,1
53583,1,0,0,0,1
53584,1,0,0,0,1
53585,0,1,0,0,1
53586,0,1,0,0,1
53587,0,0,0,1,1
53588,0,1,0,0,1
53589,1,0,0,0,1
53590,0,1,0,0,1
53591,0,1,0,0,1
53592,0,1,0,0,1
53593,0,1,0,0,1
53594,0,1,0,0,1
53595,0,1,0,0,1
53596,0,1,0,0,1
53597,0,1,0,0,1
53598,0,1,0,0,1
53599,1,0,0,0,1
53600,0,1,0,0,1
53601,0,1,0,0,1
53602,1,0,0,0,1
53603,0,1,0,0,1
53604,1,0,0,0,1
53605,0,1,0,0,1
53606,0,1,0,0,1
53607,0,1,0,0,1
53608,0,0,1,0,1
53609,0,1,0,0,1
53610,0,1,0,0,1
53611,0,1,0,0,1
53612,0,1,0,0,1
53613,0,0,0,1,1
53614,0,1,0,0,1
53615,0,1,0,0,1
53616,0,1,0,0,1
53617,0,1,0,0,1
53618,1,0,0,0,1
53619,0,1,0,0,1
53620,0,1,0,0,1
53621,0,1,0,0,1
53622,0,1,0,0,1
53623,0,1,0,0,1
53624,0,1,0,0,1
53625,0,1,0,0,1
53626,0,1,0,0,1
53627,0,1,0,0,1
53628,0,1,0,0,1
53629,0,1,0,0,1
53630,0,1,0,0,1
53631,0,1,0,0,1
53632,0,1,0,0,1
53633,0,1,0,0,1
53634,0,1,0,0,1
53635,0,1,0,0,1
53636,0,1,0,0,1
53637,0,1,0,0,1
53638,0,1,0,0,1
53639,0,1,0,0,1
53640,0,1,0,0,1
53641,0,1,0,0,1
53642,0,1,0,0,1
53643,0,1,0,0,1
53644,0,1,0,0,1
53645,0,1,0,0,1
53646,0,1,0,0,1
53647,0,1,0,0,1
53648,0,1,0,0,1
53649,0,1,0,0,1
53650,0,1,0,0,1
53651,0,1,0,0,1
53652,0,0,0,1,1
53653,1,0,0,0,1
53654,0,1,0,0,1
53655,0,1,0,0,1
53656,0,1,0,0,1
53657,0,1,0,0,1
53658,0,1,0,0,1
53659,0,1,0,0,1
53660,0,1,0,0,1
53661,0,1,0,0,1
53662,1,0,0,0,1
53663,0,0,0,1,1
53664,0,1,0,0,1
53665,0,1,0,0,1
53666,1,0,0,0,1
53667,0,1,0,0,1
53668,1,0,0,0,1
53669,0,1,0,0,1
53670,0,1,0,0,1
53671,0,1,0,0,1
53672,0,1,0,0,1
53673,0,1,0,0,1
53674,1,0,0,0,1
53675,0,1,0,0,1
53676,0,1,0,0,1
53677,0,1,0,0,1
53678,0,1,0,0,1
53679,0,1,0,0,1
53680,0,1,0,0,1
53681,1,0,0,0,1
53682,0,1,0,0,1
53683,0,1,0,0,1
53684,0,1,0,0,1
53685,0,1,0,0,1
53686,1,0,0,0,1
53687,0,1,0,0,1
53688,0,1,0,0,1
53689,0,1,0,0,1
53690,0,1,0,0,1
53691,0,1,0,0,1
53692,0,1,0,0,1
53693,0,1,0,0,1
53694,0,1,0,0,1
53695,0,1,0,0,1
53696,0,1,0,0,1
53697,0,1,0,0,1
53698,0,1,0,0,1
53699,0,1,0,0,1
53700,0,1,0,0,1
53701,0,1,0,0,1
53702,0,1,0,0,1
53703,0,1,0,0,1
53704,0,1,0,0,1
53705,0,1,0,0,1
53706,0,1,0,0,1
53707,0,1,0,0,1
53708,1,0,0,0,1
53709,0,1,0,0,1
53710,0,1,0,0,1
53711,0,1,0,0,1
53712,0,1,0,0,1
53713,0,1,0,0,1
53714,0,1,0,0,1
53715,0,1,0,0,1
53716,0,1,0,0,1
53717,0,1,0,0,1
53718,0,1,0,0,1
53719,0,1,0,0,1
53720,0,1,0,0,1
53721,0,1,0,0,1
53722,0,1,0,0,1
53723,1,0,0,0,1
53724,0,1,0,0,1
53725,0,0,0,1,1
53726,0,1,0,0,1
53727,0,1,0,0,1
53728,0,1,0,0,1
53729,0,0,1,0,1
53730,0,1,0,0,1
53731,0,0,0,1,1
53732,0,1,0,0,1
53733,0,1,0,0,1
53734,1,0,0,0,1
53735,0,0,1,0,1
53736,0,1,0,0,1
53737,0,1,0,0,1
53738,0,1,0,0,1
53739,0,1,0,0,1
53740,0,0,1,0,1
53741,0,1,0,0,1
53742,1,0,0,0,1
53743,0,1,0,0,1
53744,0,1,0,0,1
53745,0,1,0,0,1
53746,0,1,0,0,1
53747,0,1,0,0,1
53748,0,1,0,0,1
53749,0,1,0,0,1
53750,0,1,0,0,1
53751,1,0,0,0,1
53752,0,1,0,0,1
53753,0,1,0,0,1
53754,0,1,0,0,1
53755,0,1,0,0,1
53756,0,1,0,0,1
53757,0,1,0,0,1
53758,0,1,0,0,1
53759,0,1,0,0,1
53760,0,1,0,0,1
53761,0,1,0,0,1
53762,1,0,0,0,1
53763,0,1,0,0,1
53764,0,1,0,0,1
53765,0,1,0,0,1
53766,0,1,0,0,1
53767,0,1,0,0,1
53768,0,1,0,0,1
53769,0,1,0,0,1
53770,0,1,0,0,1
53771,0,1,0,0,1
53772,0,1,0,0,1
53773,0,1,0,0,1
53774,0,1,0,0,1
53775,0,1,0,0,1
53776,0,1,0,0,1
53777,0,1,0,0,1
53778,0,1,0,0,1
53779,0,0,0,1,1
53780,0,1,0,0,1
53781,1,0,0,0,1
53782,0,1,0,0,1
53783,0,1,0,0,1
53784,0,1,0,0,1
53785,0,0,0,1,1
53786,0,1,0,0,1
53787,0,1,0,0,1
53788,0,1,0,0,1
53789,0,0,0,1,1
53790,0,1,0,0,1
53791,1,0,0,0,1
53792,0,1,0,0,1
53793,1,0,0,0,1
53794,1,0,0,0,1
53795,0,1,0,0,1
53796,1,0,0,0,1
53797,1,0,0,0,1
53798,0,1,0,0,1
53799,0,1,0,0,1
53800,0,1,0,0,1
53801,1,0,0,0,1
53802,0,1,0,0,1
53803,0,1,0,0,1
53804,0,0,0,1,1
53805,0,1,0,0,1
53806,0,1,0,0,1
53807,1,0,0,0,1
53808,0,1,0,0,1
53809,0,1,0,0,1
53810,0,1,0,0,1
53811,1,0,0,0,1
53812,0,1,0,0,1
53813,0,1,0,0,1
53814,0,1,0,0,1
53815,0,1,0,0,1
53816,1,0,0,0,1
53817,0,1,0,0,1
53818,0,1,0,0,1
53819,1,0,0,0,1
53820,0,1,0,0,1
53821,0,1,0,0,1
53822,0,1,0,0,1
53823,0,1,0,0,1
53824,0,1,0,0,1
53825,1,0,0,0,1
53826,0,1,0,0,1
53827,0,1,0,0,1
53828,0,1,0,0,1
53829,0,1,0,0,1
53830,1,0,0,0,1
53831,0,1,0,0,1
53832,0,1,0,0,1
53833,0,1,0,0,1
53834,0,1,0,0,1
53835,1,0,0,0,1
53836,0,1,0,0,1
53837,0,1,0,0,1
53838,0,1,0,0,1
53839,0,1,0,0,1
53840,0,1,0,0,1
53841,0,1,0,0,1
53842,0,1,0,0,1
53843,0,1,0,0,1
53844,0,1,0,0,1
53845,1,0,0,0,1
53846,0,1,0,0,1
53847,0,1,0,0,1
53848,0,1,0,0,1
53849,0,1,0,0,1
53850,0,1,0,0,1
53851,0,1,0,0,1
53852,0,1,0,0,1
53853,0,1,0,0,1
53854,0,1,0,0,1
53855,0,1,0,0,1
53856,0,1,0,0,1
53857,0,1,0,0,1
53858,0,1,0,0,1
53859,0,1,0,0,1
53860,0,1,0,0,1
53861,1,0,0,0,1
53862,1,0,0,0,1
53863,0,1,0,0,1
53864,0,1,0,0,1
53865,1,0,0,0,1
53866,0,1,0,0,1
53867,0,1,0,0,1
53868,0,1,0,0,1
53869,0,1,0,0,1
53870,0,1,0,0,1
53871,0,1,0,0,1
53872,0,1,0,0,1
53873,1,0,0,0,1
53874,0,1,0,0,1
53875,0,1,0,0,1
53876,1,0,0,0,1
53877,1,0,0,0,1
53878,0,1,0,0,1
53879,1,0,0,0,1
53880,1,0,0,0,1
53881,0,0,0,1,1
53882,0,1,0,0,1
53883,1,0,0,0,1
53884,0,1,0,0,1
53885,1,0,0,0,1
53886,0,1,0,0,1
53887,0,1,0,0,1
53888,0,1,0,0,1
53889,0,1,0,0,1
53890,0,1,0,0,1
53891,0,1,0,0,1
53892,0,1,0,0,1
53893,0,1,0,0,1
53894,0,1,0,0,1
53895,1,0,0,0,1
53896,0,1,0,0,1
53897,0,1,0,0,1
53898,0,1,0,0,1
53899,1,0,0,0,1
53900,0,1,0,0,1
53901,0,1,0,0,1
53902,0,1,0,0,1
53903,0,1,0,0,1
53904,0,1,0,0,1
53905,0,1,0,0,1
53906,0,1,0,0,1
53907,0,1,0,0,1
53908,0,1,0,0,1
53909,0,1,0,0,1
53910,1,0,0,0,1
53911,0,1,0,0,1
53912,0,1,0,0,1
53913,0,1,0,0,1
53914,0,1,0,0,1
53915,0,1,0,0,1
53916,0,1,0,0,1
53917,0,1,0,0,1
53918,1,0,0,0,1
53919,0,1,0,0,1
53920,0,1,0,0,1
53921,0,1,0,0,1
53922,1,0,0,0,1
53923,1,0,0,0,1
53924,0,1,0,0,1
53925,0,1,0,0,1
53926,1,0,0,0,1
53927,0,1,0,0,1
53928,0,1,0,0,1
53929,0,0,1,0,1
53930,0,1,0,0,1
53931,1,0,0,0,1
53932,0,1,0,0,1
53933,0,1,0,0,1
53934,1,0,0,0,1
53935,0,1,0,0,1
53936,0,1,0,0,1
53937,0,1,0,0,1
53938,0,1,0,0,1
53939,0,1,0,0,1
53940,0,1,0,0,1
53941,0,1,0,0,1
53942,1,0,0,0,1
53943,1,0,0,0,1
53944,0,1,0,0,1
53945,1,0,0,0,1
53946,0,1,0,0,1
53947,0,0,1,0,1
53948,0,1,0,0,1
53949,0,1,0,0,1
53950,0,1,0,0,1
53951,1,0,0,0,1
53952,0,1,0,0,1
53953,0,1,0,0,1
53954,0,1,0,0,1
53955,0,1,0,0,1
53956,1,0,0,0,1
53957,0,1,0,0,1
53958,1,0,0,0,1
53959,0,1,0,0,1
53960,0,1,0,0,1
53961,1,0,0,0,1
53962,0,1,0,0,1
53963,1,0,0,0,1
53964,0,1,0,0,1
53965,0,1,0,0,1
53966,1,0,0,0,1
53967,1,0,0,0,1
53968,1,0,0,0,1
53969,0,1,0,0,1
53970,0,1,0,0,1
53971,0,1,0,0,1
53972,0,1,0,0,1
53973,0,1,0,0,1
53974,0,1,0,0,1
53975,0,1,0,0,1
53976,0,1,0,0,1
53977,0,1,0,0,1
53978,0,0,0,1,1
53979,0,0,0,1,1
53980,1,0,0,0,1
53981,1,0,0,0,1
53982,1,0,0,0,1
53983,0,1,0,0,1
53984,0,1,0,0,1
53985,0,1,0,0,1
53986,0,1,0,0,1
53987,0,0,1,0,1
53988,0,0,1,0,1
53989,0,1,0,0,1
53990,0,1,0,0,1
53991,1,0,0,0,1
53992,0,1,0,0,1
53993,0,1,0,0,1
53994,0,1,0,0,1
53995,1,0,0,0,1
53996,0,1,0,0,1
53997,0,1,0,0,1
53998,1,0,0,0,1
53999,0,1,0,0,1
54000,0,1,0,0,1
54001,0,1,0,0,1
54002,0,1,0,0,1
54003,0,1,0,0,1
54004,1,0,0,0,1
54005,0,1,0,0,1
54006,0,0,1,0,1
54007,0,1,0,0,1
54008,0,1,0,0,1
54009,0,1,0,0,1
54010,0,0,1,0,1
54011,0,1,0,0,1
54012,1,0,0,0,1
54013,0,1,0,0,1
54014,1,0,0,0,1
54015,0,1,0,0,1
54016,1,0,0,0,1
54017,0,1,0,0,1
54018,0,1,0,0,1
54019,0,1,0,0,1
54020,1,0,0,0,1
54021,0,0,0,1,1
54022,1,0,0,0,1
54023,0,1,0,0,1
54024,0,1,0,0,1
54025,0,1,0,0,1
54026,0,1,0,0,1
54027,0,1,0,0,1
54028,0,1,0,0,1
54029,0,1,0,0,1
54030,1,0,0,0,1
54031,1,0,0,0,1
54032,0,1,0,0,1
54033,1,0,0,0,1
54034,0,1,0,0,1
54035,1,0,0,0,1
54036,0,1,0,0,1
54037,0,1,0,0,1
54038,0,1,0,0,1
54039,0,1,0,0,1
54040,0,1,0,0,1
54041,0,1,0,0,1
54042,0,1,0,0,1
54043,0,1,0,0,1
54044,0,0,1,0,1
54045,0,1,0,0,1
54046,0,1,0,0,1
54047,1,0,0,0,1
54048,0,1,0,0,1
54049,1,0,0,0,1
54050,1,0,0,0,1
54051,0,1,0,0,1
54052,0,1,0,0,1
54053,0,0,0,1,1
54054,0,1,0,0,1
54055,0,1,0,0,1
54056,0,1,0,0,1
54057,1,0,0,0,1
54058,0,1,0,0,1
54059,0,0,0,1,1
54060,0,1,0,0,1
54061,0,1,0,0,1
54062,0,1,0,0,1
54063,0,1,0,0,1
54064,0,1,0,0,1
54065,0,1,0,0,1
54066,1,0,0,0,1
54067,0,1,0,0,1
54068,0,1,0,0,1
54069,0,0,0,1,1
54070,0,1,0,0,1
54071,0,1,0,0,1
54072,0,1,0,0,1
54073,0,1,0,0,1
54074,0,1,0,0,1
54075,0,0,0,1,1
54076,0,1,0,0,1
54077,1,0,0,0,1
54078,1,0,0,0,1
54079,0,1,0,0,1
54080,1,0,0,0,1
54081,1,0,0,0,1
54082,0,1,0,0,1
54083,0,1,0,0,1
54084,0,1,0,0,1
54085,0,1,0,0,1
54086,0,1,0,0,1
54087,1,0,0,0,1
54088,0,0,0,1,1
54089,0,1,0,0,1
54090,0,1,0,0,1
54091,1,0,0,0,1
54092,0,1,0,0,1
54093,1,0,0,0,1
54094,0,1,0,0,1
54095,0,1,0,0,1
54096,0,1,0,0,1
54097,0,1,0,0,1
54098,0,1,0,0,1
54099,1,0,0,0,1
54100,0,1,0,0,1
54101,0,1,0,0,1
54102,0,1,0,0,1
54103,0,1,0,0,1
54104,0,1,0,0,1
54105,0,1,0,0,1
54106,0,1,0,0,1
54107,1,0,0,0,1
54108,0,1,0,0,1
54109,0,1,0,0,1
54110,0,1,0,0,1
54111,0,1,0,0,1
54112,0,1,0,0,1
54113,0,1,0,0,1
54114,1,0,0,0,1
54115,0,1,0,0,1
54116,0,1,0,0,1
54117,0,1,0,0,1
54118,0,1,0,0,1
54119,0,1,0,0,1
54120,0,1,0,0,1
54121,0,1,0,0,1
54122,0,1,0,0,1
54123,1,0,0,0,1
54124,0,1,0,0,1
54125,0,1,0,0,1
54126,0,1,0,0,1
54127,0,1,0,0,1
54128,0,1,0,0,1
54129,0,0,1,0,1
54130,0,1,0,0,1
54131,0,1,0,0,1
54132,0,1,0,0,1
54133,1,0,0,0,1
54134,1,0,0,0,1
54135,0,0,0,1,1
54136,0,1,0,0,1
54137,0,1,0,0,1
54138,0,1,0,0,1
54139,0,1,0,0,1
54140,0,1,0,0,1
54141,0,1,0,0,1
54142,0,1,0,0,1
54143,0,1,0,0,1
54144,0,1,0,0,1
54145,1,0,0,0,1
54146,1,0,0,0,1
54147,1,0,0,0,1
54148,0,1,0,0,1
54149,0,1,0,0,1
54150,1,0,0,0,1
54151,0,1,0,0,1
54152,0,1,0,0,1
54153,0,1,0,0,1
54154,0,0,0,1,1
54155,0,1,0,0,1
54156,0,1,0,0,1
54157,0,1,0,0,1
54158,0,1,0,0,1
54159,1,0,0,0,1
54160,0,1,0,0,1
54161,0,1,0,0,1
54162,1,0,0,0,1
54163,0,1,0,0,1
54164,0,1,0,0,1
54165,0,1,0,0,1
54166,0,1,0,0,1
54167,0,1,0,0,1
54168,0,1,0,0,1
54169,0,1,0,0,1
54170,0,1,0,0,1
54171,0,1,0,0,1
54172,0,1,0,0,1
54173,0,1,0,0,1
54174,0,1,0,0,1
54175,0,1,0,0,1
54176,0,1,0,0,1
54177,0,1,0,0,1
54178,0,1,0,0,1
54179,0,1,0,0,1
54180,0,1,0,0,1
54181,0,1,0,0,1
54182,0,0,0,1,1
54183,0,1,0,0,1
54184,0,1,0,0,1
54185,0,1,0,0,1
54186,0,1,0,0,1
54187,0,1,0,0,1
54188,1,0,0,0,1
54189,0,1,0,0,1
54190,0,1,0,0,1
54191,0,1,0,0,1
54192,0,1,0,0,1
54193,1,0,0,0,1
54194,1,0,0,0,1
54195,1,0,0,0,1
54196,0,1,0,0,1
54197,1,0,0,0,1
54198,1,0,0,0,1
54199,0,1,0,0,1
54200,0,1,0,0,1
54201,0,1,0,0,1
54202,0,1,0,0,1
54203,0,0,1,0,1
54204,0,1,0,0,1
54205,0,1,0,0,1
54206,0,1,0,0,1
54207,1,0,0,0,1
54208,0,1,0,0,1
54209,0,1,0,0,1
54210,0,1,0,0,1
54211,0,1,0,0,1
54212,0,1,0,0,1
54213,0,1,0,0,1
54214,0,1,0,0,1
54215,0,1,0,0,1
54216,0,1,0,0,1
54217,0,1,0,0,1
54218,0,1,0,0,1
54219,0,1,0,0,1
54220,0,1,0,0,1
54221,0,1,0,0,1
54222,0,1,0,0,1
54223,0,1,0,0,1
54224,0,1,0,0,1
54225,0,1,0,0,1
54226,0,1,0,0,1
54227,0,1,0,0,1
54228,0,1,0,0,1
54229,0,1,0,0,1
54230,1,0,0,0,1
54231,0,1,0,0,1
54232,0,1,0,0,1
54233,0,1,0,0,1
54234,0,1,0,0,1
54235,0,0,0,1,1
54236,0,1,0,0,1
54237,1,0,0,0,1
54238,1,0,0,0,1
54239,0,1,0,0,1
54240,0,1,0,0,1
54241,1,0,0,0,1
54242,0,1,0,0,1
54243,0,1,0,0,1
54244,0,1,0,0,1
54245,0,1,0,0,1
54246,0,1,0,0,1
54247,0,1,0,0,1
54248,0,1,0,0,1
54249,0,0,0,1,1
54250,1,0,0,0,1
54251,0,1,0,0,1
54252,1,0,0,0,1
54253,0,1,0,0,1
54254,0,1,0,0,1
54255,0,1,0,0,1
54256,0,1,0,0,1
54257,0,1,0,0,1
54258,0,1,0,0,1
54259,0,1,0,0,1
54260,0,0,0,1,1
54261,0,1,0,0,1
54262,0,1,0,0,1
54263,0,1,0,0,1
54264,0,1,0,0,1
54265,0,0,0,1,1
54266,0,1,0,0,1
54267,1,0,0,0,1
54268,0,1,0,0,1
54269,0,1,0,0,1
54270,0,1,0,0,1
54271,0,1,0,0,1
54272,0,1,0,0,1
54273,0,1,0,0,1
54274,0,1,0,0,1
54275,0,1,0,0,1
54276,0,0,1,0,1
54277,0,1,0,0,1
54278,0,1,0,0,1
54279,1,0,0,0,1
54280,0,1,0,0,1
54281,1,0,0,0,1
54282,0,1,0,0,1
54283,1,0,0,0,1
54284,0,1,0,0,1
54285,0,1,0,0,1
54286,0,1,0,0,1
54287,0,1,0,0,1
54288,1,0,0,0,1
54289,0,1,0,0,1
54290,0,1,0,0,1
54291,1,0,0,0,1
54292,0,1,0,0,1
54293,1,0,0,0,1
54294,0,1,0,0,1
54295,1,0,0,0,1
54296,0,1,0,0,1
54297,0,1,0,0,1
54298,0,1,0,0,1
54299,0,1,0,0,1
54300,0,1,0,0,1
54301,0,1,0,0,1
54302,0,1,0,0,1
54303,0,1,0,0,1
54304,0,1,0,0,1
54305,0,1,0,0,1
54306,0,1,0,0,1
54307,1,0,0,0,1
54308,0,1,0,0,1
54309,0,1,0,0,1
54310,0,1,0,0,1
54311,0,1,0,0,1
54312,1,0,0,0,1
54313,0,1,0,0,1
54314,0,1,0,0,1
54315,0,1,0,0,1
54316,0,1,0,0,1
54317,0,1,0,0,1
54318,0,1,0,0,1
54319,1,0,0,0,1
54320,0,1,0,0,1
54321,0,1,0,0,1
54322,0,1,0,0,1
54323,0,1,0,0,1
54324,0,1,0,0,1
54325,0,1,0,0,1
54326,1,0,0,0,1
54327,0,1,0,0,1
54328,0,1,0,0,1
54329,1,0,0,0,1
54330,0,1,0,0,1
54331,0,1,0,0,1
54332,0,1,0,0,1
54333,0,1,0,0,1
54334,1,0,0,0,1
54335,0,1,0,0,1
54336,0,1,0,0,1
54337,0,1,0,0,1
54338,0,1,0,0,1
54339,1,0,0,0,1
54340,0,1,0,0,1
54341,0,1,0,0,1
54342,0,1,0,0,1
54343,0,1,0,0,1
54344,0,1,0,0,1
54345,0,1,0,0,1
54346,1,0,0,0,1
54347,0,1,0,0,1
54348,0,1,0,0,1
54349,0,1,0,0,1
54350,0,1,0,0,1
54351,0,1,0,0,1
54352,0,1,0,0,1
54353,0,1,0,0,1
54354,0,1,0,0,1
54355,0,1,0,0,1
54356,1,0,0,0,1
54357,0,1,0,0,1
54358,1,0,0,0,1
54359,1,0,0,0,1
54360,0,0,1,0,1
54361,0,1,0,0,1
54362,0,1,0,0,1
54363,0,1,0,0,1
54364,0,1,0,0,1
54365,0,1,0,0,1
54366,0,1,0,0,1
54367,0,1,0,0,1
54368,0,1,0,0,1
54369,0,1,0,0,1
54370,0,1,0,0,1
54371,0,1,0,0,1
54372,0,1,0,0,1
54373,0,1,0,0,1
54374,0,0,1,0,1
54375,0,1,0,0,1
54376,0,1,0,0,1
54377,0,0,1,0,1
54378,0,1,0,0,1
54379,1,0,0,0,1
54380,0,1,0,0,1
54381,1,0,0,0,1
54382,0,0,0,1,1
54383,0,1,0,0,1
54384,0,1,0,0,1
54385,0,1,0,0,1
54386,0,1,0,0,1
54387,0,1,0,0,1
54388,0,1,0,0,1
54389,0,1,0,0,1
54390,1,0,0,0,1
54391,0,1,0,0,1
54392,0,1,0,0,1
54393,0,1,0,0,1
54394,0,1,0,0,1
54395,0,1,0,0,1
54396,0,1,0,0,1
54397,0,1,0,0,1
54398,0,1,0,0,1
54399,0,1,0,0,1
54400,0,1,0,0,1
54401,0,1,0,0,1
54402,0,1,0,0,1
54403,1,0,0,0,1
54404,0,1,0,0,1
54405,1,0,0,0,1
54406,0,1,0,0,1
54407,0,1,0,0,1
54408,1,0,0,0,1
54409,0,1,0,0,1
54410,0,1,0,0,1
54411,0,1,0,0,1
54412,0,1,0,0,1
54413,0,1,0,0,1
54414,0,1,0,0,1
54415,0,1,0,0,1
54416,1,0,0,0,1
54417,0,1,0,0,1
54418,0,0,1,0,1
54419,0,1,0,0,1
54420,0,1,0,0,1
54421,0,1,0,0,1
54422,0,1,0,0,1
54423,0,1,0,0,1
54424,0,0,0,1,1
54425,0,1,0,0,1
54426,0,1,0,0,1
54427,0,1,0,0,1
54428,0,1,0,0,1
54429,0,1,0,0,1
54430,0,1,0,0,1
54431,0,1,0,0,1
54432,0,1,0,0,1
54433,0,1,0,0,1
54434,0,1,0,0,1
54435,0,1,0,0,1
54436,0,1,0,0,1
54437,0,1,0,0,1
54438,0,1,0,0,1
54439,0,1,0,0,1
54440,0,1,0,0,1
54441,0,0,0,1,1
54442,1,0,0,0,1
54443,1,0,0,0,1
54444,0,1,0,0,1
54445,0,0,0,1,1
54446,0,1,0,0,1
54447,0,1,0,0,1
54448,1,0,0,0,1
54449,0,0,1,0,1
54450,0,1,0,0,1
54451,0,1,0,0,1
54452,0,1,0,0,1
54453,0,0,0,1,1
54454,0,1,0,0,1
54455,0,0,0,1,1
54456,0,1,0,0,1
54457,0,1,0,0,1
54458,1,0,0,0,1
54459,1,0,0,0,1
54460,0,1,0,0,1
54461,1,0,0,0,1
54462,1,0,0,0,1
54463,0,1,0,0,1
54464,0,1,0,0,1
54465,0,1,0,0,1
54466,0,1,0,0,1
54467,0,1,0,0,1
54468,0,1,0,0,1
54469,0,1,0,0,1
54470,0,1,0,0,1
54471,0,1,0,0,1
54472,1,0,0,0,1
54473,0,1,0,0,1
54474,0,1,0,0,1
54475,0,1,0,0,1
54476,0,1,0,0,1
54477,0,1,0,0,1
54478,0,1,0,0,1
54479,1,0,0,0,1
54480,1,0,0,0,1
54481,0,0,1,0,1
54482,0,1,0,0,1
54483,1,0,0,0,1
54484,0,1,0,0,1
54485,0,1,0,0,1
54486,0,1,0,0,1
54487,0,1,0,0,1
54488,0,1,0,0,1
54489,0,1,0,0,1
54490,0,1,0,0,1
54491,0,1,0,0,1
54492,0,1,0,0,1
54493,0,1,0,0,1
54494,1,0,0,0,1
54495,0,1,0,0,1
54496,0,1,0,0,1
54497,0,1,0,0,1
54498,1,0,0,0,1
54499,0,1,0,0,1
54500,1,0,0,0,1
54501,0,1,0,0,1
54502,0,1,0,0,1
54503,0,1,0,0,1
54504,1,0,0,0,1
54505,0,1,0,0,1
54506,0,1,0,0,1
54507,0,0,0,1,1
54508,0,1,0,0,1
54509,1,0,0,0,1
54510,0,1,0,0,1
54511,0,1,0,0,1
54512,1,0,0,0,1
54513,0,1,0,0,1
54514,0,1,0,0,1
54515,1,0,0,0,1
54516,0,1,0,0,1
54517,0,1,0,0,1
54518,0,0,0,1,1
54519,0,1,0,0,1
54520,0,1,0,0,1
54521,0,1,0,0,1
54522,0,1,0,0,1
54523,1,0,0,0,1
54524,0,1,0,0,1
54525,0,1,0,0,1
54526,0,1,0,0,1
54527,0,1,0,0,1
54528,0,1,0,0,1
54529,1,0,0,0,1
54530,0,1,0,0,1
54531,1,0,0,0,1
54532,0,1,0,0,1
54533,0,1,0,0,1
54534,0,1,0,0,1
54535,0,0,0,1,1
54536,0,1,0,0,1
54537,0,1,0,0,1
54538,0,1,0,0,1
54539,0,1,0,0,1
54540,0,1,0,0,1
54541,1,0,0,0,1
54542,0,1,0,0,1
54543,0,1,0,0,1
54544,1,0,0,0,1
54545,0,1,0,0,1
54546,0,1,0,0,1
54547,0,0,0,1,1
54548,1,0,0,0,1
54549,0,1,0,0,1
54550,0,1,0,0,1
54551,1,0,0,0,1
54552,0,1,0,0,1
54553,0,1,0,0,1
54554,0,1,0,0,1
54555,0,1,0,0,1
54556,0,1,0,0,1
54557,0,1,0,0,1
54558,0,1,0,0,1
54559,0,1,0,0,1
54560,0,1,0,0,1
54561,0,1,0,0,1
54562,0,1,0,0,1
54563,0,1,0,0,1
54564,1,0,0,0,1
54565,0,1,0,0,1
54566,0,1,0,0,1
54567,0,1,0,0,1
54568,0,1,0,0,1
54569,0,1,0,0,1
54570,0,1,0,0,1
54571,0,1,0,0,1
54572,1,0,0,0,1
54573,1,0,0,0,1
54574,0,1,0,0,1
54575,0,1,0,0,1
54576,0,1,0,0,1
54577,0,1,0,0,1
54578,0,1,0,0,1
54579,0,1,0,0,1
54580,0,1,0,0,1
54581,0,1,0,0,1
54582,0,1,0,0,1
54583,0,1,0,0,1
54584,0,1,0,0,1
54585,0,1,0,0,1
54586,1,0,0,0,1
54587,0,1,0,0,1
54588,0,1,0,0,1
54589,0,1,0,0,1
54590,0,1,0,0,1
54591,0,0,1,0,1
54592,0,1,0,0,1
54593,0,1,0,0,1
54594,0,1,0,0,1
54595,0,1,0,0,1
54596,0,1,0,0,1
54597,1,0,0,0,1
54598,1,0,0,0,1
54599,1,0,0,0,1
54600,0,1,0,0,1
54601,0,1,0,0,1
54602,0,1,0,0,1
54603,0,1,0,0,1
54604,0,0,1,0,1
54605,0,1,0,0,1
54606,1,0,0,0,1
54607,0,1,0,0,1
54608,0,1,0,0,1
54609,0,1,0,0,1
54610,0,1,0,0,1
54611,1,0,0,0,1
54612,0,1,0,0,1
54613,0,1,0,0,1
54614,0,1,0,0,1
54615,0,1,0,0,1
54616,1,0,0,0,1
54617,0,1,0,0,1
54618,0,1,0,0,1
54619,0,1,0,0,1
54620,0,1,0,0,1
54621,0,1,0,0,1
54622,0,1,0,0,1
54623,0,1,0,0,1
54624,1,0,0,0,1
54625,0,1,0,0,1
54626,0,1,0,0,1
54627,0,1,0,0,1
54628,0,1,0,0,1
54629,0,1,0,0,1
54630,0,1,0,0,1
54631,0,1,0,0,1
54632,0,1,0,0,1
54633,0,1,0,0,1
54634,1,0,0,0,1
54635,0,1,0,0,1
54636,0,1,0,0,1
54637,0,1,0,0,1
54638,1,0,0,0,1
54639,0,0,0,1,1
54640,0,1,0,0,1
54641,0,1,0,0,1
54642,0,1,0,0,1
54643,0,1,0,0,1
54644,0,1,0,0,1
54645,0,1,0,0,1
54646,0,1,0,0,1
54647,0,1,0,0,1
54648,0,1,0,0,1
54649,0,1,0,0,1
54650,0,1,0,0,1
54651,0,1,0,0,1
54652,0,1,0,0,1
54653,0,1,0,0,1
54654,0,1,0,0,1
54655,0,1,0,0,1
54656,1,0,0,0,1
54657,1,0,0,0,1
54658,0,1,0,0,1
54659,0,1,0,0,1
54660,1,0,0,0,1
54661,0,1,0,0,1
54662,0,1,0,0,1
54663,0,1,0,0,1
54664,0,1,0,0,1
54665,0,1,0,0,1
54666,0,1,0,0,1
54667,1,0,0,0,1
54668,1,0,0,0,1
54669,0,1,0,0,1
54670,0,1,0,0,1
54671,0,0,0,1,1
54672,0,1,0,0,1
54673,0,1,0,0,1
54674,0,1,0,0,1
54675,0,1,0,0,1
54676,0,1,0,0,1
54677,0,0,0,1,1
54678,0,1,0,0,1
54679,0,1,0,0,1
54680,0,1,0,0,1
54681,1,0,0,0,1
54682,0,1,0,0,1
54683,0,1,0,0,1
54684,0,1,0,0,1
54685,0,1,0,0,1
54686,0,1,0,0,1
54687,0,1,0,0,1
54688,0,1,0,0,1
54689,0,1,0,0,1
54690,0,1,0,0,1
54691,0,1,0,0,1
54692,0,1,0,0,1
54693,0,1,0,0,1
54694,1,0,0,0,1
54695,1,0,0,0,1
54696,0,1,0,0,1
54697,0,1,0,0,1
54698,0,1,0,0,1
54699,0,1,0,0,1
54700,0,1,0,0,1
54701,0,1,0,0,1
54702,0,1,0,0,1
54703,1,0,0,0,1
54704,0,1,0,0,1
54705,0,1,0,0,1
54706,0,0,0,1,1
54707,0,1,0,0,1
54708,0,1,0,0,1
54709,1,0,0,0,1
54710,0,1,0,0,1
54711,1,0,0,0,1
54712,1,0,0,0,1
54713,0,1,0,0,1
54714,0,1,0,0,1
54715,0,1,0,0,1
54716,0,1,0,0,1
54717,0,1,0,0,1
54718,0,1,0,0,1
54719,0,1,0,0,1
54720,1,0,0,0,1
54721,0,1,0,0,1
54722,0,1,0,0,1
54723,0,1,0,0,1
54724,1,0,0,0,1
54725,0,1,0,0,1
54726,0,1,0,0,1
54727,1,0,0,0,1
54728,0,1,0,0,1
54729,1,0,0,0,1
54730,0,1,0,0,1
54731,1,0,0,0,1
54732,0,1,0,0,1
54733,0,1,0,0,1
54734,1,0,0,0,1
54735,0,1,0,0,1
54736,0,1,0,0,1
54737,0,1,0,0,1
54738,1,0,0,0,1
54739,0,1,0,0,1
54740,0,1,0,0,1
54741,0,1,0,0,1
54742,1,0,0,0,1
54743,0,1,0,0,1
54744,0,1,0,0,1
54745,0,1,0,0,1
54746,0,1,0,0,1
54747,0,1,0,0,1
54748,0,1,0,0,1
54749,0,1,0,0,1
54750,1,0,0,0,1
54751,0,1,0,0,1
54752,0,1,0,0,1
54753,1,0,0,0,1
54754,0,0,0,1,1
54755,0,1,0,0,1
54756,0,1,0,0,1
54757,0,1,0,0,1
54758,0,1,0,0,1
54759,0,1,0,0,1
54760,0,1,0,0,1
54761,0,1,0,0,1
54762,0,1,0,0,1
54763,0,0,1,0,1
54764,0,1,0,0,1
54765,0,1,0,0,1
54766,0,1,0,0,1
54767,0,1,0,0,1
54768,0,1,0,0,1
54769,0,1,0,0,1
54770,0,1,0,0,1
54771,0,1,0,0,1
54772,1,0,0,0,1
54773,0,1,0,0,1
54774,0,1,0,0,1
54775,0,1,0,0,1
54776,0,1,0,0,1
54777,0,1,0,0,1
54778,0,1,0,0,1
54779,0,1,0,0,1
54780,0,0,1,0,1
54781,0,1,0,0,1
54782,0,1,0,0,1
54783,0,1,0,0,1
54784,0,1,0,0,1
54785,0,1,0,0,1
54786,0,1,0,0,1
54787,0,1,0,0,1
54788,0,1,0,0,1
54789,0,1,0,0,1
54790,0,1,0,0,1
54791,0,1,0,0,1
54792,0,1,0,0,1
54793,0,1,0,0,1
54794,0,1,0,0,1
54795,0,1,0,0,1
54796,0,1,0,0,1
54797,0,1,0,0,1
54798,0,1,0,0,1
54799,0,1,0,0,1
54800,0,1,0,0,1
54801,0,1,0,0,1
54802,0,1,0,0,1
54803,0,1,0,0,1
54804,0,1,0,0,1
54805,0,0,1,0,1
54806,0,1,0,0,1
54807,0,1,0,0,1
54808,0,1,0,0,1
54809,1,0,0,0,1
54810,0,1,0,0,1
54811,0,1,0,0,1
54812,1,0,0,0,1
54813,0,1,0,0,1
54814,0,1,0,0,1
54815,0,1,0,0,1
54816,0,1,0,0,1
54817,0,1,0,0,1
54818,0,1,0,0,1
54819,0,1,0,0,1
54820,0,1,0,0,1
54821,0,1,0,0,1
54822,0,1,0,0,1
54823,0,1,0,0,1
54824,0,0,1,0,1
54825,0,1,0,0,1
54826,0,1,0,0,1
54827,0,1,0,0,1
54828,0,1,0,0,1
54829,0,1,0,0,1
54830,0,1,0,0,1
54831,0,1,0,0,1
54832,0,1,0,0,1
54833,0,1,0,0,1
54834,0,1,0,0,1
54835,1,0,0,0,1
54836,0,1,0,0,1
54837,0,1,0,0,1
54838,0,1,0,0,1
54839,0,1,0,0,1
54840,1,0,0,0,1
54841,0,1,0,0,1
54842,0,1,0,0,1
54843,1,0,0,0,1
54844,0,1,0,0,1
54845,0,0,1,0,1
54846,0,1,0,0,1
54847,1,0,0,0,1
54848,0,1,0,0,1
54849,0,1,0,0,1
54850,1,0,0,0,1
54851,0,1,0,0,1
54852,1,0,0,0,1
54853,0,1,0,0,1
54854,0,1,0,0,1
54855,0,1,0,0,1
54856,0,1,0,0,1
54857,0,1,0,0,1
54858,0,1,0,0,1
54859,1,0,0,0,1
54860,0,1,0,0,1
54861,0,1,0,0,1
54862,0,1,0,0,1
54863,0,1,0,0,1
54864,0,1,0,0,1
54865,0,1,0,0,1
54866,0,1,0,0,1
54867,0,1,0,0,1
54868,0,1,0,0,1
54869,0,1,0,0,1
54870,0,1,0,0,1
54871,0,1,0,0,1
54872,1,0,0,0,1
54873,0,1,0,0,1
54874,0,1,0,0,1
54875,0,1,0,0,1
54876,0,1,0,0,1
54877,0,1,0,0,1
54878,0,1,0,0,1
54879,0,1,0,0,1
54880,0,1,0,0,1
54881,1,0,0,0,1
54882,0,1,0,0,1
54883,0,1,0,0,1
54884,0,0,0,1,1
54885,0,1,0,0,1
54886,0,1,0,0,1
54887,0,1,0,0,1
54888,1,0,0,0,1
54889,1,0,0,0,1
54890,0,1,0,0,1
54891,0,1,0,0,1
54892,0,1,0,0,1
54893,0,1,0,0,1
54894,0,1,0,0,1
54895,0,1,0,0,1
54896,1,0,0,0,1
54897,0,1,0,0,1
54898,1,0,0,0,1
54899,0,1,0,0,1
54900,0,1,0,0,1
54901,0,1,0,0,1
54902,0,1,0,0,1
54903,0,1,0,0,1
54904,0,1,0,0,1
54905,1,0,0,0,1
54906,0,1,0,0,1
54907,0,1,0,0,1
54908,0,1,0,0,1
54909,0,1,0,0,1
54910,0,1,0,0,1
54911,0,1,0,0,1
54912,0,1,0,0,1
54913,0,0,0,1,1
54914,0,1,0,0,1
54915,0,1,0,0,1
54916,0,1,0,0,1
54917,0,1,0,0,1
54918,0,1,0,0,1
54919,0,1,0,0,1
54920,0,1,0,0,1
54921,0,1,0,0,1
54922,0,1,0,0,1
54923,1,0,0,0,1
54924,0,1,0,0,1
54925,0,1,0,0,1
54926,0,0,0,1,1
54927,0,1,0,0,1
54928,1,0,0,0,1
54929,0,1,0,0,1
54930,0,0,1,0,1
54931,1,0,0,0,1
54932,0,0,0,1,1
54933,0,1,0,0,1
54934,0,1,0,0,1
54935,0,1,0,0,1
54936,0,1,0,0,1
54937,0,1,0,0,1
54938,0,1,0,0,1
54939,0,1,0,0,1
54940,0,1,0,0,1
54941,0,1,0,0,1
54942,0,1,0,0,1
54943,0,1,0,0,1
54944,0,1,0,0,1
54945,0,1,0,0,1
54946,0,1,0,0,1
54947,0,1,0,0,1
54948,0,1,0,0,1
54949,0,1,0,0,1
54950,1,0,0,0,1
54951,0,1,0,0,1
54952,0,1,0,0,1
54953,1,0,0,0,1
54954,0,1,0,0,1
54955,0,1,0,0,1
54956,0,1,0,0,1
54957,0,1,0,0,1
54958,0,1,0,0,1
54959,0,1,0,0,1
54960,0,1,0,0,1
54961,0,1,0,0,1
54962,0,0,0,1,1
54963,0,1,0,0,1
54964,0,1,0,0,1
54965,0,1,0,0,1
54966,0,1,0,0,1
54967,0,1,0,0,1
54968,0,1,0,0,1
54969,0,1,0,0,1
54970,0,1,0,0,1
54971,0,1,0,0,1
54972,0,1,0,0,1
54973,1,0,0,0,1
54974,0,1,0,0,1
54975,0,1,0,0,1
54976,1,0,0,0,1
54977,1,0,0,0,1
54978,0,1,0,0,1
54979,1,0,0,0,1
54980,0,1,0,0,1
54981,0,1,0,0,1
54982,0,1,0,0,1
54983,0,1,0,0,1
54984,0,1,0,0,1
54985,0,1,0,0,1
54986,0,1,0,0,1
54987,0,1,0,0,1
54988,0,1,0,0,1
54989,0,1,0,0,1
54990,1,0,0,0,1
54991,0,1,0,0,1
54992,0,1,0,0,1
54993,0,1,0,0,1
54994,0,1,0,0,1
54995,0,1,0,0,1
54996,0,1,0,0,1
54997,0,1,0,0,1
54998,0,0,0,1,1
54999,0,1,0,0,1
55000,0,1,0,0,1
55001,0,0,0,1,1
55002,0,1,0,0,1
55003,0,1,0,0,1
55004,0,1,0,0,1
55005,0,1,0,0,1
55006,0,1,0,0,1
55007,0,1,0,0,1
55008,0,1,0,0,1
55009,0,1,0,0,1
55010,1,0,0,0,1
55011,0,1,0,0,1
55012,1,0,0,0,1
55013,0,1,0,0,1
55014,0,1,0,0,1
55015,0,1,0,0,1
55016,0,1,0,0,1
55017,0,0,0,1,1
55018,0,1,0,0,1
55019,0,1,0,0,1
55020,1,0,0,0,1
55021,0,1,0,0,1
55022,0,1,0,0,1
55023,0,1,0,0,1
55024,1,0,0,0,1
55025,0,0,0,1,1
55026,0,1,0,0,1
55027,0,0,0,1,1
55028,0,1,0,0,1
55029,0,1,0,0,1
55030,1,0,0,0,1
55031,0,1,0,0,1
55032,1,0,0,0,1
55033,1,0,0,0,1
55034,0,1,0,0,1
55035,0,1,0,0,1
55036,0,1,0,0,1
55037,0,1,0,0,1
55038,0,1,0,0,1
55039,0,1,0,0,1
55040,0,1,0,0,1
55041,1,0,0,0,1
55042,0,1,0,0,1
55043,0,1,0,0,1
55044,0,1,0,0,1
55045,0,0,0,1,1
55046,0,1,0,0,1
55047,0,0,0,1,1
55048,0,1,0,0,1
55049,0,1,0,0,1
55050,0,1,0,0,1
55051,0,1,0,0,1
55052,0,1,0,0,1
55053,1,0,0,0,1
55054,0,1,0,0,1
55055,0,0,1,0,1
55056,0,1,0,0,1
55057,0,1,0,0,1
55058,0,1,0,0,1
55059,0,1,0,0,1
55060,0,1,0,0,1
55061,0,0,0,1,1
55062,0,1,0,0,1
55063,1,0,0,0,1
55064,0,1,0,0,1
55065,0,1,0,0,1
55066,0,1,0,0,1
55067,0,1,0,0,1
55068,0,1,0,0,1
55069,0,1,0,0,1
55070,1,0,0,0,1
55071,1,0,0,0,1
55072,0,1,0,0,1
55073,0,0,0,1,1
55074,0,1,0,0,1
55075,1,0,0,0,1
55076,0,1,0,0,1
55077,0,1,0,0,1
55078,0,1,0,0,1
55079,1,0,0,0,1
55080,0,1,0,0,1
55081,0,1,0,0,1
55082,0,1,0,0,1
55083,0,1,0,0,1
55084,1,0,0,0,1
55085,0,1,0,0,1
55086,0,1,0,0,1
55087,0,1,0,0,1
55088,0,1,0,0,1
55089,0,1,0,0,1
55090,0,1,0,0,1
55091,0,0,1,0,1
55092,0,1,0,0,1
55093,0,1,0,0,1
55094,0,1,0,0,1
55095,0,1,0,0,1
55096,0,1,0,0,1
55097,1,0,0,0,1
55098,0,1,0,0,1
55099,0,1,0,0,1
55100,0,1,0,0,1
55101,0,1,0,0,1
55102,0,1,0,0,1
55103,0,1,0,0,1
55104,0,1,0,0,1
55105,0,1,0,0,1
55106,0,1,0,0,1
55107,0,1,0,0,1
55108,0,1,0,0,1
55109,0,1,0,0,1
55110,0,1,0,0,1
55111,0,1,0,0,1
55112,0,1,0,0,1
55113,0,1,0,0,1
55114,0,1,0,0,1
55115,1,0,0,0,1
55116,1,0,0,0,1
55117,1,0,0,0,1
55118,0,1,0,0,1
55119,0,0,1,0,1
55120,0,1,0,0,1
55121,0,1,0,0,1
55122,0,1,0,0,1
55123,0,1,0,0,1
55124,1,0,0,0,1
55125,0,0,0,1,1
55126,1,0,0,0,1
55127,0,1,0,0,1
55128,0,1,0,0,1
55129,0,1,0,0,1
55130,0,1,0,0,1
55131,0,1,0,0,1
55132,1,0,0,0,1
55133,1,0,0,0,1
55134,0,1,0,0,1
55135,0,1,0,0,1
55136,0,1,0,0,1
55137,0,1,0,0,1
55138,0,1,0,0,1
55139,0,1,0,0,1
55140,0,1,0,0,1
55141,0,1,0,0,1
55142,0,1,0,0,1
55143,0,1,0,0,1
55144,0,1,0,0,1
55145,0,1,0,0,1
55146,1,0,0,0,1
55147,0,1,0,0,1
55148,0,1,0,0,1
55149,0,1,0,0,1
55150,0,1,0,0,1
55151,0,1,0,0,1
55152,1,0,0,0,1
55153,1,0,0,0,1
55154,0,1,0,0,1
55155,0,1,0,0,1
55156,0,1,0,0,1
55157,0,1,0,0,1
55158,1,0,0,0,1
55159,1,0,0,0,1
55160,0,1,0,0,1
55161,0,1,0,0,1
55162,0,1,0,0,1
55163,0,1,0,0,1
55164,0,1,0,0,1
55165,1,0,0,0,1
55166,0,1,0,0,1
55167,0,1,0,0,1
55168,0,1,0,0,1
55169,0,1,0,0,1
55170,0,0,1,0,1
55171,0,1,0,0,1
55172,0,1,0,0,1
55173,0,1,0,0,1
55174,0,1,0,0,1
55175,0,1,0,0,1
55176,0,1,0,0,1
55177,1,0,0,0,1
55178,0,1,0,0,1
55179,0,1,0,0,1
55180,0,0,0,1,1
55181,0,1,0,0,1
55182,1,0,0,0,1
55183,0,1,0,0,1
55184,0,1,0,0,1
55185,0,1,0,0,1
55186,1,0,0,0,1
55187,0,1,0,0,1
55188,0,1,0,0,1
55189,0,1,0,0,1
55190,0,1,0,0,1
55191,0,1,0,0,1
55192,1,0,0,0,1
55193,0,1,0,0,1
55194,0,1,0,0,1
55195,1,0,0,0,1
55196,0,1,0,0,1
55197,0,1,0,0,1
55198,0,1,0,0,1
55199,0,1,0,0,1
55200,0,1,0,0,1
55201,1,0,0,0,1
55202,0,1,0,0,1
55203,0,1,0,0,1
55204,0,1,0,0,1
55205,0,1,0,0,1
55206,0,1,0,0,1
55207,0,1,0,0,1
55208,0,1,0,0,1
55209,0,1,0,0,1
55210,0,1,0,0,1
55211,0,1,0,0,1
55212,0,0,0,1,1
55213,0,1,0,0,1
55214,0,1,0,0,1
55215,0,1,0,0,1
55216,0,0,1,0,1
55217,0,1,0,0,1
55218,0,1,0,0,1
55219,0,0,0,1,1
55220,0,1,0,0,1
55221,0,1,0,0,1
55222,1,0,0,0,1
55223,0,1,0,0,1
55224,0,1,0,0,1
55225,0,1,0,0,1
55226,0,1,0,0,1
55227,0,1,0,0,1
55228,0,1,0,0,1
55229,1,0,0,0,1
55230,1,0,0,0,1
55231,0,0,0,1,1
55232,0,1,0,0,1
55233,0,1,0,0,1
55234,0,1,0,0,1
55235,0,0,0,1,1
55236,0,1,0,0,1
55237,0,1,0,0,1
55238,0,1,0,0,1
55239,0,1,0,0,1
55240,0,1,0,0,1
55241,0,1,0,0,1
55242,0,1,0,0,1
55243,0,1,0,0,1
55244,0,1,0,0,1
55245,0,1,0,0,1
55246,0,1,0,0,1
55247,1,0,0,0,1
55248,1,0,0,0,1
55249,0,1,0,0,1
55250,0,1,0,0,1
55251,0,1,0,0,1
55252,0,1,0,0,1
55253,0,1,0,0,1
55254,0,0,0,1,1
55255,0,1,0,0,1
55256,0,1,0,0,1
55257,0,0,0,1,1
55258,0,1,0,0,1
55259,0,1,0,0,1
55260,0,1,0,0,1
55261,0,1,0,0,1
55262,0,1,0,0,1
55263,0,1,0,0,1
55264,0,1,0,0,1
55265,0,1,0,0,1
55266,0,1,0,0,1
55267,1,0,0,0,1
55268,0,1,0,0,1
55269,1,0,0,0,1
55270,0,1,0,0,1
55271,0,1,0,0,1
55272,0,1,0,0,1
55273,0,1,0,0,1
55274,0,1,0,0,1
55275,0,0,1,0,1
55276,0,1,0,0,1
55277,0,1,0,0,1
55278,0,1,0,0,1
55279,0,1,0,0,1
55280,0,1,0,0,1
55281,0,0,0,1,1
55282,0,1,0,0,1
55283,0,1,0,0,1
55284,0,1,0,0,1
55285,0,1,0,0,1
55286,0,1,0,0,1
55287,0,1,0,0,1
55288,0,1,0,0,1
55289,0,1,0,0,1
55290,0,1,0,0,1
55291,0,1,0,0,1
55292,1,0,0,0,1
55293,0,1,0,0,1
55294,0,1,0,0,1
55295,0,1,0,0,1
55296,0,1,0,0,1
55297,0,1,0,0,1
55298,1,0,0,0,1
55299,0,1,0,0,1
55300,0,1,0,0,1
55301,0,1,0,0,1
55302,0,1,0,0,1
55303,0,1,0,0,1
55304,0,1,0,0,1
55305,0,1,0,0,1
55306,1,0,0,0,1
55307,0,1,0,0,1
55308,0,1,0,0,1
55309,1,0,0,0,1
55310,0,1,0,0,1
55311,0,1,0,0,1
55312,0,1,0,0,1
55313,0,1,0,0,1
55314,0,1,0,0,1
55315,0,1,0,0,1
55316,0,1,0,0,1
55317,0,1,0,0,1
55318,0,1,0,0,1
55319,0,1,0,0,1
55320,0,1,0,0,1
55321,0,1,0,0,1
55322,0,1,0,0,1
55323,0,1,0,0,1
55324,1,0,0,0,1
55325,0,1,0,0,1
55326,0,1,0,0,1
55327,0,1,0,0,1
55328,1,0,0,0,1
55329,0,0,1,0,1
55330,0,1,0,0,1
55331,0,1,0,0,1
55332,0,0,0,1,1
55333,0,1,0,0,1
55334,0,1,0,0,1
55335,0,1,0,0,1
55336,1,0,0,0,1
55337,0,1,0,0,1
55338,0,1,0,0,1
55339,1,0,0,0,1
55340,0,1,0,0,1
55341,0,1,0,0,1
55342,1,0,0,0,1
55343,0,1,0,0,1
55344,1,0,0,0,1
55345,0,1,0,0,1
55346,0,1,0,0,1
55347,0,1,0,0,1
55348,0,1,0,0,1
55349,0,1,0,0,1
55350,0,0,0,1,1
55351,0,1,0,0,1
55352,0,1,0,0,1
55353,0,1,0,0,1
55354,0,1,0,0,1
55355,1,0,0,0,1
55356,0,1,0,0,1
55357,0,1,0,0,1
55358,0,1,0,0,1
55359,0,1,0,0,1
55360,0,0,0,1,1
55361,0,1,0,0,1
55362,0,1,0,0,1
55363,0,1,0,0,1
55364,0,1,0,0,1
55365,0,1,0,0,1
55366,1,0,0,0,1
55367,0,1,0,0,1
55368,0,1,0,0,1
55369,0,1,0,0,1
55370,0,1,0,0,1
55371,0,1,0,0,1
55372,0,1,0,0,1
55373,0,1,0,0,1
55374,1,0,0,0,1
55375,0,1,0,0,1
55376,1,0,0,0,1
55377,0,1,0,0,1
55378,0,1,0,0,1
55379,0,1,0,0,1
55380,0,1,0,0,1
55381,0,1,0,0,1
55382,0,1,0,0,1
55383,1,0,0,0,1
55384,1,0,0,0,1
55385,0,1,0,0,1
55386,0,1,0,0,1
55387,0,1,0,0,1
55388,0,1,0,0,1
55389,0,1,0,0,1
55390,0,1,0,0,1
55391,0,1,0,0,1
55392,1,0,0,0,1
55393,0,1,0,0,1
55394,0,1,0,0,1
55395,1,0,0,0,1
55396,0,0,0,1,1
55397,0,0,0,1,1
55398,0,0,0,1,1
55399,0,1,0,0,1
55400,0,1,0,0,1
55401,0,1,0,0,1
55402,0,1,0,0,1
55403,0,1,0,0,1
55404,0,1,0,0,1
55405,0,1,0,0,1
55406,0,1,0,0,1
55407,0,1,0,0,1
55408,0,1,0,0,1
55409,0,1,0,0,1
55410,0,1,0,0,1
55411,0,1,0,0,1
55412,0,1,0,0,1
55413,0,1,0,0,1
55414,0,1,0,0,1
55415,0,1,0,0,1
55416,0,1,0,0,1
55417,0,1,0,0,1
55418,0,1,0,0,1
55419,0,1,0,0,1
55420,0,1,0,0,1
55421,0,1,0,0,1
55422,0,1,0,0,1
55423,0,1,0,0,1
55424,0,1,0,0,1
55425,1,0,0,0,1
55426,0,1,0,0,1
55427,0,1,0,0,1
55428,0,1,0,0,1
55429,0,1,0,0,1
55430,0,1,0,0,1
55431,0,1,0,0,1
55432,0,1,0,0,1
55433,0,1,0,0,1
55434,0,1,0,0,1
55435,0,0,0,1,1
55436,0,1,0,0,1
55437,1,0,0,0,1
55438,0,1,0,0,1
55439,0,1,0,0,1
55440,0,0,0,1,1
55441,0,1,0,0,1
55442,0,1,0,0,1
55443,0,1,0,0,1
55444,1,0,0,0,1
55445,0,1,0,0,1
55446,0,1,0,0,1
55447,0,1,0,0,1
55448,0,1,0,0,1
55449,0,1,0,0,1
55450,1,0,0,0,1
55451,1,0,0,0,1
55452,0,1,0,0,1
55453,0,1,0,0,1
55454,0,1,0,0,1
55455,1,0,0,0,1
55456,0,1,0,0,1
55457,0,1,0,0,1
55458,0,1,0,0,1
55459,1,0,0,0,1
55460,0,1,0,0,1
55461,0,1,0,0,1
55462,0,1,0,0,1
55463,0,1,0,0,1
55464,0,1,0,0,1
55465,0,1,0,0,1
55466,0,1,0,0,1
55467,0,1,0,0,1
55468,0,1,0,0,1
55469,0,1,0,0,1
55470,1,0,0,0,1
55471,1,0,0,0,1
55472,0,1,0,0,1
55473,0,1,0,0,1
55474,0,1,0,0,1
55475,1,0,0,0,1
55476,1,0,0,0,1
55477,0,1,0,0,1
55478,0,1,0,0,1
55479,0,1,0,0,1
55480,0,1,0,0,1
55481,0,1,0,0,1
55482,0,1,0,0,1
55483,0,1,0,0,1
55484,0,1,0,0,1
55485,0,1,0,0,1
55486,0,1,0,0,1
55487,0,1,0,0,1
55488,0,0,0,1,1
55489,1,0,0,0,1
55490,1,0,0,0,1
55491,0,1,0,0,1
55492,0,1,0,0,1
55493,1,0,0,0,1
55494,0,1,0,0,1
55495,0,1,0,0,1
55496,1,0,0,0,1
55497,0,1,0,0,1
55498,0,1,0,0,1
55499,0,1,0,0,1
55500,0,1,0,0,1
55501,0,1,0,0,1
55502,0,1,0,0,1
55503,0,1,0,0,1
55504,0,1,0,0,1
55505,0,1,0,0,1
55506,0,1,0,0,1
55507,0,1,0,0,1
55508,0,1,0,0,1
55509,0,1,0,0,1
55510,1,0,0,0,1
55511,0,1,0,0,1
55512,0,1,0,0,1
55513,0,1,0,0,1
55514,1,0,0,0,1
55515,0,1,0,0,1
55516,0,1,0,0,1
55517,0,1,0,0,1
55518,0,1,0,0,1
55519,0,1,0,0,1
55520,0,1,0,0,1
55521,1,0,0,0,1
55522,0,1,0,0,1
55523,0,1,0,0,1
55524,0,1,0,0,1
55525,0,1,0,0,1
55526,1,0,0,0,1
55527,1,0,0,0,1
55528,0,1,0,0,1
55529,1,0,0,0,1
55530,0,1,0,0,1
55531,0,1,0,0,1
55532,0,1,0,0,1
55533,0,1,0,0,1
55534,0,1,0,0,1
55535,0,1,0,0,1
55536,1,0,0,0,1
55537,0,1,0,0,1
55538,0,1,0,0,1
55539,0,1,0,0,1
55540,1,0,0,0,1
55541,0,1,0,0,1
55542,1,0,0,0,1
55543,0,1,0,0,1
55544,0,1,0,0,1
55545,0,1,0,0,1
55546,1,0,0,0,1
55547,0,1,0,0,1
55548,0,1,0,0,1
55549,0,1,0,0,1
55550,0,1,0,0,1
55551,0,1,0,0,1
55552,1,0,0,0,1
55553,0,1,0,0,1
55554,0,1,0,0,1
55555,0,1,0,0,1
55556,0,1,0,0,1
55557,0,1,0,0,1
55558,0,1,0,0,1
55559,0,1,0,0,1
55560,0,1,0,0,1
55561,0,0,0,1,1
55562,0,1,0,0,1
55563,0,1,0,0,1
55564,0,1,0,0,1
55565,1,0,0,0,1
55566,0,1,0,0,1
55567,0,1,0,0,1
55568,0,1,0,0,1
55569,0,1,0,0,1
55570,0,1,0,0,1
55571,0,1,0,0,1
55572,0,1,0,0,1
55573,0,1,0,0,1
55574,0,1,0,0,1
55575,0,1,0,0,1
55576,1,0,0,0,1
55577,0,1,0,0,1
55578,0,0,1,0,1
55579,0,1,0,0,1
55580,0,1,0,0,1
55581,0,1,0,0,1
55582,0,1,0,0,1
55583,0,0,0,1,1
55584,0,1,0,0,1
55585,0,1,0,0,1
55586,1,0,0,0,1
55587,0,1,0,0,1
55588,0,1,0,0,1
55589,0,1,0,0,1
55590,0,1,0,0,1
55591,0,1,0,0,1
55592,0,1,0,0,1
55593,1,0,0,0,1
55594,0,1,0,0,1
55595,0,1,0,0,1
55596,0,1,0,0,1
55597,0,1,0,0,1
55598,0,1,0,0,1
55599,0,1,0,0,1
55600,1,0,0,0,1
55601,0,1,0,0,1
55602,0,1,0,0,1
55603,0,1,0,0,1
55604,0,1,0,0,1
55605,0,1,0,0,1
55606,0,1,0,0,1
55607,0,1,0,0,1
55608,1,0,0,0,1
55609,0,1,0,0,1
55610,0,1,0,0,1
55611,1,0,0,0,1
55612,0,1,0,0,1
55613,0,1,0,0,1
55614,0,1,0,0,1
55615,0,1,0,0,1
55616,0,1,0,0,1
55617,0,1,0,0,1
55618,0,1,0,0,1
55619,0,1,0,0,1
55620,0,1,0,0,1
55621,0,1,0,0,1
55622,0,1,0,0,1
55623,0,1,0,0,1
55624,0,1,0,0,1
55625,0,0,1,0,1
55626,0,1,0,0,1
55627,0,1,0,0,1
55628,0,1,0,0,1
55629,0,1,0,0,1
55630,0,1,0,0,1
55631,0,1,0,0,1
55632,1,0,0,0,1
55633,1,0,0,0,1
55634,1,0,0,0,1
55635,0,1,0,0,1
55636,1,0,0,0,1
55637,0,1,0,0,1
55638,1,0,0,0,1
55639,1,0,0,0,1
55640,0,1,0,0,1
55641,0,1,0,0,1
55642,1,0,0,0,1
55643,0,1,0,0,1
55644,0,1,0,0,1
55645,0,1,0,0,1
55646,0,1,0,0,1
55647,0,1,0,0,1
55648,0,1,0,0,1
55649,1,0,0,0,1
55650,0,1,0,0,1
55651,0,1,0,0,1
55652,0,1,0,0,1
55653,0,1,0,0,1
55654,0,1,0,0,1
55655,0,1,0,0,1
55656,0,0,0,1,1
55657,0,1,0,0,1
55658,0,1,0,0,1
55659,0,1,0,0,1
55660,0,1,0,0,1
55661,0,1,0,0,1
55662,0,1,0,0,1
55663,0,0,1,0,1
55664,0,1,0,0,1
55665,0,1,0,0,1
55666,0,1,0,0,1
55667,0,1,0,0,1
55668,0,1,0,0,1
55669,0,1,0,0,1
55670,0,1,0,0,1
55671,0,1,0,0,1
55672,0,1,0,0,1
55673,0,1,0,0,1
55674,0,1,0,0,1
55675,0,1,0,0,1
55676,0,1,0,0,1
55677,0,1,0,0,1
55678,0,1,0,0,1
55679,1,0,0,0,1
55680,0,1,0,0,1
55681,0,1,0,0,1
55682,0,1,0,0,1
55683,0,1,0,0,1
55684,0,1,0,0,1
55685,0,1,0,0,1
55686,0,1,0,0,1
55687,0,1,0,0,1
55688,1,0,0,0,1
55689,0,1,0,0,1
55690,0,1,0,0,1
55691,0,1,0,0,1
55692,0,1,0,0,1
55693,1,0,0,0,1
55694,1,0,0,0,1
55695,0,1,0,0,1
55696,0,1,0,0,1
55697,0,1,0,0,1
55698,0,1,0,0,1
55699,0,1,0,0,1
55700,0,1,0,0,1
55701,0,1,0,0,1
55702,1,0,0,0,1
55703,1,0,0,0,1
55704,1,0,0,0,1
55705,0,1,0,0,1
55706,1,0,0,0,1
55707,0,1,0,0,1
55708,0,1,0,0,1
55709,0,1,0,0,1
55710,0,1,0,0,1
55711,1,0,0,0,1
55712,0,1,0,0,1
55713,0,0,0,1,1
55714,0,1,0,0,1
55715,1,0,0,0,1
55716,0,1,0,0,1
55717,0,1,0,0,1
55718,0,1,0,0,1
55719,1,0,0,0,1
55720,0,1,0,0,1
55721,0,1,0,0,1
55722,0,1,0,0,1
55723,0,1,0,0,1
55724,0,1,0,0,1
55725,0,1,0,0,1
55726,0,1,0,0,1
55727,0,1,0,0,1
55728,1,0,0,0,1
55729,0,1,0,0,1
55730,0,1,0,0,1
55731,0,1,0,0,1
55732,1,0,0,0,1
55733,0,0,1,0,1
55734,1,0,0,0,1
55735,0,1,0,0,1
55736,0,1,0,0,1
55737,0,1,0,0,1
55738,0,1,0,0,1
55739,1,0,0,0,1
55740,0,1,0,0,1
55741,0,1,0,0,1
55742,0,1,0,0,1
55743,0,1,0,0,1
55744,1,0,0,0,1
55745,0,1,0,0,1
55746,0,0,0,1,1
55747,0,1,0,0,1
55748,0,1,0,0,1
55749,0,1,0,0,1
55750,0,1,0,0,1
55751,0,1,0,0,1
55752,0,1,0,0,1
55753,0,1,0,0,1
55754,0,1,0,0,1
55755,0,1,0,0,1
55756,0,1,0,0,1
55757,0,1,0,0,1
55758,0,1,0,0,1
55759,0,1,0,0,1
55760,0,1,0,0,1
55761,0,1,0,0,1
55762,0,1,0,0,1
55763,1,0,0,0,1
55764,0,1,0,0,1
55765,0,1,0,0,1
55766,0,1,0,0,1
55767,0,1,0,0,1
55768,1,0,0,0,1
55769,0,1,0,0,1
55770,0,1,0,0,1
55771,0,1,0,0,1
55772,0,1,0,0,1
55773,0,1,0,0,1
55774,0,1,0,0,1
55775,1,0,0,0,1
55776,0,1,0,0,1
55777,0,1,0,0,1
55778,0,1,0,0,1
55779,0,1,0,0,1
55780,0,1,0,0,1
55781,0,1,0,0,1
55782,0,1,0,0,1
55783,0,1,0,0,1
55784,0,1,0,0,1
55785,0,1,0,0,1
55786,0,1,0,0,1
55787,0,1,0,0,1
55788,1,0,0,0,1
55789,0,1,0,0,1
55790,1,0,0,0,1
55791,0,1,0,0,1
55792,0,1,0,0,1
55793,0,1,0,0,1
55794,0,1,0,0,1
55795,0,1,0,0,1
55796,0,1,0,0,1
55797,0,1,0,0,1
55798,0,1,0,0,1
55799,0,0,1,0,1
55800,0,1,0,0,1
55801,0,1,0,0,1
55802,0,1,0,0,1
55803,1,0,0,0,1
55804,0,1,0,0,1
55805,0,1,0,0,1
55806,0,1,0,0,1
55807,0,1,0,0,1
55808,0,1,0,0,1
55809,0,0,0,1,1
55810,0,1,0,0,1
55811,0,1,0,0,1
55812,0,1,0,0,1
55813,0,1,0,0,1
55814,0,1,0,0,1
55815,0,1,0,0,1
55816,0,1,0,0,1
55817,1,0,0,0,1
55818,0,1,0,0,1
55819,0,1,0,0,1
55820,0,1,0,0,1
55821,0,1,0,0,1
55822,0,1,0,0,1
55823,0,1,0,0,1
55824,0,1,0,0,1
55825,1,0,0,0,1
55826,0,1,0,0,1
55827,1,0,0,0,1
55828,1,0,0,0,1
55829,0,1,0,0,1
55830,0,1,0,0,1
55831,1,0,0,0,1
55832,0,1,0,0,1
55833,0,1,0,0,1
55834,1,0,0,0,1
55835,0,1,0,0,1
55836,0,0,0,1,1
55837,0,1,0,0,1
55838,0,1,0,0,1
55839,0,1,0,0,1
55840,1,0,0,0,1
55841,0,1,0,0,1
55842,0,1,0,0,1
55843,0,1,0,0,1
55844,0,1,0,0,1
55845,1,0,0,0,1
55846,0,1,0,0,1
55847,0,1,0,0,1
55848,0,1,0,0,1
55849,1,0,0,0,1
55850,0,1,0,0,1
55851,0,1,0,0,1
55852,0,1,0,0,1
55853,0,1,0,0,1
55854,0,1,0,0,1
55855,0,1,0,0,1
55856,0,1,0,0,1
55857,0,1,0,0,1
55858,0,1,0,0,1
55859,0,1,0,0,1
55860,0,1,0,0,1
55861,0,1,0,0,1
55862,0,1,0,0,1
55863,0,1,0,0,1
55864,0,0,0,1,1
55865,0,1,0,0,1
55866,0,1,0,0,1
55867,0,1,0,0,1
55868,0,1,0,0,1
55869,0,1,0,0,1
55870,1,0,0,0,1
55871,0,1,0,0,1
55872,0,1,0,0,1
55873,0,1,0,0,1
55874,0,1,0,0,1
55875,0,1,0,0,1
55876,0,1,0,0,1
55877,1,0,0,0,1
55878,0,1,0,0,1
55879,0,1,0,0,1
55880,0,1,0,0,1
55881,0,1,0,0,1
55882,0,1,0,0,1
55883,1,0,0,0,1
55884,0,1,0,0,1
55885,0,1,0,0,1
55886,0,0,0,1,1
55887,0,1,0,0,1
55888,0,1,0,0,1
55889,0,1,0,0,1
55890,0,1,0,0,1
55891,0,1,0,0,1
55892,0,1,0,0,1
55893,0,1,0,0,1
55894,0,1,0,0,1
55895,0,1,0,0,1
55896,0,1,0,0,1
55897,0,1,0,0,1
55898,0,0,0,1,1
55899,0,1,0,0,1
55900,1,0,0,0,1
55901,0,1,0,0,1
55902,0,1,0,0,1
55903,0,1,0,0,1
55904,0,1,0,0,1
55905,0,1,0,0,1
55906,0,1,0,0,1
55907,0,1,0,0,1
55908,0,1,0,0,1
55909,0,1,0,0,1
55910,0,1,0,0,1
55911,1,0,0,0,1
55912,1,0,0,0,1
55913,0,1,0,0,1
55914,0,1,0,0,1
55915,0,1,0,0,1
55916,0,1,0,0,1
55917,0,1,0,0,1
55918,1,0,0,0,1
55919,0,1,0,0,1
55920,0,1,0,0,1
55921,0,1,0,0,1
55922,0,1,0,0,1
55923,0,1,0,0,1
55924,0,1,0,0,1
55925,0,1,0,0,1
55926,1,0,0,0,1
55927,0,1,0,0,1
55928,1,0,0,0,1
55929,0,1,0,0,1
55930,0,1,0,0,1
55931,0,1,0,0,1
55932,0,1,0,0,1
55933,1,0,0,0,1
55934,0,1,0,0,1
55935,1,0,0,0,1
55936,0,1,0,0,1
55937,0,1,0,0,1
55938,1,0,0,0,1
55939,0,0,0,1,1
55940,0,1,0,0,1
55941,0,1,0,0,1
55942,0,1,0,0,1
55943,0,1,0,0,1
55944,0,1,0,0,1
55945,0,1,0,0,1
55946,0,1,0,0,1
55947,0,1,0,0,1
55948,0,1,0,0,1
55949,1,0,0,0,1
55950,0,1,0,0,1
55951,0,1,0,0,1
55952,0,1,0,0,1
55953,0,1,0,0,1
55954,0,1,0,0,1
55955,0,0,0,1,1
55956,0,1,0,0,1
55957,0,0,0,1,1
55958,0,1,0,0,1
55959,1,0,0,0,1
55960,0,1,0,0,1
55961,0,1,0,0,1
55962,1,0,0,0,1
55963,0,1,0,0,1
55964,0,1,0,0,1
55965,0,1,0,0,1
55966,1,0,0,0,1
55967,0,1,0,0,1
55968,0,1,0,0,1
55969,0,1,0,0,1
55970,1,0,0,0,1
55971,0,1,0,0,1
55972,0,1,0,0,1
55973,0,1,0,0,1
55974,0,1,0,0,1
55975,0,1,0,0,1
55976,0,1,0,0,1
55977,0,1,0,0,1
55978,0,1,0,0,1
55979,0,1,0,0,1
55980,1,0,0,0,1
55981,0,1,0,0,1
55982,0,1,0,0,1
55983,0,1,0,0,1
55984,0,1,0,0,1
55985,0,1,0,0,1
55986,0,1,0,0,1
55987,0,1,0,0,1
55988,0,1,0,0,1
55989,0,1,0,0,1
55990,1,0,0,0,1
55991,1,0,0,0,1
55992,0,1,0,0,1
55993,0,1,0,0,1
55994,0,1,0,0,1
55995,0,1,0,0,1
55996,0,1,0,0,1
55997,0,1,0,0,1
55998,0,1,0,0,1
55999,0,1,0,0,1
56000,0,1,0,0,1
56001,0,1,0,0,1
56002,1,0,0,0,1
56003,0,0,0,1,1
56004,1,0,0,0,1
56005,1,0,0,0,1
56006,0,1,0,0,1
56007,0,0,1,0,1
56008,0,1,0,0,1
56009,0,1,0,0,1
56010,0,1,0,0,1
56011,1,0,0,0,1
56012,1,0,0,0,1
56013,1,0,0,0,1
56014,0,1,0,0,1
56015,0,1,0,0,1
56016,0,1,0,0,1
56017,0,1,0,0,1
56018,0,1,0,0,1
56019,0,1,0,0,1
56020,0,1,0,0,1
56021,0,1,0,0,1
56022,0,1,0,0,1
56023,0,1,0,0,1
56024,0,1,0,0,1
56025,1,0,0,0,1
56026,0,1,0,0,1
56027,0,0,0,1,1
56028,0,1,0,0,1
56029,1,0,0,0,1
56030,0,1,0,0,1
56031,0,1,0,0,1
56032,0,1,0,0,1
56033,0,0,0,1,1
56034,0,1,0,0,1
56035,0,1,0,0,1
56036,0,1,0,0,1
56037,0,1,0,0,1
56038,0,1,0,0,1
56039,0,1,0,0,1
56040,1,0,0,0,1
56041,0,1,0,0,1
56042,0,1,0,0,1
56043,1,0,0,0,1
56044,0,1,0,0,1
56045,0,1,0,0,1
56046,0,1,0,0,1
56047,0,1,0,0,1
56048,0,1,0,0,1
56049,0,1,0,0,1
56050,0,1,0,0,1
56051,0,1,0,0,1
56052,0,1,0,0,1
56053,0,1,0,0,1
56054,1,0,0,0,1
56055,0,1,0,0,1
56056,0,1,0,0,1
56057,0,1,0,0,1
56058,0,1,0,0,1
56059,0,1,0,0,1
56060,0,1,0,0,1
56061,0,1,0,0,1
56062,0,1,0,0,1
56063,0,1,0,0,1
56064,0,1,0,0,1
56065,0,1,0,0,1
56066,1,0,0,0,1
56067,0,1,0,0,1
56068,0,1,0,0,1
56069,0,0,0,1,1
56070,0,1,0,0,1
56071,0,1,0,0,1
56072,0,1,0,0,1
56073,0,1,0,0,1
56074,1,0,0,0,1
56075,0,1,0,0,1
56076,0,1,0,0,1
56077,0,1,0,0,1
56078,0,1,0,0,1
56079,0,1,0,0,1
56080,1,0,0,0,1
56081,0,1,0,0,1
56082,0,1,0,0,1
56083,0,1,0,0,1
56084,0,1,0,0,1
56085,0,0,0,1,1
56086,0,1,0,0,1
56087,0,1,0,0,1
56088,0,1,0,0,1
56089,1,0,0,0,1
56090,0,1,0,0,1
56091,0,1,0,0,1
56092,0,1,0,0,1
56093,1,0,0,0,1
56094,0,1,0,0,1
56095,0,1,0,0,1
56096,1,0,0,0,1
56097,0,1,0,0,1
56098,0,1,0,0,1
56099,1,0,0,0,1
56100,0,1,0,0,1
56101,0,1,0,0,1
56102,1,0,0,0,1
56103,0,1,0,0,1
56104,0,1,0,0,1
56105,0,1,0,0,1
56106,0,1,0,0,1
56107,0,1,0,0,1
56108,0,0,0,1,1
56109,0,1,0,0,1
56110,0,1,0,0,1
56111,0,1,0,0,1
56112,1,0,0,0,1
56113,0,0,1,0,1
56114,0,1,0,0,1
56115,0,1,0,0,1
56116,0,1,0,0,1
56117,0,1,0,0,1
56118,0,1,0,0,1
56119,0,1,0,0,1
56120,0,1,0,0,1
56121,0,1,0,0,1
56122,0,1,0,0,1
56123,0,1,0,0,1
56124,0,1,0,0,1
56125,0,0,0,1,1
56126,0,1,0,0,1
56127,0,1,0,0,1
56128,0,1,0,0,1
56129,1,0,0,0,1
56130,0,0,0,1,1
56131,0,1,0,0,1
56132,1,0,0,0,1
56133,1,0,0,0,1
56134,0,1,0,0,1
56135,0,1,0,0,1
56136,0,1,0,0,1
56137,0,1,0,0,1
56138,0,1,0,0,1
56139,1,0,0,0,1
56140,0,0,0,1,1
56141,1,0,0,0,1
56142,0,1,0,0,1
56143,0,1,0,0,1
56144,0,1,0,0,1
56145,0,1,0,0,1
56146,0,1,0,0,1
56147,0,1,0,0,1
56148,0,1,0,0,1
56149,0,1,0,0,1
56150,0,1,0,0,1
56151,1,0,0,0,1
56152,0,1,0,0,1
56153,0,1,0,0,1
56154,0,1,0,0,1
56155,0,1,0,0,1
56156,0,1,0,0,1
56157,0,1,0,0,1
56158,0,1,0,0,1
56159,1,0,0,0,1
56160,0,1,0,0,1
56161,0,1,0,0,1
56162,0,1,0,0,1
56163,1,0,0,0,1
56164,0,1,0,0,1
56165,1,0,0,0,1
56166,0,0,1,0,1
56167,0,1,0,0,1
56168,0,1,0,0,1
56169,1,0,0,0,1
56170,0,1,0,0,1
56171,1,0,0,0,1
56172,0,1,0,0,1
56173,0,1,0,0,1
56174,0,1,0,0,1
56175,0,1,0,0,1
56176,0,1,0,0,1
56177,1,0,0,0,1
56178,0,1,0,0,1
56179,0,1,0,0,1
56180,0,1,0,0,1
56181,0,1,0,0,1
56182,0,1,0,0,1
56183,0,1,0,0,1
56184,1,0,0,0,1
56185,0,1,0,0,1
56186,0,1,0,0,1
56187,0,1,0,0,1
56188,0,1,0,0,1
56189,0,1,0,0,1
56190,0,1,0,0,1
56191,1,0,0,0,1
56192,0,1,0,0,1
56193,0,1,0,0,1
56194,0,0,0,1,1
56195,0,1,0,0,1
56196,0,1,0,0,1
56197,0,1,0,0,1
56198,0,1,0,0,1
56199,0,1,0,0,1
56200,0,1,0,0,1
56201,0,1,0,0,1
56202,0,1,0,0,1
56203,1,0,0,0,1
56204,0,1,0,0,1
56205,0,1,0,0,1
56206,1,0,0,0,1
56207,0,1,0,0,1
56208,0,1,0,0,1
56209,0,1,0,0,1
56210,0,1,0,0,1
56211,0,1,0,0,1
56212,0,1,0,0,1
56213,0,1,0,0,1
56214,1,0,0,0,1
56215,0,1,0,0,1
56216,0,1,0,0,1
56217,0,0,1,0,1
56218,1,0,0,0,1
56219,0,1,0,0,1
56220,1,0,0,0,1
56221,0,1,0,0,1
56222,0,1,0,0,1
56223,0,1,0,0,1
56224,1,0,0,0,1
56225,0,1,0,0,1
56226,0,1,0,0,1
56227,1,0,0,0,1
56228,0,1,0,0,1
56229,0,1,0,0,1
56230,0,1,0,0,1
56231,0,1,0,0,1
56232,0,1,0,0,1
56233,0,1,0,0,1
56234,1,0,0,0,1
56235,0,0,0,1,1
56236,0,1,0,0,1
56237,1,0,0,0,1
56238,0,1,0,0,1
56239,0,1,0,0,1
56240,1,0,0,0,1
56241,0,1,0,0,1
56242,0,1,0,0,1
56243,1,0,0,0,1
56244,0,1,0,0,1
56245,0,1,0,0,1
56246,0,1,0,0,1
56247,0,0,0,1,1
56248,0,1,0,0,1
56249,0,1,0,0,1
56250,0,1,0,0,1
56251,0,1,0,0,1
56252,0,0,0,1,1
56253,0,1,0,0,1
56254,0,1,0,0,1
56255,0,0,0,1,1
56256,1,0,0,0,1
56257,0,1,0,0,1
56258,0,1,0,0,1
56259,0,1,0,0,1
56260,1,0,0,0,1
56261,0,1,0,0,1
56262,0,1,0,0,1
56263,0,1,0,0,1
56264,0,1,0,0,1
56265,1,0,0,0,1
56266,0,1,0,0,1
56267,0,1,0,0,1
56268,0,1,0,0,1
56269,0,1,0,0,1
56270,1,0,0,0,1
56271,0,1,0,0,1
56272,0,1,0,0,1
56273,1,0,0,0,1
56274,0,1,0,0,1
56275,0,1,0,0,1
56276,0,1,0,0,1
56277,0,1,0,0,1
56278,0,0,1,0,1
56279,1,0,0,0,1
56280,0,1,0,0,1
56281,0,1,0,0,1
56282,0,1,0,0,1
56283,0,1,0,0,1
56284,1,0,0,0,1
56285,0,1,0,0,1
56286,0,1,0,0,1
56287,1,0,0,0,1
56288,0,1,0,0,1
56289,0,1,0,0,1
56290,1,0,0,0,1
56291,0,1,0,0,1
56292,0,1,0,0,1
56293,0,1,0,0,1
56294,0,1,0,0,1
56295,0,1,0,0,1
56296,1,0,0,0,1
56297,0,1,0,0,1
56298,0,1,0,0,1
56299,0,1,0,0,1
56300,1,0,0,0,1
56301,0,1,0,0,1
56302,0,1,0,0,1
56303,0,1,0,0,1
56304,0,1,0,0,1
56305,0,1,0,0,1
56306,0,1,0,0,1
56307,1,0,0,0,1
56308,0,1,0,0,1
56309,0,1,0,0,1
56310,0,0,1,0,1
56311,1,0,0,0,1
56312,0,0,0,1,1
56313,0,1,0,0,1
56314,0,1,0,0,1
56315,0,1,0,0,1
56316,0,1,0,0,1
56317,0,1,0,0,1
56318,1,0,0,0,1
56319,0,1,0,0,1
56320,0,1,0,0,1
56321,1,0,0,0,1
56322,0,0,0,1,1
56323,0,1,0,0,1
56324,0,1,0,0,1
56325,0,1,0,0,1
56326,0,1,0,0,1
56327,0,1,0,0,1
56328,1,0,0,0,1
56329,0,1,0,0,1
56330,0,1,0,0,1
56331,0,1,0,0,1
56332,0,1,0,0,1
56333,1,0,0,0,1
56334,0,1,0,0,1
56335,0,1,0,0,1
56336,0,1,0,0,1
56337,0,1,0,0,1
56338,0,1,0,0,1
56339,0,1,0,0,1
56340,0,1,0,0,1
56341,0,1,0,0,1
56342,0,1,0,0,1
56343,0,1,0,0,1
56344,0,0,1,0,1
56345,1,0,0,0,1
56346,0,1,0,0,1
56347,0,1,0,0,1
56348,1,0,0,0,1
56349,0,1,0,0,1
56350,0,1,0,0,1
56351,1,0,0,0,1
56352,0,1,0,0,1
56353,0,1,0,0,1
56354,1,0,0,0,1
56355,0,1,0,0,1
56356,0,1,0,0,1
56357,1,0,0,0,1
56358,0,1,0,0,1
56359,1,0,0,0,1
56360,1,0,0,0,1
56361,0,1,0,0,1
56362,1,0,0,0,1
56363,0,1,0,0,1
56364,0,1,0,0,1
56365,0,1,0,0,1
56366,1,0,0,0,1
56367,0,1,0,0,1
56368,1,0,0,0,1
56369,0,1,0,0,1
56370,0,1,0,0,1
56371,0,1,0,0,1
56372,0,1,0,0,1
56373,1,0,0,0,1
56374,0,1,0,0,1
56375,0,1,0,0,1
56376,0,1,0,0,1
56377,0,1,0,0,1
56378,1,0,0,0,1
56379,0,1,0,0,1
56380,0,1,0,0,1
56381,0,1,0,0,1
56382,0,1,0,0,1
56383,0,1,0,0,1
56384,0,1,0,0,1
56385,0,1,0,0,1
56386,0,1,0,0,1
56387,0,1,0,0,1
56388,1,0,0,0,1
56389,0,1,0,0,1
56390,0,1,0,0,1
56391,0,1,0,0,1
56392,0,1,0,0,1
56393,1,0,0,0,1
56394,0,1,0,0,1
56395,0,1,0,0,1
56396,0,1,0,0,1
56397,0,1,0,0,1
56398,0,1,0,0,1
56399,0,1,0,0,1
56400,0,1,0,0,1
56401,1,0,0,0,1
56402,0,1,0,0,1
56403,0,1,0,0,1
56404,0,1,0,0,1
56405,0,1,0,0,1
56406,0,1,0,0,1
56407,0,1,0,0,1
56408,1,0,0,0,1
56409,1,0,0,0,1
56410,0,1,0,0,1
56411,0,1,0,0,1
56412,0,1,0,0,1
56413,0,1,0,0,1
56414,0,1,0,0,1
56415,0,1,0,0,1
56416,0,1,0,0,1
56417,0,1,0,0,1
56418,0,1,0,0,1
56419,1,0,0,0,1
56420,0,1,0,0,1
56421,0,1,0,0,1
56422,1,0,0,0,1
56423,0,1,0,0,1
56424,0,1,0,0,1
56425,1,0,0,0,1
56426,0,1,0,0,1
56427,1,0,0,0,1
56428,1,0,0,0,1
56429,0,1,0,0,1
56430,1,0,0,0,1
56431,0,1,0,0,1
56432,0,1,0,0,1
56433,0,0,0,1,1
56434,1,0,0,0,1
56435,1,0,0,0,1
56436,0,1,0,0,1
56437,0,1,0,0,1
56438,1,0,0,0,1
56439,0,1,0,0,1
56440,1,0,0,0,1
56441,0,1,0,0,1
56442,1,0,0,0,1
56443,0,1,0,0,1
56444,0,1,0,0,1
56445,0,1,0,0,1
56446,0,1,0,0,1
56447,0,1,0,0,1
56448,0,1,0,0,1
56449,0,1,0,0,1
56450,0,1,0,0,1
56451,0,1,0,0,1
56452,1,0,0,0,1
56453,1,0,0,0,1
56454,1,0,0,0,1
56455,0,1,0,0,1
56456,0,1,0,0,1
56457,1,0,0,0,1
56458,1,0,0,0,1
56459,0,1,0,0,1
56460,0,1,0,0,1
56461,0,1,0,0,1
56462,0,0,1,0,1
56463,0,0,0,1,1
56464,0,1,0,0,1
56465,1,0,0,0,1
56466,0,1,0,0,1
56467,0,1,0,0,1
56468,0,1,0,0,1
56469,0,1,0,0,1
56470,1,0,0,0,1
56471,0,1,0,0,1
56472,0,1,0,0,1
56473,0,1,0,0,1
56474,0,1,0,0,1
56475,0,1,0,0,1
56476,0,1,0,0,1
56477,1,0,0,0,1
56478,1,0,0,0,1
56479,0,1,0,0,1
56480,0,1,0,0,1
56481,0,1,0,0,1
56482,0,1,0,0,1
56483,1,0,0,0,1
56484,0,1,0,0,1
56485,0,1,0,0,1
56486,0,1,0,0,1
56487,0,0,0,1,1
56488,0,1,0,0,1
56489,0,1,0,0,1
56490,0,1,0,0,1
56491,0,0,0,1,1
56492,0,1,0,0,1
56493,0,1,0,0,1
56494,1,0,0,0,1
56495,0,1,0,0,1
56496,0,1,0,0,1
56497,1,0,0,0,1
56498,0,1,0,0,1
56499,0,1,0,0,1
56500,0,1,0,0,1
56501,0,1,0,0,1
56502,0,1,0,0,1
56503,0,1,0,0,1
56504,0,1,0,0,1
56505,0,1,0,0,1
56506,0,1,0,0,1
56507,0,1,0,0,1
56508,0,1,0,0,1
56509,0,1,0,0,1
56510,0,1,0,0,1
56511,0,1,0,0,1
56512,0,1,0,0,1
56513,0,1,0,0,1
56514,0,1,0,0,1
56515,0,1,0,0,1
56516,0,1,0,0,1
56517,0,1,0,0,1
56518,0,1,0,0,1
56519,0,1,0,0,1
56520,0,1,0,0,1
56521,0,1,0,0,1
56522,0,0,0,1,1
56523,0,1,0,0,1
56524,0,1,0,0,1
56525,1,0,0,0,1
56526,0,1,0,0,1
56527,0,1,0,0,1
56528,0,1,0,0,1
56529,0,1,0,0,1
56530,0,1,0,0,1
56531,1,0,0,0,1
56532,0,1,0,0,1
56533,0,1,0,0,1
56534,0,1,0,0,1
56535,0,1,0,0,1
56536,0,1,0,0,1
56537,0,1,0,0,1
56538,1,0,0,0,1
56539,0,1,0,0,1
56540,0,1,0,0,1
56541,1,0,0,0,1
56542,0,1,0,0,1
56543,0,0,1,0,1
56544,0,1,0,0,1
56545,0,1,0,0,1
56546,0,1,0,0,1
56547,0,1,0,0,1
56548,0,1,0,0,1
56549,0,1,0,0,1
56550,0,1,0,0,1
56551,0,1,0,0,1
56552,0,0,1,0,1
56553,1,0,0,0,1
56554,1,0,0,0,1
56555,0,1,0,0,1
56556,0,1,0,0,1
56557,0,1,0,0,1
56558,0,1,0,0,1
56559,0,1,0,0,1
56560,0,1,0,0,1
56561,1,0,0,0,1
56562,0,1,0,0,1
56563,0,1,0,0,1
56564,0,1,0,0,1
56565,0,1,0,0,1
56566,0,1,0,0,1
56567,0,1,0,0,1
56568,0,1,0,0,1
56569,0,1,0,0,1
56570,0,1,0,0,1
56571,0,1,0,0,1
56572,1,0,0,0,1
56573,0,1,0,0,1
56574,0,1,0,0,1
56575,0,1,0,0,1
56576,0,1,0,0,1
56577,0,1,0,0,1
56578,0,1,0,0,1
56579,0,1,0,0,1
56580,0,1,0,0,1
56581,0,1,0,0,1
56582,0,1,0,0,1
56583,0,1,0,0,1
56584,0,1,0,0,1
56585,0,1,0,0,1
56586,0,1,0,0,1
56587,0,1,0,0,1
56588,0,1,0,0,1
56589,0,1,0,0,1
56590,0,1,0,0,1
56591,1,0,0,0,1
56592,0,1,0,0,1
56593,0,1,0,0,1
56594,1,0,0,0,1
56595,0,1,0,0,1
56596,1,0,0,0,1
56597,0,1,0,0,1
56598,0,1,0,0,1
56599,0,1,0,0,1
56600,0,0,0,1,1
56601,0,1,0,0,1
56602,0,1,0,0,1
56603,0,1,0,0,1
56604,0,1,0,0,1
56605,0,1,0,0,1
56606,0,0,1,0,1
56607,0,1,0,0,1
56608,0,1,0,0,1
56609,0,1,0,0,1
56610,1,0,0,0,1
56611,1,0,0,0,1
56612,0,1,0,0,1
56613,0,1,0,0,1
56614,0,1,0,0,1
56615,1,0,0,0,1
56616,0,1,0,0,1
56617,0,1,0,0,1
56618,0,1,0,0,1
56619,0,1,0,0,1
56620,0,1,0,0,1
56621,0,1,0,0,1
56622,0,1,0,0,1
56623,0,1,0,0,1
56624,0,1,0,0,1
56625,1,0,0,0,1
56626,0,1,0,0,1
56627,0,1,0,0,1
56628,0,1,0,0,1
56629,0,1,0,0,1
56630,0,1,0,0,1
56631,0,1,0,0,1
56632,0,1,0,0,1
56633,0,1,0,0,1
56634,0,1,0,0,1
56635,0,1,0,0,1
56636,0,1,0,0,1
56637,1,0,0,0,1
56638,0,1,0,0,1
56639,0,1,0,0,1
56640,0,1,0,0,1
56641,1,0,0,0,1
56642,0,1,0,0,1
56643,0,1,0,0,1
56644,0,1,0,0,1
56645,0,1,0,0,1
56646,1,0,0,0,1
56647,0,1,0,0,1
56648,0,1,0,0,1
56649,1,0,0,0,1
56650,0,1,0,0,1
56651,0,1,0,0,1
56652,0,1,0,0,1
56653,0,1,0,0,1
56654,1,0,0,0,1
56655,0,1,0,0,1
56656,1,0,0,0,1
56657,1,0,0,0,1
56658,1,0,0,0,1
56659,0,1,0,0,1
56660,0,1,0,0,1
56661,0,1,0,0,1
56662,0,1,0,0,1
56663,0,1,0,0,1
56664,0,1,0,0,1
56665,0,1,0,0,1
56666,0,1,0,0,1
56667,0,1,0,0,1
56668,0,0,0,1,1
56669,0,1,0,0,1
56670,0,1,0,0,1
56671,0,1,0,0,1
56672,1,0,0,0,1
56673,0,1,0,0,1
56674,0,1,0,0,1
56675,1,0,0,0,1
56676,1,0,0,0,1
56677,0,1,0,0,1
56678,0,1,0,0,1
56679,0,1,0,0,1
56680,0,1,0,0,1
56681,0,1,0,0,1
56682,0,1,0,0,1
56683,1,0,0,0,1
56684,0,1,0,0,1
56685,1,0,0,0,1
56686,0,1,0,0,1
56687,0,1,0,0,1
56688,0,1,0,0,1
56689,0,1,0,0,1
56690,0,1,0,0,1
56691,0,1,0,0,1
56692,0,1,0,0,1
56693,0,0,0,1,1
56694,0,1,0,0,1
56695,0,1,0,0,1
56696,1,0,0,0,1
56697,1,0,0,0,1
56698,0,1,0,0,1
56699,1,0,0,0,1
56700,0,1,0,0,1
56701,0,1,0,0,1
56702,0,1,0,0,1
56703,1,0,0,0,1
56704,0,1,0,0,1
56705,0,1,0,0,1
56706,0,0,1,0,1
56707,0,0,0,1,1
56708,0,1,0,0,1
56709,0,1,0,0,1
56710,0,1,0,0,1
56711,0,1,0,0,1
56712,0,1,0,0,1
56713,0,1,0,0,1
56714,0,1,0,0,1
56715,0,1,0,0,1
56716,0,1,0,0,1
56717,0,1,0,0,1
56718,0,1,0,0,1
56719,0,1,0,0,1
56720,1,0,0,0,1
56721,0,1,0,0,1
56722,0,1,0,0,1
56723,0,1,0,0,1
56724,1,0,0,0,1
56725,0,0,0,1,1
56726,1,0,0,0,1
56727,0,1,0,0,1
56728,0,1,0,0,1
56729,0,1,0,0,1
56730,0,1,0,0,1
56731,0,1,0,0,1
56732,0,1,0,0,1
56733,0,1,0,0,1
56734,1,0,0,0,1
56735,0,1,0,0,1
56736,0,1,0,0,1
56737,0,1,0,0,1
56738,0,1,0,0,1
56739,0,1,0,0,1
56740,1,0,0,0,1
56741,0,1,0,0,1
56742,0,1,0,0,1
56743,0,0,0,1,1
56744,0,1,0,0,1
56745,0,1,0,0,1
56746,0,1,0,0,1
56747,0,1,0,0,1
56748,1,0,0,0,1
56749,1,0,0,0,1
56750,1,0,0,0,1
56751,0,1,0,0,1
56752,0,0,0,1,1
56753,0,1,0,0,1
56754,1,0,0,0,1
56755,0,1,0,0,1
56756,0,1,0,0,1
56757,0,1,0,0,1
56758,0,1,0,0,1
56759,0,1,0,0,1
56760,0,1,0,0,1
56761,0,1,0,0,1
56762,0,1,0,0,1
56763,0,1,0,0,1
56764,0,1,0,0,1
56765,0,1,0,0,1
56766,0,1,0,0,1
56767,0,1,0,0,1
56768,0,1,0,0,1
56769,0,1,0,0,1
56770,0,1,0,0,1
56771,0,1,0,0,1
56772,0,1,0,0,1
56773,0,1,0,0,1
56774,0,0,0,1,1
56775,0,1,0,0,1
56776,0,1,0,0,1
56777,0,1,0,0,1
56778,0,1,0,0,1
56779,1,0,0,0,1
56780,0,0,0,1,1
56781,0,1,0,0,1
56782,0,1,0,0,1
56783,0,1,0,0,1
56784,0,1,0,0,1
56785,0,1,0,0,1
56786,1,0,0,0,1
56787,0,1,0,0,1
56788,1,0,0,0,1
56789,0,1,0,0,1
56790,0,1,0,0,1
56791,0,1,0,0,1
56792,0,1,0,0,1
56793,1,0,0,0,1
56794,0,0,1,0,1
56795,1,0,0,0,1
56796,0,1,0,0,1
56797,0,1,0,0,1
56798,0,1,0,0,1
56799,0,1,0,0,1
56800,0,1,0,0,1
56801,0,1,0,0,1
56802,0,1,0,0,1
56803,0,1,0,0,1
56804,0,1,0,0,1
56805,1,0,0,0,1
56806,0,1,0,0,1
56807,0,1,0,0,1
56808,0,1,0,0,1
56809,0,1,0,0,1
56810,0,1,0,0,1
56811,0,1,0,0,1
56812,1,0,0,0,1
56813,0,1,0,0,1
56814,1,0,0,0,1
56815,0,1,0,0,1
56816,0,1,0,0,1
56817,0,1,0,0,1
56818,0,1,0,0,1
56819,0,1,0,0,1
56820,0,0,0,1,1
56821,0,1,0,0,1
56822,0,1,0,0,1
56823,0,0,1,0,1
56824,0,1,0,0,1
56825,0,1,0,0,1
56826,0,1,0,0,1
56827,0,1,0,0,1
56828,0,1,0,0,1
56829,0,1,0,0,1
56830,0,1,0,0,1
56831,0,1,0,0,1
56832,0,1,0,0,1
56833,1,0,0,0,1
56834,1,0,0,0,1
56835,1,0,0,0,1
56836,0,1,0,0,1
56837,0,1,0,0,1
56838,0,1,0,0,1
56839,0,1,0,0,1
56840,0,1,0,0,1
56841,1,0,0,0,1
56842,0,1,0,0,1
56843,0,1,0,0,1
56844,0,1,0,0,1
56845,0,1,0,0,1
56846,0,1,0,0,1
56847,0,1,0,0,1
56848,1,0,0,0,1
56849,1,0,0,0,1
56850,0,1,0,0,1
56851,1,0,0,0,1
56852,0,1,0,0,1
56853,0,1,0,0,1
56854,1,0,0,0,1
56855,0,0,0,1,1
56856,0,1,0,0,1
56857,0,1,0,0,1
56858,0,1,0,0,1
56859,0,1,0,0,1
56860,0,1,0,0,1
56861,0,1,0,0,1
56862,0,1,0,0,1
56863,0,0,0,1,1
56864,0,1,0,0,1
56865,0,1,0,0,1
56866,0,1,0,0,1
56867,0,0,0,1,1
56868,1,0,0,0,1
56869,0,1,0,0,1
56870,0,1,0,0,1
56871,1,0,0,0,1
56872,0,1,0,0,1
56873,0,1,0,0,1
56874,0,1,0,0,1
56875,0,1,0,0,1
56876,0,1,0,0,1
56877,0,1,0,0,1
56878,0,1,0,0,1
56879,0,1,0,0,1
56880,0,1,0,0,1
56881,0,1,0,0,1
56882,0,1,0,0,1
56883,0,0,0,1,1
56884,0,1,0,0,1
56885,0,1,0,0,1
56886,0,1,0,0,1
56887,1,0,0,0,1
56888,0,1,0,0,1
56889,0,1,0,0,1
56890,0,0,1,0,1
56891,0,1,0,0,1
56892,0,1,0,0,1
56893,1,0,0,0,1
56894,0,1,0,0,1
56895,0,1,0,0,1
56896,0,1,0,0,1
56897,0,1,0,0,1
56898,0,1,0,0,1
56899,0,1,0,0,1
56900,0,1,0,0,1
56901,0,1,0,0,1
56902,0,1,0,0,1
56903,0,0,1,0,1
56904,0,1,0,0,1
56905,0,1,0,0,1
56906,0,1,0,0,1
56907,0,1,0,0,1
56908,0,1,0,0,1
56909,0,1,0,0,1
56910,1,0,0,0,1
56911,0,1,0,0,1
56912,1,0,0,0,1
56913,0,1,0,0,1
56914,0,1,0,0,1
56915,0,1,0,0,1
56916,0,1,0,0,1
56917,1,0,0,0,1
56918,0,1,0,0,1
56919,0,1,0,0,1
56920,0,1,0,0,1
56921,1,0,0,0,1
56922,0,1,0,0,1
56923,0,1,0,0,1
56924,0,1,0,0,1
56925,1,0,0,0,1
56926,0,1,0,0,1
56927,0,1,0,0,1
56928,0,1,0,0,1
56929,0,1,0,0,1
56930,0,1,0,0,1
56931,0,1,0,0,1
56932,0,1,0,0,1
56933,0,1,0,0,1
56934,0,1,0,0,1
56935,0,1,0,0,1
56936,0,1,0,0,1
56937,0,1,0,0,1
56938,0,1,0,0,1
56939,0,1,0,0,1
56940,0,1,0,0,1
56941,0,1,0,0,1
56942,0,1,0,0,1
56943,0,1,0,0,1
56944,0,1,0,0,1
56945,0,1,0,0,1
56946,0,1,0,0,1
56947,0,1,0,0,1
56948,0,1,0,0,1
56949,0,1,0,0,1
56950,0,1,0,0,1
56951,0,1,0,0,1
56952,0,1,0,0,1
56953,0,1,0,0,1
56954,0,1,0,0,1
56955,0,1,0,0,1
56956,0,1,0,0,1
56957,0,1,0,0,1
56958,0,1,0,0,1
56959,0,1,0,0,1
56960,0,1,0,0,1
56961,1,0,0,0,1
56962,0,1,0,0,1
56963,0,1,0,0,1
56964,0,1,0,0,1
56965,1,0,0,0,1
56966,0,1,0,0,1
56967,0,1,0,0,1
56968,0,1,0,0,1
56969,0,1,0,0,1
56970,0,1,0,0,1
56971,1,0,0,0,1
56972,0,1,0,0,1
56973,0,1,0,0,1
56974,0,1,0,0,1
56975,1,0,0,0,1
56976,0,1,0,0,1
56977,0,1,0,0,1
56978,0,1,0,0,1
56979,1,0,0,0,1
56980,1,0,0,0,1
56981,0,1,0,0,1
56982,0,1,0,0,1
56983,0,1,0,0,1
56984,0,1,0,0,1
56985,0,1,0,0,1
56986,0,1,0,0,1
56987,0,1,0,0,1
56988,0,1,0,0,1
56989,1,0,0,0,1
56990,0,1,0,0,1
56991,0,1,0,0,1
56992,0,1,0,0,1
56993,0,1,0,0,1
56994,0,1,0,0,1
56995,1,0,0,0,1
56996,0,1,0,0,1
56997,0,1,0,0,1
56998,0,1,0,0,1
56999,0,1,0,0,1
57000,1,0,0,0,1
57001,1,0,0,0,1
57002,0,1,0,0,1
57003,0,1,0,0,1
57004,0,1,0,0,1
57005,1,0,0,0,1
57006,0,1,0,0,1
57007,0,1,0,0,1
57008,0,1,0,0,1
57009,0,1,0,0,1
57010,0,1,0,0,1
57011,1,0,0,0,1
57012,0,1,0,0,1
57013,0,1,0,0,1
57014,0,1,0,0,1
57015,0,1,0,0,1
57016,0,1,0,0,1
57017,0,1,0,0,1
57018,0,1,0,0,1
57019,0,1,0,0,1
57020,0,1,0,0,1
57021,0,1,0,0,1
57022,0,1,0,0,1
57023,0,1,0,0,1
57024,0,1,0,0,1
57025,0,1,0,0,1
57026,0,1,0,0,1
57027,1,0,0,0,1
57028,0,1,0,0,1
57029,0,1,0,0,1
57030,0,1,0,0,1
57031,1,0,0,0,1
57032,1,0,0,0,1
57033,0,1,0,0,1
57034,0,1,0,0,1
57035,1,0,0,0,1
57036,0,1,0,0,1
57037,0,1,0,0,1
57038,0,1,0,0,1
57039,0,1,0,0,1
57040,0,1,0,0,1
57041,0,1,0,0,1
57042,0,1,0,0,1
57043,0,1,0,0,1
57044,0,1,0,0,1
57045,0,1,0,0,1
57046,0,1,0,0,1
57047,0,1,0,0,1
57048,0,1,0,0,1
57049,0,1,0,0,1
57050,0,1,0,0,1
57051,0,1,0,0,1
57052,0,1,0,0,1
57053,1,0,0,0,1
57054,0,1,0,0,1
57055,0,1,0,0,1
57056,1,0,0,0,1
57057,0,1,0,0,1
57058,0,1,0,0,1
57059,0,1,0,0,1
57060,0,1,0,0,1
57061,1,0,0,0,1
57062,0,1,0,0,1
57063,0,1,0,0,1
57064,0,1,0,0,1
57065,0,1,0,0,1
57066,0,1,0,0,1
57067,0,1,0,0,1
57068,0,1,0,0,1
57069,1,0,0,0,1
57070,0,1,0,0,1
57071,0,1,0,0,1
57072,0,1,0,0,1
57073,0,1,0,0,1
57074,0,1,0,0,1
57075,1,0,0,0,1
57076,0,1,0,0,1
57077,1,0,0,0,1
57078,1,0,0,0,1
57079,0,1,0,0,1
57080,0,1,0,0,1
57081,0,1,0,0,1
57082,0,1,0,0,1
57083,0,1,0,0,1
57084,0,1,0,0,1
57085,0,1,0,0,1
57086,1,0,0,0,1
57087,0,1,0,0,1
57088,0,1,0,0,1
57089,0,1,0,0,1
57090,0,1,0,0,1
57091,0,1,0,0,1
57092,0,1,0,0,1
57093,1,0,0,0,1
57094,0,0,0,1,1
57095,0,1,0,0,1
57096,0,1,0,0,1
57097,0,1,0,0,1
57098,0,1,0,0,1
57099,0,1,0,0,1
57100,0,1,0,0,1
57101,0,1,0,0,1
57102,0,1,0,0,1
57103,0,1,0,0,1
57104,0,1,0,0,1
57105,0,0,1,0,1
57106,0,1,0,0,1
57107,0,1,0,0,1
57108,1,0,0,0,1
57109,0,1,0,0,1
57110,0,1,0,0,1
57111,0,1,0,0,1
57112,0,1,0,0,1
57113,1,0,0,0,1
57114,0,1,0,0,1
57115,0,1,0,0,1
57116,0,1,0,0,1
57117,0,1,0,0,1
57118,0,1,0,0,1
57119,1,0,0,0,1
57120,0,1,0,0,1
57121,0,1,0,0,1
57122,0,1,0,0,1
57123,0,1,0,0,1
57124,1,0,0,0,1
57125,0,1,0,0,1
57126,1,0,0,0,1
57127,1,0,0,0,1
57128,0,1,0,0,1
57129,0,1,0,0,1
57130,0,1,0,0,1
57131,0,1,0,0,1
57132,1,0,0,0,1
57133,0,1,0,0,1
57134,0,1,0,0,1
57135,0,1,0,0,1
57136,1,0,0,0,1
57137,0,1,0,0,1
57138,0,1,0,0,1
57139,0,1,0,0,1
57140,0,1,0,0,1
57141,0,1,0,0,1
57142,0,1,0,0,1
57143,1,0,0,0,1
57144,0,1,0,0,1
57145,0,1,0,0,1
57146,0,1,0,0,1
57147,0,1,0,0,1
57148,1,0,0,0,1
57149,0,1,0,0,1
57150,0,1,0,0,1
57151,0,0,0,1,1
57152,1,0,0,0,1
57153,0,1,0,0,1
57154,0,1,0,0,1
57155,0,1,0,0,1
57156,1,0,0,0,1
57157,0,1,0,0,1
57158,0,1,0,0,1
57159,0,1,0,0,1
57160,0,1,0,0,1
57161,0,1,0,0,1
57162,0,1,0,0,1
57163,0,1,0,0,1
57164,1,0,0,0,1
57165,0,1,0,0,1
57166,1,0,0,0,1
57167,0,1,0,0,1
57168,0,1,0,0,1
57169,0,1,0,0,1
57170,0,1,0,0,1
57171,0,1,0,0,1
57172,0,1,0,0,1
57173,0,1,0,0,1
57174,0,1,0,0,1
57175,0,1,0,0,1
57176,0,1,0,0,1
57177,0,1,0,0,1
57178,0,0,0,1,1
57179,0,1,0,0,1
57180,0,0,0,1,1
57181,0,1,0,0,1
57182,0,1,0,0,1
57183,0,1,0,0,1
57184,0,1,0,0,1
57185,0,1,0,0,1
57186,0,1,0,0,1
57187,0,1,0,0,1
57188,0,1,0,0,1
57189,0,1,0,0,1
57190,0,1,0,0,1
57191,0,1,0,0,1
57192,1,0,0,0,1
57193,0,1,0,0,1
57194,0,1,0,0,1
57195,0,1,0,0,1
57196,1,0,0,0,1
57197,0,0,0,1,1
57198,0,1,0,0,1
57199,0,1,0,0,1
57200,0,1,0,0,1
57201,0,1,0,0,1
57202,0,1,0,0,1
57203,1,0,0,0,1
57204,1,0,0,0,1
57205,0,1,0,0,1
57206,0,1,0,0,1
57207,0,1,0,0,1
57208,0,1,0,0,1
57209,0,1,0,0,1
57210,0,1,0,0,1
57211,0,1,0,0,1
57212,0,1,0,0,1
57213,1,0,0,0,1
57214,0,1,0,0,1
57215,0,1,0,0,1
57216,0,1,0,0,1
57217,0,1,0,0,1
57218,0,1,0,0,1
57219,0,1,0,0,1
57220,0,1,0,0,1
57221,0,0,0,1,1
57222,1,0,0,0,1
57223,0,0,0,1,1
57224,0,1,0,0,1
57225,1,0,0,0,1
57226,1,0,0,0,1
57227,0,1,0,0,1
57228,0,1,0,0,1
57229,0,1,0,0,1
57230,0,1,0,0,1
57231,0,1,0,0,1
57232,0,1,0,0,1
57233,0,1,0,0,1
57234,0,1,0,0,1
57235,0,1,0,0,1
57236,0,1,0,0,1
57237,0,1,0,0,1
57238,0,1,0,0,1
57239,0,1,0,0,1
57240,0,1,0,0,1
57241,0,1,0,0,1
57242,0,1,0,0,1
57243,0,1,0,0,1
57244,1,0,0,0,1
57245,0,1,0,0,1
57246,0,1,0,0,1
57247,0,1,0,0,1
57248,0,1,0,0,1
57249,0,1,0,0,1
57250,0,1,0,0,1
57251,0,1,0,0,1
57252,0,1,0,0,1
57253,1,0,0,0,1
57254,0,1,0,0,1
57255,0,1,0,0,1
57256,0,1,0,0,1
57257,0,1,0,0,1
57258,0,1,0,0,1
57259,1,0,0,0,1
57260,0,1,0,0,1
57261,0,1,0,0,1
57262,0,1,0,0,1
57263,1,0,0,0,1
57264,0,1,0,0,1
57265,0,1,0,0,1
57266,0,1,0,0,1
57267,0,1,0,0,1
57268,0,1,0,0,1
57269,0,1,0,0,1
57270,0,1,0,0,1
57271,0,0,1,0,1
57272,0,1,0,0,1
57273,1,0,0,0,1
57274,1,0,0,0,1
57275,0,1,0,0,1
57276,0,1,0,0,1
57277,1,0,0,0,1
57278,0,1,0,0,1
57279,0,1,0,0,1
57280,0,1,0,0,1
57281,0,1,0,0,1
57282,0,1,0,0,1
57283,1,0,0,0,1
57284,0,1,0,0,1
57285,0,1,0,0,1
57286,0,1,0,0,1
57287,0,1,0,0,1
57288,0,1,0,0,1
57289,0,1,0,0,1
57290,0,1,0,0,1
57291,0,1,0,0,1
57292,0,1,0,0,1
57293,0,1,0,0,1
57294,0,1,0,0,1
57295,0,1,0,0,1
57296,0,1,0,0,1
57297,0,1,0,0,1
57298,0,1,0,0,1
57299,0,1,0,0,1
57300,0,1,0,0,1
57301,0,1,0,0,1
57302,0,1,0,0,1
57303,0,1,0,0,1
57304,1,0,0,0,1
57305,1,0,0,0,1
57306,0,1,0,0,1
57307,0,0,0,1,1
57308,0,1,0,0,1
57309,0,0,0,1,1
57310,0,1,0,0,1
57311,0,0,0,1,1
57312,0,1,0,0,1
57313,0,1,0,0,1
57314,0,1,0,0,1
57315,0,1,0,0,1
57316,1,0,0,0,1
57317,0,1,0,0,1
57318,0,1,0,0,1
57319,1,0,0,0,1
57320,0,1,0,0,1
57321,0,1,0,0,1
57322,0,1,0,0,1
57323,0,1,0,0,1
57324,0,1,0,0,1
57325,0,1,0,0,1
57326,0,1,0,0,1
57327,0,1,0,0,1
57328,0,1,0,0,1
57329,0,1,0,0,1
57330,0,1,0,0,1
57331,0,1,0,0,1
57332,1,0,0,0,1
57333,0,1,0,0,1
57334,1,0,0,0,1
57335,0,1,0,0,1
57336,0,1,0,0,1
57337,1,0,0,0,1
57338,0,1,0,0,1
57339,1,0,0,0,1
57340,0,1,0,0,1
57341,0,1,0,0,1
57342,0,1,0,0,1
57343,0,1,0,0,1
57344,0,1,0,0,1
57345,0,1,0,0,1
57346,0,1,0,0,1
57347,0,1,0,0,1
57348,0,1,0,0,1
57349,0,1,0,0,1
57350,0,1,0,0,1
57351,0,0,0,1,1
57352,1,0,0,0,1
57353,0,1,0,0,1
57354,0,1,0,0,1
57355,0,1,0,0,1
57356,1,0,0,0,1
57357,0,0,1,0,1
57358,0,0,0,1,1
57359,1,0,0,0,1
57360,1,0,0,0,1
57361,0,1,0,0,1
57362,0,1,0,0,1
57363,0,1,0,0,1
57364,0,1,0,0,1
57365,0,1,0,0,1
57366,0,1,0,0,1
57367,0,1,0,0,1
57368,1,0,0,0,1
57369,0,1,0,0,1
57370,0,1,0,0,1
57371,1,0,0,0,1
57372,1,0,0,0,1
57373,0,1,0,0,1
57374,0,1,0,0,1
57375,0,1,0,0,1
57376,0,1,0,0,1
57377,0,1,0,0,1
57378,1,0,0,0,1
57379,0,1,0,0,1
57380,0,1,0,0,1
57381,0,1,0,0,1
57382,0,1,0,0,1
57383,1,0,0,0,1
57384,0,1,0,0,1
57385,0,1,0,0,1
57386,0,1,0,0,1
57387,0,1,0,0,1
57388,0,1,0,0,1
57389,1,0,0,0,1
57390,1,0,0,0,1
57391,0,1,0,0,1
57392,0,1,0,0,1
57393,0,1,0,0,1
57394,0,1,0,0,1
57395,0,1,0,0,1
57396,0,1,0,0,1
57397,1,0,0,0,1
57398,1,0,0,0,1
57399,0,1,0,0,1
57400,0,1,0,0,1
57401,0,1,0,0,1
57402,0,1,0,0,1
57403,1,0,0,0,1
57404,1,0,0,0,1
57405,0,1,0,0,1
57406,0,1,0,0,1
57407,1,0,0,0,1
57408,0,1,0,0,1
57409,0,1,0,0,1
57410,0,1,0,0,1
57411,0,1,0,0,1
57412,0,1,0,0,1
57413,0,1,0,0,1
57414,0,1,0,0,1
57415,0,1,0,0,1
57416,0,1,0,0,1
57417,0,1,0,0,1
57418,0,1,0,0,1
57419,0,1,0,0,1
57420,0,1,0,0,1
57421,0,1,0,0,1
57422,0,0,1,0,1
57423,0,1,0,0,1
57424,0,1,0,0,1
57425,0,1,0,0,1
57426,0,1,0,0,1
57427,0,1,0,0,1
57428,0,0,0,1,1
57429,0,1,0,0,1
57430,0,1,0,0,1
57431,0,1,0,0,1
57432,0,1,0,0,1
57433,0,1,0,0,1
57434,0,1,0,0,1
57435,0,1,0,0,1
57436,0,1,0,0,1
57437,0,1,0,0,1
57438,0,1,0,0,1
57439,1,0,0,0,1
57440,1,0,0,0,1
57441,0,1,0,0,1
57442,0,1,0,0,1
57443,1,0,0,0,1
57444,0,1,0,0,1
57445,1,0,0,0,1
57446,0,1,0,0,1
57447,0,1,0,0,1
57448,0,0,1,0,1
57449,0,1,0,0,1
57450,0,1,0,0,1
57451,0,1,0,0,1
57452,0,1,0,0,1
57453,0,1,0,0,1
57454,0,1,0,0,1
57455,1,0,0,0,1
57456,0,1,0,0,1
57457,0,1,0,0,1
57458,1,0,0,0,1
57459,0,1,0,0,1
57460,0,1,0,0,1
57461,0,1,0,0,1
57462,0,1,0,0,1
57463,0,1,0,0,1
57464,0,1,0,0,1
57465,0,1,0,0,1
57466,0,1,0,0,1
57467,0,1,0,0,1
57468,0,1,0,0,1
57469,0,1,0,0,1
57470,1,0,0,0,1
57471,0,1,0,0,1
57472,0,1,0,0,1
57473,1,0,0,0,1
57474,0,1,0,0,1
57475,0,1,0,0,1
57476,1,0,0,0,1
57477,0,1,0,0,1
57478,0,1,0,0,1
57479,1,0,0,0,1
57480,0,0,1,0,1
57481,0,1,0,0,1
57482,0,1,0,0,1
57483,1,0,0,0,1
57484,1,0,0,0,1
57485,0,1,0,0,1
57486,0,1,0,0,1
57487,0,1,0,0,1
57488,1,0,0,0,1
57489,0,1,0,0,1
57490,0,1,0,0,1
57491,0,1,0,0,1
57492,0,1,0,0,1
57493,0,1,0,0,1
57494,0,1,0,0,1
57495,0,1,0,0,1
57496,0,1,0,0,1
57497,0,1,0,0,1
57498,0,1,0,0,1
57499,0,1,0,0,1
57500,1,0,0,0,1
57501,0,1,0,0,1
57502,0,1,0,0,1
57503,0,1,0,0,1
57504,0,0,1,0,1
57505,0,1,0,0,1
57506,0,1,0,0,1
57507,1,0,0,0,1
57508,0,1,0,0,1
57509,0,1,0,0,1
57510,0,1,0,0,1
57511,0,1,0,0,1
57512,0,1,0,0,1
57513,0,1,0,0,1
57514,0,1,0,0,1
57515,0,1,0,0,1
57516,1,0,0,0,1
57517,0,1,0,0,1
57518,0,1,0,0,1
57519,1,0,0,0,1
57520,0,1,0,0,1
57521,0,1,0,0,1
57522,0,1,0,0,1
57523,0,1,0,0,1
57524,0,1,0,0,1
57525,0,1,0,0,1
57526,0,1,0,0,1
57527,0,1,0,0,1
57528,0,1,0,0,1
57529,0,1,0,0,1
57530,0,1,0,0,1
57531,0,1,0,0,1
57532,0,1,0,0,1
57533,0,1,0,0,1
57534,0,1,0,0,1
57535,0,1,0,0,1
57536,1,0,0,0,1
57537,0,1,0,0,1
57538,0,1,0,0,1
57539,0,1,0,0,1
57540,0,1,0,0,1
57541,0,1,0,0,1
57542,0,0,0,1,1
57543,0,1,0,0,1
57544,0,1,0,0,1
57545,0,1,0,0,1
57546,0,0,1,0,1
57547,0,1,0,0,1
57548,0,1,0,0,1
57549,0,1,0,0,1
57550,0,1,0,0,1
57551,0,1,0,0,1
57552,0,1,0,0,1
57553,0,1,0,0,1
57554,0,1,0,0,1
57555,1,0,0,0,1
57556,0,1,0,0,1
57557,0,1,0,0,1
57558,0,1,0,0,1
57559,0,1,0,0,1
57560,0,1,0,0,1
57561,1,0,0,0,1
57562,0,1,0,0,1
57563,0,1,0,0,1
57564,0,1,0,0,1
57565,0,1,0,0,1
57566,0,1,0,0,1
57567,1,0,0,0,1
57568,0,1,0,0,1
57569,0,1,0,0,1
57570,1,0,0,0,1
57571,1,0,0,0,1
57572,0,1,0,0,1
57573,0,1,0,0,1
57574,0,1,0,0,1
57575,0,1,0,0,1
57576,1,0,0,0,1
57577,0,0,0,1,1
57578,0,1,0,0,1
57579,0,1,0,0,1
57580,1,0,0,0,1
57581,0,1,0,0,1
57582,0,1,0,0,1
57583,0,1,0,0,1
57584,0,1,0,0,1
57585,0,1,0,0,1
57586,0,1,0,0,1
57587,0,1,0,0,1
57588,0,1,0,0,1
57589,0,0,0,1,1
57590,0,1,0,0,1
57591,0,1,0,0,1
57592,1,0,0,0,1
57593,0,1,0,0,1
57594,0,1,0,0,1
57595,0,1,0,0,1
57596,0,1,0,0,1
57597,1,0,0,0,1
57598,0,1,0,0,1
57599,0,1,0,0,1
57600,0,1,0,0,1
57601,0,1,0,0,1
57602,0,1,0,0,1
57603,1,0,0,0,1
57604,0,1,0,0,1
57605,0,1,0,0,1
57606,1,0,0,0,1
57607,0,1,0,0,1
57608,0,0,0,1,1
57609,0,1,0,0,1
57610,0,1,0,0,1
57611,0,1,0,0,1
57612,0,1,0,0,1
57613,0,1,0,0,1
57614,0,1,0,0,1
57615,0,1,0,0,1
57616,0,1,0,0,1
57617,0,1,0,0,1
57618,0,1,0,0,1
57619,0,1,0,0,1
57620,0,1,0,0,1
57621,0,1,0,0,1
57622,1,0,0,0,1
57623,1,0,0,0,1
57624,0,1,0,0,1
57625,0,1,0,0,1
57626,0,0,1,0,1
57627,1,0,0,0,1
57628,0,1,0,0,1
57629,1,0,0,0,1
57630,0,1,0,0,1
57631,0,0,0,1,1
57632,0,1,0,0,1
57633,0,1,0,0,1
57634,0,1,0,0,1
57635,0,1,0,0,1
57636,0,1,0,0,1
57637,0,1,0,0,1
57638,0,1,0,0,1
57639,0,1,0,0,1
57640,1,0,0,0,1
57641,1,0,0,0,1
57642,1,0,0,0,1
57643,0,1,0,0,1
57644,1,0,0,0,1
57645,0,1,0,0,1
57646,0,1,0,0,1
57647,0,1,0,0,1
57648,0,1,0,0,1
57649,0,1,0,0,1
57650,0,1,0,0,1
57651,1,0,0,0,1
57652,0,1,0,0,1
57653,0,1,0,0,1
57654,0,1,0,0,1
57655,0,1,0,0,1
57656,0,1,0,0,1
57657,1,0,0,0,1
57658,0,1,0,0,1
57659,0,1,0,0,1
57660,0,1,0,0,1
57661,0,1,0,0,1
57662,0,1,0,0,1
57663,0,1,0,0,1
57664,0,1,0,0,1
57665,0,1,0,0,1
57666,0,1,0,0,1
57667,0,0,1,0,1
57668,1,0,0,0,1
57669,0,1,0,0,1
57670,0,0,1,0,1
57671,0,1,0,0,1
57672,0,0,1,0,1
57673,0,1,0,0,1
57674,0,1,0,0,1
57675,0,1,0,0,1
57676,0,1,0,0,1
57677,0,1,0,0,1
57678,0,1,0,0,1
57679,0,0,1,0,1
57680,0,1,0,0,1
57681,0,1,0,0,1
57682,0,1,0,0,1
57683,1,0,0,0,1
57684,0,1,0,0,1
57685,0,1,0,0,1
57686,0,1,0,0,1
57687,0,1,0,0,1
57688,0,1,0,0,1
57689,0,1,0,0,1
57690,0,1,0,0,1
57691,0,1,0,0,1
57692,0,1,0,0,1
57693,0,1,0,0,1
57694,0,0,0,1,1
57695,0,1,0,0,1
57696,0,1,0,0,1
57697,0,0,1,0,1
57698,0,1,0,0,1
57699,0,1,0,0,1
57700,1,0,0,0,1
57701,0,1,0,0,1
57702,0,1,0,0,1
57703,0,1,0,0,1
57704,0,1,0,0,1
57705,0,1,0,0,1
57706,0,1,0,0,1
57707,0,1,0,0,1
57708,0,1,0,0,1
57709,1,0,0,0,1
57710,0,1,0,0,1
57711,1,0,0,0,1
57712,1,0,0,0,1
57713,0,1,0,0,1
57714,0,1,0,0,1
57715,1,0,0,0,1
57716,0,1,0,0,1
57717,0,1,0,0,1
57718,0,1,0,0,1
57719,0,1,0,0,1
57720,0,1,0,0,1
57721,0,0,0,1,1
57722,1,0,0,0,1
57723,0,1,0,0,1
57724,1,0,0,0,1
57725,0,1,0,0,1
57726,0,1,0,0,1
57727,1,0,0,0,1
57728,0,1,0,0,1
57729,1,0,0,0,1
57730,1,0,0,0,1
57731,0,1,0,0,1
57732,1,0,0,0,1
57733,0,1,0,0,1
57734,0,1,0,0,1
57735,0,1,0,0,1
57736,0,1,0,0,1
57737,0,1,0,0,1
57738,0,1,0,0,1
57739,0,1,0,0,1
57740,0,1,0,0,1
57741,0,1,0,0,1
57742,0,1,0,0,1
57743,0,1,0,0,1
57744,0,1,0,0,1
57745,1,0,0,0,1
57746,0,1,0,0,1
57747,0,1,0,0,1
57748,1,0,0,0,1
57749,0,1,0,0,1
57750,0,1,0,0,1
57751,0,1,0,0,1
57752,0,1,0,0,1
57753,0,1,0,0,1
57754,0,1,0,0,1
57755,0,1,0,0,1
57756,0,1,0,0,1
57757,0,1,0,0,1
57758,0,1,0,0,1
57759,0,1,0,0,1
57760,0,1,0,0,1
57761,1,0,0,0,1
57762,1,0,0,0,1
57763,1,0,0,0,1
57764,0,1,0,0,1
57765,0,1,0,0,1
57766,0,1,0,0,1
57767,0,1,0,0,1
57768,0,1,0,0,1
57769,0,1,0,0,1
57770,0,1,0,0,1
57771,0,0,1,0,1
57772,0,1,0,0,1
57773,1,0,0,0,1
57774,0,1,0,0,1
57775,0,1,0,0,1
57776,0,1,0,0,1
57777,1,0,0,0,1
57778,1,0,0,0,1
57779,0,1,0,0,1
57780,0,1,0,0,1
57781,1,0,0,0,1
57782,1,0,0,0,1
57783,0,1,0,0,1
57784,1,0,0,0,1
57785,0,1,0,0,1
57786,0,1,0,0,1
57787,0,1,0,0,1
57788,0,1,0,0,1
57789,0,1,0,0,1
57790,0,1,0,0,1
57791,0,1,0,0,1
57792,0,1,0,0,1
57793,0,1,0,0,1
57794,0,1,0,0,1
57795,0,1,0,0,1
57796,0,1,0,0,1
57797,0,1,0,0,1
57798,0,1,0,0,1
57799,1,0,0,0,1
57800,0,1,0,0,1
57801,0,0,0,1,1
57802,0,0,1,0,1
57803,0,0,1,0,1
57804,0,1,0,0,1
57805,0,1,0,0,1
57806,0,1,0,0,1
57807,0,1,0,0,1
57808,0,1,0,0,1
57809,0,1,0,0,1
57810,1,0,0,0,1
57811,1,0,0,0,1
57812,0,1,0,0,1
57813,0,0,0,1,1
57814,1,0,0,0,1
57815,0,1,0,0,1
57816,0,0,0,1,1
57817,0,1,0,0,1
57818,0,1,0,0,1
57819,0,1,0,0,1
57820,0,1,0,0,1
57821,0,1,0,0,1
57822,0,1,0,0,1
57823,0,1,0,0,1
57824,0,1,0,0,1
57825,0,1,0,0,1
57826,0,1,0,0,1
57827,0,1,0,0,1
57828,0,1,0,0,1
57829,1,0,0,0,1
57830,0,1,0,0,1
57831,0,1,0,0,1
57832,0,1,0,0,1
57833,1,0,0,0,1
57834,0,1,0,0,1
57835,0,1,0,0,1
57836,0,1,0,0,1
57837,0,1,0,0,1
57838,1,0,0,0,1
57839,0,1,0,0,1
57840,0,1,0,0,1
57841,1,0,0,0,1
57842,0,1,0,0,1
57843,1,0,0,0,1
57844,0,1,0,0,1
57845,0,1,0,0,1
57846,0,1,0,0,1
57847,0,1,0,0,1
57848,1,0,0,0,1
57849,0,1,0,0,1
57850,1,0,0,0,1
57851,1,0,0,0,1
57852,1,0,0,0,1
57853,0,1,0,0,1
57854,0,1,0,0,1
57855,1,0,0,0,1
57856,0,1,0,0,1
57857,0,1,0,0,1
57858,0,1,0,0,1
57859,0,1,0,0,1
57860,0,1,0,0,1
57861,0,1,0,0,1
57862,0,1,0,0,1
57863,0,1,0,0,1
57864,0,1,0,0,1
57865,0,1,0,0,1
57866,0,1,0,0,1
57867,0,1,0,0,1
57868,0,1,0,0,1
57869,1,0,0,0,1
57870,0,1,0,0,1
57871,0,1,0,0,1
57872,1,0,0,0,1
57873,0,1,0,0,1
57874,0,1,0,0,1
57875,0,1,0,0,1
57876,0,1,0,0,1
57877,0,1,0,0,1
57878,1,0,0,0,1
57879,0,0,0,1,1
57880,0,1,0,0,1
57881,0,1,0,0,1
57882,1,0,0,0,1
57883,0,1,0,0,1
57884,0,1,0,0,1
57885,0,1,0,0,1
57886,0,1,0,0,1
57887,0,1,0,0,1
57888,1,0,0,0,1
57889,0,1,0,0,1
57890,0,1,0,0,1
57891,0,1,0,0,1
57892,0,1,0,0,1
57893,0,1,0,0,1
57894,0,1,0,0,1
57895,0,1,0,0,1
57896,0,1,0,0,1
57897,0,1,0,0,1
57898,1,0,0,0,1
57899,0,1,0,0,1
57900,0,1,0,0,1
57901,0,1,0,0,1
57902,0,1,0,0,1
57903,0,1,0,0,1
57904,1,0,0,0,1
57905,0,1,0,0,1
57906,0,1,0,0,1
57907,0,1,0,0,1
57908,0,1,0,0,1
57909,1,0,0,0,1
57910,0,1,0,0,1
57911,0,1,0,0,1
57912,0,0,1,0,1
57913,0,1,0,0,1
57914,0,1,0,0,1
57915,0,1,0,0,1
57916,0,1,0,0,1
57917,0,1,0,0,1
57918,1,0,0,0,1
57919,0,1,0,0,1
57920,0,1,0,0,1
57921,0,1,0,0,1
57922,1,0,0,0,1
57923,0,1,0,0,1
57924,0,1,0,0,1
57925,0,1,0,0,1
57926,0,1,0,0,1
57927,0,1,0,0,1
57928,0,1,0,0,1
57929,0,1,0,0,1
57930,1,0,0,0,1
57931,0,1,0,0,1
57932,0,1,0,0,1
57933,0,1,0,0,1
57934,0,1,0,0,1
57935,0,1,0,0,1
57936,1,0,0,0,1
57937,1,0,0,0,1
57938,0,1,0,0,1
57939,1,0,0,0,1
57940,0,1,0,0,1
57941,0,1,0,0,1
57942,0,1,0,0,1
57943,0,1,0,0,1
57944,0,1,0,0,1
57945,0,1,0,0,1
57946,0,0,1,0,1
57947,0,1,0,0,1
57948,0,1,0,0,1
57949,0,1,0,0,1
57950,0,0,1,0,1
57951,0,1,0,0,1
57952,0,1,0,0,1
57953,0,1,0,0,1
57954,0,1,0,0,1
57955,1,0,0,0,1
57956,0,1,0,0,1
57957,0,1,0,0,1
57958,0,1,0,0,1
57959,0,1,0,0,1
57960,0,0,0,1,1
57961,1,0,0,0,1
57962,0,1,0,0,1
57963,0,1,0,0,1
57964,0,1,0,0,1
57965,0,1,0,0,1
57966,0,1,0,0,1
57967,0,1,0,0,1
57968,1,0,0,0,1
57969,0,1,0,0,1
57970,0,1,0,0,1
57971,0,1,0,0,1
57972,0,1,0,0,1
57973,0,1,0,0,1
57974,0,1,0,0,1
57975,0,1,0,0,1
57976,0,1,0,0,1
57977,0,1,0,0,1
57978,0,1,0,0,1
57979,0,1,0,0,1
57980,0,1,0,0,1
57981,0,1,0,0,1
57982,0,1,0,0,1
57983,0,1,0,0,1
57984,0,1,0,0,1
57985,0,1,0,0,1
57986,0,1,0,0,1
57987,0,1,0,0,1
57988,1,0,0,0,1
57989,0,1,0,0,1
57990,0,1,0,0,1
57991,0,0,1,0,1
57992,0,1,0,0,1
57993,0,1,0,0,1
57994,0,1,0,0,1
57995,0,1,0,0,1
57996,0,1,0,0,1
57997,0,1,0,0,1
57998,0,1,0,0,1
57999,0,1,0,0,1
58000,0,0,1,0,1
58001,0,1,0,0,1
58002,0,1,0,0,1
58003,0,1,0,0,1
58004,0,1,0,0,1
58005,0,1,0,0,1
58006,0,1,0,0,1
58007,1,0,0,0,1
58008,0,1,0,0,1
58009,0,1,0,0,1
58010,0,1,0,0,1
58011,0,1,0,0,1
58012,0,1,0,0,1
58013,0,1,0,0,1
58014,0,1,0,0,1
58015,0,1,0,0,1
58016,0,1,0,0,1
58017,0,1,0,0,1
58018,0,1,0,0,1
58019,0,0,0,1,1
58020,0,1,0,0,1
58021,1,0,0,0,1
58022,1,0,0,0,1
58023,0,1,0,0,1
58024,1,0,0,0,1
58025,0,1,0,0,1
58026,0,1,0,0,1
58027,0,1,0,0,1
58028,0,1,0,0,1
58029,0,1,0,0,1
58030,1,0,0,0,1
58031,0,1,0,0,1
58032,0,1,0,0,1
58033,0,1,0,0,1
58034,0,0,1,0,1
58035,1,0,0,0,1
58036,0,1,0,0,1
58037,1,0,0,0,1
58038,0,1,0,0,1
58039,0,1,0,0,1
58040,0,1,0,0,1
58041,0,1,0,0,1
58042,0,1,0,0,1
58043,0,1,0,0,1
58044,1,0,0,0,1
58045,0,1,0,0,1
58046,0,1,0,0,1
58047,0,1,0,0,1
58048,0,0,0,1,1
58049,0,0,1,0,1
58050,0,1,0,0,1
58051,0,1,0,0,1
58052,0,1,0,0,1
58053,0,1,0,0,1
58054,1,0,0,0,1
58055,0,1,0,0,1
58056,0,1,0,0,1
58057,0,0,1,0,1
58058,0,1,0,0,1
58059,0,1,0,0,1
58060,1,0,0,0,1
58061,1,0,0,0,1
58062,0,1,0,0,1
58063,0,1,0,0,1
58064,0,1,0,0,1
58065,0,1,0,0,1
58066,1,0,0,0,1
58067,0,1,0,0,1
58068,0,0,1,0,1
58069,0,1,0,0,1
58070,0,1,0,0,1
58071,1,0,0,0,1
58072,0,1,0,0,1
58073,0,1,0,0,1
58074,0,1,0,0,1
58075,1,0,0,0,1
58076,0,0,0,1,1
58077,0,1,0,0,1
58078,0,1,0,0,1
58079,0,1,0,0,1
58080,0,0,1,0,1
58081,0,1,0,0,1
58082,0,1,0,0,1
58083,0,1,0,0,1
58084,1,0,0,0,1
58085,0,1,0,0,1
58086,0,1,0,0,1
58087,0,1,0,0,1
58088,0,1,0,0,1
58089,0,1,0,0,1
58090,0,1,0,0,1
58091,0,1,0,0,1
58092,0,1,0,0,1
58093,0,1,0,0,1
58094,0,1,0,0,1
58095,1,0,0,0,1
58096,0,1,0,0,1
58097,0,1,0,0,1
58098,0,1,0,0,1
58099,0,1,0,0,1
58100,0,1,0,0,1
58101,0,1,0,0,1
58102,0,1,0,0,1
58103,0,1,0,0,1
58104,0,1,0,0,1
58105,1,0,0,0,1
58106,0,1,0,0,1
58107,0,1,0,0,1
58108,1,0,0,0,1
58109,0,1,0,0,1
58110,0,1,0,0,1
58111,0,1,0,0,1
58112,1,0,0,0,1
58113,0,1,0,0,1
58114,0,1,0,0,1
58115,0,1,0,0,1
58116,0,1,0,0,1
58117,1,0,0,0,1
58118,0,1,0,0,1
58119,0,1,0,0,1
58120,0,1,0,0,1
58121,0,1,0,0,1
58122,0,1,0,0,1
58123,0,1,0,0,1
58124,0,1,0,0,1
58125,0,1,0,0,1
58126,0,1,0,0,1
58127,0,1,0,0,1
58128,0,1,0,0,1
58129,1,0,0,0,1
58130,0,1,0,0,1
58131,0,1,0,0,1
58132,0,0,1,0,1
58133,0,1,0,0,1
58134,0,1,0,0,1
58135,1,0,0,0,1
58136,0,1,0,0,1
58137,1,0,0,0,1
58138,0,1,0,0,1
58139,0,1,0,0,1
58140,0,1,0,0,1
58141,1,0,0,0,1
58142,0,1,0,0,1
58143,0,1,0,0,1
58144,0,1,0,0,1
58145,0,1,0,0,1
58146,0,1,0,0,1
58147,0,1,0,0,1
58148,1,0,0,0,1
58149,0,1,0,0,1
58150,0,1,0,0,1
58151,0,1,0,0,1
58152,0,1,0,0,1
58153,0,1,0,0,1
58154,0,1,0,0,1
58155,0,1,0,0,1
58156,0,1,0,0,1
58157,1,0,0,0,1
58158,1,0,0,0,1
58159,0,1,0,0,1
58160,0,1,0,0,1
58161,1,0,0,0,1
58162,0,1,0,0,1
58163,0,0,1,0,1
58164,1,0,0,0,1
58165,0,1,0,0,1
58166,0,1,0,0,1
58167,0,1,0,0,1
58168,0,1,0,0,1
58169,0,1,0,0,1
58170,0,1,0,0,1
58171,0,1,0,0,1
58172,0,1,0,0,1
58173,0,1,0,0,1
58174,0,0,0,1,1
58175,0,0,1,0,1
58176,0,1,0,0,1
58177,0,0,0,1,1
58178,0,1,0,0,1
58179,1,0,0,0,1
58180,1,0,0,0,1
58181,0,1,0,0,1
58182,0,0,1,0,1
58183,0,1,0,0,1
58184,0,1,0,0,1
58185,1,0,0,0,1
58186,0,1,0,0,1
58187,0,1,0,0,1
58188,0,1,0,0,1
58189,0,1,0,0,1
58190,0,1,0,0,1
58191,0,1,0,0,1
58192,0,0,0,1,1
58193,0,1,0,0,1
58194,1,0,0,0,1
58195,0,1,0,0,1
58196,0,1,0,0,1
58197,0,1,0,0,1
58198,0,1,0,0,1
58199,0,1,0,0,1
58200,0,1,0,0,1
58201,0,1,0,0,1
58202,0,1,0,0,1
58203,0,1,0,0,1
58204,0,1,0,0,1
58205,0,1,0,0,1
58206,0,1,0,0,1
58207,0,1,0,0,1
58208,0,1,0,0,1
58209,0,1,0,0,1
58210,0,1,0,0,1
58211,0,1,0,0,1
58212,0,1,0,0,1
58213,0,1,0,0,1
58214,0,1,0,0,1
58215,0,1,0,0,1
58216,0,1,0,0,1
58217,0,0,0,1,1
58218,0,1,0,0,1
58219,0,1,0,0,1
58220,0,1,0,0,1
58221,0,1,0,0,1
58222,0,1,0,0,1
58223,0,1,0,0,1
58224,0,1,0,0,1
58225,0,1,0,0,1
58226,0,1,0,0,1
58227,0,1,0,0,1
58228,1,0,0,0,1
58229,0,1,0,0,1
58230,0,1,0,0,1
58231,0,1,0,0,1
58232,0,1,0,0,1
58233,0,1,0,0,1
58234,0,1,0,0,1
58235,0,1,0,0,1
58236,0,1,0,0,1
58237,0,1,0,0,1
58238,1,0,0,0,1
58239,1,0,0,0,1
58240,0,0,0,1,1
58241,1,0,0,0,1
58242,0,1,0,0,1
58243,0,1,0,0,1
58244,0,1,0,0,1
58245,0,1,0,0,1
58246,0,1,0,0,1
58247,0,1,0,0,1
58248,0,1,0,0,1
58249,0,1,0,0,1
58250,0,1,0,0,1
58251,0,1,0,0,1
58252,0,0,0,1,1
58253,0,1,0,0,1
58254,0,1,0,0,1
58255,0,1,0,0,1
58256,0,1,0,0,1
58257,1,0,0,0,1
58258,0,1,0,0,1
58259,0,1,0,0,1
58260,0,1,0,0,1
58261,0,1,0,0,1
58262,0,0,1,0,1
58263,1,0,0,0,1
58264,0,1,0,0,1
58265,1,0,0,0,1
58266,0,1,0,0,1
58267,0,1,0,0,1
58268,0,1,0,0,1
58269,0,1,0,0,1
58270,0,1,0,0,1
58271,0,1,0,0,1
58272,0,1,0,0,1
58273,1,0,0,0,1
58274,0,1,0,0,1
58275,0,1,0,0,1
58276,0,1,0,0,1
58277,0,1,0,0,1
58278,0,1,0,0,1
58279,0,1,0,0,1
58280,0,1,0,0,1
58281,0,1,0,0,1
58282,1,0,0,0,1
58283,0,1,0,0,1
58284,0,0,0,1,1
58285,0,1,0,0,1
58286,0,0,0,1,1
58287,0,1,0,0,1
58288,0,1,0,0,1
58289,0,1,0,0,1
58290,0,1,0,0,1
58291,0,1,0,0,1
58292,0,1,0,0,1
58293,0,0,0,1,1
58294,0,1,0,0,1
58295,1,0,0,0,1
58296,0,1,0,0,1
58297,0,1,0,0,1
58298,0,1,0,0,1
58299,0,1,0,0,1
58300,0,0,1,0,1
58301,0,1,0,0,1
58302,0,1,0,0,1
58303,1,0,0,0,1
58304,0,1,0,0,1
58305,0,1,0,0,1
58306,0,1,0,0,1
58307,1,0,0,0,1
58308,0,1,0,0,1
58309,0,1,0,0,1
58310,0,1,0,0,1
58311,1,0,0,0,1
58312,1,0,0,0,1
58313,0,1,0,0,1
58314,0,1,0,0,1
58315,0,1,0,0,1
58316,0,1,0,0,1
58317,0,1,0,0,1
58318,0,1,0,0,1
58319,1,0,0,0,1
58320,0,1,0,0,1
58321,1,0,0,0,1
58322,1,0,0,0,1
58323,0,1,0,0,1
58324,0,1,0,0,1
58325,0,1,0,0,1
58326,0,1,0,0,1
58327,1,0,0,0,1
58328,0,1,0,0,1
58329,0,1,0,0,1
58330,0,1,0,0,1
58331,0,1,0,0,1
58332,0,1,0,0,1
58333,0,1,0,0,1
58334,1,0,0,0,1
58335,0,1,0,0,1
58336,0,1,0,0,1
58337,0,1,0,0,1
58338,0,0,1,0,1
58339,0,1,0,0,1
58340,0,1,0,0,1
58341,0,1,0,0,1
58342,0,1,0,0,1
58343,0,1,0,0,1
58344,0,1,0,0,1
58345,0,1,0,0,1
58346,0,1,0,0,1
58347,0,1,0,0,1
58348,0,1,0,0,1
58349,1,0,0,0,1
58350,0,1,0,0,1
58351,0,1,0,0,1
58352,0,1,0,0,1
58353,0,0,0,1,1
58354,0,1,0,0,1
58355,0,1,0,0,1
58356,0,1,0,0,1
58357,0,1,0,0,1
58358,0,1,0,0,1
58359,0,1,0,0,1
58360,0,1,0,0,1
58361,0,1,0,0,1
58362,0,1,0,0,1
58363,0,1,0,0,1
58364,0,1,0,0,1
58365,0,0,0,1,1
58366,0,1,0,0,1
58367,0,1,0,0,1
58368,0,1,0,0,1
58369,0,1,0,0,1
58370,1,0,0,0,1
58371,0,1,0,0,1
58372,0,1,0,0,1
58373,0,1,0,0,1
58374,0,1,0,0,1
58375,0,1,0,0,1
58376,0,1,0,0,1
58377,0,1,0,0,1
58378,0,1,0,0,1
58379,0,1,0,0,1
58380,0,1,0,0,1
58381,0,1,0,0,1
58382,0,1,0,0,1
58383,1,0,0,0,1
58384,0,1,0,0,1
58385,0,1,0,0,1
58386,0,0,0,1,1
58387,0,1,0,0,1
58388,0,1,0,0,1
58389,0,1,0,0,1
58390,0,0,1,0,1
58391,0,1,0,0,1
58392,0,1,0,0,1
58393,1,0,0,0,1
58394,0,1,0,0,1
58395,0,1,0,0,1
58396,0,0,0,1,1
58397,0,1,0,0,1
58398,0,1,0,0,1
58399,1,0,0,0,1
58400,0,1,0,0,1
58401,0,0,0,1,1
58402,0,1,0,0,1
58403,0,1,0,0,1
58404,0,1,0,0,1
58405,0,1,0,0,1
58406,0,0,1,0,1
58407,0,1,0,0,1
58408,0,1,0,0,1
58409,0,1,0,0,1
58410,0,1,0,0,1
58411,1,0,0,0,1
58412,0,1,0,0,1
58413,0,1,0,0,1
58414,0,1,0,0,1
58415,0,1,0,0,1
58416,0,1,0,0,1
58417,0,1,0,0,1
58418,0,1,0,0,1
58419,0,1,0,0,1
58420,0,0,0,1,1
58421,0,1,0,0,1
58422,0,1,0,0,1
58423,0,0,0,1,1
58424,0,1,0,0,1
58425,0,1,0,0,1
58426,0,1,0,0,1
58427,0,1,0,0,1
58428,0,1,0,0,1
58429,0,1,0,0,1
58430,0,1,0,0,1
58431,0,1,0,0,1
58432,0,1,0,0,1
58433,1,0,0,0,1
58434,1,0,0,0,1
58435,1,0,0,0,1
58436,0,1,0,0,1
58437,0,1,0,0,1
58438,0,1,0,0,1
58439,0,1,0,0,1
58440,0,1,0,0,1
58441,1,0,0,0,1
58442,0,1,0,0,1
58443,1,0,0,0,1
58444,0,1,0,0,1
58445,0,1,0,0,1
58446,0,1,0,0,1
58447,1,0,0,0,1
58448,0,1,0,0,1
58449,0,1,0,0,1
58450,1,0,0,0,1
58451,0,0,0,1,1
58452,0,1,0,0,1
58453,0,1,0,0,1
58454,0,1,0,0,1
58455,0,1,0,0,1
58456,0,1,0,0,1
58457,0,1,0,0,1
58458,0,1,0,0,1
58459,0,1,0,0,1
58460,0,1,0,0,1
58461,1,0,0,0,1
58462,0,1,0,0,1
58463,0,1,0,0,1
58464,0,1,0,0,1
58465,0,0,1,0,1
58466,0,1,0,0,1
58467,0,1,0,0,1
58468,0,1,0,0,1
58469,0,1,0,0,1
58470,0,0,0,1,1
58471,0,1,0,0,1
58472,1,0,0,0,1
58473,0,1,0,0,1
58474,1,0,0,0,1
58475,0,1,0,0,1
58476,0,1,0,0,1
58477,0,1,0,0,1
58478,0,1,0,0,1
58479,0,1,0,0,1
58480,0,1,0,0,1
58481,0,1,0,0,1
58482,0,1,0,0,1
58483,1,0,0,0,1
58484,0,1,0,0,1
58485,0,1,0,0,1
58486,0,1,0,0,1
58487,1,0,0,0,1
58488,0,1,0,0,1
58489,0,1,0,0,1
58490,0,1,0,0,1
58491,0,1,0,0,1
58492,0,0,1,0,1
58493,0,1,0,0,1
58494,0,1,0,0,1
58495,0,1,0,0,1
58496,0,1,0,0,1
58497,1,0,0,0,1
58498,0,1,0,0,1
58499,1,0,0,0,1
58500,1,0,0,0,1
58501,1,0,0,0,1
58502,0,1,0,0,1
58503,0,1,0,0,1
58504,0,1,0,0,1
58505,0,1,0,0,1
58506,0,1,0,0,1
58507,0,1,0,0,1
58508,0,1,0,0,1
58509,1,0,0,0,1
58510,1,0,0,0,1
58511,0,1,0,0,1
58512,1,0,0,0,1
58513,1,0,0,0,1
58514,0,1,0,0,1
58515,0,0,0,1,1
58516,1,0,0,0,1
58517,1,0,0,0,1
58518,1,0,0,0,1
58519,1,0,0,0,1
58520,0,1,0,0,1
58521,0,1,0,0,1
58522,0,1,0,0,1
58523,0,1,0,0,1
58524,0,1,0,0,1
58525,0,1,0,0,1
58526,1,0,0,0,1
58527,0,1,0,0,1
58528,1,0,0,0,1
58529,0,1,0,0,1
58530,0,1,0,0,1
58531,0,1,0,0,1
58532,0,1,0,0,1
58533,0,1,0,0,1
58534,0,1,0,0,1
58535,0,1,0,0,1
58536,0,1,0,0,1
58537,0,1,0,0,1
58538,0,1,0,0,1
58539,1,0,0,0,1
58540,0,1,0,0,1
58541,0,1,0,0,1
58542,0,1,0,0,1
58543,0,1,0,0,1
58544,0,1,0,0,1
58545,0,1,0,0,1
58546,0,1,0,0,1
58547,0,1,0,0,1
58548,0,1,0,0,1
58549,1,0,0,0,1
58550,0,1,0,0,1
58551,0,1,0,0,1
58552,0,1,0,0,1
58553,0,1,0,0,1
58554,0,1,0,0,1
58555,0,1,0,0,1
58556,1,0,0,0,1
58557,0,1,0,0,1
58558,0,1,0,0,1
58559,0,1,0,0,1
58560,0,1,0,0,1
58561,0,1,0,0,1
58562,0,0,1,0,1
58563,0,1,0,0,1
58564,0,1,0,0,1
58565,0,1,0,0,1
58566,1,0,0,0,1
58567,0,1,0,0,1
58568,0,1,0,0,1
58569,0,1,0,0,1
58570,0,1,0,0,1
58571,0,1,0,0,1
58572,0,1,0,0,1
58573,0,1,0,0,1
58574,0,1,0,0,1
58575,0,1,0,0,1
58576,0,1,0,0,1
58577,0,1,0,0,1
58578,0,1,0,0,1
58579,0,0,1,0,1
58580,0,1,0,0,1
58581,0,1,0,0,1
58582,0,1,0,0,1
58583,0,1,0,0,1
58584,0,1,0,0,1
58585,0,1,0,0,1
58586,1,0,0,0,1
58587,0,1,0,0,1
58588,0,1,0,0,1
58589,1,0,0,0,1
58590,0,1,0,0,1
58591,0,1,0,0,1
58592,0,1,0,0,1
58593,1,0,0,0,1
58594,0,1,0,0,1
58595,0,1,0,0,1
58596,1,0,0,0,1
58597,0,1,0,0,1
58598,0,1,0,0,1
58599,0,1,0,0,1
58600,0,1,0,0,1
58601,0,1,0,0,1
58602,0,1,0,0,1
58603,0,1,0,0,1
58604,0,1,0,0,1
58605,0,1,0,0,1
58606,0,0,1,0,1
58607,0,1,0,0,1
58608,1,0,0,0,1
58609,0,1,0,0,1
58610,1,0,0,0,1
58611,1,0,0,0,1
58612,0,1,0,0,1
58613,0,1,0,0,1
58614,0,1,0,0,1
58615,0,1,0,0,1
58616,0,1,0,0,1
58617,0,1,0,0,1
58618,0,1,0,0,1
58619,1,0,0,0,1
58620,0,1,0,0,1
58621,0,1,0,0,1
58622,0,1,0,0,1
58623,0,1,0,0,1
58624,0,0,1,0,1
58625,0,1,0,0,1
58626,0,1,0,0,1
58627,1,0,0,0,1
58628,0,1,0,0,1
58629,0,1,0,0,1
58630,0,1,0,0,1
58631,1,0,0,0,1
58632,0,1,0,0,1
58633,0,1,0,0,1
58634,0,1,0,0,1
58635,0,1,0,0,1
58636,1,0,0,0,1
58637,0,1,0,0,1
58638,0,1,0,0,1
58639,0,1,0,0,1
58640,1,0,0,0,1
58641,0,1,0,0,1
58642,0,1,0,0,1
58643,0,1,0,0,1
58644,0,1,0,0,1
58645,1,0,0,0,1
58646,1,0,0,0,1
58647,0,1,0,0,1
58648,0,1,0,0,1
58649,0,1,0,0,1
58650,0,1,0,0,1
58651,0,1,0,0,1
58652,0,1,0,0,1
58653,0,1,0,0,1
58654,0,1,0,0,1
58655,0,1,0,0,1
58656,0,1,0,0,1
58657,0,1,0,0,1
58658,0,1,0,0,1
58659,1,0,0,0,1
58660,0,1,0,0,1
58661,0,1,0,0,1
58662,0,1,0,0,1
58663,0,0,0,1,1
58664,1,0,0,0,1
58665,0,1,0,0,1
58666,0,1,0,0,1
58667,0,1,0,0,1
58668,1,0,0,0,1
58669,0,1,0,0,1
58670,1,0,0,0,1
58671,0,1,0,0,1
58672,1,0,0,0,1
58673,0,1,0,0,1
58674,0,1,0,0,1
58675,0,1,0,0,1
58676,0,1,0,0,1
58677,0,1,0,0,1
58678,1,0,0,0,1
58679,0,1,0,0,1
58680,0,1,0,0,1
58681,0,1,0,0,1
58682,0,1,0,0,1
58683,0,1,0,0,1
58684,0,1,0,0,1
58685,0,1,0,0,1
58686,0,1,0,0,1
58687,0,1,0,0,1
58688,0,1,0,0,1
58689,1,0,0,0,1
58690,0,0,0,1,1
58691,0,0,1,0,1
58692,0,1,0,0,1
58693,1,0,0,0,1
58694,1,0,0,0,1
58695,1,0,0,0,1
58696,0,1,0,0,1
58697,0,1,0,0,1
58698,0,1,0,0,1
58699,0,1,0,0,1
58700,0,1,0,0,1
58701,1,0,0,0,1
58702,0,1,0,0,1
58703,0,0,0,1,1
58704,0,1,0,0,1
58705,1,0,0,0,1
58706,0,1,0,0,1
58707,0,1,0,0,1
58708,0,1,0,0,1
58709,0,1,0,0,1
58710,0,1,0,0,1
58711,0,1,0,0,1
58712,0,1,0,0,1
58713,0,1,0,0,1
58714,0,1,0,0,1
58715,0,1,0,0,1
58716,0,1,0,0,1
58717,0,1,0,0,1
58718,0,1,0,0,1
58719,0,1,0,0,1
58720,1,0,0,0,1
58721,0,1,0,0,1
58722,1,0,0,0,1
58723,0,1,0,0,1
58724,0,1,0,0,1
58725,0,1,0,0,1
58726,0,1,0,0,1
58727,0,1,0,0,1
58728,0,1,0,0,1
58729,1,0,0,0,1
58730,0,1,0,0,1
58731,0,1,0,0,1
58732,0,1,0,0,1
58733,0,1,0,0,1
58734,0,1,0,0,1
58735,0,1,0,0,1
58736,0,1,0,0,1
58737,0,1,0,0,1
58738,0,1,0,0,1
58739,0,1,0,0,1
58740,1,0,0,0,1
58741,1,0,0,0,1
58742,0,1,0,0,1
58743,0,1,0,0,1
58744,0,1,0,0,1
58745,0,1,0,0,1
58746,0,1,0,0,1
58747,0,1,0,0,1
58748,0,1,0,0,1
58749,1,0,0,0,1
58750,0,1,0,0,1
58751,0,1,0,0,1
58752,0,1,0,0,1
58753,0,1,0,0,1
58754,0,1,0,0,1
58755,0,1,0,0,1
58756,1,0,0,0,1
58757,0,1,0,0,1
58758,0,1,0,0,1
58759,0,1,0,0,1
58760,0,1,0,0,1
58761,0,1,0,0,1
58762,1,0,0,0,1
58763,1,0,0,0,1
58764,0,1,0,0,1
58765,0,1,0,0,1
58766,0,1,0,0,1
58767,0,1,0,0,1
58768,0,1,0,0,1
58769,0,1,0,0,1
58770,0,1,0,0,1
58771,0,1,0,0,1
58772,0,1,0,0,1
58773,0,1,0,0,1
58774,0,1,0,0,1
58775,0,1,0,0,1
58776,0,1,0,0,1
58777,0,1,0,0,1
58778,0,1,0,0,1
58779,1,0,0,0,1
58780,0,1,0,0,1
58781,1,0,0,0,1
58782,0,1,0,0,1
58783,0,1,0,0,1
58784,0,1,0,0,1
58785,0,1,0,0,1
58786,0,1,0,0,1
58787,0,1,0,0,1
58788,0,1,0,0,1
58789,0,1,0,0,1
58790,0,1,0,0,1
58791,0,1,0,0,1
58792,0,0,0,1,1
58793,1,0,0,0,1
58794,1,0,0,0,1
58795,0,1,0,0,1
58796,1,0,0,0,1
58797,1,0,0,0,1
58798,0,0,0,1,1
58799,0,1,0,0,1
58800,1,0,0,0,1
58801,0,1,0,0,1
58802,0,1,0,0,1
58803,0,1,0,0,1
58804,0,0,0,1,1
58805,0,0,0,1,1
58806,0,1,0,0,1
58807,1,0,0,0,1
58808,0,1,0,0,1
58809,0,1,0,0,1
58810,0,0,1,0,1
58811,0,1,0,0,1
58812,0,1,0,0,1
58813,0,1,0,0,1
58814,1,0,0,0,1
58815,0,1,0,0,1
58816,0,1,0,0,1
58817,0,1,0,0,1
58818,0,1,0,0,1
58819,0,1,0,0,1
58820,0,1,0,0,1
58821,0,1,0,0,1
58822,0,1,0,0,1
58823,0,1,0,0,1
58824,0,1,0,0,1
58825,0,1,0,0,1
58826,0,1,0,0,1
58827,0,1,0,0,1
58828,0,1,0,0,1
58829,0,1,0,0,1
58830,0,1,0,0,1
58831,0,0,1,0,1
58832,0,0,0,1,1
58833,1,0,0,0,1
58834,0,1,0,0,1
58835,0,1,0,0,1
58836,0,1,0,0,1
58837,0,1,0,0,1
58838,0,1,0,0,1
58839,1,0,0,0,1
58840,0,1,0,0,1
58841,0,1,0,0,1
58842,1,0,0,0,1
58843,0,1,0,0,1
58844,0,1,0,0,1
58845,1,0,0,0,1
58846,0,1,0,0,1
58847,0,1,0,0,1
58848,0,1,0,0,1
58849,0,1,0,0,1
58850,1,0,0,0,1
58851,0,1,0,0,1
58852,0,1,0,0,1
58853,0,1,0,0,1
58854,0,0,1,0,1
58855,0,1,0,0,1
58856,0,1,0,0,1
58857,0,1,0,0,1
58858,0,1,0,0,1
58859,0,1,0,0,1
58860,0,1,0,0,1
58861,0,1,0,0,1
58862,0,1,0,0,1
58863,0,1,0,0,1
58864,0,1,0,0,1
58865,0,1,0,0,1
58866,0,1,0,0,1
58867,0,1,0,0,1
58868,0,1,0,0,1
58869,0,1,0,0,1
58870,0,1,0,0,1
58871,0,1,0,0,1
58872,0,1,0,0,1
58873,0,1,0,0,1
58874,0,1,0,0,1
58875,0,1,0,0,1
58876,0,1,0,0,1
58877,0,1,0,0,1
58878,0,1,0,0,1
58879,0,1,0,0,1
58880,0,1,0,0,1
58881,0,1,0,0,1
58882,0,1,0,0,1
58883,0,1,0,0,1
58884,1,0,0,0,1
58885,0,1,0,0,1
58886,0,1,0,0,1
58887,1,0,0,0,1
58888,1,0,0,0,1
58889,0,1,0,0,1
58890,1,0,0,0,1
58891,0,1,0,0,1
58892,0,1,0,0,1
58893,0,0,0,1,1
58894,0,1,0,0,1
58895,0,1,0,0,1
58896,0,1,0,0,1
58897,1,0,0,0,1
58898,0,1,0,0,1
58899,0,0,0,1,1
58900,0,1,0,0,1
58901,0,1,0,0,1
58902,0,1,0,0,1
58903,0,1,0,0,1
58904,0,1,0,0,1
58905,0,1,0,0,1
58906,0,1,0,0,1
58907,1,0,0,0,1
58908,0,1,0,0,1
58909,0,1,0,0,1
58910,0,1,0,0,1
58911,1,0,0,0,1
58912,0,1,0,0,1
58913,0,1,0,0,1
58914,0,1,0,0,1
58915,0,1,0,0,1
58916,0,1,0,0,1
58917,0,1,0,0,1
58918,1,0,0,0,1
58919,0,1,0,0,1
58920,0,1,0,0,1
58921,0,1,0,0,1
58922,0,1,0,0,1
58923,0,1,0,0,1
58924,0,1,0,0,1
58925,0,1,0,0,1
58926,0,1,0,0,1
58927,0,1,0,0,1
58928,0,1,0,0,1
58929,0,1,0,0,1
58930,0,1,0,0,1
58931,0,1,0,0,1
58932,0,1,0,0,1
58933,0,1,0,0,1
58934,0,1,0,0,1
58935,0,1,0,0,1
58936,1,0,0,0,1
58937,0,1,0,0,1
58938,0,1,0,0,1
58939,0,1,0,0,1
58940,0,1,0,0,1
58941,0,1,0,0,1
58942,0,1,0,0,1
58943,1,0,0,0,1
58944,0,1,0,0,1
58945,0,1,0,0,1
58946,0,1,0,0,1
58947,0,1,0,0,1
58948,0,1,0,0,1
58949,0,0,0,1,1
58950,0,1,0,0,1
58951,1,0,0,0,1
58952,0,1,0,0,1
58953,0,1,0,0,1
58954,1,0,0,0,1
58955,0,1,0,0,1
58956,0,1,0,0,1
58957,0,1,0,0,1
58958,0,1,0,0,1
58959,1,0,0,0,1
58960,1,0,0,0,1
58961,0,1,0,0,1
58962,0,1,0,0,1
58963,0,0,0,1,1
58964,0,1,0,0,1
58965,0,1,0,0,1
58966,0,1,0,0,1
58967,0,1,0,0,1
58968,1,0,0,0,1
58969,1,0,0,0,1
58970,0,1,0,0,1
58971,0,1,0,0,1
58972,0,1,0,0,1
58973,0,1,0,0,1
58974,0,1,0,0,1
58975,0,1,0,0,1
58976,0,1,0,0,1
58977,0,1,0,0,1
58978,0,0,0,1,1
58979,1,0,0,0,1
58980,0,1,0,0,1
58981,1,0,0,0,1
58982,0,0,0,1,1
58983,0,1,0,0,1
58984,0,1,0,0,1
58985,0,1,0,0,1
58986,0,1,0,0,1
58987,0,1,0,0,1
58988,0,1,0,0,1
58989,0,1,0,0,1
58990,1,0,0,0,1
58991,1,0,0,0,1
58992,1,0,0,0,1
58993,0,1,0,0,1
58994,0,1,0,0,1
58995,0,1,0,0,1
58996,1,0,0,0,1
58997,0,1,0,0,1
58998,0,1,0,0,1
58999,0,1,0,0,1
59000,0,1,0,0,1
59001,1,0,0,0,1
59002,0,1,0,0,1
59003,0,1,0,0,1
59004,0,1,0,0,1
59005,0,1,0,0,1
59006,0,1,0,0,1
59007,0,1,0,0,1
59008,0,1,0,0,1
59009,0,1,0,0,1
59010,0,1,0,0,1
59011,0,1,0,0,1
59012,0,1,0,0,1
59013,1,0,0,0,1
59014,0,1,0,0,1
59015,0,0,0,1,1
59016,0,1,0,0,1
59017,1,0,0,0,1
59018,0,1,0,0,1
59019,0,1,0,0,1
59020,0,1,0,0,1
59021,0,0,1,0,1
59022,1,0,0,0,1
59023,0,1,0,0,1
59024,1,0,0,0,1
59025,0,1,0,0,1
59026,0,1,0,0,1
59027,0,1,0,0,1
59028,1,0,0,0,1
59029,0,1,0,0,1
59030,0,1,0,0,1
59031,0,1,0,0,1
59032,1,0,0,0,1
59033,0,1,0,0,1
59034,0,1,0,0,1
59035,1,0,0,0,1
59036,1,0,0,0,1
59037,0,1,0,0,1
59038,0,1,0,0,1
59039,1,0,0,0,1
59040,0,1,0,0,1
59041,1,0,0,0,1
59042,0,1,0,0,1
59043,0,1,0,0,1
59044,0,1,0,0,1
59045,0,1,0,0,1
59046,0,1,0,0,1
59047,0,1,0,0,1
59048,0,1,0,0,1
59049,0,1,0,0,1
59050,0,1,0,0,1
59051,1,0,0,0,1
59052,0,1,0,0,1
59053,1,0,0,0,1
59054,0,1,0,0,1
59055,1,0,0,0,1
59056,0,1,0,0,1
59057,1,0,0,0,1
59058,0,1,0,0,1
59059,0,1,0,0,1
59060,0,1,0,0,1
59061,0,1,0,0,1
59062,0,1,0,0,1
59063,0,1,0,0,1
59064,0,1,0,0,1
59065,0,1,0,0,1
59066,0,1,0,0,1
59067,0,1,0,0,1
59068,0,1,0,0,1
59069,0,1,0,0,1
59070,0,1,0,0,1
59071,0,1,0,0,1
59072,0,0,1,0,1
59073,0,1,0,0,1
59074,0,1,0,0,1
59075,0,1,0,0,1
59076,0,1,0,0,1
59077,0,1,0,0,1
59078,0,1,0,0,1
59079,0,1,0,0,1
59080,0,1,0,0,1
59081,0,1,0,0,1
59082,0,1,0,0,1
59083,0,1,0,0,1
59084,0,1,0,0,1
59085,1,0,0,0,1
59086,0,1,0,0,1
59087,1,0,0,0,1
59088,0,1,0,0,1
59089,0,1,0,0,1
59090,0,1,0,0,1
59091,0,1,0,0,1
59092,0,1,0,0,1
59093,1,0,0,0,1
59094,0,1,0,0,1
59095,0,1,0,0,1
59096,0,1,0,0,1
59097,0,1,0,0,1
59098,0,0,0,1,1
59099,0,1,0,0,1
59100,0,1,0,0,1
59101,0,0,0,1,1
59102,0,1,0,0,1
59103,0,0,0,1,1
59104,0,1,0,0,1
59105,0,1,0,0,1
59106,1,0,0,0,1
59107,0,1,0,0,1
59108,0,1,0,0,1
59109,1,0,0,0,1
59110,0,1,0,0,1
59111,0,1,0,0,1
59112,0,1,0,0,1
59113,0,1,0,0,1
59114,1,0,0,0,1
59115,0,1,0,0,1
59116,0,1,0,0,1
59117,0,1,0,0,1
59118,0,1,0,0,1
59119,0,1,0,0,1
59120,0,1,0,0,1
59121,0,1,0,0,1
59122,1,0,0,0,1
59123,0,1,0,0,1
59124,0,1,0,0,1
59125,0,1,0,0,1
59126,0,1,0,0,1
59127,0,1,0,0,1
59128,1,0,0,0,1
59129,0,1,0,0,1
59130,0,1,0,0,1
59131,0,1,0,0,1
59132,0,1,0,0,1
59133,0,1,0,0,1
59134,0,1,0,0,1
59135,0,1,0,0,1
59136,1,0,0,0,1
59137,1,0,0,0,1
59138,0,1,0,0,1
59139,0,0,1,0,1
59140,0,0,0,1,1
59141,0,1,0,0,1
59142,0,1,0,0,1
59143,0,1,0,0,1
59144,0,1,0,0,1
59145,0,1,0,0,1
59146,0,1,0,0,1
59147,0,1,0,0,1
59148,0,1,0,0,1
59149,0,1,0,0,1
59150,0,1,0,0,1
59151,0,1,0,0,1
59152,1,0,0,0,1
59153,0,1,0,0,1
59154,0,1,0,0,1
59155,0,1,0,0,1
59156,0,1,0,0,1
59157,0,1,0,0,1
59158,1,0,0,0,1
59159,0,1,0,0,1
59160,1,0,0,0,1
59161,0,1,0,0,1
59162,0,1,0,0,1
59163,0,1,0,0,1
59164,0,1,0,0,1
59165,0,1,0,0,1
59166,0,1,0,0,1
59167,0,1,0,0,1
59168,1,0,0,0,1
59169,0,1,0,0,1
59170,0,1,0,0,1
59171,0,1,0,0,1
59172,1,0,0,0,1
59173,0,0,0,1,1
59174,0,1,0,0,1
59175,1,0,0,0,1
59176,1,0,0,0,1
59177,0,1,0,0,1
59178,0,1,0,0,1
59179,0,1,0,0,1
59180,0,1,0,0,1
59181,0,1,0,0,1
59182,0,1,0,0,1
59183,0,0,1,0,1
59184,0,1,0,0,1
59185,0,1,0,0,1
59186,1,0,0,0,1
59187,0,1,0,0,1
59188,0,1,0,0,1
59189,0,1,0,0,1
59190,0,1,0,0,1
59191,0,1,0,0,1
59192,0,1,0,0,1
59193,0,1,0,0,1
59194,0,1,0,0,1
59195,0,1,0,0,1
59196,0,1,0,0,1
59197,0,1,0,0,1
59198,0,1,0,0,1
59199,0,1,0,0,1
59200,0,1,0,0,1
59201,0,1,0,0,1
59202,0,1,0,0,1
59203,0,1,0,0,1
59204,1,0,0,0,1
59205,1,0,0,0,1
59206,0,1,0,0,1
59207,0,1,0,0,1
59208,0,1,0,0,1
59209,1,0,0,0,1
59210,0,1,0,0,1
59211,0,1,0,0,1
59212,0,1,0,0,1
59213,0,0,0,1,1
59214,0,1,0,0,1
59215,0,1,0,0,1
59216,1,0,0,0,1
59217,0,0,1,0,1
59218,0,1,0,0,1
59219,0,1,0,0,1
59220,1,0,0,0,1
59221,0,1,0,0,1
59222,0,1,0,0,1
59223,0,1,0,0,1
59224,0,1,0,0,1
59225,0,1,0,0,1
59226,0,1,0,0,1
59227,0,1,0,0,1
59228,0,1,0,0,1
59229,0,1,0,0,1
59230,1,0,0,0,1
59231,0,1,0,0,1
59232,1,0,0,0,1
59233,1,0,0,0,1
59234,0,1,0,0,1
59235,0,1,0,0,1
59236,0,1,0,0,1
59237,1,0,0,0,1
59238,0,1,0,0,1
59239,0,1,0,0,1
59240,0,1,0,0,1
59241,0,1,0,0,1
59242,0,1,0,0,1
59243,0,0,1,0,1
59244,0,1,0,0,1
59245,0,1,0,0,1
59246,1,0,0,0,1
59247,1,0,0,0,1
59248,1,0,0,0,1
59249,0,1,0,0,1
59250,0,1,0,0,1
59251,1,0,0,0,1
59252,0,0,1,0,1
59253,0,1,0,0,1
59254,0,0,0,1,1
59255,0,1,0,0,1
59256,1,0,0,0,1
59257,1,0,0,0,1
59258,0,1,0,0,1
59259,0,1,0,0,1
59260,0,1,0,0,1
59261,0,1,0,0,1
59262,0,1,0,0,1
59263,0,1,0,0,1
59264,0,1,0,0,1
59265,0,1,0,0,1
59266,0,1,0,0,1
59267,0,1,0,0,1
59268,1,0,0,0,1
59269,0,1,0,0,1
59270,0,1,0,0,1
59271,0,1,0,0,1
59272,0,1,0,0,1
59273,1,0,0,0,1
59274,0,1,0,0,1
59275,1,0,0,0,1
59276,0,1,0,0,1
59277,0,1,0,0,1
59278,0,1,0,0,1
59279,0,1,0,0,1
59280,0,1,0,0,1
59281,0,1,0,0,1
59282,0,1,0,0,1
59283,0,1,0,0,1
59284,0,1,0,0,1
59285,0,0,0,1,1
59286,0,1,0,0,1
59287,0,1,0,0,1
59288,0,1,0,0,1
59289,0,1,0,0,1
59290,0,1,0,0,1
59291,0,1,0,0,1
59292,1,0,0,0,1
59293,0,1,0,0,1
59294,0,1,0,0,1
59295,0,1,0,0,1
59296,0,1,0,0,1
59297,0,1,0,0,1
59298,0,1,0,0,1
59299,0,1,0,0,1
59300,1,0,0,0,1
59301,0,1,0,0,1
59302,1,0,0,0,1
59303,0,1,0,0,1
59304,0,1,0,0,1
59305,0,1,0,0,1
59306,0,1,0,0,1
59307,1,0,0,0,1
59308,1,0,0,0,1
59309,0,1,0,0,1
59310,1,0,0,0,1
59311,1,0,0,0,1
59312,1,0,0,0,1
59313,0,0,1,0,1
59314,0,1,0,0,1
59315,0,1,0,0,1
59316,0,1,0,0,1
59317,0,1,0,0,1
59318,1,0,0,0,1
59319,0,1,0,0,1
59320,0,0,1,0,1
59321,0,1,0,0,1
59322,0,1,0,0,1
59323,0,1,0,0,1
59324,0,1,0,0,1
59325,0,1,0,0,1
59326,0,0,1,0,1
59327,0,1,0,0,1
59328,1,0,0,0,1
59329,0,1,0,0,1
59330,0,1,0,0,1
59331,0,1,0,0,1
59332,0,1,0,0,1
59333,0,1,0,0,1
59334,0,1,0,0,1
59335,0,1,0,0,1
59336,0,1,0,0,1
59337,1,0,0,0,1
59338,0,1,0,0,1
59339,0,1,0,0,1
59340,0,1,0,0,1
59341,0,1,0,0,1
59342,0,1,0,0,1
59343,0,1,0,0,1
59344,1,0,0,0,1
59345,0,1,0,0,1
59346,0,1,0,0,1
59347,0,1,0,0,1
59348,0,1,0,0,1
59349,0,0,1,0,1
59350,0,1,0,0,1
59351,0,1,0,0,1
59352,0,1,0,0,1
59353,0,1,0,0,1
59354,0,1,0,0,1
59355,1,0,0,0,1
59356,0,1,0,0,1
59357,0,1,0,0,1
59358,0,1,0,0,1
59359,0,1,0,0,1
59360,0,1,0,0,1
59361,0,1,0,0,1
59362,0,1,0,0,1
59363,0,1,0,0,1
59364,0,1,0,0,1
59365,1,0,0,0,1
59366,0,1,0,0,1
59367,0,1,0,0,1
59368,1,0,0,0,1
59369,0,1,0,0,1
59370,1,0,0,0,1
59371,0,1,0,0,1
59372,0,1,0,0,1
59373,0,1,0,0,1
59374,0,1,0,0,1
59375,0,1,0,0,1
59376,0,1,0,0,1
59377,0,1,0,0,1
59378,1,0,0,0,1
59379,0,1,0,0,1
59380,1,0,0,0,1
59381,0,0,0,1,1
59382,0,1,0,0,1
59383,0,1,0,0,1
59384,0,1,0,0,1
59385,0,1,0,0,1
59386,0,1,0,0,1
59387,0,1,0,0,1
59388,0,1,0,0,1
59389,0,1,0,0,1
59390,0,1,0,0,1
59391,0,1,0,0,1
59392,0,1,0,0,1
59393,1,0,0,0,1
59394,1,0,0,0,1
59395,0,1,0,0,1
59396,0,1,0,0,1
59397,0,1,0,0,1
59398,0,1,0,0,1
59399,0,1,0,0,1
59400,0,1,0,0,1
59401,0,1,0,0,1
59402,0,1,0,0,1
59403,0,1,0,0,1
59404,0,1,0,0,1
59405,0,1,0,0,1
59406,1,0,0,0,1
59407,0,1,0,0,1
59408,0,1,0,0,1
59409,0,1,0,0,1
59410,0,1,0,0,1
59411,1,0,0,0,1
59412,0,1,0,0,1
59413,0,1,0,0,1
59414,0,1,0,0,1
59415,0,1,0,0,1
59416,1,0,0,0,1
59417,1,0,0,0,1
59418,0,0,0,1,1
59419,0,1,0,0,1
59420,0,1,0,0,1
59421,0,1,0,0,1
59422,0,1,0,0,1
59423,0,1,0,0,1
59424,1,0,0,0,1
59425,1,0,0,0,1
59426,0,1,0,0,1
59427,0,1,0,0,1
59428,0,1,0,0,1
59429,1,0,0,0,1
59430,0,1,0,0,1
59431,0,1,0,0,1
59432,0,1,0,0,1
59433,0,0,0,1,1
59434,0,1,0,0,1
59435,0,1,0,0,1
59436,0,1,0,0,1
59437,0,1,0,0,1
59438,0,1,0,0,1
59439,1,0,0,0,1
59440,0,1,0,0,1
59441,0,1,0,0,1
59442,0,1,0,0,1
59443,1,0,0,0,1
59444,1,0,0,0,1
59445,0,1,0,0,1
59446,1,0,0,0,1
59447,0,1,0,0,1
59448,0,1,0,0,1
59449,0,1,0,0,1
59450,0,1,0,0,1
59451,0,1,0,0,1
59452,0,1,0,0,1
59453,0,1,0,0,1
59454,0,1,0,0,1
59455,0,1,0,0,1
59456,0,1,0,0,1
59457,1,0,0,0,1
59458,1,0,0,0,1
59459,0,1,0,0,1
59460,0,1,0,0,1
59461,0,1,0,0,1
59462,0,1,0,0,1
59463,0,1,0,0,1
59464,0,1,0,0,1
59465,0,1,0,0,1
59466,0,1,0,0,1
59467,0,1,0,0,1
59468,0,1,0,0,1
59469,0,1,0,0,1
59470,0,1,0,0,1
59471,0,0,0,1,1
59472,0,1,0,0,1
59473,0,1,0,0,1
59474,0,1,0,0,1
59475,1,0,0,0,1
59476,1,0,0,0,1
59477,0,1,0,0,1
59478,1,0,0,0,1
59479,0,1,0,0,1
59480,0,0,1,0,1
59481,0,1,0,0,1
59482,0,0,0,1,1
59483,0,1,0,0,1
59484,0,1,0,0,1
59485,0,1,0,0,1
59486,0,1,0,0,1
59487,0,1,0,0,1
59488,0,1,0,0,1
59489,0,1,0,0,1
59490,0,0,1,0,1
59491,0,1,0,0,1
59492,0,1,0,0,1
59493,0,1,0,0,1
59494,0,1,0,0,1
59495,0,1,0,0,1
59496,0,1,0,0,1
59497,0,1,0,0,1
59498,1,0,0,0,1
59499,1,0,0,0,1
59500,0,1,0,0,1
59501,0,1,0,0,1
59502,0,1,0,0,1
59503,0,1,0,0,1
59504,0,1,0,0,1
59505,0,1,0,0,1
59506,1,0,0,0,1
59507,0,1,0,0,1
59508,0,1,0,0,1
59509,0,1,0,0,1
59510,0,1,0,0,1
59511,0,1,0,0,1
59512,0,1,0,0,1
59513,0,1,0,0,1
59514,0,1,0,0,1
59515,0,0,1,0,1
59516,0,1,0,0,1
59517,1,0,0,0,1
59518,0,1,0,0,1
59519,0,1,0,0,1
59520,0,1,0,0,1
59521,0,1,0,0,1
59522,0,1,0,0,1
59523,0,1,0,0,1
59524,0,1,0,0,1
59525,0,1,0,0,1
59526,0,1,0,0,1
59527,1,0,0,0,1
59528,0,1,0,0,1
59529,0,1,0,0,1
59530,0,1,0,0,1
59531,1,0,0,0,1
59532,0,1,0,0,1
59533,1,0,0,0,1
59534,0,1,0,0,1
59535,0,1,0,0,1
59536,0,1,0,0,1
59537,0,1,0,0,1
59538,0,1,0,0,1
59539,0,1,0,0,1
59540,0,1,0,0,1
59541,0,1,0,0,1
59542,0,1,0,0,1
59543,0,1,0,0,1
59544,0,1,0,0,1
59545,0,1,0,0,1
59546,0,1,0,0,1
59547,0,1,0,0,1
59548,0,1,0,0,1
59549,0,1,0,0,1
59550,0,0,0,1,1
59551,0,1,0,0,1
59552,0,1,0,0,1
59553,0,1,0,0,1
59554,0,0,0,1,1
59555,0,1,0,0,1
59556,0,1,0,0,1
59557,0,0,0,1,1
59558,0,1,0,0,1
59559,0,1,0,0,1
59560,0,1,0,0,1
59561,0,1,0,0,1
59562,0,1,0,0,1
59563,0,1,0,0,1
59564,0,1,0,0,1
59565,0,1,0,0,1
59566,0,1,0,0,1
59567,1,0,0,0,1
59568,0,1,0,0,1
59569,0,1,0,0,1
59570,0,1,0,0,1
59571,0,1,0,0,1
59572,0,1,0,0,1
59573,0,1,0,0,1
59574,0,1,0,0,1
59575,0,0,0,1,1
59576,0,1,0,0,1
59577,0,1,0,0,1
59578,0,1,0,0,1
59579,0,1,0,0,1
59580,0,1,0,0,1
59581,0,1,0,0,1
59582,0,0,0,1,1
59583,1,0,0,0,1
59584,0,0,0,1,1
59585,1,0,0,0,1
59586,0,1,0,0,1
59587,0,1,0,0,1
59588,0,1,0,0,1
59589,1,0,0,0,1
59590,0,1,0,0,1
59591,0,1,0,0,1
59592,0,0,0,1,1
59593,0,1,0,0,1
59594,0,1,0,0,1
59595,0,1,0,0,1
59596,0,0,0,1,1
59597,0,1,0,0,1
59598,0,1,0,0,1
59599,1,0,0,0,1
59600,0,1,0,0,1
59601,0,1,0,0,1
59602,0,1,0,0,1
59603,0,1,0,0,1
59604,0,1,0,0,1
59605,1,0,0,0,1
59606,0,1,0,0,1
59607,0,1,0,0,1
59608,1,0,0,0,1
59609,0,1,0,0,1
59610,0,1,0,0,1
59611,0,1,0,0,1
59612,0,1,0,0,1
59613,0,1,0,0,1
59614,0,1,0,0,1
59615,0,1,0,0,1
59616,0,1,0,0,1
59617,0,1,0,0,1
59618,1,0,0,0,1
59619,0,1,0,0,1
59620,0,1,0,0,1
59621,0,1,0,0,1
59622,1,0,0,0,1
59623,0,1,0,0,1
59624,0,0,0,1,1
59625,0,1,0,0,1
59626,0,1,0,0,1
59627,0,1,0,0,1
59628,1,0,0,0,1
59629,0,1,0,0,1
59630,0,1,0,0,1
59631,0,1,0,0,1
59632,0,1,0,0,1
59633,0,1,0,0,1
59634,0,1,0,0,1
59635,0,1,0,0,1
59636,0,1,0,0,1
59637,0,1,0,0,1
59638,0,1,0,0,1
59639,1,0,0,0,1
59640,0,1,0,0,1
59641,1,0,0,0,1
59642,0,1,0,0,1
59643,0,1,0,0,1
59644,0,1,0,0,1
59645,0,1,0,0,1
59646,0,1,0,0,1
59647,0,1,0,0,1
59648,0,0,0,1,1
59649,0,1,0,0,1
59650,0,1,0,0,1
59651,0,1,0,0,1
59652,0,1,0,0,1
59653,0,1,0,0,1
59654,0,1,0,0,1
59655,0,1,0,0,1
59656,1,0,0,0,1
59657,0,1,0,0,1
59658,0,1,0,0,1
59659,0,1,0,0,1
59660,0,1,0,0,1
59661,0,1,0,0,1
59662,0,1,0,0,1
59663,0,1,0,0,1
59664,0,1,0,0,1
59665,1,0,0,0,1
59666,0,1,0,0,1
59667,1,0,0,0,1
59668,0,1,0,0,1
59669,0,1,0,0,1
59670,0,1,0,0,1
59671,0,1,0,0,1
59672,1,0,0,0,1
59673,0,1,0,0,1
59674,1,0,0,0,1
59675,1,0,0,0,1
59676,0,1,0,0,1
59677,0,1,0,0,1
59678,0,0,1,0,1
59679,0,1,0,0,1
59680,0,1,0,0,1
59681,1,0,0,0,1
59682,0,1,0,0,1
59683,0,0,1,0,1
59684,0,1,0,0,1
59685,1,0,0,0,1
59686,0,1,0,0,1
59687,0,1,0,0,1
59688,0,1,0,0,1
59689,0,1,0,0,1
59690,0,1,0,0,1
59691,0,1,0,0,1
59692,1,0,0,0,1
59693,0,1,0,0,1
59694,0,1,0,0,1
59695,0,1,0,0,1
59696,0,1,0,0,1
59697,0,1,0,0,1
59698,1,0,0,0,1
59699,0,1,0,0,1
59700,1,0,0,0,1
59701,0,1,0,0,1
59702,0,1,0,0,1
59703,0,1,0,0,1
59704,0,1,0,0,1
59705,0,1,0,0,1
59706,0,1,0,0,1
59707,0,1,0,0,1
59708,1,0,0,0,1
59709,0,1,0,0,1
59710,0,1,0,0,1
59711,0,1,0,0,1
59712,0,1,0,0,1
59713,1,0,0,0,1
59714,0,1,0,0,1
59715,0,1,0,0,1
59716,0,1,0,0,1
59717,0,1,0,0,1
59718,1,0,0,0,1
59719,0,0,0,1,1
59720,0,1,0,0,1
59721,0,0,0,1,1
59722,0,1,0,0,1
59723,0,1,0,0,1
59724,0,1,0,0,1
59725,1,0,0,0,1
59726,0,1,0,0,1
59727,0,1,0,0,1
59728,0,1,0,0,1
59729,0,1,0,0,1
59730,0,0,1,0,1
59731,0,1,0,0,1
59732,0,1,0,0,1
59733,0,1,0,0,1
59734,0,1,0,0,1
59735,0,1,0,0,1
59736,0,1,0,0,1
59737,0,1,0,0,1
59738,0,1,0,0,1
59739,0,1,0,0,1
59740,0,1,0,0,1
59741,0,1,0,0,1
59742,0,1,0,0,1
59743,0,1,0,0,1
59744,0,1,0,0,1
59745,0,1,0,0,1
59746,0,1,0,0,1
59747,0,1,0,0,1
59748,0,1,0,0,1
59749,0,1,0,0,1
59750,0,1,0,0,1
59751,0,1,0,0,1
59752,1,0,0,0,1
59753,1,0,0,0,1
59754,0,1,0,0,1
59755,0,1,0,0,1
59756,1,0,0,0,1
59757,0,1,0,0,1
59758,0,1,0,0,1
59759,0,1,0,0,1
59760,0,1,0,0,1
59761,0,1,0,0,1
59762,0,1,0,0,1
59763,0,0,0,1,1
59764,0,1,0,0,1
59765,0,1,0,0,1
59766,1,0,0,0,1
59767,0,1,0,0,1
59768,1,0,0,0,1
59769,0,1,0,0,1
59770,1,0,0,0,1
59771,1,0,0,0,1
59772,0,1,0,0,1
59773,0,1,0,0,1
59774,1,0,0,0,1
59775,0,1,0,0,1
59776,0,1,0,0,1
59777,0,1,0,0,1
59778,0,1,0,0,1
59779,0,1,0,0,1
59780,0,1,0,0,1
59781,0,1,0,0,1
59782,0,1,0,0,1
59783,0,0,0,1,1
59784,0,1,0,0,1
59785,0,1,0,0,1
59786,0,1,0,0,1
59787,1,0,0,0,1
59788,1,0,0,0,1
59789,1,0,0,0,1
59790,1,0,0,0,1
59791,1,0,0,0,1
59792,0,1,0,0,1
59793,0,1,0,0,1
59794,0,1,0,0,1
59795,0,1,0,0,1
59796,0,1,0,0,1
59797,0,1,0,0,1
59798,0,1,0,0,1
59799,1,0,0,0,1
59800,0,1,0,0,1
59801,0,1,0,0,1
59802,0,1,0,0,1
59803,0,1,0,0,1
59804,0,0,1,0,1
59805,0,1,0,0,1
59806,0,1,0,0,1
59807,0,1,0,0,1
59808,0,1,0,0,1
59809,0,1,0,0,1
59810,0,1,0,0,1
59811,1,0,0,0,1
59812,0,0,1,0,1
59813,0,1,0,0,1
59814,0,1,0,0,1
59815,1,0,0,0,1
59816,0,1,0,0,1
59817,0,1,0,0,1
59818,1,0,0,0,1
59819,0,1,0,0,1
59820,0,1,0,0,1
59821,0,1,0,0,1
59822,0,1,0,0,1
59823,0,1,0,0,1
59824,0,1,0,0,1
59825,0,1,0,0,1
59826,0,1,0,0,1
59827,0,1,0,0,1
59828,0,1,0,0,1
59829,0,1,0,0,1
59830,0,1,0,0,1
59831,1,0,0,0,1
59832,1,0,0,0,1
59833,0,1,0,0,1
59834,0,1,0,0,1
59835,0,1,0,0,1
59836,0,1,0,0,1
59837,0,1,0,0,1
59838,0,1,0,0,1
59839,0,1,0,0,1
59840,0,1,0,0,1
59841,0,1,0,0,1
59842,0,1,0,0,1
59843,0,1,0,0,1
59844,0,0,1,0,1
59845,0,1,0,0,1
59846,0,1,0,0,1
59847,0,1,0,0,1
59848,0,1,0,0,1
59849,0,1,0,0,1
59850,0,1,0,0,1
59851,0,1,0,0,1
59852,0,0,1,0,1
59853,0,1,0,0,1
59854,0,1,0,0,1
59855,0,1,0,0,1
59856,0,1,0,0,1
59857,0,1,0,0,1
59858,0,1,0,0,1
59859,0,1,0,0,1
59860,0,1,0,0,1
59861,0,1,0,0,1
59862,0,1,0,0,1
59863,0,1,0,0,1
59864,0,1,0,0,1
59865,0,1,0,0,1
59866,0,1,0,0,1
59867,0,1,0,0,1
59868,0,1,0,0,1
59869,0,1,0,0,1
59870,0,1,0,0,1
59871,0,1,0,0,1
59872,0,1,0,0,1
59873,0,1,0,0,1
59874,0,1,0,0,1
59875,0,1,0,0,1
59876,0,1,0,0,1
59877,0,1,0,0,1
59878,0,1,0,0,1
59879,0,1,0,0,1
59880,0,1,0,0,1
59881,0,1,0,0,1
59882,0,1,0,0,1
59883,1,0,0,0,1
59884,0,1,0,0,1
59885,1,0,0,0,1
59886,0,1,0,0,1
59887,0,1,0,0,1
59888,0,1,0,0,1
59889,0,1,0,0,1
59890,0,1,0,0,1
59891,0,1,0,0,1
59892,0,1,0,0,1
59893,0,1,0,0,1
59894,0,1,0,0,1
59895,0,1,0,0,1
59896,0,1,0,0,1
59897,0,1,0,0,1
59898,1,0,0,0,1
59899,0,1,0,0,1
59900,0,1,0,0,1
59901,0,1,0,0,1
59902,0,1,0,0,1
59903,0,1,0,0,1
59904,0,1,0,0,1
59905,0,1,0,0,1
59906,0,1,0,0,1
59907,1,0,0,0,1
59908,0,1,0,0,1
59909,1,0,0,0,1
59910,1,0,0,0,1
59911,0,1,0,0,1
59912,0,1,0,0,1
59913,0,1,0,0,1
59914,1,0,0,0,1
59915,0,1,0,0,1
59916,0,1,0,0,1
59917,0,1,0,0,1
59918,0,1,0,0,1
59919,0,1,0,0,1
59920,0,1,0,0,1
59921,0,1,0,0,1
59922,0,1,0,0,1
59923,0,1,0,0,1
59924,0,1,0,0,1
59925,0,1,0,0,1
59926,0,1,0,0,1
59927,1,0,0,0,1
59928,0,1,0,0,1
59929,0,1,0,0,1
59930,0,1,0,0,1
59931,0,1,0,0,1
59932,1,0,0,0,1
59933,0,1,0,0,1
59934,0,1,0,0,1
59935,1,0,0,0,1
59936,0,1,0,0,1
59937,0,1,0,0,1
59938,0,1,0,0,1
59939,1,0,0,0,1
59940,0,1,0,0,1
59941,0,1,0,0,1
59942,0,1,0,0,1
59943,0,0,0,1,1
59944,0,0,1,0,1
59945,0,1,0,0,1
59946,0,1,0,0,1
59947,0,1,0,0,1
59948,0,1,0,0,1
59949,0,1,0,0,1
59950,0,1,0,0,1
59951,0,1,0,0,1
59952,0,1,0,0,1
59953,1,0,0,0,1
59954,0,1,0,0,1
59955,0,0,0,1,1
59956,0,1,0,0,1
59957,0,1,0,0,1
59958,0,1,0,0,1
59959,0,1,0,0,1
59960,1,0,0,0,1
59961,0,1,0,0,1
59962,0,1,0,0,1
59963,0,1,0,0,1
59964,0,1,0,0,1
59965,0,1,0,0,1
59966,0,1,0,0,1
59967,0,1,0,0,1
59968,0,1,0,0,1
59969,1,0,0,0,1
59970,0,0,1,0,1
59971,1,0,0,0,1
59972,0,1,0,0,1
59973,0,1,0,0,1
59974,0,1,0,0,1
59975,0,1,0,0,1
59976,0,1,0,0,1
59977,0,1,0,0,1
59978,0,0,1,0,1
59979,0,1,0,0,1
59980,0,1,0,0,1
59981,0,1,0,0,1
59982,0,1,0,0,1
59983,0,1,0,0,1
59984,0,1,0,0,1
59985,0,1,0,0,1
59986,0,1,0,0,1
59987,0,1,0,0,1
59988,0,1,0,0,1
59989,0,1,0,0,1
59990,0,1,0,0,1
59991,0,1,0,0,1
59992,0,1,0,0,1
59993,1,0,0,0,1
59994,0,1,0,0,1
59995,0,1,0,0,1
59996,1,0,0,0,1
59997,0,1,0,0,1
59998,0,1,0,0,1
59999,0,1,0,0,1
60000,0,1,0,0,1
60001,0,1,0,0,1
60002,0,1,0,0,1
60003,0,1,0,0,1
60004,0,0,1,0,1
60005,0,1,0,0,1
60006,0,1,0,0,1
60007,0,1,0,0,1
60008,0,1,0,0,1
60009,0,1,0,0,1
60010,0,1,0,0,1
60011,0,1,0,0,1
60012,1,0,0,0,1
60013,0,1,0,0,1
60014,0,1,0,0,1
60015,0,1,0,0,1
60016,0,1,0,0,1
60017,0,1,0,0,1
60018,1,0,0,0,1
60019,0,1,0,0,1
60020,1,0,0,0,1
60021,0,1,0,0,1
60022,0,1,0,0,1
60023,0,1,0,0,1
60024,0,1,0,0,1
60025,1,0,0,0,1
60026,0,1,0,0,1
60027,0,1,0,0,1
60028,0,1,0,0,1
60029,0,1,0,0,1
60030,0,1,0,0,1
60031,0,1,0,0,1
60032,0,1,0,0,1
60033,0,1,0,0,1
60034,0,1,0,0,1
60035,0,1,0,0,1
60036,0,1,0,0,1
60037,0,1,0,0,1
60038,0,0,1,0,1
60039,1,0,0,0,1
60040,1,0,0,0,1
60041,1,0,0,0,1
60042,0,1,0,0,1
60043,1,0,0,0,1
60044,0,1,0,0,1
60045,0,1,0,0,1
60046,0,1,0,0,1
60047,0,1,0,0,1
60048,0,1,0,0,1
60049,0,1,0,0,1
60050,1,0,0,0,1
60051,0,1,0,0,1
60052,0,1,0,0,1
60053,0,1,0,0,1
60054,0,1,0,0,1
60055,1,0,0,0,1
60056,0,1,0,0,1
60057,0,1,0,0,1
60058,0,1,0,0,1
60059,0,1,0,0,1
60060,0,1,0,0,1
60061,0,1,0,0,1
60062,0,0,0,1,1
60063,1,0,0,0,1
60064,1,0,0,0,1
60065,0,1,0,0,1
60066,0,1,0,0,1
60067,0,1,0,0,1
60068,0,0,0,1,1
60069,1,0,0,0,1
60070,0,1,0,0,1
60071,0,1,0,0,1
60072,0,1,0,0,1
60073,0,1,0,0,1
60074,0,1,0,0,1
60075,0,1,0,0,1
60076,0,1,0,0,1
60077,0,1,0,0,1
60078,0,1,0,0,1
60079,0,1,0,0,1
60080,0,1,0,0,1
60081,0,1,0,0,1
60082,0,1,0,0,1
60083,0,1,0,0,1
60084,0,1,0,0,1
60085,0,1,0,0,1
60086,0,1,0,0,1
60087,0,1,0,0,1
60088,0,1,0,0,1
60089,0,1,0,0,1
60090,1,0,0,0,1
60091,0,1,0,0,1
60092,0,1,0,0,1
60093,0,1,0,0,1
60094,0,1,0,0,1
60095,0,1,0,0,1
60096,0,1,0,0,1
60097,0,1,0,0,1
60098,1,0,0,0,1
60099,0,1,0,0,1
60100,0,1,0,0,1
60101,0,1,0,0,1
60102,0,1,0,0,1
60103,0,1,0,0,1
60104,1,0,0,0,1
60105,0,1,0,0,1
60106,0,1,0,0,1
60107,0,1,0,0,1
60108,1,0,0,0,1
60109,0,1,0,0,1
60110,0,1,0,0,1
60111,0,1,0,0,1
60112,0,1,0,0,1
60113,0,1,0,0,1
60114,0,1,0,0,1
60115,0,1,0,0,1
60116,1,0,0,0,1
60117,0,1,0,0,1
60118,0,1,0,0,1
60119,1,0,0,0,1
60120,0,1,0,0,1
60121,0,1,0,0,1
60122,1,0,0,0,1
60123,1,0,0,0,1
60124,0,1,0,0,1
60125,0,1,0,0,1
60126,0,1,0,0,1
60127,0,1,0,0,1
60128,0,1,0,0,1
60129,0,1,0,0,1
60130,0,1,0,0,1
60131,0,1,0,0,1
60132,1,0,0,0,1
60133,0,1,0,0,1
60134,0,1,0,0,1
60135,1,0,0,0,1
60136,0,1,0,0,1
60137,0,1,0,0,1
60138,0,0,1,0,1
60139,0,1,0,0,1
60140,0,1,0,0,1
60141,0,1,0,0,1
60142,1,0,0,0,1
60143,0,1,0,0,1
60144,0,1,0,0,1
60145,0,0,1,0,1
60146,0,1,0,0,1
60147,0,1,0,0,1
60148,0,1,0,0,1
60149,0,1,0,0,1
60150,0,1,0,0,1
60151,0,1,0,0,1
60152,0,1,0,0,1
60153,0,1,0,0,1
60154,0,1,0,0,1
60155,0,1,0,0,1
60156,0,1,0,0,1
60157,0,1,0,0,1
60158,0,1,0,0,1
60159,0,1,0,0,1
60160,0,1,0,0,1
60161,0,1,0,0,1
60162,0,1,0,0,1
60163,0,1,0,0,1
60164,0,1,0,0,1
60165,0,1,0,0,1
60166,0,1,0,0,1
60167,0,1,0,0,1
60168,0,1,0,0,1
60169,0,0,0,1,1
60170,0,1,0,0,1
60171,0,1,0,0,1
60172,1,0,0,0,1
60173,0,1,0,0,1
60174,1,0,0,0,1
60175,0,1,0,0,1
60176,0,1,0,0,1
60177,0,1,0,0,1
60178,0,1,0,0,1
60179,0,1,0,0,1
60180,0,1,0,0,1
60181,0,1,0,0,1
60182,0,1,0,0,1
60183,0,1,0,0,1
60184,0,1,0,0,1
60185,0,1,0,0,1
60186,0,1,0,0,1
60187,0,1,0,0,1
60188,0,1,0,0,1
60189,1,0,0,0,1
60190,0,1,0,0,1
60191,0,1,0,0,1
60192,0,1,0,0,1
60193,0,1,0,0,1
60194,0,1,0,0,1
60195,1,0,0,0,1
60196,0,1,0,0,1
60197,0,1,0,0,1
60198,0,1,0,0,1
60199,0,0,0,1,1
60200,0,1,0,0,1
60201,0,1,0,0,1
60202,0,1,0,0,1
60203,0,1,0,0,1
60204,0,1,0,0,1
60205,1,0,0,0,1
60206,0,1,0,0,1
60207,0,1,0,0,1
60208,0,1,0,0,1
60209,0,0,1,0,1
60210,0,1,0,0,1
60211,0,1,0,0,1
60212,0,1,0,0,1
60213,0,1,0,0,1
60214,0,1,0,0,1
60215,0,1,0,0,1
60216,0,1,0,0,1
60217,0,1,0,0,1
60218,0,1,0,0,1
60219,0,1,0,0,1
60220,0,1,0,0,1
60221,1,0,0,0,1
60222,0,1,0,0,1
60223,1,0,0,0,1
60224,1,0,0,0,1
60225,0,1,0,0,1
60226,0,1,0,0,1
60227,0,1,0,0,1
60228,0,1,0,0,1
60229,0,1,0,0,1
60230,0,1,0,0,1
60231,0,1,0,0,1
60232,0,1,0,0,1
60233,0,1,0,0,1
60234,0,1,0,0,1
60235,0,1,0,0,1
60236,0,1,0,0,1
60237,0,1,0,0,1
60238,0,1,0,0,1
60239,0,1,0,0,1
60240,0,1,0,0,1
60241,0,1,0,0,1
60242,0,1,0,0,1
60243,0,1,0,0,1
60244,0,1,0,0,1
60245,0,1,0,0,1
60246,1,0,0,0,1
60247,0,1,0,0,1
60248,0,1,0,0,1
60249,0,1,0,0,1
60250,1,0,0,0,1
60251,0,1,0,0,1
60252,0,1,0,0,1
60253,0,1,0,0,1
60254,0,1,0,0,1
60255,0,1,0,0,1
60256,0,1,0,0,1
60257,0,1,0,0,1
60258,0,1,0,0,1
60259,0,1,0,0,1
60260,0,1,0,0,1
60261,0,1,0,0,1
60262,0,1,0,0,1
60263,0,1,0,0,1
60264,0,1,0,0,1
60265,0,1,0,0,1
60266,0,1,0,0,1
60267,0,1,0,0,1
60268,0,1,0,0,1
60269,0,1,0,0,1
60270,0,1,0,0,1
60271,0,1,0,0,1
60272,0,1,0,0,1
60273,0,1,0,0,1
60274,0,1,0,0,1
60275,0,1,0,0,1
60276,0,1,0,0,1
60277,0,1,0,0,1
60278,0,1,0,0,1
60279,1,0,0,0,1
60280,0,1,0,0,1
60281,0,0,1,0,1
60282,0,1,0,0,1
60283,0,1,0,0,1
60284,0,1,0,0,1
60285,0,1,0,0,1
60286,1,0,0,0,1
60287,0,1,0,0,1
60288,0,1,0,0,1
60289,0,1,0,0,1
60290,0,1,0,0,1
60291,1,0,0,0,1
60292,0,1,0,0,1
60293,0,1,0,0,1
60294,0,1,0,0,1
60295,0,1,0,0,1
60296,1,0,0,0,1
60297,0,1,0,0,1
60298,0,1,0,0,1
60299,0,1,0,0,1
60300,0,1,0,0,1
60301,1,0,0,0,1
60302,0,1,0,0,1
60303,0,1,0,0,1
60304,0,1,0,0,1
60305,0,1,0,0,1
60306,1,0,0,0,1
60307,0,1,0,0,1
60308,0,1,0,0,1
60309,0,1,0,0,1
60310,0,1,0,0,1
60311,0,1,0,0,1
60312,0,1,0,0,1
60313,0,1,0,0,1
60314,0,1,0,0,1
60315,0,1,0,0,1
60316,0,1,0,0,1
60317,0,1,0,0,1
60318,0,1,0,0,1
60319,0,1,0,0,1
60320,0,1,0,0,1
60321,0,1,0,0,1
60322,0,1,0,0,1
60323,0,1,0,0,1
60324,1,0,0,0,1
60325,0,1,0,0,1
60326,0,1,0,0,1
60327,1,0,0,0,1
60328,0,1,0,0,1
60329,0,1,0,0,1
60330,0,0,0,1,1
60331,0,1,0,0,1
60332,0,1,0,0,1
60333,0,1,0,0,1
60334,0,1,0,0,1
60335,0,0,0,1,1
60336,0,1,0,0,1
60337,0,1,0,0,1
60338,0,1,0,0,1
60339,0,1,0,0,1
60340,0,1,0,0,1
60341,0,1,0,0,1
60342,0,1,0,0,1
60343,0,1,0,0,1
60344,0,1,0,0,1
60345,0,1,0,0,1
60346,0,1,0,0,1
60347,1,0,0,0,1
60348,0,1,0,0,1
60349,0,1,0,0,1
60350,0,0,0,1,1
60351,0,1,0,0,1
60352,0,1,0,0,1
60353,0,1,0,0,1
60354,0,1,0,0,1
60355,0,1,0,0,1
60356,0,1,0,0,1
60357,0,1,0,0,1
60358,0,1,0,0,1
60359,0,1,0,0,1
60360,0,1,0,0,1
60361,0,1,0,0,1
60362,0,1,0,0,1
60363,0,1,0,0,1
60364,1,0,0,0,1
60365,0,1,0,0,1
60366,0,1,0,0,1
60367,0,1,0,0,1
60368,1,0,0,0,1
60369,0,1,0,0,1
60370,0,1,0,0,1
60371,0,1,0,0,1
60372,0,1,0,0,1
60373,0,1,0,0,1
60374,0,1,0,0,1
60375,0,1,0,0,1
60376,1,0,0,0,1
60377,0,1,0,0,1
60378,0,1,0,0,1
60379,0,1,0,0,1
60380,1,0,0,0,1
60381,0,1,0,0,1
60382,0,1,0,0,1
60383,1,0,0,0,1
60384,0,1,0,0,1
60385,0,1,0,0,1
60386,0,1,0,0,1
60387,0,1,0,0,1
60388,0,1,0,0,1
60389,0,1,0,0,1
60390,0,1,0,0,1
60391,0,1,0,0,1
60392,0,1,0,0,1
60393,0,1,0,0,1
60394,0,1,0,0,1
60395,1,0,0,0,1
60396,0,1,0,0,1
60397,0,1,0,0,1
60398,0,1,0,0,1
60399,0,0,0,1,1
60400,0,1,0,0,1
60401,0,1,0,0,1
60402,0,1,0,0,1
60403,0,1,0,0,1
60404,0,1,0,0,1
60405,0,1,0,0,1
60406,0,1,0,0,1
60407,1,0,0,0,1
60408,0,1,0,0,1
60409,0,1,0,0,1
60410,0,1,0,0,1
60411,0,1,0,0,1
60412,0,1,0,0,1
60413,0,0,1,0,1
60414,0,1,0,0,1
60415,1,0,0,0,1
60416,0,1,0,0,1
60417,1,0,0,0,1
60418,0,1,0,0,1
60419,0,0,0,1,1
60420,0,1,0,0,1
60421,0,1,0,0,1
60422,0,1,0,0,1
60423,0,1,0,0,1
60424,0,1,0,0,1
60425,1,0,0,0,1
60426,0,1,0,0,1
60427,0,0,1,0,1
60428,0,1,0,0,1
60429,0,1,0,0,1
60430,1,0,0,0,1
60431,0,1,0,0,1
60432,0,1,0,0,1
60433,0,1,0,0,1
60434,0,1,0,0,1
60435,0,1,0,0,1
60436,1,0,0,0,1
60437,0,1,0,0,1
60438,0,1,0,0,1
60439,0,1,0,0,1
60440,0,1,0,0,1
60441,0,0,0,1,1
60442,0,1,0,0,1
60443,0,1,0,0,1
60444,0,1,0,0,1
60445,1,0,0,0,1
60446,0,1,0,0,1
60447,0,1,0,0,1
60448,0,1,0,0,1
60449,1,0,0,0,1
60450,0,1,0,0,1
60451,0,1,0,0,1
60452,0,1,0,0,1
60453,1,0,0,0,1
60454,1,0,0,0,1
60455,0,1,0,0,1
60456,0,1,0,0,1
60457,0,1,0,0,1
60458,0,1,0,0,1
60459,0,1,0,0,1
60460,0,1,0,0,1
60461,0,1,0,0,1
60462,0,1,0,0,1
60463,0,1,0,0,1
60464,0,1,0,0,1
60465,0,1,0,0,1
60466,0,1,0,0,1
60467,0,1,0,0,1
60468,0,1,0,0,1
60469,0,1,0,0,1
60470,0,1,0,0,1
60471,0,1,0,0,1
60472,0,1,0,0,1
60473,0,1,0,0,1
60474,1,0,0,0,1
60475,0,1,0,0,1
60476,0,1,0,0,1
60477,1,0,0,0,1
60478,0,1,0,0,1
60479,0,1,0,0,1
60480,0,1,0,0,1
60481,0,1,0,0,1
60482,0,1,0,0,1
60483,0,1,0,0,1
60484,1,0,0,0,1
60485,0,1,0,0,1
60486,1,0,0,0,1
60487,0,1,0,0,1
60488,0,1,0,0,1
60489,0,1,0,0,1
60490,0,1,0,0,1
60491,0,1,0,0,1
60492,0,1,0,0,1
60493,0,1,0,0,1
60494,0,1,0,0,1
60495,0,1,0,0,1
60496,0,1,0,0,1
60497,0,1,0,0,1
60498,0,1,0,0,1
60499,0,1,0,0,1
60500,0,1,0,0,1
60501,0,1,0,0,1
60502,0,1,0,0,1
60503,1,0,0,0,1
60504,0,1,0,0,1
60505,0,0,1,0,1
60506,0,1,0,0,1
60507,0,1,0,0,1
60508,1,0,0,0,1
60509,0,1,0,0,1
60510,0,1,0,0,1
60511,0,1,0,0,1
60512,0,1,0,0,1
60513,0,1,0,0,1
60514,1,0,0,0,1
60515,0,1,0,0,1
60516,0,1,0,0,1
60517,0,1,0,0,1
60518,1,0,0,0,1
60519,0,1,0,0,1
60520,0,1,0,0,1
60521,0,1,0,0,1
60522,0,1,0,0,1
60523,0,1,0,0,1
60524,0,1,0,0,1
60525,0,1,0,0,1
60526,0,1,0,0,1
60527,1,0,0,0,1
60528,0,1,0,0,1
60529,0,1,0,0,1
60530,0,1,0,0,1
60531,0,1,0,0,1
60532,0,1,0,0,1
60533,0,1,0,0,1
60534,0,1,0,0,1
60535,0,1,0,0,1
60536,0,1,0,0,1
60537,0,1,0,0,1
60538,1,0,0,0,1
60539,1,0,0,0,1
60540,0,1,0,0,1
60541,0,1,0,0,1
60542,0,1,0,0,1
60543,0,1,0,0,1
60544,1,0,0,0,1
60545,0,1,0,0,1
60546,0,1,0,0,1
60547,0,1,0,0,1
60548,0,1,0,0,1
60549,0,1,0,0,1
60550,0,1,0,0,1
60551,0,1,0,0,1
60552,0,1,0,0,1
60553,0,1,0,0,1
60554,0,1,0,0,1
60555,1,0,0,0,1
60556,0,1,0,0,1
60557,0,1,0,0,1
60558,0,1,0,0,1
60559,1,0,0,0,1
60560,0,1,0,0,1
60561,0,1,0,0,1
60562,1,0,0,0,1
60563,0,1,0,0,1
60564,0,1,0,0,1
60565,0,1,0,0,1
60566,0,1,0,0,1
60567,0,0,0,1,1
60568,0,1,0,0,1
60569,1,0,0,0,1
60570,0,1,0,0,1
60571,0,1,0,0,1
60572,0,1,0,0,1
60573,0,1,0,0,1
60574,0,1,0,0,1
60575,0,1,0,0,1
60576,0,0,0,1,1
60577,0,1,0,0,1
60578,0,1,0,0,1
60579,0,1,0,0,1
60580,0,1,0,0,1
60581,0,1,0,0,1
60582,0,1,0,0,1
60583,0,1,0,0,1
60584,0,1,0,0,1
60585,0,1,0,0,1
60586,0,1,0,0,1
60587,0,1,0,0,1
60588,1,0,0,0,1
60589,0,1,0,0,1
60590,0,1,0,0,1
60591,0,0,1,0,1
60592,0,1,0,0,1
60593,0,1,0,0,1
60594,0,1,0,0,1
60595,0,1,0,0,1
60596,0,1,0,0,1
60597,1,0,0,0,1
60598,0,1,0,0,1
60599,0,1,0,0,1
60600,0,1,0,0,1
60601,0,1,0,0,1
60602,0,1,0,0,1
60603,1,0,0,0,1
60604,1,0,0,0,1
60605,0,1,0,0,1
60606,0,1,0,0,1
60607,1,0,0,0,1
60608,0,1,0,0,1
60609,0,1,0,0,1
60610,0,1,0,0,1
60611,0,1,0,0,1
60612,0,0,0,1,1
60613,1,0,0,0,1
60614,0,1,0,0,1
60615,1,0,0,0,1
60616,0,1,0,0,1
60617,0,1,0,0,1
60618,0,1,0,0,1
60619,0,1,0,0,1
60620,0,1,0,0,1
60621,0,1,0,0,1
60622,0,1,0,0,1
60623,0,0,0,1,1
60624,0,1,0,0,1
60625,0,1,0,0,1
60626,0,1,0,0,1
60627,0,0,0,1,1
60628,1,0,0,0,1
60629,1,0,0,0,1
60630,0,1,0,0,1
60631,1,0,0,0,1
60632,0,1,0,0,1
60633,1,0,0,0,1
60634,0,1,0,0,1
60635,0,1,0,0,1
60636,0,1,0,0,1
60637,0,1,0,0,1
60638,0,1,0,0,1
60639,0,1,0,0,1
60640,1,0,0,0,1
60641,0,1,0,0,1
60642,0,1,0,0,1
60643,1,0,0,0,1
60644,0,1,0,0,1
60645,0,1,0,0,1
60646,0,1,0,0,1
60647,0,1,0,0,1
60648,0,1,0,0,1
60649,1,0,0,0,1
60650,1,0,0,0,1
60651,0,1,0,0,1
60652,0,1,0,0,1
60653,0,1,0,0,1
60654,0,1,0,0,1
60655,1,0,0,0,1
60656,1,0,0,0,1
60657,1,0,0,0,1
60658,0,1,0,0,1
60659,0,1,0,0,1
60660,0,1,0,0,1
60661,0,1,0,0,1
60662,0,1,0,0,1
60663,0,1,0,0,1
60664,0,1,0,0,1
60665,0,1,0,0,1
60666,0,1,0,0,1
60667,0,1,0,0,1
60668,1,0,0,0,1
60669,0,1,0,0,1
60670,0,1,0,0,1
60671,1,0,0,0,1
60672,0,1,0,0,1
60673,1,0,0,0,1
60674,0,1,0,0,1
60675,0,1,0,0,1
60676,0,1,0,0,1
60677,0,1,0,0,1
60678,0,1,0,0,1
60679,0,1,0,0,1
60680,1,0,0,0,1
60681,0,1,0,0,1
60682,0,1,0,0,1
60683,0,1,0,0,1
60684,0,1,0,0,1
60685,0,1,0,0,1
60686,0,1,0,0,1
60687,0,1,0,0,1
60688,0,1,0,0,1
60689,0,1,0,0,1
60690,0,1,0,0,1
60691,0,1,0,0,1
60692,0,1,0,0,1
60693,0,1,0,0,1
60694,0,1,0,0,1
60695,0,1,0,0,1
60696,1,0,0,0,1
60697,1,0,0,0,1
60698,0,0,0,1,1
60699,1,0,0,0,1
60700,1,0,0,0,1
60701,0,1,0,0,1
60702,0,0,1,0,1
60703,0,1,0,0,1
60704,0,1,0,0,1
60705,0,1,0,0,1
60706,0,1,0,0,1
60707,0,1,0,0,1
60708,0,1,0,0,1
60709,1,0,0,0,1
60710,0,1,0,0,1
60711,0,1,0,0,1
60712,1,0,0,0,1
60713,0,1,0,0,1
60714,0,1,0,0,1
60715,0,1,0,0,1
60716,0,1,0,0,1
60717,0,1,0,0,1
60718,0,1,0,0,1
60719,1,0,0,0,1
60720,0,1,0,0,1
60721,0,1,0,0,1
60722,0,0,1,0,1
60723,0,1,0,0,1
60724,0,1,0,0,1
60725,0,1,0,0,1
60726,0,1,0,0,1
60727,0,1,0,0,1
60728,0,1,0,0,1
60729,1,0,0,0,1
60730,0,1,0,0,1
60731,0,1,0,0,1
60732,0,1,0,0,1
60733,0,1,0,0,1
60734,0,1,0,0,1
60735,0,1,0,0,1
60736,0,1,0,0,1
60737,0,1,0,0,1
60738,0,0,0,1,1
60739,0,1,0,0,1
60740,0,1,0,0,1
60741,0,1,0,0,1
60742,0,1,0,0,1
60743,0,1,0,0,1
60744,0,1,0,0,1
60745,0,1,0,0,1
60746,0,1,0,0,1
60747,0,1,0,0,1
60748,0,1,0,0,1
60749,0,1,0,0,1
60750,0,1,0,0,1
60751,0,1,0,0,1
60752,0,1,0,0,1
60753,0,1,0,0,1
60754,0,1,0,0,1
60755,0,1,0,0,1
60756,0,1,0,0,1
60757,0,1,0,0,1
60758,0,0,1,0,1
60759,0,1,0,0,1
60760,0,1,0,0,1
60761,0,1,0,0,1
60762,0,1,0,0,1
60763,1,0,0,0,1
60764,0,1,0,0,1
60765,0,1,0,0,1
60766,0,1,0,0,1
60767,0,1,0,0,1
60768,0,1,0,0,1
60769,1,0,0,0,1
60770,0,1,0,0,1
60771,0,1,0,0,1
60772,0,1,0,0,1
60773,1,0,0,0,1
60774,0,1,0,0,1
60775,0,1,0,0,1
60776,0,1,0,0,1
60777,0,1,0,0,1
60778,0,1,0,0,1
60779,0,1,0,0,1
60780,0,1,0,0,1
60781,0,1,0,0,1
60782,0,0,0,1,1
60783,0,1,0,0,1
60784,0,1,0,0,1
60785,0,1,0,0,1
60786,0,1,0,0,1
60787,0,1,0,0,1
60788,1,0,0,0,1
60789,1,0,0,0,1
60790,0,1,0,0,1
60791,0,1,0,0,1
60792,0,1,0,0,1
60793,1,0,0,0,1
60794,0,1,0,0,1
60795,0,1,0,0,1
60796,0,1,0,0,1
60797,0,1,0,0,1
60798,0,1,0,0,1
60799,0,1,0,0,1
60800,0,1,0,0,1
60801,0,1,0,0,1
60802,0,1,0,0,1
60803,0,1,0,0,1
60804,0,1,0,0,1
60805,0,1,0,0,1
60806,1,0,0,0,1
60807,0,1,0,0,1
60808,0,1,0,0,1
60809,0,1,0,0,1
60810,0,1,0,0,1
60811,0,1,0,0,1
60812,0,1,0,0,1
60813,0,1,0,0,1
60814,0,1,0,0,1
60815,0,1,0,0,1
60816,0,1,0,0,1
60817,0,1,0,0,1
60818,1,0,0,0,1
60819,0,1,0,0,1
60820,0,1,0,0,1
60821,1,0,0,0,1
60822,0,1,0,0,1
60823,1,0,0,0,1
60824,0,1,0,0,1
60825,1,0,0,0,1
60826,0,1,0,0,1
60827,0,1,0,0,1
60828,0,1,0,0,1
60829,0,1,0,0,1
60830,0,1,0,0,1
60831,0,1,0,0,1
60832,1,0,0,0,1
60833,0,1,0,0,1
60834,0,1,0,0,1
60835,0,1,0,0,1
60836,0,1,0,0,1
60837,0,1,0,0,1
60838,0,1,0,0,1
60839,1,0,0,0,1
60840,0,1,0,0,1
60841,1,0,0,0,1
60842,0,1,0,0,1
60843,0,1,0,0,1
60844,0,1,0,0,1
60845,0,1,0,0,1
60846,0,1,0,0,1
60847,0,1,0,0,1
60848,1,0,0,0,1
60849,0,1,0,0,1
60850,0,1,0,0,1
60851,0,1,0,0,1
60852,0,0,0,1,1
60853,0,1,0,0,1
60854,0,1,0,0,1
60855,1,0,0,0,1
60856,0,1,0,0,1
60857,1,0,0,0,1
60858,0,1,0,0,1
60859,0,0,0,1,1
60860,0,1,0,0,1
60861,0,1,0,0,1
60862,0,1,0,0,1
60863,0,1,0,0,1
60864,0,1,0,0,1
60865,0,1,0,0,1
60866,0,1,0,0,1
60867,0,1,0,0,1
60868,0,1,0,0,1
60869,0,1,0,0,1
60870,0,1,0,0,1
60871,0,1,0,0,1
60872,0,1,0,0,1
60873,0,0,1,0,1
60874,1,0,0,0,1
60875,0,1,0,0,1
60876,0,1,0,0,1
60877,0,1,0,0,1
60878,0,1,0,0,1
60879,0,1,0,0,1
60880,0,0,0,1,1
60881,1,0,0,0,1
60882,0,1,0,0,1
60883,0,1,0,0,1
60884,0,1,0,0,1
60885,1,0,0,0,1
60886,1,0,0,0,1
60887,0,1,0,0,1
60888,0,1,0,0,1
60889,0,1,0,0,1
60890,0,1,0,0,1
60891,0,1,0,0,1
60892,0,1,0,0,1
60893,0,1,0,0,1
60894,1,0,0,0,1
60895,0,1,0,0,1
60896,0,1,0,0,1
60897,1,0,0,0,1
60898,0,1,0,0,1
60899,0,1,0,0,1
60900,0,1,0,0,1
60901,0,1,0,0,1
60902,0,1,0,0,1
60903,0,1,0,0,1
60904,0,1,0,0,1
60905,0,0,1,0,1
60906,0,1,0,0,1
60907,0,1,0,0,1
60908,0,1,0,0,1
60909,1,0,0,0,1
60910,0,0,0,1,1
60911,0,1,0,0,1
60912,0,1,0,0,1
60913,0,1,0,0,1
60914,0,1,0,0,1
60915,1,0,0,0,1
60916,1,0,0,0,1
60917,0,0,1,0,1
60918,1,0,0,0,1
60919,0,1,0,0,1
60920,0,1,0,0,1
60921,0,1,0,0,1
60922,0,1,0,0,1
60923,0,1,0,0,1
60924,0,0,1,0,1
60925,0,1,0,0,1
60926,0,1,0,0,1
60927,0,1,0,0,1
60928,0,1,0,0,1
60929,0,1,0,0,1
60930,0,1,0,0,1
60931,1,0,0,0,1
60932,0,1,0,0,1
60933,0,1,0,0,1
60934,0,1,0,0,1
60935,0,1,0,0,1
60936,0,1,0,0,1
60937,1,0,0,0,1
60938,0,1,0,0,1
60939,0,1,0,0,1
60940,1,0,0,0,1
60941,0,1,0,0,1
60942,0,1,0,0,1
60943,0,1,0,0,1
60944,0,1,0,0,1
60945,0,1,0,0,1
60946,0,1,0,0,1
60947,0,1,0,0,1
60948,1,0,0,0,1
60949,0,1,0,0,1
60950,0,0,0,1,1
60951,0,1,0,0,1
60952,0,1,0,0,1
60953,0,1,0,0,1
60954,1,0,0,0,1
60955,0,1,0,0,1
60956,1,0,0,0,1
60957,0,1,0,0,1
60958,0,1,0,0,1
60959,0,1,0,0,1
60960,0,1,0,0,1
60961,0,1,0,0,1
60962,0,1,0,0,1
60963,0,1,0,0,1
60964,1,0,0,0,1
60965,0,1,0,0,1
60966,0,1,0,0,1
60967,0,1,0,0,1
60968,1,0,0,0,1
60969,0,1,0,0,1
60970,1,0,0,0,1
60971,0,0,1,0,1
60972,0,1,0,0,1
60973,0,1,0,0,1
60974,0,1,0,0,1
60975,1,0,0,0,1
60976,0,1,0,0,1
60977,1,0,0,0,1
60978,0,1,0,0,1
60979,0,1,0,0,1
60980,0,1,0,0,1
60981,0,1,0,0,1
60982,0,1,0,0,1
60983,0,1,0,0,1
60984,0,1,0,0,1
60985,1,0,0,0,1
60986,0,1,0,0,1
60987,0,1,0,0,1
60988,0,1,0,0,1
60989,0,1,0,0,1
60990,1,0,0,0,1
60991,0,1,0,0,1
60992,0,1,0,0,1
60993,0,1,0,0,1
60994,0,0,0,1,1
60995,1,0,0,0,1
60996,0,1,0,0,1
60997,1,0,0,0,1
60998,0,1,0,0,1
60999,0,1,0,0,1
61000,0,1,0,0,1
61001,0,1,0,0,1
61002,0,1,0,0,1
61003,0,1,0,0,1
61004,0,1,0,0,1
61005,0,1,0,0,1
61006,0,1,0,0,1
61007,0,1,0,0,1
61008,1,0,0,0,1
61009,0,1,0,0,1
61010,0,1,0,0,1
61011,0,1,0,0,1
61012,0,1,0,0,1
61013,0,1,0,0,1
61014,1,0,0,0,1
61015,1,0,0,0,1
61016,0,1,0,0,1
61017,0,1,0,0,1
61018,0,1,0,0,1
61019,0,1,0,0,1
61020,0,1,0,0,1
61021,0,1,0,0,1
61022,0,1,0,0,1
61023,0,1,0,0,1
61024,0,1,0,0,1
61025,0,1,0,0,1
61026,0,1,0,0,1
61027,0,1,0,0,1
61028,1,0,0,0,1
61029,0,1,0,0,1
61030,0,1,0,0,1
61031,0,1,0,0,1
61032,0,1,0,0,1
61033,0,1,0,0,1
61034,0,1,0,0,1
61035,0,1,0,0,1
61036,0,1,0,0,1
61037,0,1,0,0,1
61038,0,1,0,0,1
61039,0,1,0,0,1
61040,0,1,0,0,1
61041,0,1,0,0,1
61042,0,1,0,0,1
61043,0,1,0,0,1
61044,0,1,0,0,1
61045,0,1,0,0,1
61046,0,1,0,0,1
61047,0,1,0,0,1
61048,0,1,0,0,1
61049,1,0,0,0,1
61050,0,1,0,0,1
61051,0,1,0,0,1
61052,0,1,0,0,1
61053,0,1,0,0,1
61054,0,1,0,0,1
61055,0,1,0,0,1
61056,0,1,0,0,1
61057,0,1,0,0,1
61058,0,1,0,0,1
61059,0,1,0,0,1
61060,1,0,0,0,1
61061,0,1,0,0,1
61062,0,1,0,0,1
61063,1,0,0,0,1
61064,0,1,0,0,1
61065,0,1,0,0,1
61066,0,1,0,0,1
61067,0,0,0,1,1
61068,0,1,0,0,1
61069,0,1,0,0,1
61070,0,1,0,0,1
61071,0,1,0,0,1
61072,0,1,0,0,1
61073,0,1,0,0,1
61074,0,1,0,0,1
61075,0,1,0,0,1
61076,0,1,0,0,1
61077,0,1,0,0,1
61078,0,1,0,0,1
61079,0,0,1,0,1
61080,0,1,0,0,1
61081,1,0,0,0,1
61082,0,1,0,0,1
61083,1,0,0,0,1
61084,0,1,0,0,1
61085,0,1,0,0,1
61086,0,1,0,0,1
61087,1,0,0,0,1
61088,0,0,1,0,1
61089,1,0,0,0,1
61090,0,1,0,0,1
61091,0,1,0,0,1
61092,0,1,0,0,1
61093,0,1,0,0,1
61094,0,1,0,0,1
61095,1,0,0,0,1
61096,0,1,0,0,1
61097,0,1,0,0,1
61098,0,1,0,0,1
61099,0,1,0,0,1
61100,0,1,0,0,1
61101,0,1,0,0,1
61102,0,1,0,0,1
61103,0,1,0,0,1
61104,0,1,0,0,1
61105,0,1,0,0,1
61106,0,1,0,0,1
61107,0,1,0,0,1
61108,0,1,0,0,1
61109,0,1,0,0,1
61110,0,1,0,0,1
61111,1,0,0,0,1
61112,0,1,0,0,1
61113,0,1,0,0,1
61114,0,1,0,0,1
61115,0,1,0,0,1
61116,0,1,0,0,1
61117,1,0,0,0,1
61118,0,1,0,0,1
61119,0,1,0,0,1
61120,0,1,0,0,1
61121,1,0,0,0,1
61122,0,1,0,0,1
61123,0,1,0,0,1
61124,0,1,0,0,1
61125,1,0,0,0,1
61126,0,1,0,0,1
61127,0,1,0,0,1
61128,0,1,0,0,1
61129,0,1,0,0,1
61130,0,1,0,0,1
61131,0,1,0,0,1
61132,0,1,0,0,1
61133,0,1,0,0,1
61134,0,1,0,0,1
61135,0,1,0,0,1
61136,0,1,0,0,1
61137,1,0,0,0,1
61138,0,1,0,0,1
61139,0,1,0,0,1
61140,1,0,0,0,1
61141,0,1,0,0,1
61142,0,1,0,0,1
61143,0,1,0,0,1
61144,0,1,0,0,1
61145,0,1,0,0,1
61146,0,1,0,0,1
61147,0,1,0,0,1
61148,0,1,0,0,1
61149,0,1,0,0,1
61150,0,1,0,0,1
61151,0,1,0,0,1
61152,0,1,0,0,1
61153,0,1,0,0,1
61154,1,0,0,0,1
61155,1,0,0,0,1
61156,0,1,0,0,1
61157,0,1,0,0,1
61158,0,1,0,0,1
61159,0,1,0,0,1
61160,0,1,0,0,1
61161,0,1,0,0,1
61162,0,1,0,0,1
61163,1,0,0,0,1
61164,0,1,0,0,1
61165,0,1,0,0,1
61166,0,1,0,0,1
61167,0,1,0,0,1
61168,0,1,0,0,1
61169,0,1,0,0,1
61170,0,1,0,0,1
61171,0,1,0,0,1
61172,0,1,0,0,1
61173,0,1,0,0,1
61174,0,1,0,0,1
61175,0,1,0,0,1
61176,0,1,0,0,1
61177,1,0,0,0,1
61178,0,1,0,0,1
61179,0,1,0,0,1
61180,0,1,0,0,1
61181,0,1,0,0,1
61182,0,1,0,0,1
61183,0,1,0,0,1
61184,0,1,0,0,1
61185,0,1,0,0,1
61186,0,1,0,0,1
61187,0,1,0,0,1
61188,0,1,0,0,1
61189,0,1,0,0,1
61190,0,1,0,0,1
61191,1,0,0,0,1
61192,0,1,0,0,1
61193,0,0,0,1,1
61194,0,1,0,0,1
61195,0,1,0,0,1
61196,1,0,0,0,1
61197,0,1,0,0,1
61198,0,1,0,0,1
61199,0,0,1,0,1
61200,0,0,0,1,1
61201,0,1,0,0,1
61202,0,1,0,0,1
61203,0,1,0,0,1
61204,0,1,0,0,1
61205,0,1,0,0,1
61206,0,1,0,0,1
61207,0,1,0,0,1
61208,0,1,0,0,1
61209,0,1,0,0,1
61210,0,1,0,0,1
61211,0,1,0,0,1
61212,0,1,0,0,1
61213,0,1,0,0,1
61214,0,1,0,0,1
61215,0,1,0,0,1
61216,0,1,0,0,1
61217,0,1,0,0,1
61218,0,1,0,0,1
61219,0,1,0,0,1
61220,0,1,0,0,1
61221,0,1,0,0,1
61222,0,1,0,0,1
61223,0,1,0,0,1
61224,0,1,0,0,1
61225,0,1,0,0,1
61226,0,1,0,0,1
61227,1,0,0,0,1
61228,0,1,0,0,1
61229,0,1,0,0,1
61230,0,1,0,0,1
61231,0,1,0,0,1
61232,0,1,0,0,1
61233,0,1,0,0,1
61234,0,1,0,0,1
61235,0,1,0,0,1
61236,0,1,0,0,1
61237,0,1,0,0,1
61238,0,1,0,0,1
61239,1,0,0,0,1
61240,0,1,0,0,1
61241,0,1,0,0,1
61242,0,1,0,0,1
61243,0,1,0,0,1
61244,0,1,0,0,1
61245,0,1,0,0,1
61246,0,1,0,0,1
61247,0,1,0,0,1
61248,0,0,1,0,1
61249,1,0,0,0,1
61250,0,1,0,0,1
61251,1,0,0,0,1
61252,0,1,0,0,1
61253,0,1,0,0,1
61254,0,1,0,0,1
61255,0,1,0,0,1
61256,0,1,0,0,1
61257,0,1,0,0,1
61258,0,0,0,1,1
61259,0,1,0,0,1
61260,1,0,0,0,1
61261,1,0,0,0,1
61262,0,1,0,0,1
61263,1,0,0,0,1
61264,0,1,0,0,1
61265,0,1,0,0,1
61266,1,0,0,0,1
61267,0,0,0,1,1
61268,0,1,0,0,1
61269,0,1,0,0,1
61270,0,1,0,0,1
61271,0,1,0,0,1
61272,0,1,0,0,1
61273,0,1,0,0,1
61274,0,1,0,0,1
61275,0,1,0,0,1
61276,0,1,0,0,1
61277,0,1,0,0,1
61278,0,1,0,0,1
61279,1,0,0,0,1
61280,0,1,0,0,1
61281,0,1,0,0,1
61282,0,1,0,0,1
61283,1,0,0,0,1
61284,0,1,0,0,1
61285,0,1,0,0,1
61286,0,1,0,0,1
61287,0,1,0,0,1
61288,0,1,0,0,1
61289,0,1,0,0,1
61290,0,1,0,0,1
61291,0,1,0,0,1
61292,0,1,0,0,1
61293,0,1,0,0,1
61294,0,1,0,0,1
61295,0,1,0,0,1
61296,0,1,0,0,1
61297,0,0,0,1,1
61298,0,1,0,0,1
61299,0,1,0,0,1
61300,0,1,0,0,1
61301,0,1,0,0,1
61302,0,1,0,0,1
61303,0,1,0,0,1
61304,0,1,0,0,1
61305,0,1,0,0,1
61306,0,1,0,0,1
61307,1,0,0,0,1
61308,0,1,0,0,1
61309,0,1,0,0,1
61310,0,1,0,0,1
61311,0,1,0,0,1
61312,0,1,0,0,1
61313,0,1,0,0,1
61314,0,1,0,0,1
61315,0,1,0,0,1
61316,1,0,0,0,1
61317,0,0,0,1,1
61318,0,1,0,0,1
61319,0,1,0,0,1
61320,0,1,0,0,1
61321,0,0,0,1,1
61322,0,1,0,0,1
61323,0,0,1,0,1
61324,0,1,0,0,1
61325,0,1,0,0,1
61326,0,1,0,0,1
61327,0,1,0,0,1
61328,0,1,0,0,1
61329,0,1,0,0,1
61330,0,1,0,0,1
61331,1,0,0,0,1
61332,0,1,0,0,1
61333,0,1,0,0,1
61334,0,1,0,0,1
61335,0,0,1,0,1
61336,0,1,0,0,1
61337,0,1,0,0,1
61338,0,0,1,0,1
61339,0,1,0,0,1
61340,1,0,0,0,1
61341,0,1,0,0,1
61342,0,1,0,0,1
61343,0,1,0,0,1
61344,0,1,0,0,1
61345,0,1,0,0,1
61346,0,1,0,0,1
61347,0,1,0,0,1
61348,0,1,0,0,1
61349,0,1,0,0,1
61350,0,1,0,0,1
61351,0,1,0,0,1
61352,0,1,0,0,1
61353,0,1,0,0,1
61354,0,1,0,0,1
61355,0,1,0,0,1
61356,0,1,0,0,1
61357,0,1,0,0,1
61358,0,1,0,0,1
61359,0,1,0,0,1
61360,0,1,0,0,1
61361,0,1,0,0,1
61362,0,1,0,0,1
61363,1,0,0,0,1
61364,0,1,0,0,1
61365,0,1,0,0,1
61366,0,1,0,0,1
61367,0,1,0,0,1
61368,0,1,0,0,1
61369,0,1,0,0,1
61370,0,1,0,0,1
61371,0,1,0,0,1
61372,1,0,0,0,1
61373,0,1,0,0,1
61374,0,1,0,0,1
61375,0,1,0,0,1
61376,1,0,0,0,1
61377,0,1,0,0,1
61378,1,0,0,0,1
61379,0,1,0,0,1
61380,1,0,0,0,1
61381,0,1,0,0,1
61382,0,1,0,0,1
61383,0,1,0,0,1
61384,0,1,0,0,1
61385,0,1,0,0,1
61386,1,0,0,0,1
61387,1,0,0,0,1
61388,0,1,0,0,1
61389,1,0,0,0,1
61390,0,1,0,0,1
61391,0,1,0,0,1
61392,0,1,0,0,1
61393,0,1,0,0,1
61394,0,1,0,0,1
61395,0,1,0,0,1
61396,0,1,0,0,1
61397,0,1,0,0,1
61398,0,1,0,0,1
61399,0,1,0,0,1
61400,1,0,0,0,1
61401,0,1,0,0,1
61402,0,1,0,0,1
61403,0,1,0,0,1
61404,0,1,0,0,1
61405,0,1,0,0,1
61406,0,1,0,0,1
61407,0,1,0,0,1
61408,0,1,0,0,1
61409,0,1,0,0,1
61410,1,0,0,0,1
61411,0,1,0,0,1
61412,0,1,0,0,1
61413,0,1,0,0,1
61414,1,0,0,0,1
61415,0,1,0,0,1
61416,0,1,0,0,1
61417,0,0,1,0,1
61418,0,1,0,0,1
61419,0,1,0,0,1
61420,0,0,1,0,1
61421,0,1,0,0,1
61422,0,1,0,0,1
61423,0,1,0,0,1
61424,0,1,0,0,1
61425,0,1,0,0,1
61426,0,1,0,0,1
61427,0,1,0,0,1
61428,1,0,0,0,1
61429,0,1,0,0,1
61430,1,0,0,0,1
61431,0,1,0,0,1
61432,0,1,0,0,1
61433,0,1,0,0,1
61434,1,0,0,0,1
61435,0,1,0,0,1
61436,0,1,0,0,1
61437,0,1,0,0,1
61438,0,1,0,0,1
61439,0,1,0,0,1
61440,0,1,0,0,1
61441,1,0,0,0,1
61442,0,1,0,0,1
61443,0,1,0,0,1
61444,0,0,0,1,1
61445,0,1,0,0,1
61446,1,0,0,0,1
61447,0,1,0,0,1
61448,0,1,0,0,1
61449,0,1,0,0,1
61450,0,1,0,0,1
61451,0,1,0,0,1
61452,0,1,0,0,1
61453,0,1,0,0,1
61454,0,1,0,0,1
61455,1,0,0,0,1
61456,0,1,0,0,1
61457,0,1,0,0,1
61458,0,1,0,0,1
61459,1,0,0,0,1
61460,0,1,0,0,1
61461,0,1,0,0,1
61462,0,1,0,0,1
61463,1,0,0,0,1
61464,0,1,0,0,1
61465,0,1,0,0,1
61466,0,1,0,0,1
61467,0,1,0,0,1
61468,0,0,1,0,1
61469,1,0,0,0,1
61470,0,1,0,0,1
61471,0,1,0,0,1
61472,1,0,0,0,1
61473,0,1,0,0,1
61474,1,0,0,0,1
61475,0,1,0,0,1
61476,0,1,0,0,1
61477,0,1,0,0,1
61478,0,0,1,0,1
61479,0,1,0,0,1
61480,0,1,0,0,1
61481,0,1,0,0,1
61482,0,1,0,0,1
61483,0,1,0,0,1
61484,0,1,0,0,1
61485,0,1,0,0,1
61486,0,1,0,0,1
61487,0,1,0,0,1
61488,0,1,0,0,1
61489,0,1,0,0,1
61490,0,1,0,0,1
61491,1,0,0,0,1
61492,0,1,0,0,1
61493,0,1,0,0,1
61494,1,0,0,0,1
61495,0,1,0,0,1
61496,0,1,0,0,1
61497,0,0,1,0,1
61498,0,1,0,0,1
61499,0,1,0,0,1
61500,0,1,0,0,1
61501,1,0,0,0,1
61502,1,0,0,0,1
61503,0,1,0,0,1
61504,0,1,0,0,1
61505,0,1,0,0,1
61506,0,1,0,0,1
61507,0,1,0,0,1
61508,0,1,0,0,1
61509,0,1,0,0,1
61510,0,1,0,0,1
61511,0,1,0,0,1
61512,0,1,0,0,1
61513,0,1,0,0,1
61514,0,1,0,0,1
61515,0,1,0,0,1
61516,0,1,0,0,1
61517,0,0,0,1,1
61518,0,1,0,0,1
61519,1,0,0,0,1
61520,0,1,0,0,1
61521,0,1,0,0,1
61522,0,1,0,0,1
61523,0,1,0,0,1
61524,0,1,0,0,1
61525,0,1,0,0,1
61526,0,1,0,0,1
61527,0,1,0,0,1
61528,0,1,0,0,1
61529,0,1,0,0,1
61530,1,0,0,0,1
61531,0,1,0,0,1
61532,0,0,0,1,1
61533,0,1,0,0,1
61534,0,1,0,0,1
61535,0,1,0,0,1
61536,0,1,0,0,1
61537,0,1,0,0,1
61538,0,1,0,0,1
61539,0,1,0,0,1
61540,0,1,0,0,1
61541,0,1,0,0,1
61542,0,1,0,0,1
61543,0,1,0,0,1
61544,1,0,0,0,1
61545,0,1,0,0,1
61546,0,1,0,0,1
61547,0,1,0,0,1
61548,0,1,0,0,1
61549,0,0,0,1,1
61550,0,1,0,0,1
61551,0,1,0,0,1
61552,0,1,0,0,1
61553,0,1,0,0,1
61554,0,1,0,0,1
61555,0,1,0,0,1
61556,0,1,0,0,1
61557,0,1,0,0,1
61558,0,1,0,0,1
61559,0,1,0,0,1
61560,0,1,0,0,1
61561,1,0,0,0,1
61562,0,1,0,0,1
61563,0,1,0,0,1
61564,0,1,0,0,1
61565,0,1,0,0,1
61566,0,1,0,0,1
61567,0,0,0,1,1
61568,0,1,0,0,1
61569,0,1,0,0,1
61570,0,0,0,1,1
61571,0,1,0,0,1
61572,0,1,0,0,1
61573,0,1,0,0,1
61574,0,1,0,0,1
61575,0,1,0,0,1
61576,0,1,0,0,1
61577,0,1,0,0,1
61578,0,1,0,0,1
61579,1,0,0,0,1
61580,0,1,0,0,1
61581,0,1,0,0,1
61582,0,1,0,0,1
61583,0,1,0,0,1
61584,0,1,0,0,1
61585,0,1,0,0,1
61586,0,1,0,0,1
61587,0,1,0,0,1
61588,1,0,0,0,1
61589,0,1,0,0,1
61590,0,1,0,0,1
61591,0,1,0,0,1
61592,0,1,0,0,1
61593,0,1,0,0,1
61594,1,0,0,0,1
61595,0,1,0,0,1
61596,1,0,0,0,1
61597,0,1,0,0,1
61598,0,1,0,0,1
61599,0,1,0,0,1
61600,0,1,0,0,1
61601,0,1,0,0,1
61602,0,1,0,0,1
61603,0,1,0,0,1
61604,0,1,0,0,1
61605,0,1,0,0,1
61606,0,1,0,0,1
61607,0,1,0,0,1
61608,0,1,0,0,1
61609,0,1,0,0,1
61610,0,1,0,0,1
61611,0,1,0,0,1
61612,0,1,0,0,1
61613,0,1,0,0,1
61614,0,1,0,0,1
61615,0,1,0,0,1
61616,0,1,0,0,1
61617,0,1,0,0,1
61618,1,0,0,0,1
61619,0,1,0,0,1
61620,0,1,0,0,1
61621,0,1,0,0,1
61622,0,1,0,0,1
61623,0,1,0,0,1
61624,1,0,0,0,1
61625,0,1,0,0,1
61626,0,1,0,0,1
61627,0,1,0,0,1
61628,0,1,0,0,1
61629,0,1,0,0,1
61630,1,0,0,0,1
61631,0,1,0,0,1
61632,0,1,0,0,1
61633,0,1,0,0,1
61634,0,0,0,1,1
61635,0,0,0,1,1
61636,1,0,0,0,1
61637,1,0,0,0,1
61638,0,1,0,0,1
61639,0,1,0,0,1
61640,0,1,0,0,1
61641,0,1,0,0,1
61642,0,1,0,0,1
61643,0,1,0,0,1
61644,0,1,0,0,1
61645,0,1,0,0,1
61646,1,0,0,0,1
61647,0,1,0,0,1
61648,0,1,0,0,1
61649,0,1,0,0,1
61650,0,1,0,0,1
61651,0,1,0,0,1
61652,0,1,0,0,1
61653,0,1,0,0,1
61654,0,1,0,0,1
61655,0,1,0,0,1
61656,0,1,0,0,1
61657,0,0,0,1,1
61658,0,0,0,1,1
61659,0,1,0,0,1
61660,0,1,0,0,1
61661,1,0,0,0,1
61662,0,1,0,0,1
61663,1,0,0,0,1
61664,0,1,0,0,1
61665,1,0,0,0,1
61666,0,1,0,0,1
61667,0,0,0,1,1
61668,0,1,0,0,1
61669,0,1,0,0,1
61670,0,1,0,0,1
61671,1,0,0,0,1
61672,0,1,0,0,1
61673,1,0,0,0,1
61674,0,1,0,0,1
61675,0,1,0,0,1
61676,0,1,0,0,1
61677,0,1,0,0,1
61678,0,1,0,0,1
61679,0,1,0,0,1
61680,0,1,0,0,1
61681,0,1,0,0,1
61682,0,1,0,0,1
61683,0,1,0,0,1
61684,0,1,0,0,1
61685,0,1,0,0,1
61686,1,0,0,0,1
61687,0,1,0,0,1
61688,0,1,0,0,1
61689,0,1,0,0,1
61690,1,0,0,0,1
61691,0,1,0,0,1
61692,0,1,0,0,1
61693,1,0,0,0,1
61694,0,1,0,0,1
61695,0,1,0,0,1
61696,0,1,0,0,1
61697,0,1,0,0,1
61698,0,1,0,0,1
61699,0,1,0,0,1
61700,0,1,0,0,1
61701,0,1,0,0,1
61702,0,1,0,0,1
61703,0,1,0,0,1
61704,0,1,0,0,1
61705,0,1,0,0,1
61706,0,1,0,0,1
61707,0,1,0,0,1
61708,0,1,0,0,1
61709,0,1,0,0,1
61710,0,1,0,0,1
61711,1,0,0,0,1
61712,0,1,0,0,1
61713,0,0,1,0,1
61714,0,1,0,0,1
61715,0,1,0,0,1
61716,0,1,0,0,1
61717,1,0,0,0,1
61718,0,1,0,0,1
61719,0,1,0,0,1
61720,0,1,0,0,1
61721,0,1,0,0,1
61722,0,1,0,0,1
61723,0,1,0,0,1
61724,1,0,0,0,1
61725,0,1,0,0,1
61726,1,0,0,0,1
61727,0,1,0,0,1
61728,0,1,0,0,1
61729,1,0,0,0,1
61730,0,1,0,0,1
61731,0,1,0,0,1
61732,0,0,1,0,1
61733,1,0,0,0,1
61734,0,1,0,0,1
61735,0,1,0,0,1
61736,0,1,0,0,1
61737,0,1,0,0,1
61738,0,1,0,0,1
61739,0,1,0,0,1
61740,1,0,0,0,1
61741,0,1,0,0,1
61742,0,1,0,0,1
61743,0,1,0,0,1
61744,0,1,0,0,1
61745,0,1,0,0,1
61746,0,1,0,0,1
61747,1,0,0,0,1
61748,0,1,0,0,1
61749,0,1,0,0,1
61750,0,1,0,0,1
61751,0,1,0,0,1
61752,0,1,0,0,1
61753,0,1,0,0,1
61754,0,1,0,0,1
61755,0,1,0,0,1
61756,0,1,0,0,1
61757,0,1,0,0,1
61758,0,1,0,0,1
61759,0,1,0,0,1
61760,1,0,0,0,1
61761,0,1,0,0,1
61762,0,1,0,0,1
61763,0,1,0,0,1
61764,0,1,0,0,1
61765,0,1,0,0,1
61766,0,1,0,0,1
61767,1,0,0,0,1
61768,0,1,0,0,1
61769,0,1,0,0,1
61770,1,0,0,0,1
61771,0,1,0,0,1
61772,0,1,0,0,1
61773,0,1,0,0,1
61774,0,1,0,0,1
61775,0,1,0,0,1
61776,0,1,0,0,1
61777,0,1,0,0,1
61778,0,1,0,0,1
61779,0,0,1,0,1
61780,0,1,0,0,1
61781,0,1,0,0,1
61782,0,1,0,0,1
61783,1,0,0,0,1
61784,0,1,0,0,1
61785,0,1,0,0,1
61786,0,1,0,0,1
61787,0,1,0,0,1
61788,0,1,0,0,1
61789,0,1,0,0,1
61790,0,1,0,0,1
61791,0,1,0,0,1
61792,1,0,0,0,1
61793,0,1,0,0,1
61794,0,1,0,0,1
61795,0,1,0,0,1
61796,0,1,0,0,1
61797,1,0,0,0,1
61798,0,0,0,1,1
61799,0,1,0,0,1
61800,0,1,0,0,1
61801,0,1,0,0,1
61802,0,1,0,0,1
61803,0,1,0,0,1
61804,0,1,0,0,1
61805,0,1,0,0,1
61806,0,1,0,0,1
61807,1,0,0,0,1
61808,1,0,0,0,1
61809,0,0,1,0,1
61810,0,1,0,0,1
61811,1,0,0,0,1
61812,0,1,0,0,1
61813,0,1,0,0,1
61814,1,0,0,0,1
61815,0,1,0,0,1
61816,0,1,0,0,1
61817,0,1,0,0,1
61818,0,1,0,0,1
61819,0,1,0,0,1
61820,0,1,0,0,1
61821,0,1,0,0,1
61822,0,1,0,0,1
61823,0,1,0,0,1
61824,0,1,0,0,1
61825,1,0,0,0,1
61826,0,1,0,0,1
61827,1,0,0,0,1
61828,0,1,0,0,1
61829,0,1,0,0,1
61830,0,1,0,0,1
61831,0,1,0,0,1
61832,0,1,0,0,1
61833,0,1,0,0,1
61834,0,1,0,0,1
61835,0,1,0,0,1
61836,1,0,0,0,1
61837,0,1,0,0,1
61838,0,1,0,0,1
61839,0,1,0,0,1
61840,0,0,0,1,1
61841,0,1,0,0,1
61842,0,1,0,0,1
61843,0,1,0,0,1
61844,0,1,0,0,1
61845,0,1,0,0,1
61846,0,1,0,0,1
61847,0,1,0,0,1
61848,0,1,0,0,1
61849,0,1,0,0,1
61850,0,1,0,0,1
61851,1,0,0,0,1
61852,0,1,0,0,1
61853,0,1,0,0,1
61854,0,1,0,0,1
61855,0,1,0,0,1
61856,1,0,0,0,1
61857,0,0,1,0,1
61858,0,1,0,0,1
61859,0,1,0,0,1
61860,1,0,0,0,1
61861,0,1,0,0,1
61862,0,1,0,0,1
61863,0,1,0,0,1
61864,1,0,0,0,1
61865,0,1,0,0,1
61866,0,1,0,0,1
61867,0,1,0,0,1
61868,1,0,0,0,1
61869,0,1,0,0,1
61870,0,1,0,0,1
61871,0,1,0,0,1
61872,0,1,0,0,1
61873,0,1,0,0,1
61874,0,1,0,0,1
61875,0,1,0,0,1
61876,1,0,0,0,1
61877,0,1,0,0,1
61878,0,1,0,0,1
61879,0,1,0,0,1
61880,0,1,0,0,1
61881,0,1,0,0,1
61882,0,1,0,0,1
61883,0,1,0,0,1
61884,0,1,0,0,1
61885,0,1,0,0,1
61886,0,0,0,1,1
61887,0,1,0,0,1
61888,0,1,0,0,1
61889,1,0,0,0,1
61890,0,1,0,0,1
61891,0,1,0,0,1
61892,0,1,0,0,1
61893,0,1,0,0,1
61894,0,1,0,0,1
61895,0,1,0,0,1
61896,0,1,0,0,1
61897,0,1,0,0,1
61898,0,1,0,0,1
61899,0,1,0,0,1
61900,0,1,0,0,1
61901,0,1,0,0,1
61902,0,1,0,0,1
61903,0,1,0,0,1
61904,1,0,0,0,1
61905,0,1,0,0,1
61906,0,1,0,0,1
61907,0,1,0,0,1
61908,0,1,0,0,1
61909,0,1,0,0,1
61910,0,1,0,0,1
61911,0,1,0,0,1
61912,0,1,0,0,1
61913,0,0,1,0,1
61914,0,1,0,0,1
61915,0,1,0,0,1
61916,1,0,0,0,1
61917,0,1,0,0,1
61918,0,1,0,0,1
61919,0,1,0,0,1
61920,0,1,0,0,1
61921,0,1,0,0,1
61922,0,1,0,0,1
61923,1,0,0,0,1
61924,0,1,0,0,1
61925,1,0,0,0,1
61926,0,0,0,1,1
61927,0,1,0,0,1
61928,0,1,0,0,1
61929,0,1,0,0,1
61930,0,1,0,0,1
61931,0,1,0,0,1
61932,0,1,0,0,1
61933,0,1,0,0,1
61934,0,1,0,0,1
61935,0,1,0,0,1
61936,0,1,0,0,1
61937,0,1,0,0,1
61938,0,0,1,0,1
61939,0,1,0,0,1
61940,0,1,0,0,1
61941,0,1,0,0,1
61942,1,0,0,0,1
61943,0,1,0,0,1
61944,0,1,0,0,1
61945,0,1,0,0,1
61946,0,1,0,0,1
61947,0,1,0,0,1
61948,0,1,0,0,1
61949,0,0,1,0,1
61950,0,1,0,0,1
61951,0,1,0,0,1
61952,0,1,0,0,1
61953,1,0,0,0,1
61954,0,1,0,0,1
61955,0,1,0,0,1
61956,0,1,0,0,1
61957,0,1,0,0,1
61958,0,1,0,0,1
61959,0,0,0,1,1
61960,1,0,0,0,1
61961,0,1,0,0,1
61962,0,1,0,0,1
61963,0,1,0,0,1
61964,0,1,0,0,1
61965,1,0,0,0,1
61966,0,1,0,0,1
61967,0,1,0,0,1
61968,0,0,0,1,1
61969,0,1,0,0,1
61970,0,1,0,0,1
61971,0,1,0,0,1
61972,0,1,0,0,1
61973,1,0,0,0,1
61974,1,0,0,0,1
61975,0,1,0,0,1
61976,0,0,1,0,1
61977,0,1,0,0,1
61978,0,1,0,0,1
61979,0,1,0,0,1
61980,0,1,0,0,1
61981,0,1,0,0,1
61982,0,1,0,0,1
61983,0,1,0,0,1
61984,0,1,0,0,1
61985,1,0,0,0,1
61986,0,1,0,0,1
61987,0,1,0,0,1
61988,0,1,0,0,1
61989,0,0,0,1,1
61990,0,1,0,0,1
61991,0,1,0,0,1
61992,1,0,0,0,1
61993,0,1,0,0,1
61994,0,1,0,0,1
61995,0,1,0,0,1
61996,0,1,0,0,1
61997,0,1,0,0,1
61998,0,1,0,0,1
61999,0,1,0,0,1
62000,0,1,0,0,1
62001,0,1,0,0,1
62002,0,0,0,1,1
62003,0,1,0,0,1
62004,0,1,0,0,1
62005,1,0,0,0,1
62006,0,1,0,0,1
62007,1,0,0,0,1
62008,0,1,0,0,1
62009,0,1,0,0,1
62010,0,1,0,0,1
62011,1,0,0,0,1
62012,1,0,0,0,1
62013,0,1,0,0,1
62014,1,0,0,0,1
62015,0,1,0,0,1
62016,1,0,0,0,1
62017,0,1,0,0,1
62018,0,1,0,0,1
62019,0,1,0,0,1
62020,0,1,0,0,1
62021,0,1,0,0,1
62022,0,1,0,0,1
62023,0,1,0,0,1
62024,0,1,0,0,1
62025,0,1,0,0,1
62026,0,1,0,0,1
62027,0,1,0,0,1
62028,0,1,0,0,1
62029,0,1,0,0,1
62030,0,1,0,0,1
62031,0,1,0,0,1
62032,0,1,0,0,1
62033,0,1,0,0,1
62034,0,1,0,0,1
62035,0,1,0,0,1
62036,0,1,0,0,1
62037,0,1,0,0,1
62038,0,1,0,0,1
62039,0,1,0,0,1
62040,0,1,0,0,1
62041,1,0,0,0,1
62042,0,1,0,0,1
62043,0,1,0,0,1
62044,0,1,0,0,1
62045,0,1,0,0,1
62046,0,1,0,0,1
62047,0,1,0,0,1
62048,1,0,0,0,1
62049,1,0,0,0,1
62050,0,0,0,1,1
62051,0,1,0,0,1
62052,0,1,0,0,1
62053,0,1,0,0,1
62054,0,1,0,0,1
62055,1,0,0,0,1
62056,1,0,0,0,1
62057,1,0,0,0,1
62058,0,0,0,1,1
62059,0,1,0,0,1
62060,0,1,0,0,1
62061,1,0,0,0,1
62062,1,0,0,0,1
62063,0,1,0,0,1
62064,0,1,0,0,1
62065,0,1,0,0,1
62066,0,1,0,0,1
62067,0,1,0,0,1
62068,0,1,0,0,1
62069,0,1,0,0,1
62070,0,1,0,0,1
62071,0,1,0,0,1
62072,0,1,0,0,1
62073,0,1,0,0,1
62074,1,0,0,0,1
62075,0,1,0,0,1
62076,0,1,0,0,1
62077,0,1,0,0,1
62078,0,1,0,0,1
62079,0,1,0,0,1
62080,1,0,0,0,1
62081,0,1,0,0,1
62082,1,0,0,0,1
62083,0,1,0,0,1
62084,0,1,0,0,1
62085,1,0,0,0,1
62086,0,1,0,0,1
62087,0,1,0,0,1
62088,0,1,0,0,1
62089,0,1,0,0,1
62090,0,1,0,0,1
62091,1,0,0,0,1
62092,0,1,0,0,1
62093,0,1,0,0,1
62094,1,0,0,0,1
62095,0,1,0,0,1
62096,0,1,0,0,1
62097,1,0,0,0,1
62098,0,1,0,0,1
62099,0,1,0,0,1
62100,0,1,0,0,1
62101,0,1,0,0,1
62102,0,1,0,0,1
62103,0,1,0,0,1
62104,0,1,0,0,1
62105,1,0,0,0,1
62106,0,1,0,0,1
62107,0,1,0,0,1
62108,0,1,0,0,1
62109,0,1,0,0,1
62110,0,1,0,0,1
62111,0,1,0,0,1
62112,1,0,0,0,1
62113,0,1,0,0,1
62114,0,1,0,0,1
62115,0,1,0,0,1
62116,0,1,0,0,1
62117,0,1,0,0,1
62118,0,1,0,0,1
62119,0,1,0,0,1
62120,0,1,0,0,1
62121,0,1,0,0,1
62122,0,1,0,0,1
62123,0,1,0,0,1
62124,0,1,0,0,1
62125,0,0,0,1,1
62126,0,1,0,0,1
62127,1,0,0,0,1
62128,1,0,0,0,1
62129,0,1,0,0,1
62130,0,1,0,0,1
62131,0,1,0,0,1
62132,0,1,0,0,1
62133,0,1,0,0,1
62134,0,1,0,0,1
62135,0,1,0,0,1
62136,1,0,0,0,1
62137,0,1,0,0,1
62138,0,1,0,0,1
62139,0,1,0,0,1
62140,0,1,0,0,1
62141,0,1,0,0,1
62142,0,1,0,0,1
62143,1,0,0,0,1
62144,0,1,0,0,1
62145,0,1,0,0,1
62146,0,1,0,0,1
62147,0,1,0,0,1
62148,0,1,0,0,1
62149,0,0,1,0,1
62150,0,0,1,0,1
62151,0,1,0,0,1
62152,0,1,0,0,1
62153,0,1,0,0,1
62154,0,1,0,0,1
62155,0,1,0,0,1
62156,0,1,0,0,1
62157,1,0,0,0,1
62158,0,1,0,0,1
62159,0,1,0,0,1
62160,0,1,0,0,1
62161,0,0,0,1,1
62162,0,1,0,0,1
62163,0,1,0,0,1
62164,0,1,0,0,1
62165,0,1,0,0,1
62166,0,1,0,0,1
62167,0,1,0,0,1
62168,0,1,0,0,1
62169,0,1,0,0,1
62170,1,0,0,0,1
62171,0,1,0,0,1
62172,0,1,0,0,1
62173,0,1,0,0,1
62174,0,1,0,0,1
62175,0,1,0,0,1
62176,0,1,0,0,1
62177,0,1,0,0,1
62178,0,1,0,0,1
62179,0,0,1,0,1
62180,0,1,0,0,1
62181,0,1,0,0,1
62182,0,1,0,0,1
62183,0,1,0,0,1
62184,0,1,0,0,1
62185,0,1,0,0,1
62186,0,1,0,0,1
62187,0,1,0,0,1
62188,0,1,0,0,1
62189,0,1,0,0,1
62190,0,1,0,0,1
62191,0,1,0,0,1
62192,0,1,0,0,1
62193,0,1,0,0,1
62194,0,1,0,0,1
62195,0,1,0,0,1
62196,0,1,0,0,1
62197,0,1,0,0,1
62198,0,1,0,0,1
62199,0,1,0,0,1
62200,0,1,0,0,1
62201,0,0,1,0,1
62202,1,0,0,0,1
62203,1,0,0,0,1
62204,0,1,0,0,1
62205,0,1,0,0,1
62206,0,1,0,0,1
62207,0,1,0,0,1
62208,1,0,0,0,1
62209,0,1,0,0,1
62210,0,1,0,0,1
62211,0,1,0,0,1
62212,0,1,0,0,1
62213,0,1,0,0,1
62214,0,1,0,0,1
62215,0,1,0,0,1
62216,0,1,0,0,1
62217,0,1,0,0,1
62218,0,1,0,0,1
62219,0,1,0,0,1
62220,0,1,0,0,1
62221,0,1,0,0,1
62222,0,1,0,0,1
62223,1,0,0,0,1
62224,0,1,0,0,1
62225,0,1,0,0,1
62226,1,0,0,0,1
62227,0,1,0,0,1
62228,0,1,0,0,1
62229,0,1,0,0,1
62230,0,1,0,0,1
62231,1,0,0,0,1
62232,0,1,0,0,1
62233,0,1,0,0,1
62234,0,0,0,1,1
62235,0,1,0,0,1
62236,0,1,0,0,1
62237,0,1,0,0,1
62238,0,1,0,0,1
62239,1,0,0,0,1
62240,0,1,0,0,1
62241,0,0,0,1,1
62242,0,1,0,0,1
62243,1,0,0,0,1
62244,0,0,0,1,1
62245,0,1,0,0,1
62246,1,0,0,0,1
62247,0,1,0,0,1
62248,0,1,0,0,1
62249,0,1,0,0,1
62250,0,1,0,0,1
62251,1,0,0,0,1
62252,0,1,0,0,1
62253,1,0,0,0,1
62254,0,1,0,0,1
62255,0,1,0,0,1
62256,0,1,0,0,1
62257,0,1,0,0,1
62258,0,1,0,0,1
62259,0,1,0,0,1
62260,0,1,0,0,1
62261,0,1,0,0,1
62262,0,1,0,0,1
62263,0,1,0,0,1
62264,0,1,0,0,1
62265,0,1,0,0,1
62266,0,1,0,0,1
62267,0,1,0,0,1
62268,0,1,0,0,1
62269,0,1,0,0,1
62270,0,1,0,0,1
62271,0,1,0,0,1
62272,0,1,0,0,1
62273,0,1,0,0,1
62274,0,1,0,0,1
62275,0,1,0,0,1
62276,0,1,0,0,1
62277,0,0,1,0,1
62278,0,1,0,0,1
62279,0,1,0,0,1
62280,0,1,0,0,1
62281,0,1,0,0,1
62282,1,0,0,0,1
62283,1,0,0,0,1
62284,0,1,0,0,1
62285,0,1,0,0,1
62286,0,1,0,0,1
62287,0,1,0,0,1
62288,0,1,0,0,1
62289,0,1,0,0,1
62290,0,1,0,0,1
62291,0,1,0,0,1
62292,0,1,0,0,1
62293,1,0,0,0,1
62294,0,1,0,0,1
62295,1,0,0,0,1
62296,1,0,0,0,1
62297,1,0,0,0,1
62298,0,1,0,0,1
62299,0,1,0,0,1
62300,0,1,0,0,1
62301,0,1,0,0,1
62302,1,0,0,0,1
62303,0,1,0,0,1
62304,1,0,0,0,1
62305,0,1,0,0,1
62306,0,1,0,0,1
62307,0,1,0,0,1
62308,0,0,1,0,1
62309,0,1,0,0,1
62310,1,0,0,0,1
62311,0,1,0,0,1
62312,0,1,0,0,1
62313,1,0,0,0,1
62314,0,1,0,0,1
62315,0,1,0,0,1
62316,1,0,0,0,1
62317,0,1,0,0,1
62318,0,1,0,0,1
62319,0,1,0,0,1
62320,0,1,0,0,1
62321,0,1,0,0,1
62322,0,1,0,0,1
62323,0,1,0,0,1
62324,0,1,0,0,1
62325,0,1,0,0,1
62326,0,1,0,0,1
62327,0,1,0,0,1
62328,0,1,0,0,1
62329,0,1,0,0,1
62330,0,1,0,0,1
62331,0,1,0,0,1
62332,1,0,0,0,1
62333,0,1,0,0,1
62334,0,1,0,0,1
62335,0,1,0,0,1
62336,0,1,0,0,1
62337,0,1,0,0,1
62338,0,1,0,0,1
62339,0,1,0,0,1
62340,0,1,0,0,1
62341,0,1,0,0,1
62342,0,1,0,0,1
62343,0,1,0,0,1
62344,0,1,0,0,1
62345,0,1,0,0,1
62346,0,1,0,0,1
62347,0,1,0,0,1
62348,0,1,0,0,1
62349,0,1,0,0,1
62350,0,1,0,0,1
62351,0,0,0,1,1
62352,0,1,0,0,1
62353,1,0,0,0,1
62354,0,1,0,0,1
62355,1,0,0,0,1
62356,0,1,0,0,1
62357,1,0,0,0,1
62358,0,1,0,0,1
62359,0,1,0,0,1
62360,0,1,0,0,1
62361,0,1,0,0,1
62362,0,1,0,0,1
62363,0,1,0,0,1
62364,0,1,0,0,1
62365,1,0,0,0,1
62366,0,1,0,0,1
62367,0,1,0,0,1
62368,0,1,0,0,1
62369,0,1,0,0,1
62370,0,1,0,0,1
62371,0,1,0,0,1
62372,0,0,1,0,1
62373,0,0,0,1,1
62374,0,1,0,0,1
62375,0,1,0,0,1
62376,0,1,0,0,1
62377,0,1,0,0,1
62378,1,0,0,0,1
62379,1,0,0,0,1
62380,0,1,0,0,1
62381,0,1,0,0,1
62382,1,0,0,0,1
62383,0,1,0,0,1
62384,0,1,0,0,1
62385,1,0,0,0,1
62386,0,1,0,0,1
62387,0,1,0,0,1
62388,0,1,0,0,1
62389,0,1,0,0,1
62390,1,0,0,0,1
62391,0,1,0,0,1
62392,0,1,0,0,1
62393,0,1,0,0,1
62394,0,1,0,0,1
62395,1,0,0,0,1
62396,0,1,0,0,1
62397,0,1,0,0,1
62398,0,1,0,0,1
62399,0,1,0,0,1
62400,0,1,0,0,1
62401,0,1,0,0,1
62402,0,1,0,0,1
62403,0,1,0,0,1
62404,0,1,0,0,1
62405,0,1,0,0,1
62406,0,1,0,0,1
62407,0,1,0,0,1
62408,0,1,0,0,1
62409,0,1,0,0,1
62410,1,0,0,0,1
62411,0,1,0,0,1
62412,0,1,0,0,1
62413,0,1,0,0,1
62414,0,1,0,0,1
62415,0,1,0,0,1
62416,0,1,0,0,1
62417,1,0,0,0,1
62418,0,1,0,0,1
62419,0,0,0,1,1
62420,1,0,0,0,1
62421,0,1,0,0,1
62422,0,1,0,0,1
62423,0,1,0,0,1
62424,0,1,0,0,1
62425,0,1,0,0,1
62426,0,1,0,0,1
62427,0,1,0,0,1
62428,0,1,0,0,1
62429,0,0,0,1,1
62430,0,1,0,0,1
62431,0,1,0,0,1
62432,1,0,0,0,1
62433,0,1,0,0,1
62434,0,1,0,0,1
62435,0,1,0,0,1
62436,1,0,0,0,1
62437,0,1,0,0,1
62438,0,1,0,0,1
62439,0,1,0,0,1
62440,0,1,0,0,1
62441,0,1,0,0,1
62442,0,1,0,0,1
62443,0,1,0,0,1
62444,0,1,0,0,1
62445,0,1,0,0,1
62446,1,0,0,0,1
62447,1,0,0,0,1
62448,0,1,0,0,1
62449,0,1,0,0,1
62450,0,1,0,0,1
62451,0,1,0,0,1
62452,0,1,0,0,1
62453,0,1,0,0,1
62454,0,1,0,0,1
62455,1,0,0,0,1
62456,0,1,0,0,1
62457,1,0,0,0,1
62458,0,1,0,0,1
62459,0,1,0,0,1
62460,0,1,0,0,1
62461,0,1,0,0,1
62462,0,1,0,0,1
62463,0,1,0,0,1
62464,0,1,0,0,1
62465,0,1,0,0,1
62466,0,1,0,0,1
62467,0,1,0,0,1
62468,0,1,0,0,1
62469,1,0,0,0,1
62470,0,1,0,0,1
62471,0,1,0,0,1
62472,1,0,0,0,1
62473,0,1,0,0,1
62474,0,1,0,0,1
62475,0,1,0,0,1
62476,0,1,0,0,1
62477,0,1,0,0,1
62478,0,1,0,0,1
62479,0,1,0,0,1
62480,1,0,0,0,1
62481,1,0,0,0,1
62482,0,1,0,0,1
62483,1,0,0,0,1
62484,0,1,0,0,1
62485,0,1,0,0,1
62486,1,0,0,0,1
62487,1,0,0,0,1
62488,0,1,0,0,1
62489,0,1,0,0,1
62490,0,1,0,0,1
62491,0,1,0,0,1
62492,0,1,0,0,1
62493,0,1,0,0,1
62494,0,1,0,0,1
62495,0,1,0,0,1
62496,0,1,0,0,1
62497,0,1,0,0,1
62498,0,1,0,0,1
62499,0,1,0,0,1
62500,0,0,0,1,1
62501,0,1,0,0,1
62502,0,1,0,0,1
62503,0,1,0,0,1
62504,1,0,0,0,1
62505,0,1,0,0,1
62506,1,0,0,0,1
62507,0,0,1,0,1
62508,0,1,0,0,1
62509,0,1,0,0,1
62510,0,1,0,0,1
62511,0,1,0,0,1
62512,0,1,0,0,1
62513,1,0,0,0,1
62514,0,1,0,0,1
62515,0,1,0,0,1
62516,0,0,0,1,1
62517,0,1,0,0,1
62518,0,1,0,0,1
62519,0,1,0,0,1
62520,0,1,0,0,1
62521,0,1,0,0,1
62522,1,0,0,0,1
62523,0,1,0,0,1
62524,0,1,0,0,1
62525,0,1,0,0,1
62526,1,0,0,0,1
62527,0,1,0,0,1
62528,1,0,0,0,1
62529,0,1,0,0,1
62530,1,0,0,0,1
62531,0,1,0,0,1
62532,0,1,0,0,1
62533,0,1,0,0,1
62534,0,1,0,0,1
62535,1,0,0,0,1
62536,0,1,0,0,1
62537,0,1,0,0,1
62538,0,1,0,0,1
62539,0,0,0,1,1
62540,0,1,0,0,1
62541,0,1,0,0,1
62542,0,1,0,0,1
62543,0,1,0,0,1
62544,0,1,0,0,1
62545,0,0,1,0,1
62546,0,1,0,0,1
62547,0,1,0,0,1
62548,0,1,0,0,1
62549,1,0,0,0,1
62550,0,1,0,0,1
62551,0,1,0,0,1
62552,0,0,0,1,1
62553,0,1,0,0,1
62554,0,1,0,0,1
62555,0,1,0,0,1
62556,0,1,0,0,1
62557,0,1,0,0,1
62558,0,1,0,0,1
62559,0,1,0,0,1
62560,0,1,0,0,1
62561,0,1,0,0,1
62562,0,1,0,0,1
62563,0,1,0,0,1
62564,0,1,0,0,1
62565,0,1,0,0,1
62566,0,1,0,0,1
62567,0,1,0,0,1
62568,0,1,0,0,1
62569,0,1,0,0,1
62570,1,0,0,0,1
62571,0,0,1,0,1
62572,0,0,0,1,1
62573,0,1,0,0,1
62574,0,1,0,0,1
62575,0,1,0,0,1
62576,0,1,0,0,1
62577,1,0,0,0,1
62578,0,1,0,0,1
62579,0,1,0,0,1
62580,0,0,1,0,1
62581,0,1,0,0,1
62582,0,1,0,0,1
62583,0,1,0,0,1
62584,0,1,0,0,1
62585,0,1,0,0,1
62586,0,1,0,0,1
62587,0,1,0,0,1
62588,1,0,0,0,1
62589,0,1,0,0,1
62590,0,1,0,0,1
62591,0,1,0,0,1
62592,0,1,0,0,1
62593,1,0,0,0,1
62594,0,1,0,0,1
62595,0,1,0,0,1
62596,0,1,0,0,1
62597,0,1,0,0,1
62598,0,1,0,0,1
62599,0,1,0,0,1
62600,0,1,0,0,1
62601,0,1,0,0,1
62602,0,1,0,0,1
62603,0,1,0,0,1
62604,0,1,0,0,1
62605,0,1,0,0,1
62606,1,0,0,0,1
62607,0,0,0,1,1
62608,0,0,1,0,1
62609,0,1,0,0,1
62610,0,0,0,1,1
62611,0,1,0,0,1
62612,0,1,0,0,1
62613,0,0,0,1,1
62614,0,0,0,1,1
62615,0,1,0,0,1
62616,0,1,0,0,1
62617,0,0,1,0,1
62618,0,1,0,0,1
62619,0,1,0,0,1
62620,0,1,0,0,1
62621,0,1,0,0,1
62622,1,0,0,0,1
62623,0,1,0,0,1
62624,0,1,0,0,1
62625,1,0,0,0,1
62626,0,1,0,0,1
62627,0,1,0,0,1
62628,0,1,0,0,1
62629,0,1,0,0,1
62630,1,0,0,0,1
62631,1,0,0,0,1
62632,1,0,0,0,1
62633,0,1,0,0,1
62634,0,1,0,0,1
62635,0,0,0,1,1
62636,0,1,0,0,1
62637,0,1,0,0,1
62638,0,1,0,0,1
62639,0,1,0,0,1
62640,0,0,0,1,1
62641,1,0,0,0,1
62642,0,1,0,0,1
62643,0,0,0,1,1
62644,0,1,0,0,1
62645,0,1,0,0,1
62646,1,0,0,0,1
62647,0,1,0,0,1
62648,0,1,0,0,1
62649,0,1,0,0,1
62650,0,1,0,0,1
62651,0,1,0,0,1
62652,0,1,0,0,1
62653,0,1,0,0,1
62654,0,1,0,0,1
62655,0,1,0,0,1
62656,0,1,0,0,1
62657,0,1,0,0,1
62658,0,1,0,0,1
62659,0,1,0,0,1
62660,0,1,0,0,1
62661,0,0,0,1,1
62662,0,1,0,0,1
62663,0,1,0,0,1
62664,1,0,0,0,1
62665,0,1,0,0,1
62666,0,1,0,0,1
62667,0,1,0,0,1
62668,0,1,0,0,1
62669,0,1,0,0,1
62670,1,0,0,0,1
62671,0,1,0,0,1
62672,0,1,0,0,1
62673,0,1,0,0,1
62674,0,1,0,0,1
62675,0,1,0,0,1
62676,0,1,0,0,1
62677,0,1,0,0,1
62678,0,1,0,0,1
62679,1,0,0,0,1
62680,0,1,0,0,1
62681,0,1,0,0,1
62682,0,1,0,0,1
62683,0,1,0,0,1
62684,0,1,0,0,1
62685,0,1,0,0,1
62686,0,1,0,0,1
62687,0,1,0,0,1
62688,1,0,0,0,1
62689,0,1,0,0,1
62690,0,1,0,0,1
62691,0,1,0,0,1
62692,0,1,0,0,1
62693,0,1,0,0,1
62694,1,0,0,0,1
62695,0,1,0,0,1
62696,0,1,0,0,1
62697,0,1,0,0,1
62698,0,1,0,0,1
62699,0,1,0,0,1
62700,0,0,0,1,1
62701,0,1,0,0,1
62702,0,1,0,0,1
62703,0,1,0,0,1
62704,0,1,0,0,1
62705,0,1,0,0,1
62706,0,1,0,0,1
62707,0,1,0,0,1
62708,0,0,1,0,1
62709,0,1,0,0,1
62710,1,0,0,0,1
62711,0,1,0,0,1
62712,0,0,1,0,1
62713,0,1,0,0,1
62714,1,0,0,0,1
62715,0,1,0,0,1
62716,0,1,0,0,1
62717,0,1,0,0,1
62718,0,1,0,0,1
62719,0,1,0,0,1
62720,1,0,0,0,1
62721,0,1,0,0,1
62722,0,1,0,0,1
62723,0,1,0,0,1
62724,0,1,0,0,1
62725,0,1,0,0,1
62726,0,1,0,0,1
62727,0,1,0,0,1
62728,0,1,0,0,1
62729,0,0,0,1,1
62730,0,1,0,0,1
62731,1,0,0,0,1
62732,0,1,0,0,1
62733,0,1,0,0,1
62734,0,1,0,0,1
62735,0,1,0,0,1
62736,0,1,0,0,1
62737,0,1,0,0,1
62738,0,1,0,0,1
62739,0,1,0,0,1
62740,0,1,0,0,1
62741,0,1,0,0,1
62742,1,0,0,0,1
62743,0,1,0,0,1
62744,0,1,0,0,1
62745,0,0,0,1,1
62746,0,1,0,0,1
62747,0,1,0,0,1
62748,0,1,0,0,1
62749,0,1,0,0,1
62750,0,1,0,0,1
62751,0,1,0,0,1
62752,0,1,0,0,1
62753,0,1,0,0,1
62754,0,1,0,0,1
62755,0,1,0,0,1
62756,0,1,0,0,1
62757,0,1,0,0,1
62758,0,1,0,0,1
62759,0,1,0,0,1
62760,1,0,0,0,1
62761,0,1,0,0,1
62762,0,1,0,0,1
62763,0,1,0,0,1
62764,0,1,0,0,1
62765,1,0,0,0,1
62766,0,1,0,0,1
62767,0,1,0,0,1
62768,0,0,0,1,1
62769,0,1,0,0,1
62770,0,1,0,0,1
62771,1,0,0,0,1
62772,0,1,0,0,1
62773,1,0,0,0,1
62774,0,1,0,0,1
62775,0,1,0,0,1
62776,0,1,0,0,1
62777,0,1,0,0,1
62778,0,1,0,0,1
62779,0,1,0,0,1
62780,1,0,0,0,1
62781,0,1,0,0,1
62782,0,1,0,0,1
62783,0,1,0,0,1
62784,0,1,0,0,1
62785,0,1,0,0,1
62786,0,1,0,0,1
62787,0,1,0,0,1
62788,0,0,1,0,1
62789,0,1,0,0,1
62790,0,1,0,0,1
62791,0,1,0,0,1
62792,0,1,0,0,1
62793,0,1,0,0,1
62794,0,1,0,0,1
62795,0,1,0,0,1
62796,0,1,0,0,1
62797,0,1,0,0,1
62798,0,1,0,0,1
62799,0,1,0,0,1
62800,0,1,0,0,1
62801,0,1,0,0,1
62802,0,1,0,0,1
62803,0,1,0,0,1
62804,1,0,0,0,1
62805,0,1,0,0,1
62806,0,1,0,0,1
62807,1,0,0,0,1
62808,0,1,0,0,1
62809,0,1,0,0,1
62810,0,1,0,0,1
62811,0,1,0,0,1
62812,1,0,0,0,1
62813,0,1,0,0,1
62814,0,1,0,0,1
62815,0,1,0,0,1
62816,0,1,0,0,1
62817,0,1,0,0,1
62818,0,1,0,0,1
62819,0,0,0,1,1
62820,0,1,0,0,1
62821,0,1,0,0,1
62822,0,1,0,0,1
62823,0,1,0,0,1
62824,0,1,0,0,1
62825,0,1,0,0,1
62826,0,1,0,0,1
62827,0,1,0,0,1
62828,0,1,0,0,1
62829,0,1,0,0,1
62830,0,1,0,0,1
62831,1,0,0,0,1
62832,0,1,0,0,1
62833,0,1,0,0,1
62834,1,0,0,0,1
62835,0,1,0,0,1
62836,0,1,0,0,1
62837,0,0,1,0,1
62838,0,1,0,0,1
62839,0,1,0,0,1
62840,0,1,0,0,1
62841,0,1,0,0,1
62842,0,1,0,0,1
62843,0,1,0,0,1
62844,0,0,0,1,1
62845,0,0,1,0,1
62846,0,1,0,0,1
62847,0,1,0,0,1
62848,0,1,0,0,1
62849,1,0,0,0,1
62850,0,1,0,0,1
62851,0,1,0,0,1
62852,0,1,0,0,1
62853,1,0,0,0,1
62854,0,1,0,0,1
62855,1,0,0,0,1
62856,0,1,0,0,1
62857,1,0,0,0,1
62858,0,1,0,0,1
62859,0,1,0,0,1
62860,0,1,0,0,1
62861,0,1,0,0,1
62862,0,1,0,0,1
62863,0,1,0,0,1
62864,1,0,0,0,1
62865,0,0,1,0,1
62866,1,0,0,0,1
62867,0,1,0,0,1
62868,0,1,0,0,1
62869,1,0,0,0,1
62870,1,0,0,0,1
62871,1,0,0,0,1
62872,0,1,0,0,1
62873,0,1,0,0,1
62874,0,0,1,0,1
62875,0,1,0,0,1
62876,0,1,0,0,1
62877,0,1,0,0,1
62878,1,0,0,0,1
62879,0,0,1,0,1
62880,1,0,0,0,1
62881,0,1,0,0,1
62882,0,1,0,0,1
62883,0,1,0,0,1
62884,0,1,0,0,1
62885,1,0,0,0,1
62886,0,1,0,0,1
62887,0,1,0,0,1
62888,0,1,0,0,1
62889,0,1,0,0,1
62890,0,1,0,0,1
62891,0,1,0,0,1
62892,0,1,0,0,1
62893,0,1,0,0,1
62894,0,1,0,0,1
62895,1,0,0,0,1
62896,0,1,0,0,1
62897,0,1,0,0,1
62898,0,1,0,0,1
62899,0,1,0,0,1
62900,0,1,0,0,1
62901,0,1,0,0,1
62902,0,1,0,0,1
62903,0,1,0,0,1
62904,0,1,0,0,1
62905,0,1,0,0,1
62906,0,1,0,0,1
62907,0,1,0,0,1
62908,0,1,0,0,1
62909,0,1,0,0,1
62910,0,1,0,0,1
62911,0,1,0,0,1
62912,0,1,0,0,1
62913,0,1,0,0,1
62914,0,1,0,0,1
62915,0,1,0,0,1
62916,0,1,0,0,1
62917,0,1,0,0,1
62918,0,1,0,0,1
62919,0,1,0,0,1
62920,0,1,0,0,1
62921,1,0,0,0,1
62922,0,1,0,0,1
62923,0,1,0,0,1
62924,0,0,0,1,1
62925,0,1,0,0,1
62926,0,1,0,0,1
62927,0,1,0,0,1
62928,0,1,0,0,1
62929,0,1,0,0,1
62930,0,1,0,0,1
62931,0,1,0,0,1
62932,0,1,0,0,1
62933,0,1,0,0,1
62934,1,0,0,0,1
62935,0,1,0,0,1
62936,0,1,0,0,1
62937,0,1,0,0,1
62938,0,0,0,1,1
62939,0,1,0,0,1
62940,0,1,0,0,1
62941,0,1,0,0,1
62942,0,1,0,0,1
62943,0,1,0,0,1
62944,0,1,0,0,1
62945,0,1,0,0,1
62946,0,1,0,0,1
62947,0,1,0,0,1
62948,0,1,0,0,1
62949,0,1,0,0,1
62950,0,1,0,0,1
62951,0,0,1,0,1
62952,0,1,0,0,1
62953,0,1,0,0,1
62954,1,0,0,0,1
62955,0,1,0,0,1
62956,1,0,0,0,1
62957,0,1,0,0,1
62958,0,1,0,0,1
62959,0,1,0,0,1
62960,0,1,0,0,1
62961,0,1,0,0,1
62962,0,1,0,0,1
62963,0,1,0,0,1
62964,0,1,0,0,1
62965,0,1,0,0,1
62966,0,1,0,0,1
62967,0,1,0,0,1
62968,0,1,0,0,1
62969,0,1,0,0,1
62970,0,1,0,0,1
62971,0,1,0,0,1
62972,0,1,0,0,1
62973,0,1,0,0,1
62974,0,1,0,0,1
62975,0,0,0,1,1
62976,0,1,0,0,1
62977,0,1,0,0,1
62978,0,1,0,0,1
62979,0,1,0,0,1
62980,0,1,0,0,1
62981,0,1,0,0,1
62982,1,0,0,0,1
62983,0,1,0,0,1
62984,0,1,0,0,1
62985,0,1,0,0,1
62986,0,1,0,0,1
62987,1,0,0,0,1
62988,0,1,0,0,1
62989,0,1,0,0,1
62990,0,1,0,0,1
62991,0,1,0,0,1
62992,1,0,0,0,1
62993,0,1,0,0,1
62994,0,1,0,0,1
62995,0,1,0,0,1
62996,0,1,0,0,1
62997,0,1,0,0,1
62998,0,1,0,0,1
62999,0,1,0,0,1
63000,0,1,0,0,1
63001,0,1,0,0,1
63002,0,1,0,0,1
63003,0,1,0,0,1
63004,0,1,0,0,1
63005,0,1,0,0,1
63006,1,0,0,0,1
63007,0,0,1,0,1
63008,0,1,0,0,1
63009,0,0,0,1,1
63010,0,0,1,0,1
63011,0,1,0,0,1
63012,0,1,0,0,1
63013,0,1,0,0,1
63014,1,0,0,0,1
63015,0,1,0,0,1
63016,0,0,1,0,1
63017,0,1,0,0,1
63018,0,1,0,0,1
63019,0,1,0,0,1
63020,0,1,0,0,1
63021,0,1,0,0,1
63022,0,1,0,0,1
63023,0,1,0,0,1
63024,0,1,0,0,1
63025,0,1,0,0,1
63026,0,1,0,0,1
63027,0,1,0,0,1
63028,0,1,0,0,1
63029,0,1,0,0,1
63030,0,0,0,1,1
63031,0,1,0,0,1
63032,0,0,0,1,1
63033,0,1,0,0,1
63034,0,1,0,0,1
63035,1,0,0,0,1
63036,0,1,0,0,1
63037,0,1,0,0,1
63038,0,1,0,0,1
63039,0,1,0,0,1
63040,0,1,0,0,1
63041,0,1,0,0,1
63042,1,0,0,0,1
63043,0,1,0,0,1
63044,0,0,1,0,1
63045,0,0,0,1,1
63046,0,1,0,0,1
63047,0,1,0,0,1
63048,0,0,0,1,1
63049,0,1,0,0,1
63050,0,1,0,0,1
63051,0,1,0,0,1
63052,0,1,0,0,1
63053,0,1,0,0,1
63054,0,1,0,0,1
63055,1,0,0,0,1
63056,0,1,0,0,1
63057,0,0,0,1,1
63058,0,1,0,0,1
63059,0,1,0,0,1
63060,0,1,0,0,1
63061,0,1,0,0,1
63062,0,1,0,0,1
63063,0,1,0,0,1
63064,0,1,0,0,1
63065,0,1,0,0,1
63066,0,1,0,0,1
63067,0,1,0,0,1
63068,0,1,0,0,1
63069,0,1,0,0,1
63070,0,1,0,0,1
63071,0,1,0,0,1
63072,0,1,0,0,1
63073,0,1,0,0,1
63074,0,1,0,0,1
63075,0,1,0,0,1
63076,0,1,0,0,1
63077,0,1,0,0,1
63078,0,1,0,0,1
63079,0,1,0,0,1
63080,0,1,0,0,1
63081,0,1,0,0,1
63082,0,1,0,0,1
63083,0,1,0,0,1
63084,0,1,0,0,1
63085,0,1,0,0,1
63086,0,1,0,0,1
63087,1,0,0,0,1
63088,0,1,0,0,1
63089,0,1,0,0,1
63090,0,1,0,0,1
63091,1,0,0,0,1
63092,0,1,0,0,1
63093,0,1,0,0,1
63094,0,1,0,0,1
63095,0,1,0,0,1
63096,1,0,0,0,1
63097,0,1,0,0,1
63098,0,1,0,0,1
63099,0,1,0,0,1
63100,0,1,0,0,1
63101,0,1,0,0,1
63102,0,1,0,0,1
63103,1,0,0,0,1
63104,0,1,0,0,1
63105,0,1,0,0,1
63106,0,1,0,0,1
63107,0,1,0,0,1
63108,0,1,0,0,1
63109,0,1,0,0,1
63110,0,1,0,0,1
63111,0,1,0,0,1
63112,0,1,0,0,1
63113,0,0,0,1,1
63114,0,1,0,0,1
63115,0,1,0,0,1
63116,0,1,0,0,1
63117,1,0,0,0,1
63118,0,1,0,0,1
63119,0,1,0,0,1
63120,0,1,0,0,1
63121,0,1,0,0,1
63122,0,1,0,0,1
63123,0,1,0,0,1
63124,0,1,0,0,1
63125,0,1,0,0,1
63126,0,1,0,0,1
63127,0,1,0,0,1
63128,0,1,0,0,1
63129,1,0,0,0,1
63130,0,1,0,0,1
63131,1,0,0,0,1
63132,0,1,0,0,1
63133,0,1,0,0,1
63134,0,1,0,0,1
63135,0,1,0,0,1
63136,0,1,0,0,1
63137,0,1,0,0,1
63138,0,1,0,0,1
63139,0,0,1,0,1
63140,0,1,0,0,1
63141,1,0,0,0,1
63142,0,1,0,0,1
63143,0,1,0,0,1
63144,0,1,0,0,1
63145,0,1,0,0,1
63146,1,0,0,0,1
63147,0,1,0,0,1
63148,0,1,0,0,1
63149,0,1,0,0,1
63150,0,1,0,0,1
63151,0,1,0,0,1
63152,0,1,0,0,1
63153,0,1,0,0,1
63154,0,1,0,0,1
63155,0,1,0,0,1
63156,0,1,0,0,1
63157,0,1,0,0,1
63158,0,0,0,1,1
63159,0,1,0,0,1
63160,0,1,0,0,1
63161,0,1,0,0,1
63162,0,1,0,0,1
63163,0,1,0,0,1
63164,0,1,0,0,1
63165,1,0,0,0,1
63166,0,1,0,0,1
63167,0,1,0,0,1
63168,0,1,0,0,1
63169,0,1,0,0,1
63170,0,1,0,0,1
63171,0,0,1,0,1
63172,0,1,0,0,1
63173,1,0,0,0,1
63174,1,0,0,0,1
63175,0,1,0,0,1
63176,1,0,0,0,1
63177,0,1,0,0,1
63178,0,1,0,0,1
63179,0,1,0,0,1
63180,0,1,0,0,1
63181,0,1,0,0,1
63182,0,1,0,0,1
63183,0,1,0,0,1
63184,1,0,0,0,1
63185,1,0,0,0,1
63186,0,1,0,0,1
63187,0,1,0,0,1
63188,0,1,0,0,1
63189,0,1,0,0,1
63190,0,0,0,1,1
63191,0,1,0,0,1
63192,0,1,0,0,1
63193,0,1,0,0,1
63194,0,1,0,0,1
63195,0,0,1,0,1
63196,0,1,0,0,1
63197,0,1,0,0,1
63198,0,1,0,0,1
63199,0,1,0,0,1
63200,0,1,0,0,1
63201,0,1,0,0,1
63202,0,1,0,0,1
63203,0,1,0,0,1
63204,0,1,0,0,1
63205,0,1,0,0,1
63206,0,1,0,0,1
63207,0,1,0,0,1
63208,0,1,0,0,1
63209,0,1,0,0,1
63210,1,0,0,0,1
63211,0,1,0,0,1
63212,0,1,0,0,1
63213,0,1,0,0,1
63214,0,1,0,0,1
63215,0,1,0,0,1
63216,0,1,0,0,1
63217,0,1,0,0,1
63218,0,1,0,0,1
63219,0,1,0,0,1
63220,1,0,0,0,1
63221,0,1,0,0,1
63222,0,1,0,0,1
63223,0,1,0,0,1
63224,0,1,0,0,1
63225,0,1,0,0,1
63226,0,1,0,0,1
63227,1,0,0,0,1
63228,1,0,0,0,1
63229,0,1,0,0,1
63230,1,0,0,0,1
63231,0,1,0,0,1
63232,0,1,0,0,1
63233,0,1,0,0,1
63234,0,1,0,0,1
63235,0,1,0,0,1
63236,0,1,0,0,1
63237,0,1,0,0,1
63238,0,1,0,0,1
63239,0,1,0,0,1
63240,0,1,0,0,1
63241,0,1,0,0,1
63242,0,1,0,0,1
63243,0,1,0,0,1
63244,0,1,0,0,1
63245,0,1,0,0,1
63246,0,1,0,0,1
63247,0,1,0,0,1
63248,0,1,0,0,1
63249,0,1,0,0,1
63250,1,0,0,0,1
63251,0,1,0,0,1
63252,1,0,0,0,1
63253,0,1,0,0,1
63254,0,1,0,0,1
63255,0,1,0,0,1
63256,0,1,0,0,1
63257,0,1,0,0,1
63258,0,1,0,0,1
63259,0,1,0,0,1
63260,0,1,0,0,1
63261,0,1,0,0,1
63262,0,1,0,0,1
63263,0,0,0,1,1
63264,0,1,0,0,1
63265,1,0,0,0,1
63266,0,1,0,0,1
63267,0,1,0,0,1
63268,0,1,0,0,1
63269,0,1,0,0,1
63270,0,1,0,0,1
63271,0,0,1,0,1
63272,0,1,0,0,1
63273,0,1,0,0,1
63274,0,1,0,0,1
63275,0,1,0,0,1
63276,0,0,0,1,1
63277,0,1,0,0,1
63278,0,1,0,0,1
63279,0,1,0,0,1
63280,0,1,0,0,1
63281,0,1,0,0,1
63282,0,1,0,0,1
63283,0,1,0,0,1
63284,1,0,0,0,1
63285,0,1,0,0,1
63286,0,1,0,0,1
63287,0,1,0,0,1
63288,1,0,0,0,1
63289,0,1,0,0,1
63290,0,1,0,0,1
63291,0,1,0,0,1
63292,0,1,0,0,1
63293,0,1,0,0,1
63294,0,1,0,0,1
63295,0,1,0,0,1
63296,0,1,0,0,1
63297,0,1,0,0,1
63298,0,1,0,0,1
63299,0,1,0,0,1
63300,0,1,0,0,1
63301,0,1,0,0,1
63302,0,1,0,0,1
63303,1,0,0,0,1
63304,0,1,0,0,1
63305,0,1,0,0,1
63306,0,1,0,0,1
63307,0,1,0,0,1
63308,0,1,0,0,1
63309,0,1,0,0,1
63310,0,1,0,0,1
63311,0,1,0,0,1
63312,0,1,0,0,1
63313,1,0,0,0,1
63314,0,1,0,0,1
63315,0,1,0,0,1
63316,0,1,0,0,1
63317,0,1,0,0,1
63318,0,1,0,0,1
63319,0,1,0,0,1
63320,0,1,0,0,1
63321,0,1,0,0,1
63322,0,1,0,0,1
63323,1,0,0,0,1
63324,1,0,0,0,1
63325,0,1,0,0,1
63326,0,1,0,0,1
63327,0,1,0,0,1
63328,0,1,0,0,1
63329,0,1,0,0,1
63330,0,0,0,1,1
63331,0,1,0,0,1
63332,0,0,0,1,1
63333,0,1,0,0,1
63334,0,1,0,0,1
63335,0,1,0,0,1
63336,0,1,0,0,1
63337,0,1,0,0,1
63338,0,1,0,0,1
63339,0,1,0,0,1
63340,0,0,1,0,1
63341,0,1,0,0,1
63342,0,1,0,0,1
63343,0,1,0,0,1
63344,0,1,0,0,1
63345,0,1,0,0,1
63346,0,1,0,0,1
63347,0,1,0,0,1
63348,0,1,0,0,1
63349,0,1,0,0,1
63350,0,1,0,0,1
63351,0,1,0,0,1
63352,1,0,0,0,1
63353,0,1,0,0,1
63354,0,1,0,0,1
63355,0,1,0,0,1
63356,0,1,0,0,1
63357,1,0,0,0,1
63358,0,1,0,0,1
63359,0,1,0,0,1
63360,0,1,0,0,1
63361,0,1,0,0,1
63362,0,1,0,0,1
63363,0,1,0,0,1
63364,0,1,0,0,1
63365,0,0,0,1,1
63366,0,1,0,0,1
63367,0,1,0,0,1
63368,0,1,0,0,1
63369,0,1,0,0,1
63370,0,1,0,0,1
63371,0,1,0,0,1
63372,1,0,0,0,1
63373,0,1,0,0,1
63374,0,1,0,0,1
63375,0,1,0,0,1
63376,1,0,0,0,1
63377,0,1,0,0,1
63378,0,1,0,0,1
63379,0,1,0,0,1
63380,0,1,0,0,1
63381,0,1,0,0,1
63382,0,0,0,1,1
63383,0,1,0,0,1
63384,0,1,0,0,1
63385,0,1,0,0,1
63386,0,0,0,1,1
63387,0,1,0,0,1
63388,0,1,0,0,1
63389,0,1,0,0,1
63390,1,0,0,0,1
63391,0,1,0,0,1
63392,0,1,0,0,1
63393,0,1,0,0,1
63394,0,1,0,0,1
63395,0,1,0,0,1
63396,0,1,0,0,1
63397,0,1,0,0,1
63398,1,0,0,0,1
63399,0,1,0,0,1
63400,0,1,0,0,1
63401,0,0,1,0,1
63402,1,0,0,0,1
63403,0,1,0,0,1
63404,1,0,0,0,1
63405,0,1,0,0,1
63406,0,1,0,0,1
63407,0,1,0,0,1
63408,0,1,0,0,1
63409,0,1,0,0,1
63410,0,1,0,0,1
63411,1,0,0,0,1
63412,0,1,0,0,1
63413,1,0,0,0,1
63414,0,1,0,0,1
63415,0,1,0,0,1
63416,1,0,0,0,1
63417,1,0,0,0,1
63418,0,1,0,0,1
63419,0,1,0,0,1
63420,0,1,0,0,1
63421,1,0,0,0,1
63422,0,1,0,0,1
63423,0,1,0,0,1
63424,0,1,0,0,1
63425,0,1,0,0,1
63426,0,1,0,0,1
63427,0,1,0,0,1
63428,1,0,0,0,1
63429,0,1,0,0,1
63430,1,0,0,0,1
63431,0,1,0,0,1
63432,0,1,0,0,1
63433,0,0,1,0,1
63434,1,0,0,0,1
63435,0,1,0,0,1
63436,0,1,0,0,1
63437,0,1,0,0,1
63438,0,1,0,0,1
63439,0,1,0,0,1
63440,0,1,0,0,1
63441,0,1,0,0,1
63442,0,1,0,0,1
63443,0,1,0,0,1
63444,0,1,0,0,1
63445,0,1,0,0,1
63446,0,1,0,0,1
63447,0,1,0,0,1
63448,0,1,0,0,1
63449,0,1,0,0,1
63450,0,1,0,0,1
63451,0,1,0,0,1
63452,0,1,0,0,1
63453,0,1,0,0,1
63454,0,1,0,0,1
63455,0,1,0,0,1
63456,0,1,0,0,1
63457,0,1,0,0,1
63458,0,1,0,0,1
63459,0,1,0,0,1
63460,0,1,0,0,1
63461,0,1,0,0,1
63462,0,1,0,0,1
63463,0,1,0,0,1
63464,0,0,1,0,1
63465,0,1,0,0,1
63466,0,1,0,0,1
63467,0,1,0,0,1
63468,1,0,0,0,1
63469,0,1,0,0,1
63470,0,1,0,0,1
63471,0,1,0,0,1
63472,1,0,0,0,1
63473,0,1,0,0,1
63474,1,0,0,0,1
63475,0,1,0,0,1
63476,0,1,0,0,1
63477,0,1,0,0,1
63478,1,0,0,0,1
63479,1,0,0,0,1
63480,0,1,0,0,1
63481,0,1,0,0,1
63482,0,1,0,0,1
63483,1,0,0,0,1
63484,0,1,0,0,1
63485,0,1,0,0,1
63486,0,1,0,0,1
63487,0,1,0,0,1
63488,0,1,0,0,1
63489,0,1,0,0,1
63490,0,1,0,0,1
63491,0,1,0,0,1
63492,1,0,0,0,1
63493,1,0,0,0,1
63494,0,1,0,0,1
63495,1,0,0,0,1
63496,1,0,0,0,1
63497,0,1,0,0,1
63498,0,1,0,0,1
63499,0,1,0,0,1
63500,0,1,0,0,1
63501,0,1,0,0,1
63502,0,1,0,0,1
63503,0,1,0,0,1
63504,0,1,0,0,1
63505,0,1,0,0,1
63506,0,1,0,0,1
63507,0,1,0,0,1
63508,0,1,0,0,1
63509,0,1,0,0,1
63510,0,1,0,0,1
63511,1,0,0,0,1
63512,1,0,0,0,1
63513,0,1,0,0,1
63514,0,1,0,0,1
63515,0,1,0,0,1
63516,1,0,0,0,1
63517,0,1,0,0,1
63518,0,1,0,0,1
63519,0,1,0,0,1
63520,0,1,0,0,1
63521,1,0,0,0,1
63522,0,1,0,0,1
63523,0,1,0,0,1
63524,0,1,0,0,1
63525,0,1,0,0,1
63526,0,1,0,0,1
63527,0,1,0,0,1
63528,0,0,1,0,1
63529,0,1,0,0,1
63530,0,1,0,0,1
63531,0,1,0,0,1
63532,0,1,0,0,1
63533,0,1,0,0,1
63534,0,1,0,0,1
63535,0,1,0,0,1
63536,1,0,0,0,1
63537,0,1,0,0,1
63538,0,1,0,0,1
63539,0,0,1,0,1
63540,1,0,0,0,1
63541,0,0,0,1,1
63542,0,1,0,0,1
63543,0,1,0,0,1
63544,1,0,0,0,1
63545,0,1,0,0,1
63546,0,1,0,0,1
63547,1,0,0,0,1
63548,0,1,0,0,1
63549,0,1,0,0,1
63550,1,0,0,0,1
63551,0,1,0,0,1
63552,0,1,0,0,1
63553,0,1,0,0,1
63554,0,1,0,0,1
63555,0,0,0,1,1
63556,0,1,0,0,1
63557,0,1,0,0,1
63558,1,0,0,0,1
63559,0,1,0,0,1
63560,0,1,0,0,1
63561,0,1,0,0,1
63562,0,1,0,0,1
63563,0,1,0,0,1
63564,1,0,0,0,1
63565,0,1,0,0,1
63566,0,1,0,0,1
63567,0,1,0,0,1
63568,0,1,0,0,1
63569,0,1,0,0,1
63570,0,1,0,0,1
63571,0,1,0,0,1
63572,0,1,0,0,1
63573,1,0,0,0,1
63574,1,0,0,0,1
63575,1,0,0,0,1
63576,0,1,0,0,1
63577,1,0,0,0,1
63578,0,1,0,0,1
63579,0,1,0,0,1
63580,0,1,0,0,1
63581,1,0,0,0,1
63582,1,0,0,0,1
63583,1,0,0,0,1
63584,0,1,0,0,1
63585,0,1,0,0,1
63586,0,1,0,0,1
63587,0,1,0,0,1
63588,0,1,0,0,1
63589,0,1,0,0,1
63590,1,0,0,0,1
63591,1,0,0,0,1
63592,0,1,0,0,1
63593,0,1,0,0,1
63594,0,1,0,0,1
63595,0,1,0,0,1
63596,0,1,0,0,1
63597,0,1,0,0,1
63598,0,1,0,0,1
63599,0,1,0,0,1
63600,0,0,1,0,1
63601,0,1,0,0,1
63602,0,1,0,0,1
63603,0,1,0,0,1
63604,0,1,0,0,1
63605,0,1,0,0,1
63606,0,1,0,0,1
63607,0,1,0,0,1
63608,0,1,0,0,1
63609,0,1,0,0,1
63610,0,1,0,0,1
63611,0,1,0,0,1
63612,0,1,0,0,1
63613,0,1,0,0,1
63614,0,0,0,1,1
63615,0,1,0,0,1
63616,0,1,0,0,1
63617,0,1,0,0,1
63618,1,0,0,0,1
63619,0,1,0,0,1
63620,0,1,0,0,1
63621,1,0,0,0,1
63622,0,1,0,0,1
63623,0,1,0,0,1
63624,0,1,0,0,1
63625,0,1,0,0,1
63626,0,1,0,0,1
63627,1,0,0,0,1
63628,0,1,0,0,1
63629,0,1,0,0,1
63630,0,1,0,0,1
63631,0,1,0,0,1
63632,1,0,0,0,1
63633,0,1,0,0,1
63634,1,0,0,0,1
63635,0,1,0,0,1
63636,0,1,0,0,1
63637,1,0,0,0,1
63638,0,1,0,0,1
63639,0,1,0,0,1
63640,0,1,0,0,1
63641,0,1,0,0,1
63642,0,1,0,0,1
63643,1,0,0,0,1
63644,0,0,0,1,1
63645,0,1,0,0,1
63646,0,1,0,0,1
63647,0,1,0,0,1
63648,0,1,0,0,1
63649,0,1,0,0,1
63650,1,0,0,0,1
63651,0,1,0,0,1
63652,1,0,0,0,1
63653,0,1,0,0,1
63654,0,1,0,0,1
63655,1,0,0,0,1
63656,0,1,0,0,1
63657,1,0,0,0,1
63658,0,1,0,0,1
63659,0,1,0,0,1
63660,0,1,0,0,1
63661,0,1,0,0,1
63662,0,1,0,0,1
63663,0,1,0,0,1
63664,0,1,0,0,1
63665,0,1,0,0,1
63666,0,1,0,0,1
63667,0,0,0,1,1
63668,1,0,0,0,1
63669,0,1,0,0,1
63670,0,1,0,0,1
63671,0,1,0,0,1
63672,0,1,0,0,1
63673,0,1,0,0,1
63674,0,1,0,0,1
63675,0,1,0,0,1
63676,0,1,0,0,1
63677,0,1,0,0,1
63678,0,1,0,0,1
63679,0,1,0,0,1
63680,1,0,0,0,1
63681,0,1,0,0,1
63682,0,1,0,0,1
63683,0,1,0,0,1
63684,0,1,0,0,1
63685,0,0,0,1,1
63686,0,1,0,0,1
63687,0,1,0,0,1
63688,0,1,0,0,1
63689,0,1,0,0,1
63690,0,1,0,0,1
63691,0,1,0,0,1
63692,0,1,0,0,1
63693,0,1,0,0,1
63694,0,1,0,0,1
63695,1,0,0,0,1
63696,0,1,0,0,1
63697,1,0,0,0,1
63698,0,1,0,0,1
63699,0,1,0,0,1
63700,0,1,0,0,1
63701,0,1,0,0,1
63702,0,1,0,0,1
63703,0,1,0,0,1
63704,0,1,0,0,1
63705,0,1,0,0,1
63706,0,1,0,0,1
63707,0,0,1,0,1
63708,0,1,0,0,1
63709,0,1,0,0,1
63710,0,1,0,0,1
63711,1,0,0,0,1
63712,0,1,0,0,1
63713,0,1,0,0,1
63714,0,1,0,0,1
63715,0,1,0,0,1
63716,0,1,0,0,1
63717,0,1,0,0,1
63718,0,1,0,0,1
63719,0,1,0,0,1
63720,0,1,0,0,1
63721,0,1,0,0,1
63722,0,1,0,0,1
63723,0,1,0,0,1
63724,0,1,0,0,1
63725,0,0,0,1,1
63726,0,1,0,0,1
63727,0,1,0,0,1
63728,0,1,0,0,1
63729,0,1,0,0,1
63730,0,1,0,0,1
63731,1,0,0,0,1
63732,0,1,0,0,1
63733,0,1,0,0,1
63734,0,1,0,0,1
63735,1,0,0,0,1
63736,0,1,0,0,1
63737,0,1,0,0,1
63738,0,1,0,0,1
63739,1,0,0,0,1
63740,0,1,0,0,1
63741,0,1,0,0,1
63742,0,1,0,0,1
63743,0,1,0,0,1
63744,0,1,0,0,1
63745,0,1,0,0,1
63746,1,0,0,0,1
63747,0,1,0,0,1
63748,1,0,0,0,1
63749,1,0,0,0,1
63750,0,0,1,0,1
63751,0,1,0,0,1
63752,0,1,0,0,1
63753,0,1,0,0,1
63754,1,0,0,0,1
63755,0,1,0,0,1
63756,0,1,0,0,1
63757,0,1,0,0,1
63758,0,1,0,0,1
63759,0,1,0,0,1
63760,0,1,0,0,1
63761,0,1,0,0,1
63762,0,0,0,1,1
63763,0,1,0,0,1
63764,0,1,0,0,1
63765,0,1,0,0,1
63766,0,1,0,0,1
63767,0,1,0,0,1
63768,0,1,0,0,1
63769,0,1,0,0,1
63770,0,1,0,0,1
63771,0,1,0,0,1
63772,0,1,0,0,1
63773,0,1,0,0,1
63774,1,0,0,0,1
63775,0,1,0,0,1
63776,0,1,0,0,1
63777,0,1,0,0,1
63778,0,1,0,0,1
63779,1,0,0,0,1
63780,0,1,0,0,1
63781,1,0,0,0,1
63782,0,1,0,0,1
63783,0,1,0,0,1
63784,0,0,1,0,1
63785,0,1,0,0,1
63786,0,1,0,0,1
63787,1,0,0,0,1
63788,0,1,0,0,1
63789,1,0,0,0,1
63790,1,0,0,0,1
63791,1,0,0,0,1
63792,0,1,0,0,1
63793,0,1,0,0,1
63794,0,1,0,0,1
63795,0,1,0,0,1
63796,0,1,0,0,1
63797,0,1,0,0,1
63798,0,1,0,0,1
63799,1,0,0,0,1
63800,0,1,0,0,1
63801,0,0,0,1,1
63802,0,1,0,0,1
63803,0,1,0,0,1
63804,0,1,0,0,1
63805,0,1,0,0,1
63806,0,1,0,0,1
63807,0,1,0,0,1
63808,0,0,0,1,1
63809,0,1,0,0,1
63810,0,1,0,0,1
63811,1,0,0,0,1
63812,0,1,0,0,1
63813,0,0,0,1,1
63814,0,1,0,0,1
63815,0,1,0,0,1
63816,0,1,0,0,1
63817,1,0,0,0,1
63818,1,0,0,0,1
63819,0,1,0,0,1
63820,0,1,0,0,1
63821,0,0,1,0,1
63822,0,1,0,0,1
63823,0,1,0,0,1
63824,1,0,0,0,1
63825,0,1,0,0,1
63826,0,1,0,0,1
63827,1,0,0,0,1
63828,0,1,0,0,1
63829,0,1,0,0,1
63830,0,1,0,0,1
63831,0,1,0,0,1
63832,0,1,0,0,1
63833,0,1,0,0,1
63834,0,1,0,0,1
63835,0,1,0,0,1
63836,1,0,0,0,1
63837,0,1,0,0,1
63838,0,1,0,0,1
63839,0,1,0,0,1
63840,0,1,0,0,1
63841,0,1,0,0,1
63842,0,1,0,0,1
63843,1,0,0,0,1
63844,0,1,0,0,1
63845,0,0,0,1,1
63846,0,1,0,0,1
63847,0,1,0,0,1
63848,0,1,0,0,1
63849,1,0,0,0,1
63850,1,0,0,0,1
63851,0,1,0,0,1
63852,0,1,0,0,1
63853,0,1,0,0,1
63854,0,1,0,0,1
63855,0,1,0,0,1
63856,0,0,0,1,1
63857,1,0,0,0,1
63858,1,0,0,0,1
63859,0,1,0,0,1
63860,1,0,0,0,1
63861,0,1,0,0,1
63862,0,1,0,0,1
63863,0,1,0,0,1
63864,1,0,0,0,1
63865,0,1,0,0,1
63866,1,0,0,0,1
63867,0,1,0,0,1
63868,0,1,0,0,1
63869,0,1,0,0,1
63870,0,1,0,0,1
63871,0,1,0,0,1
63872,1,0,0,0,1
63873,1,0,0,0,1
63874,0,1,0,0,1
63875,0,1,0,0,1
63876,0,1,0,0,1
63877,0,1,0,0,1
63878,0,1,0,0,1
63879,0,1,0,0,1
63880,0,1,0,0,1
63881,1,0,0,0,1
63882,0,1,0,0,1
63883,0,1,0,0,1
63884,0,1,0,0,1
63885,0,1,0,0,1
63886,0,1,0,0,1
63887,1,0,0,0,1
63888,1,0,0,0,1
63889,0,1,0,0,1
63890,0,1,0,0,1
63891,0,1,0,0,1
63892,0,1,0,0,1
63893,0,1,0,0,1
63894,0,1,0,0,1
63895,0,1,0,0,1
63896,1,0,0,0,1
63897,0,1,0,0,1
63898,0,1,0,0,1
63899,0,1,0,0,1
63900,0,1,0,0,1
63901,1,0,0,0,1
63902,0,1,0,0,1
63903,0,1,0,0,1
63904,0,1,0,0,1
63905,0,1,0,0,1
63906,0,1,0,0,1
63907,0,1,0,0,1
63908,0,1,0,0,1
63909,0,1,0,0,1
63910,0,1,0,0,1
63911,0,1,0,0,1
63912,0,1,0,0,1
63913,0,1,0,0,1
63914,0,1,0,0,1
63915,0,1,0,0,1
63916,0,1,0,0,1
63917,0,1,0,0,1
63918,0,1,0,0,1
63919,1,0,0,0,1
63920,0,1,0,0,1
63921,0,1,0,0,1
63922,0,1,0,0,1
63923,0,1,0,0,1
63924,0,1,0,0,1
63925,0,1,0,0,1
63926,0,1,0,0,1
63927,0,1,0,0,1
63928,0,1,0,0,1
63929,0,1,0,0,1
63930,0,1,0,0,1
63931,1,0,0,0,1
63932,0,1,0,0,1
63933,0,1,0,0,1
63934,0,1,0,0,1
63935,0,1,0,0,1
63936,0,1,0,0,1
63937,0,1,0,0,1
63938,0,1,0,0,1
63939,0,1,0,0,1
63940,0,1,0,0,1
63941,0,1,0,0,1
63942,0,1,0,0,1
63943,0,1,0,0,1
63944,0,1,0,0,1
63945,0,1,0,0,1
63946,0,1,0,0,1
63947,1,0,0,0,1
63948,0,1,0,0,1
63949,0,1,0,0,1
63950,0,1,0,0,1
63951,0,1,0,0,1
63952,0,1,0,0,1
63953,0,1,0,0,1
63954,0,1,0,0,1
63955,0,1,0,0,1
63956,0,1,0,0,1
63957,0,1,0,0,1
63958,0,1,0,0,1
63959,1,0,0,0,1
63960,0,1,0,0,1
63961,0,1,0,0,1
63962,0,1,0,0,1
63963,0,1,0,0,1
63964,0,1,0,0,1
63965,0,1,0,0,1
63966,0,1,0,0,1
63967,1,0,0,0,1
63968,0,1,0,0,1
63969,1,0,0,0,1
63970,0,1,0,0,1
63971,0,1,0,0,1
63972,0,1,0,0,1
63973,0,1,0,0,1
63974,1,0,0,0,1
63975,0,1,0,0,1
63976,0,1,0,0,1
63977,0,1,0,0,1
63978,0,1,0,0,1
63979,0,1,0,0,1
63980,0,1,0,0,1
63981,0,1,0,0,1
63982,1,0,0,0,1
63983,1,0,0,0,1
63984,0,1,0,0,1
63985,0,0,1,0,1
63986,0,1,0,0,1
63987,0,1,0,0,1
63988,1,0,0,0,1
63989,0,1,0,0,1
63990,1,0,0,0,1
63991,0,1,0,0,1
63992,0,1,0,0,1
63993,0,1,0,0,1
63994,0,1,0,0,1
63995,0,1,0,0,1
63996,1,0,0,0,1
63997,0,0,0,1,1
63998,0,1,0,0,1
63999,0,1,0,0,1
64000,0,1,0,0,1
64001,0,1,0,0,1
64002,0,1,0,0,1
64003,1,0,0,0,1
64004,1,0,0,0,1
64005,0,1,0,0,1
64006,0,1,0,0,1
64007,0,1,0,0,1
64008,0,1,0,0,1
64009,0,1,0,0,1
64010,0,1,0,0,1
64011,0,1,0,0,1
64012,1,0,0,0,1
64013,1,0,0,0,1
64014,0,1,0,0,1
64015,0,1,0,0,1
64016,0,1,0,0,1
64017,0,1,0,0,1
64018,0,1,0,0,1
64019,0,1,0,0,1
64020,0,1,0,0,1
64021,0,1,0,0,1
64022,0,1,0,0,1
64023,0,1,0,0,1
64024,0,1,0,0,1
64025,0,1,0,0,1
64026,0,1,0,0,1
64027,0,1,0,0,1
64028,1,0,0,0,1
64029,0,1,0,0,1
64030,0,1,0,0,1
64031,0,1,0,0,1
64032,0,1,0,0,1
64033,0,1,0,0,1
64034,0,1,0,0,1
64035,0,1,0,0,1
64036,0,1,0,0,1
64037,0,1,0,0,1
64038,0,1,0,0,1
64039,0,1,0,0,1
64040,0,1,0,0,1
64041,1,0,0,0,1
64042,1,0,0,0,1
64043,0,1,0,0,1
64044,0,1,0,0,1
64045,0,1,0,0,1
64046,0,1,0,0,1
64047,0,1,0,0,1
64048,0,0,0,1,1
64049,0,1,0,0,1
64050,0,1,0,0,1
64051,0,1,0,0,1
64052,0,1,0,0,1
64053,0,1,0,0,1
64054,0,1,0,0,1
64055,0,1,0,0,1
64056,0,1,0,0,1
64057,0,1,0,0,1
64058,0,1,0,0,1
64059,1,0,0,0,1
64060,0,1,0,0,1
64061,0,1,0,0,1
64062,0,1,0,0,1
64063,0,1,0,0,1
64064,1,0,0,0,1
64065,0,1,0,0,1
64066,1,0,0,0,1
64067,0,1,0,0,1
64068,0,1,0,0,1
64069,0,1,0,0,1
64070,0,1,0,0,1
64071,0,1,0,0,1
64072,0,1,0,0,1
64073,0,1,0,0,1
64074,1,0,0,0,1
64075,1,0,0,0,1
64076,0,1,0,0,1
64077,1,0,0,0,1
64078,0,1,0,0,1
64079,0,1,0,0,1
64080,0,1,0,0,1
64081,1,0,0,0,1
64082,0,1,0,0,1
64083,1,0,0,0,1
64084,0,1,0,0,1
64085,0,1,0,0,1
64086,1,0,0,0,1
64087,1,0,0,0,1
64088,0,1,0,0,1
64089,0,1,0,0,1
64090,0,0,0,1,1
64091,0,1,0,0,1
64092,0,1,0,0,1
64093,0,1,0,0,1
64094,0,1,0,0,1
64095,0,1,0,0,1
64096,1,0,0,0,1
64097,0,1,0,0,1
64098,0,1,0,0,1
64099,0,1,0,0,1
64100,1,0,0,0,1
64101,1,0,0,0,1
64102,0,1,0,0,1
64103,0,1,0,0,1
64104,0,1,0,0,1
64105,0,1,0,0,1
64106,0,1,0,0,1
64107,0,0,1,0,1
64108,1,0,0,0,1
64109,0,1,0,0,1
64110,0,1,0,0,1
64111,0,1,0,0,1
64112,0,1,0,0,1
64113,0,1,0,0,1
64114,0,1,0,0,1
64115,0,0,0,1,1
64116,0,0,0,1,1
64117,0,0,1,0,1
64118,1,0,0,0,1
64119,1,0,0,0,1
64120,0,1,0,0,1
64121,0,1,0,0,1
64122,0,1,0,0,1
64123,1,0,0,0,1
64124,0,1,0,0,1
64125,0,1,0,0,1
64126,1,0,0,0,1
64127,0,1,0,0,1
64128,0,1,0,0,1
64129,0,1,0,0,1
64130,0,1,0,0,1
64131,1,0,0,0,1
64132,0,1,0,0,1
64133,0,1,0,0,1
64134,0,1,0,0,1
64135,0,1,0,0,1
64136,0,1,0,0,1
64137,1,0,0,0,1
64138,0,1,0,0,1
64139,0,1,0,0,1
64140,0,1,0,0,1
64141,0,1,0,0,1
64142,0,1,0,0,1
64143,0,0,1,0,1
64144,0,1,0,0,1
64145,0,1,0,0,1
64146,1,0,0,0,1
64147,0,1,0,0,1
64148,0,0,0,1,1
64149,0,1,0,0,1
64150,0,1,0,0,1
64151,0,1,0,0,1
64152,0,1,0,0,1
64153,0,1,0,0,1
64154,0,1,0,0,1
64155,0,1,0,0,1
64156,0,1,0,0,1
64157,0,1,0,0,1
64158,1,0,0,0,1
64159,0,1,0,0,1
64160,0,1,0,0,1
64161,0,1,0,0,1
64162,0,0,1,0,1
64163,0,1,0,0,1
64164,0,1,0,0,1
64165,0,1,0,0,1
64166,0,1,0,0,1
64167,0,0,0,1,1
64168,1,0,0,0,1
64169,0,1,0,0,1
64170,0,1,0,0,1
64171,0,1,0,0,1
64172,0,1,0,0,1
64173,0,1,0,0,1
64174,0,1,0,0,1
64175,0,1,0,0,1
64176,0,1,0,0,1
64177,0,1,0,0,1
64178,0,1,0,0,1
64179,0,1,0,0,1
64180,0,1,0,0,1
64181,0,1,0,0,1
64182,0,1,0,0,1
64183,0,1,0,0,1
64184,0,1,0,0,1
64185,0,1,0,0,1
64186,0,1,0,0,1
64187,0,1,0,0,1
64188,0,1,0,0,1
64189,1,0,0,0,1
64190,0,1,0,0,1
64191,0,1,0,0,1
64192,0,1,0,0,1
64193,0,1,0,0,1
64194,1,0,0,0,1
64195,0,1,0,0,1
64196,0,1,0,0,1
64197,1,0,0,0,1
64198,0,1,0,0,1
64199,0,1,0,0,1
64200,0,1,0,0,1
64201,0,1,0,0,1
64202,1,0,0,0,1
64203,0,1,0,0,1
64204,0,1,0,0,1
64205,0,1,0,0,1
64206,1,0,0,0,1
64207,0,1,0,0,1
64208,0,1,0,0,1
64209,0,1,0,0,1
64210,0,1,0,0,1
64211,0,1,0,0,1
64212,0,1,0,0,1
64213,0,1,0,0,1
64214,0,1,0,0,1
64215,0,1,0,0,1
64216,1,0,0,0,1
64217,1,0,0,0,1
64218,0,1,0,0,1
64219,0,1,0,0,1
64220,1,0,0,0,1
64221,0,1,0,0,1
64222,0,1,0,0,1
64223,0,1,0,0,1
64224,0,1,0,0,1
64225,1,0,0,0,1
64226,0,1,0,0,1
64227,0,1,0,0,1
64228,0,1,0,0,1
64229,0,1,0,0,1
64230,0,1,0,0,1
64231,0,1,0,0,1
64232,0,1,0,0,1
64233,0,1,0,0,1
64234,0,1,0,0,1
64235,0,1,0,0,1
64236,0,1,0,0,1
64237,0,1,0,0,1
64238,0,1,0,0,1
64239,0,1,0,0,1
64240,0,1,0,0,1
64241,0,1,0,0,1
64242,0,1,0,0,1
64243,0,1,0,0,1
64244,0,1,0,0,1
64245,0,1,0,0,1
64246,0,1,0,0,1
64247,0,1,0,0,1
64248,0,1,0,0,1
64249,0,1,0,0,1
64250,0,1,0,0,1
64251,0,0,0,1,1
64252,0,1,0,0,1
64253,1,0,0,0,1
64254,0,1,0,0,1
64255,0,1,0,0,1
64256,1,0,0,0,1
64257,0,1,0,0,1
64258,0,1,0,0,1
64259,0,1,0,0,1
64260,0,1,0,0,1
64261,0,1,0,0,1
64262,1,0,0,0,1
64263,0,1,0,0,1
64264,0,0,0,1,1
64265,0,1,0,0,1
64266,0,1,0,0,1
64267,0,0,1,0,1
64268,0,1,0,0,1
64269,0,1,0,0,1
64270,0,1,0,0,1
64271,1,0,0,0,1
64272,0,1,0,0,1
64273,0,1,0,0,1
64274,0,0,1,0,1
64275,0,1,0,0,1
64276,0,1,0,0,1
64277,0,1,0,0,1
64278,0,1,0,0,1
64279,1,0,0,0,1
64280,0,1,0,0,1
64281,0,1,0,0,1
64282,0,1,0,0,1
64283,1,0,0,0,1
64284,1,0,0,0,1
64285,0,1,0,0,1
64286,0,1,0,0,1
64287,0,1,0,0,1
64288,0,1,0,0,1
64289,0,1,0,0,1
64290,1,0,0,0,1
64291,1,0,0,0,1
64292,0,1,0,0,1
64293,0,1,0,0,1
64294,1,0,0,0,1
64295,1,0,0,0,1
64296,0,1,0,0,1
64297,0,1,0,0,1
64298,0,1,0,0,1
64299,0,1,0,0,1
64300,0,0,0,1,1
64301,0,1,0,0,1
64302,1,0,0,0,1
64303,0,1,0,0,1
64304,0,1,0,0,1
64305,0,1,0,0,1
64306,0,1,0,0,1
64307,0,1,0,0,1
64308,0,1,0,0,1
64309,0,1,0,0,1
64310,0,1,0,0,1
64311,0,1,0,0,1
64312,0,1,0,0,1
64313,0,1,0,0,1
64314,0,1,0,0,1
64315,1,0,0,0,1
64316,1,0,0,0,1
64317,1,0,0,0,1
64318,0,1,0,0,1
64319,0,1,0,0,1
64320,0,0,0,1,1
64321,0,1,0,0,1
64322,0,1,0,0,1
64323,0,1,0,0,1
64324,0,0,1,0,1
64325,1,0,0,0,1
64326,0,1,0,0,1
64327,1,0,0,0,1
64328,0,1,0,0,1
64329,1,0,0,0,1
64330,0,1,0,0,1
64331,0,1,0,0,1
64332,0,1,0,0,1
64333,0,1,0,0,1
64334,1,0,0,0,1
64335,0,0,0,1,1
64336,0,1,0,0,1
64337,0,0,1,0,1
64338,0,1,0,0,1
64339,0,1,0,0,1
64340,0,0,0,1,1
64341,1,0,0,0,1
64342,0,1,0,0,1
64343,0,1,0,0,1
64344,0,1,0,0,1
64345,0,1,0,0,1
64346,0,1,0,0,1
64347,0,1,0,0,1
64348,0,1,0,0,1
64349,1,0,0,0,1
64350,0,1,0,0,1
64351,0,1,0,0,1
64352,1,0,0,0,1
64353,0,1,0,0,1
64354,0,1,0,0,1
64355,0,1,0,0,1
64356,0,1,0,0,1
64357,0,1,0,0,1
64358,1,0,0,0,1
64359,0,1,0,0,1
64360,0,1,0,0,1
64361,1,0,0,0,1
64362,0,1,0,0,1
64363,1,0,0,0,1
64364,0,1,0,0,1
64365,0,1,0,0,1
64366,0,1,0,0,1
64367,0,1,0,0,1
64368,0,1,0,0,1
64369,1,0,0,0,1
64370,1,0,0,0,1
64371,0,1,0,0,1
64372,0,1,0,0,1
64373,1,0,0,0,1
64374,0,1,0,0,1
64375,0,1,0,0,1
64376,0,1,0,0,1
64377,0,1,0,0,1
64378,1,0,0,0,1
64379,0,1,0,0,1
64380,0,1,0,0,1
64381,0,1,0,0,1
64382,0,1,0,0,1
64383,0,1,0,0,1
64384,0,1,0,0,1
64385,0,1,0,0,1
64386,0,0,0,1,1
64387,1,0,0,0,1
64388,1,0,0,0,1
64389,0,1,0,0,1
64390,0,0,0,1,1
64391,0,1,0,0,1
64392,0,1,0,0,1
64393,1,0,0,0,1
64394,0,1,0,0,1
64395,0,1,0,0,1
64396,0,1,0,0,1
64397,0,1,0,0,1
64398,1,0,0,0,1
64399,0,1,0,0,1
64400,1,0,0,0,1
64401,0,0,1,0,1
64402,0,1,0,0,1
64403,0,1,0,0,1
64404,0,1,0,0,1
64405,0,1,0,0,1
64406,0,1,0,0,1
64407,0,1,0,0,1
64408,0,1,0,0,1
64409,0,1,0,0,1
64410,0,1,0,0,1
64411,0,1,0,0,1
64412,1,0,0,0,1
64413,0,1,0,0,1
64414,0,1,0,0,1
64415,0,1,0,0,1
64416,0,1,0,0,1
64417,0,1,0,0,1
64418,0,1,0,0,1
64419,0,1,0,0,1
64420,0,1,0,0,1
64421,1,0,0,0,1
64422,0,1,0,0,1
64423,0,1,0,0,1
64424,1,0,0,0,1
64425,0,1,0,0,1
64426,1,0,0,0,1
64427,0,1,0,0,1
64428,0,1,0,0,1
64429,0,1,0,0,1
64430,0,1,0,0,1
64431,0,1,0,0,1
64432,0,1,0,0,1
64433,0,1,0,0,1
64434,0,1,0,0,1
64435,0,1,0,0,1
64436,0,1,0,0,1
64437,0,1,0,0,1
64438,0,1,0,0,1
64439,0,1,0,0,1
64440,0,1,0,0,1
64441,0,1,0,0,1
64442,0,1,0,0,1
64443,0,1,0,0,1
64444,0,1,0,0,1
64445,0,1,0,0,1
64446,0,1,0,0,1
64447,1,0,0,0,1
64448,0,1,0,0,1
64449,0,1,0,0,1
64450,0,1,0,0,1
64451,0,1,0,0,1
64452,0,1,0,0,1
64453,1,0,0,0,1
64454,0,1,0,0,1
64455,0,1,0,0,1
64456,0,1,0,0,1
64457,0,1,0,0,1
64458,0,1,0,0,1
64459,0,1,0,0,1
64460,0,1,0,0,1
64461,0,0,1,0,1
64462,0,1,0,0,1
64463,0,1,0,0,1
64464,1,0,0,0,1
64465,0,1,0,0,1
64466,0,1,0,0,1
64467,0,1,0,0,1
64468,0,1,0,0,1
64469,0,1,0,0,1
64470,0,1,0,0,1
64471,1,0,0,0,1
64472,0,1,0,0,1
64473,0,1,0,0,1
64474,0,1,0,0,1
64475,0,1,0,0,1
64476,0,1,0,0,1
64477,1,0,0,0,1
64478,0,1,0,0,1
64479,0,1,0,0,1
64480,0,1,0,0,1
64481,0,1,0,0,1
64482,0,1,0,0,1
64483,0,1,0,0,1
64484,0,0,1,0,1
64485,1,0,0,0,1
64486,0,1,0,0,1
64487,0,1,0,0,1
64488,0,1,0,0,1
64489,0,1,0,0,1
64490,0,1,0,0,1
64491,0,1,0,0,1
64492,0,1,0,0,1
64493,0,1,0,0,1
64494,0,1,0,0,1
64495,0,1,0,0,1
64496,0,1,0,0,1
64497,0,1,0,0,1
64498,0,1,0,0,1
64499,0,1,0,0,1
64500,0,1,0,0,1
64501,0,1,0,0,1
64502,0,1,0,0,1
64503,0,1,0,0,1
64504,1,0,0,0,1
64505,0,1,0,0,1
64506,0,0,0,1,1
64507,0,1,0,0,1
64508,0,1,0,0,1
64509,0,1,0,0,1
64510,0,1,0,0,1
64511,0,1,0,0,1
64512,1,0,0,0,1
64513,1,0,0,0,1
64514,0,0,1,0,1
64515,0,1,0,0,1
64516,0,1,0,0,1
64517,0,0,1,0,1
64518,0,1,0,0,1
64519,1,0,0,0,1
64520,0,1,0,0,1
64521,1,0,0,0,1
64522,0,1,0,0,1
64523,0,1,0,0,1
64524,0,1,0,0,1
64525,0,1,0,0,1
64526,0,1,0,0,1
64527,0,1,0,0,1
64528,1,0,0,0,1
64529,0,1,0,0,1
64530,0,1,0,0,1
64531,1,0,0,0,1
64532,0,1,0,0,1
64533,1,0,0,0,1
64534,0,1,0,0,1
64535,0,1,0,0,1
64536,0,1,0,0,1
64537,0,1,0,0,1
64538,0,1,0,0,1
64539,0,1,0,0,1
64540,0,1,0,0,1
64541,0,1,0,0,1
64542,0,1,0,0,1
64543,0,1,0,0,1
64544,0,1,0,0,1
64545,0,1,0,0,1
64546,0,1,0,0,1
64547,1,0,0,0,1
64548,0,1,0,0,1
64549,0,1,0,0,1
64550,0,1,0,0,1
64551,0,1,0,0,1
64552,0,1,0,0,1
64553,0,1,0,0,1
64554,0,1,0,0,1
64555,0,1,0,0,1
64556,0,1,0,0,1
64557,0,1,0,0,1
64558,0,1,0,0,1
64559,0,1,0,0,1
64560,0,1,0,0,1
64561,0,1,0,0,1
64562,0,1,0,0,1
64563,1,0,0,0,1
64564,0,0,0,1,1
64565,0,1,0,0,1
64566,1,0,0,0,1
64567,0,1,0,0,1
64568,0,1,0,0,1
64569,0,1,0,0,1
64570,1,0,0,0,1
64571,0,1,0,0,1
64572,0,1,0,0,1
64573,0,1,0,0,1
64574,0,1,0,0,1
64575,0,1,0,0,1
64576,0,1,0,0,1
64577,1,0,0,0,1
64578,0,1,0,0,1
64579,1,0,0,0,1
64580,0,0,1,0,1
64581,1,0,0,0,1
64582,1,0,0,0,1
64583,0,1,0,0,1
64584,0,0,1,0,1
64585,1,0,0,0,1
64586,0,1,0,0,1
64587,0,1,0,0,1
64588,0,1,0,0,1
64589,0,1,0,0,1
64590,0,1,0,0,1
64591,0,1,0,0,1
64592,1,0,0,0,1
64593,0,1,0,0,1
64594,1,0,0,0,1
64595,0,1,0,0,1
64596,0,1,0,0,1
64597,0,1,0,0,1
64598,0,0,1,0,1
64599,0,1,0,0,1
64600,0,1,0,0,1
64601,0,0,1,0,1
64602,0,0,0,1,1
64603,1,0,0,0,1
64604,0,1,0,0,1
64605,0,1,0,0,1
64606,0,1,0,0,1
64607,1,0,0,0,1
64608,0,1,0,0,1
64609,0,1,0,0,1
64610,0,1,0,0,1
64611,0,0,0,1,1
64612,1,0,0,0,1
64613,0,1,0,0,1
64614,0,1,0,0,1
64615,0,1,0,0,1
64616,0,1,0,0,1
64617,1,0,0,0,1
64618,0,1,0,0,1
64619,0,1,0,0,1
64620,0,1,0,0,1
64621,0,1,0,0,1
64622,0,1,0,0,1
64623,0,1,0,0,1
64624,0,1,0,0,1
64625,0,1,0,0,1
64626,1,0,0,0,1
64627,0,1,0,0,1
64628,1,0,0,0,1
64629,0,1,0,0,1
64630,0,1,0,0,1
64631,0,1,0,0,1
64632,0,1,0,0,1
64633,0,1,0,0,1
64634,0,1,0,0,1
64635,0,1,0,0,1
64636,0,1,0,0,1
64637,0,1,0,0,1
64638,0,1,0,0,1
64639,0,1,0,0,1
64640,1,0,0,0,1
64641,0,1,0,0,1
64642,0,1,0,0,1
64643,1,0,0,0,1
64644,0,1,0,0,1
64645,0,1,0,0,1
64646,0,1,0,0,1
64647,1,0,0,0,1
64648,0,1,0,0,1
64649,0,1,0,0,1
64650,1,0,0,0,1
64651,1,0,0,0,1
64652,0,1,0,0,1
64653,0,1,0,0,1
64654,0,1,0,0,1
64655,0,1,0,0,1
64656,0,1,0,0,1
64657,0,1,0,0,1
64658,0,1,0,0,1
64659,0,1,0,0,1
64660,0,1,0,0,1
64661,1,0,0,0,1
64662,0,1,0,0,1
64663,0,1,0,0,1
64664,0,0,0,1,1
64665,0,1,0,0,1
64666,0,1,0,0,1
64667,0,1,0,0,1
64668,0,1,0,0,1
64669,0,1,0,0,1
64670,0,1,0,0,1
64671,0,1,0,0,1
64672,0,1,0,0,1
64673,0,1,0,0,1
64674,0,1,0,0,1
64675,0,0,1,0,1
64676,0,1,0,0,1
64677,0,1,0,0,1
64678,1,0,0,0,1
64679,1,0,0,0,1
64680,0,1,0,0,1
64681,0,1,0,0,1
64682,0,1,0,0,1
64683,0,1,0,0,1
64684,1,0,0,0,1
64685,0,1,0,0,1
64686,0,1,0,0,1
64687,0,1,0,0,1
64688,0,1,0,0,1
64689,0,1,0,0,1
64690,0,1,0,0,1
64691,0,1,0,0,1
64692,0,1,0,0,1
64693,0,1,0,0,1
64694,0,1,0,0,1
64695,0,1,0,0,1
64696,1,0,0,0,1
64697,0,1,0,0,1
64698,1,0,0,0,1
64699,0,1,0,0,1
64700,0,1,0,0,1
64701,1,0,0,0,1
64702,0,1,0,0,1
64703,0,1,0,0,1
64704,0,1,0,0,1
64705,0,1,0,0,1
64706,0,1,0,0,1
64707,0,1,0,0,1
64708,0,1,0,0,1
64709,0,1,0,0,1
64710,0,0,0,1,1
64711,0,1,0,0,1
64712,0,1,0,0,1
64713,1,0,0,0,1
64714,0,1,0,0,1
64715,0,1,0,0,1
64716,0,1,0,0,1
64717,0,1,0,0,1
64718,0,1,0,0,1
64719,0,1,0,0,1
64720,0,1,0,0,1
64721,0,1,0,0,1
64722,0,1,0,0,1
64723,0,1,0,0,1
64724,0,1,0,0,1
64725,0,1,0,0,1
64726,0,1,0,0,1
64727,0,1,0,0,1
64728,0,1,0,0,1
64729,0,1,0,0,1
64730,0,1,0,0,1
64731,0,1,0,0,1
64732,0,1,0,0,1
64733,0,1,0,0,1
64734,0,1,0,0,1
64735,0,1,0,0,1
64736,0,0,1,0,1
64737,0,0,1,0,1
64738,0,1,0,0,1
64739,0,1,0,0,1
64740,0,1,0,0,1
64741,0,1,0,0,1
64742,1,0,0,0,1
64743,0,1,0,0,1
64744,1,0,0,0,1
64745,0,1,0,0,1
64746,0,1,0,0,1
64747,0,1,0,0,1
64748,0,1,0,0,1
64749,0,1,0,0,1
64750,0,1,0,0,1
64751,0,1,0,0,1
64752,0,1,0,0,1
64753,1,0,0,0,1
64754,0,1,0,0,1
64755,0,1,0,0,1
64756,1,0,0,0,1
64757,0,1,0,0,1
64758,0,1,0,0,1
64759,0,1,0,0,1
64760,0,1,0,0,1
64761,0,1,0,0,1
64762,0,1,0,0,1
64763,0,1,0,0,1
64764,0,1,0,0,1
64765,0,1,0,0,1
64766,0,1,0,0,1
64767,0,1,0,0,1
64768,0,1,0,0,1
64769,0,1,0,0,1
64770,0,1,0,0,1
64771,0,1,0,0,1
64772,0,1,0,0,1
64773,1,0,0,0,1
64774,0,1,0,0,1
64775,1,0,0,0,1
64776,0,1,0,0,1
64777,0,1,0,0,1
64778,0,1,0,0,1
64779,0,1,0,0,1
64780,0,1,0,0,1
64781,0,1,0,0,1
64782,0,0,0,1,1
64783,0,1,0,0,1
64784,0,1,0,0,1
64785,0,1,0,0,1
64786,0,1,0,0,1
64787,1,0,0,0,1
64788,0,1,0,0,1
64789,0,1,0,0,1
64790,1,0,0,0,1
64791,0,1,0,0,1
64792,0,1,0,0,1
64793,0,1,0,0,1
64794,0,1,0,0,1
64795,0,1,0,0,1
64796,1,0,0,0,1
64797,0,1,0,0,1
64798,0,1,0,0,1
64799,0,1,0,0,1
64800,0,1,0,0,1
64801,0,1,0,0,1
64802,0,1,0,0,1
64803,0,1,0,0,1
64804,0,1,0,0,1
64805,0,1,0,0,1
64806,0,1,0,0,1
64807,0,1,0,0,1
64808,0,1,0,0,1
64809,1,0,0,0,1
64810,0,1,0,0,1
64811,0,1,0,0,1
64812,0,1,0,0,1
64813,0,1,0,0,1
64814,0,1,0,0,1
64815,0,1,0,0,1
64816,0,1,0,0,1
64817,0,0,0,1,1
64818,0,1,0,0,1
64819,0,1,0,0,1
64820,0,1,0,0,1
64821,0,1,0,0,1
64822,1,0,0,0,1
64823,0,1,0,0,1
64824,1,0,0,0,1
64825,0,1,0,0,1
64826,0,1,0,0,1
64827,0,1,0,0,1
64828,0,1,0,0,1
64829,1,0,0,0,1
64830,0,1,0,0,1
64831,0,1,0,0,1
64832,0,0,0,1,1
64833,0,1,0,0,1
64834,1,0,0,0,1
64835,0,1,0,0,1
64836,0,1,0,0,1
64837,0,1,0,0,1
64838,1,0,0,0,1
64839,0,1,0,0,1
64840,0,1,0,0,1
64841,0,1,0,0,1
64842,0,1,0,0,1
64843,1,0,0,0,1
64844,0,1,0,0,1
64845,0,1,0,0,1
64846,0,1,0,0,1
64847,0,1,0,0,1
64848,0,1,0,0,1
64849,0,1,0,0,1
64850,0,1,0,0,1
64851,1,0,0,0,1
64852,0,1,0,0,1
64853,0,1,0,0,1
64854,0,1,0,0,1
64855,0,1,0,0,1
64856,0,0,0,1,1
64857,0,1,0,0,1
64858,1,0,0,0,1
64859,0,1,0,0,1
64860,0,1,0,0,1
64861,0,1,0,0,1
64862,0,0,1,0,1
64863,0,1,0,0,1
64864,0,1,0,0,1
64865,0,1,0,0,1
64866,0,1,0,0,1
64867,0,1,0,0,1
64868,0,1,0,0,1
64869,0,1,0,0,1
64870,1,0,0,0,1
64871,0,1,0,0,1
64872,0,1,0,0,1
64873,1,0,0,0,1
64874,0,1,0,0,1
64875,0,1,0,0,1
64876,0,1,0,0,1
64877,0,1,0,0,1
64878,0,1,0,0,1
64879,1,0,0,0,1
64880,0,1,0,0,1
64881,0,1,0,0,1
64882,0,1,0,0,1
64883,0,0,0,1,1
64884,0,1,0,0,1
64885,0,1,0,0,1
64886,0,1,0,0,1
64887,0,1,0,0,1
64888,0,1,0,0,1
64889,0,1,0,0,1
64890,0,1,0,0,1
64891,0,0,0,1,1
64892,0,1,0,0,1
64893,0,1,0,0,1
64894,0,1,0,0,1
64895,1,0,0,0,1
64896,0,1,0,0,1
64897,0,1,0,0,1
64898,0,1,0,0,1
64899,0,1,0,0,1
64900,0,1,0,0,1
64901,1,0,0,0,1
64902,0,1,0,0,1
64903,0,1,0,0,1
64904,1,0,0,0,1
64905,1,0,0,0,1
64906,0,1,0,0,1
64907,0,1,0,0,1
64908,0,1,0,0,1
64909,0,1,0,0,1
64910,0,1,0,0,1
64911,0,1,0,0,1
64912,0,1,0,0,1
64913,0,0,0,1,1
64914,0,1,0,0,1
64915,0,1,0,0,1
64916,0,1,0,0,1
64917,0,1,0,0,1
64918,0,1,0,0,1
64919,1,0,0,0,1
64920,0,1,0,0,1
64921,0,1,0,0,1
64922,0,1,0,0,1
64923,0,1,0,0,1
64924,0,1,0,0,1
64925,0,1,0,0,1
64926,0,1,0,0,1
64927,0,1,0,0,1
64928,0,1,0,0,1
64929,0,1,0,0,1
64930,0,1,0,0,1
64931,0,1,0,0,1
64932,0,1,0,0,1
64933,0,1,0,0,1
64934,1,0,0,0,1
64935,0,1,0,0,1
64936,0,1,0,0,1
64937,0,1,0,0,1
64938,1,0,0,0,1
64939,0,1,0,0,1
64940,0,1,0,0,1
64941,0,1,0,0,1
64942,0,1,0,0,1
64943,1,0,0,0,1
64944,0,1,0,0,1
64945,0,1,0,0,1
64946,0,1,0,0,1
64947,0,1,0,0,1
64948,0,1,0,0,1
64949,1,0,0,0,1
64950,0,0,1,0,1
64951,0,1,0,0,1
64952,0,1,0,0,1
64953,0,1,0,0,1
64954,0,1,0,0,1
64955,0,1,0,0,1
64956,0,1,0,0,1
64957,0,1,0,0,1
64958,0,1,0,0,1
64959,0,1,0,0,1
64960,1,0,0,0,1
64961,0,1,0,0,1
64962,0,1,0,0,1
64963,0,1,0,0,1
64964,0,1,0,0,1
64965,0,1,0,0,1
64966,0,1,0,0,1
64967,1,0,0,0,1
64968,0,1,0,0,1
64969,0,1,0,0,1
64970,0,1,0,0,1
64971,0,0,1,0,1
64972,0,1,0,0,1
64973,0,1,0,0,1
64974,0,1,0,0,1
64975,0,1,0,0,1
64976,0,1,0,0,1
64977,0,1,0,0,1
64978,0,1,0,0,1
64979,0,1,0,0,1
64980,0,1,0,0,1
64981,0,1,0,0,1
64982,1,0,0,0,1
64983,0,1,0,0,1
64984,0,1,0,0,1
64985,0,1,0,0,1
64986,0,1,0,0,1
64987,0,1,0,0,1
64988,0,1,0,0,1
64989,0,1,0,0,1
64990,0,1,0,0,1
64991,0,1,0,0,1
64992,0,1,0,0,1
64993,0,1,0,0,1
64994,1,0,0,0,1
64995,0,1,0,0,1
64996,1,0,0,0,1
64997,0,1,0,0,1
64998,0,1,0,0,1
64999,0,1,0,0,1
65000,0,1,0,0,1
65001,0,1,0,0,1
65002,0,1,0,0,1
65003,0,1,0,0,1
65004,0,1,0,0,1
65005,1,0,0,0,1
65006,0,1,0,0,1
65007,0,1,0,0,1
65008,0,1,0,0,1
65009,0,1,0,0,1
65010,0,1,0,0,1
65011,0,1,0,0,1
65012,0,1,0,0,1
65013,0,1,0,0,1
65014,0,1,0,0,1
65015,0,1,0,0,1
65016,0,1,0,0,1
65017,1,0,0,0,1
65018,0,1,0,0,1
65019,0,0,0,1,1
65020,0,1,0,0,1
65021,1,0,0,0,1
65022,0,1,0,0,1
65023,0,1,0,0,1
65024,0,1,0,0,1
65025,0,1,0,0,1
65026,0,1,0,0,1
65027,0,1,0,0,1
65028,0,1,0,0,1
65029,0,1,0,0,1
65030,0,1,0,0,1
65031,0,1,0,0,1
65032,1,0,0,0,1
65033,0,1,0,0,1
65034,0,1,0,0,1
65035,0,1,0,0,1
65036,0,1,0,0,1
65037,0,1,0,0,1
65038,0,1,0,0,1
65039,0,1,0,0,1
65040,0,1,0,0,1
65041,0,1,0,0,1
65042,1,0,0,0,1
65043,0,1,0,0,1
65044,0,1,0,0,1
65045,0,0,0,1,1
65046,0,1,0,0,1
65047,0,1,0,0,1
65048,0,1,0,0,1
65049,0,1,0,0,1
65050,0,1,0,0,1
65051,0,1,0,0,1
65052,0,1,0,0,1
65053,1,0,0,0,1
65054,0,1,0,0,1
65055,0,1,0,0,1
65056,0,1,0,0,1
65057,0,1,0,0,1
65058,0,1,0,0,1
65059,0,1,0,0,1
65060,0,1,0,0,1
65061,0,1,0,0,1
65062,0,1,0,0,1
65063,0,1,0,0,1
65064,0,1,0,0,1
65065,0,1,0,0,1
65066,0,1,0,0,1
65067,0,1,0,0,1
65068,0,1,0,0,1
65069,1,0,0,0,1
65070,0,1,0,0,1
65071,0,1,0,0,1
65072,0,1,0,0,1
65073,1,0,0,0,1
65074,0,1,0,0,1
65075,0,1,0,0,1
65076,0,1,0,0,1
65077,1,0,0,0,1
65078,0,0,1,0,1
65079,0,1,0,0,1
65080,0,1,0,0,1
65081,1,0,0,0,1
65082,0,1,0,0,1
65083,0,1,0,0,1
65084,0,1,0,0,1
65085,0,1,0,0,1
65086,0,1,0,0,1
65087,0,1,0,0,1
65088,0,1,0,0,1
65089,0,1,0,0,1
65090,0,1,0,0,1
65091,0,1,0,0,1
65092,0,1,0,0,1
65093,0,1,0,0,1
65094,1,0,0,0,1
65095,0,1,0,0,1
65096,1,0,0,0,1
65097,0,1,0,0,1
65098,0,1,0,0,1
65099,0,1,0,0,1
65100,0,1,0,0,1
65101,0,1,0,0,1
65102,0,1,0,0,1
65103,0,1,0,0,1
65104,0,1,0,0,1
65105,1,0,0,0,1
65106,0,1,0,0,1
65107,0,1,0,0,1
65108,0,1,0,0,1
65109,0,1,0,0,1
65110,0,1,0,0,1
65111,0,1,0,0,1
65112,0,1,0,0,1
65113,1,0,0,0,1
65114,0,1,0,0,1
65115,1,0,0,0,1
65116,0,1,0,0,1
65117,0,1,0,0,1
65118,0,1,0,0,1
65119,0,1,0,0,1
65120,0,1,0,0,1
65121,0,1,0,0,1
65122,0,1,0,0,1
65123,0,1,0,0,1
65124,0,1,0,0,1
65125,0,1,0,0,1
65126,0,1,0,0,1
65127,1,0,0,0,1
65128,0,1,0,0,1
65129,0,1,0,0,1
65130,0,1,0,0,1
65131,1,0,0,0,1
65132,0,1,0,0,1
65133,0,1,0,0,1
65134,1,0,0,0,1
65135,0,1,0,0,1
65136,0,1,0,0,1
65137,0,1,0,0,1
65138,0,1,0,0,1
65139,0,1,0,0,1
65140,0,1,0,0,1
65141,0,1,0,0,1
65142,1,0,0,0,1
65143,0,1,0,0,1
65144,0,1,0,0,1
65145,1,0,0,0,1
65146,0,1,0,0,1
65147,0,1,0,0,1
65148,0,1,0,0,1
65149,0,1,0,0,1
65150,0,1,0,0,1
65151,1,0,0,0,1
65152,0,1,0,0,1
65153,1,0,0,0,1
65154,0,1,0,0,1
65155,0,1,0,0,1
65156,0,1,0,0,1
65157,0,1,0,0,1
65158,0,1,0,0,1
65159,1,0,0,0,1
65160,0,1,0,0,1
65161,0,1,0,0,1
65162,0,1,0,0,1
65163,0,1,0,0,1
65164,0,1,0,0,1
65165,0,1,0,0,1
65166,0,1,0,0,1
65167,0,1,0,0,1
65168,0,1,0,0,1
65169,0,0,0,1,1
65170,0,1,0,0,1
65171,0,1,0,0,1
65172,0,1,0,0,1
65173,1,0,0,0,1
65174,0,1,0,0,1
65175,0,1,0,0,1
65176,0,1,0,0,1
65177,0,1,0,0,1
65178,0,1,0,0,1
65179,0,1,0,0,1
65180,0,1,0,0,1
65181,0,1,0,0,1
65182,0,1,0,0,1
65183,0,0,0,1,1
65184,0,1,0,0,1
65185,0,1,0,0,1
65186,0,1,0,0,1
65187,0,1,0,0,1
65188,0,1,0,0,1
65189,0,1,0,0,1
65190,0,1,0,0,1
65191,0,1,0,0,1
65192,1,0,0,0,1
65193,0,1,0,0,1
65194,1,0,0,0,1
65195,0,1,0,0,1
65196,0,1,0,0,1
65197,0,1,0,0,1
65198,0,1,0,0,1
65199,0,1,0,0,1
65200,0,1,0,0,1
65201,0,1,0,0,1
65202,0,1,0,0,1
65203,0,1,0,0,1
65204,1,0,0,0,1
65205,0,1,0,0,1
65206,0,1,0,0,1
65207,0,1,0,0,1
65208,0,1,0,0,1
65209,0,1,0,0,1
65210,0,1,0,0,1
65211,0,1,0,0,1
65212,0,1,0,0,1
65213,0,1,0,0,1
65214,0,1,0,0,1
65215,0,1,0,0,1
65216,0,1,0,0,1
65217,0,0,1,0,1
65218,0,1,0,0,1
65219,0,0,0,1,1
65220,0,1,0,0,1
65221,0,1,0,0,1
65222,1,0,0,0,1
65223,0,1,0,0,1
65224,0,1,0,0,1
65225,0,1,0,0,1
65226,0,1,0,0,1
65227,0,1,0,0,1
65228,1,0,0,0,1
65229,0,1,0,0,1
65230,0,1,0,0,1
65231,1,0,0,0,1
65232,0,1,0,0,1
65233,0,1,0,0,1
65234,0,1,0,0,1
65235,1,0,0,0,1
65236,0,1,0,0,1
65237,0,1,0,0,1
65238,0,1,0,0,1
65239,0,1,0,0,1
65240,1,0,0,0,1
65241,0,1,0,0,1
65242,0,1,0,0,1
65243,0,1,0,0,1
65244,0,1,0,0,1
65245,0,1,0,0,1
65246,0,1,0,0,1
65247,0,1,0,0,1
65248,1,0,0,0,1
65249,0,1,0,0,1
65250,1,0,0,0,1
65251,0,1,0,0,1
65252,0,1,0,0,1
65253,0,0,1,0,1
65254,1,0,0,0,1
65255,1,0,0,0,1
65256,0,1,0,0,1
65257,0,1,0,0,1
65258,0,1,0,0,1
65259,0,1,0,0,1
65260,0,1,0,0,1
65261,1,0,0,0,1
65262,0,1,0,0,1
65263,0,1,0,0,1
65264,0,1,0,0,1
65265,0,1,0,0,1
65266,0,1,0,0,1
65267,0,0,1,0,1
65268,0,1,0,0,1
65269,0,1,0,0,1
65270,1,0,0,0,1
65271,0,1,0,0,1
65272,0,1,0,0,1
65273,1,0,0,0,1
65274,0,1,0,0,1
65275,0,1,0,0,1
65276,0,1,0,0,1
65277,0,1,0,0,1
65278,0,0,0,1,1
65279,1,0,0,0,1
65280,1,0,0,0,1
65281,0,1,0,0,1
65282,0,1,0,0,1
65283,0,0,0,1,1
65284,0,1,0,0,1
65285,0,1,0,0,1
65286,0,1,0,0,1
65287,0,1,0,0,1
65288,0,1,0,0,1
65289,0,1,0,0,1
65290,0,0,0,1,1
65291,0,1,0,0,1
65292,0,1,0,0,1
65293,0,1,0,0,1
65294,1,0,0,0,1
65295,0,1,0,0,1
65296,1,0,0,0,1
65297,0,1,0,0,1
65298,0,0,0,1,1
65299,0,1,0,0,1
65300,0,1,0,0,1
65301,0,1,0,0,1
65302,0,1,0,0,1
65303,0,1,0,0,1
65304,1,0,0,0,1
65305,0,1,0,0,1
65306,0,1,0,0,1
65307,0,1,0,0,1
65308,0,1,0,0,1
65309,0,1,0,0,1
65310,0,1,0,0,1
65311,0,1,0,0,1
65312,0,1,0,0,1
65313,0,1,0,0,1
65314,0,1,0,0,1
65315,0,0,0,1,1
65316,0,0,0,1,1
65317,1,0,0,0,1
65318,0,1,0,0,1
65319,0,1,0,0,1
65320,1,0,0,0,1
65321,0,1,0,0,1
65322,1,0,0,0,1
65323,0,1,0,0,1
65324,1,0,0,0,1
65325,0,1,0,0,1
65326,0,1,0,0,1
65327,0,1,0,0,1
65328,0,1,0,0,1
65329,0,1,0,0,1
65330,0,1,0,0,1
65331,1,0,0,0,1
65332,0,1,0,0,1
65333,0,1,0,0,1
65334,0,1,0,0,1
65335,0,1,0,0,1
65336,1,0,0,0,1
65337,0,1,0,0,1
65338,0,1,0,0,1
65339,0,1,0,0,1
65340,0,1,0,0,1
65341,0,1,0,0,1
65342,0,0,1,0,1
65343,0,1,0,0,1
65344,0,1,0,0,1
65345,0,1,0,0,1
65346,0,1,0,0,1
65347,0,1,0,0,1
65348,0,1,0,0,1
65349,0,1,0,0,1
65350,0,1,0,0,1
65351,1,0,0,0,1
65352,0,1,0,0,1
65353,1,0,0,0,1
65354,0,1,0,0,1
65355,0,1,0,0,1
65356,1,0,0,0,1
65357,0,1,0,0,1
65358,0,1,0,0,1
65359,0,1,0,0,1
65360,0,1,0,0,1
65361,0,1,0,0,1
65362,1,0,0,0,1
65363,0,1,0,0,1
65364,0,1,0,0,1
65365,0,1,0,0,1
65366,1,0,0,0,1
65367,0,1,0,0,1
65368,1,0,0,0,1
65369,0,0,0,1,1
65370,1,0,0,0,1
65371,0,1,0,0,1
65372,0,1,0,0,1
65373,0,1,0,0,1
65374,0,1,0,0,1
65375,0,1,0,0,1
65376,0,1,0,0,1
65377,0,1,0,0,1
65378,0,1,0,0,1
65379,0,1,0,0,1
65380,1,0,0,0,1
65381,0,1,0,0,1
65382,0,1,0,0,1
65383,0,1,0,0,1
65384,1,0,0,0,1
65385,0,1,0,0,1
65386,0,1,0,0,1
65387,0,1,0,0,1
65388,0,1,0,0,1
65389,1,0,0,0,1
65390,0,1,0,0,1
65391,0,1,0,0,1
65392,0,1,0,0,1
65393,0,1,0,0,1
65394,0,1,0,0,1
65395,0,1,0,0,1
65396,0,1,0,0,1
65397,0,1,0,0,1
65398,0,0,1,0,1
65399,0,1,0,0,1
65400,0,1,0,0,1
65401,0,1,0,0,1
65402,0,1,0,0,1
65403,0,1,0,0,1
65404,0,1,0,0,1
65405,0,1,0,0,1
65406,0,1,0,0,1
65407,0,1,0,0,1
65408,1,0,0,0,1
65409,0,1,0,0,1
65410,0,1,0,0,1
65411,0,1,0,0,1
65412,0,1,0,0,1
65413,0,1,0,0,1
65414,0,1,0,0,1
65415,0,1,0,0,1
65416,0,1,0,0,1
65417,0,1,0,0,1
65418,0,1,0,0,1
65419,0,1,0,0,1
65420,0,1,0,0,1
65421,0,1,0,0,1
65422,0,1,0,0,1
65423,1,0,0,0,1
65424,0,1,0,0,1
65425,0,1,0,0,1
65426,0,1,0,0,1
65427,0,1,0,0,1
65428,0,1,0,0,1
65429,0,1,0,0,1
65430,0,1,0,0,1
65431,0,1,0,0,1
65432,0,1,0,0,1
65433,1,0,0,0,1
65434,0,1,0,0,1
65435,1,0,0,0,1
65436,0,1,0,0,1
65437,0,1,0,0,1
65438,0,1,0,0,1
65439,0,1,0,0,1
65440,0,1,0,0,1
65441,0,1,0,0,1
65442,0,1,0,0,1
65443,0,0,1,0,1
65444,0,0,1,0,1
65445,0,1,0,0,1
65446,0,1,0,0,1
65447,0,1,0,0,1
65448,0,1,0,0,1
65449,0,1,0,0,1
65450,0,0,0,1,1
65451,0,1,0,0,1
65452,0,1,0,0,1
65453,0,0,0,1,1
65454,0,1,0,0,1
65455,1,0,0,0,1
65456,0,1,0,0,1
65457,0,1,0,0,1
65458,0,1,0,0,1
65459,0,1,0,0,1
65460,0,1,0,0,1
65461,0,1,0,0,1
65462,0,1,0,0,1
65463,0,0,0,1,1
65464,0,1,0,0,1
65465,0,1,0,0,1
65466,1,0,0,0,1
65467,0,1,0,0,1
65468,0,1,0,0,1
65469,0,1,0,0,1
65470,0,1,0,0,1
65471,0,1,0,0,1
65472,0,1,0,0,1
65473,0,1,0,0,1
65474,0,1,0,0,1
65475,0,1,0,0,1
65476,0,1,0,0,1
65477,0,1,0,0,1
65478,0,1,0,0,1
65479,0,1,0,0,1
65480,0,1,0,0,1
65481,0,1,0,0,1
65482,1,0,0,0,1
65483,0,1,0,0,1
65484,0,1,0,0,1
65485,0,1,0,0,1
65486,0,1,0,0,1
65487,1,0,0,0,1
65488,0,1,0,0,1
65489,0,1,0,0,1
65490,0,1,0,0,1
65491,0,1,0,0,1
65492,0,1,0,0,1
65493,0,1,0,0,1
65494,0,1,0,0,1
65495,1,0,0,0,1
65496,0,1,0,0,1
65497,0,1,0,0,1
65498,0,1,0,0,1
65499,0,1,0,0,1
65500,0,1,0,0,1
65501,0,1,0,0,1
65502,0,1,0,0,1
65503,0,1,0,0,1
65504,1,0,0,0,1
65505,0,1,0,0,1
65506,1,0,0,0,1
65507,0,1,0,0,1
65508,0,1,0,0,1
65509,0,1,0,0,1
65510,0,1,0,0,1
65511,0,1,0,0,1
65512,0,1,0,0,1
65513,0,1,0,0,1
65514,0,1,0,0,1
65515,0,1,0,0,1
65516,0,1,0,0,1
65517,1,0,0,0,1
65518,0,1,0,0,1
65519,0,1,0,0,1
65520,0,0,1,0,1
65521,0,1,0,0,1
65522,0,1,0,0,1
65523,0,1,0,0,1
65524,0,1,0,0,1
65525,0,1,0,0,1
65526,0,1,0,0,1
65527,0,1,0,0,1
65528,0,1,0,0,1
65529,0,1,0,0,1
65530,0,0,0,1,1
65531,0,1,0,0,1
65532,1,0,0,0,1
65533,0,1,0,0,1
65534,0,1,0,0,1
65535,0,1,0,0,1
65536,0,1,0,0,1
65537,1,0,0,0,1
65538,0,1,0,0,1
65539,0,1,0,0,1
65540,0,1,0,0,1
65541,0,1,0,0,1
65542,0,1,0,0,1
65543,0,1,0,0,1
65544,0,1,0,0,1
65545,0,1,0,0,1
65546,0,1,0,0,1
65547,0,1,0,0,1
65548,0,1,0,0,1
65549,0,1,0,0,1
65550,0,1,0,0,1
65551,0,0,0,1,1
65552,0,1,0,0,1
65553,0,1,0,0,1
65554,0,1,0,0,1
65555,0,1,0,0,1
65556,0,1,0,0,1
65557,0,1,0,0,1
65558,0,1,0,0,1
65559,0,1,0,0,1
65560,0,1,0,0,1
65561,0,1,0,0,1
65562,0,1,0,0,1
65563,0,1,0,0,1
65564,0,1,0,0,1
65565,0,1,0,0,1
65566,0,1,0,0,1
65567,0,1,0,0,1
65568,0,1,0,0,1
65569,0,1,0,0,1
65570,0,1,0,0,1
65571,0,1,0,0,1
65572,0,1,0,0,1
65573,0,1,0,0,1
65574,0,1,0,0,1
65575,0,1,0,0,1
65576,0,1,0,0,1
65577,1,0,0,0,1
65578,0,1,0,0,1
65579,0,1,0,0,1
65580,1,0,0,0,1
65581,1,0,0,0,1
65582,1,0,0,0,1
65583,0,1,0,0,1
65584,1,0,0,0,1
65585,0,1,0,0,1
65586,0,1,0,0,1
65587,0,1,0,0,1
65588,0,0,0,1,1
65589,0,1,0,0,1
65590,0,1,0,0,1
65591,0,1,0,0,1
65592,0,1,0,0,1
65593,0,1,0,0,1
65594,0,1,0,0,1
65595,0,1,0,0,1
65596,0,1,0,0,1
65597,0,1,0,0,1
65598,0,1,0,0,1
65599,1,0,0,0,1
65600,1,0,0,0,1
65601,0,1,0,0,1
65602,0,1,0,0,1
65603,0,1,0,0,1
65604,0,1,0,0,1
65605,1,0,0,0,1
65606,0,1,0,0,1
65607,0,1,0,0,1
65608,0,1,0,0,1
65609,0,1,0,0,1
65610,0,1,0,0,1
65611,0,1,0,0,1
65612,1,0,0,0,1
65613,0,1,0,0,1
65614,1,0,0,0,1
65615,0,1,0,0,1
65616,1,0,0,0,1
65617,0,1,0,0,1
65618,0,0,0,1,1
65619,0,1,0,0,1
65620,0,1,0,0,1
65621,0,0,1,0,1
65622,0,1,0,0,1
65623,0,1,0,0,1
65624,0,1,0,0,1
65625,0,1,0,0,1
65626,0,0,0,1,1
65627,0,1,0,0,1
65628,0,1,0,0,1
65629,0,1,0,0,1
65630,1,0,0,0,1
65631,0,1,0,0,1
65632,0,1,0,0,1
65633,1,0,0,0,1
65634,0,1,0,0,1
65635,0,1,0,0,1
65636,0,1,0,0,1
65637,0,1,0,0,1
65638,0,1,0,0,1
65639,0,1,0,0,1
65640,0,1,0,0,1
65641,0,1,0,0,1
65642,0,1,0,0,1
65643,0,1,0,0,1
65644,0,1,0,0,1
65645,0,1,0,0,1
65646,0,1,0,0,1
65647,0,1,0,0,1
65648,0,1,0,0,1
65649,0,1,0,0,1
65650,0,1,0,0,1
65651,0,1,0,0,1
65652,1,0,0,0,1
65653,1,0,0,0,1
65654,0,1,0,0,1
65655,0,1,0,0,1
65656,0,1,0,0,1
65657,0,1,0,0,1
65658,0,1,0,0,1
65659,0,1,0,0,1
65660,0,1,0,0,1
65661,0,1,0,0,1
65662,1,0,0,0,1
65663,0,1,0,0,1
65664,0,1,0,0,1
65665,0,1,0,0,1
65666,0,1,0,0,1
65667,0,1,0,0,1
65668,0,1,0,0,1
65669,0,1,0,0,1
65670,0,1,0,0,1
65671,0,1,0,0,1
65672,0,1,0,0,1
65673,1,0,0,0,1
65674,0,1,0,0,1
65675,0,1,0,0,1
65676,0,1,0,0,1
65677,0,1,0,0,1
65678,0,1,0,0,1
65679,0,1,0,0,1
65680,0,1,0,0,1
65681,1,0,0,0,1
65682,1,0,0,0,1
65683,0,1,0,0,1
65684,0,1,0,0,1
65685,0,1,0,0,1
65686,0,1,0,0,1
65687,0,0,0,1,1
65688,0,1,0,0,1
65689,0,1,0,0,1
65690,1,0,0,0,1
65691,0,1,0,0,1
65692,0,1,0,0,1
65693,0,1,0,0,1
65694,0,1,0,0,1
65695,0,1,0,0,1
65696,0,1,0,0,1
65697,0,1,0,0,1
65698,0,1,0,0,1
65699,0,1,0,0,1
65700,0,1,0,0,1
65701,0,1,0,0,1
65702,0,1,0,0,1
65703,0,1,0,0,1
65704,1,0,0,0,1
65705,0,1,0,0,1
65706,0,1,0,0,1
65707,0,1,0,0,1
65708,0,1,0,0,1
65709,0,1,0,0,1
65710,0,1,0,0,1
65711,0,1,0,0,1
65712,0,1,0,0,1
65713,0,1,0,0,1
65714,0,1,0,0,1
65715,0,1,0,0,1
65716,0,1,0,0,1
65717,0,1,0,0,1
65718,1,0,0,0,1
65719,1,0,0,0,1
65720,0,1,0,0,1
65721,0,1,0,0,1
65722,0,1,0,0,1
65723,1,0,0,0,1
65724,0,0,1,0,1
65725,1,0,0,0,1
65726,0,1,0,0,1
65727,0,1,0,0,1
65728,0,1,0,0,1
65729,1,0,0,0,1
65730,1,0,0,0,1
65731,0,1,0,0,1
65732,0,1,0,0,1
65733,0,1,0,0,1
65734,0,1,0,0,1
65735,0,1,0,0,1
65736,1,0,0,0,1
65737,0,1,0,0,1
65738,0,1,0,0,1
65739,1,0,0,0,1
65740,0,1,0,0,1
65741,0,1,0,0,1
65742,0,1,0,0,1
65743,0,1,0,0,1
65744,0,1,0,0,1
65745,0,1,0,0,1
65746,0,1,0,0,1
65747,0,1,0,0,1
65748,0,1,0,0,1
65749,0,1,0,0,1
65750,0,1,0,0,1
65751,1,0,0,0,1
65752,0,1,0,0,1
65753,0,1,0,0,1
65754,1,0,0,0,1
65755,0,1,0,0,1
65756,1,0,0,0,1
65757,0,1,0,0,1
65758,0,1,0,0,1
65759,0,1,0,0,1
65760,0,1,0,0,1
65761,0,1,0,0,1
65762,1,0,0,0,1
65763,1,0,0,0,1
65764,1,0,0,0,1
65765,0,1,0,0,1
65766,0,1,0,0,1
65767,1,0,0,0,1
65768,0,1,0,0,1
65769,1,0,0,0,1
65770,0,1,0,0,1
65771,0,1,0,0,1
65772,0,1,0,0,1
65773,0,1,0,0,1
65774,0,1,0,0,1
65775,1,0,0,0,1
65776,0,1,0,0,1
65777,0,1,0,0,1
65778,0,1,0,0,1
65779,0,1,0,0,1
65780,0,1,0,0,1
65781,0,1,0,0,1
65782,0,1,0,0,1
65783,0,1,0,0,1
65784,0,1,0,0,1
65785,0,0,1,0,1
65786,0,1,0,0,1
65787,0,1,0,0,1
65788,1,0,0,0,1
65789,0,1,0,0,1
65790,0,1,0,0,1
65791,0,1,0,0,1
65792,0,1,0,0,1
65793,0,1,0,0,1
65794,0,1,0,0,1
65795,0,1,0,0,1
65796,0,0,0,1,1
65797,1,0,0,0,1
65798,0,1,0,0,1
65799,1,0,0,0,1
65800,0,1,0,0,1
65801,0,1,0,0,1
65802,0,1,0,0,1
65803,0,1,0,0,1
65804,0,1,0,0,1
65805,0,1,0,0,1
65806,0,1,0,0,1
65807,0,1,0,0,1
65808,0,1,0,0,1
65809,0,0,0,1,1
65810,0,1,0,0,1
65811,0,1,0,0,1
65812,0,1,0,0,1
65813,0,1,0,0,1
65814,0,1,0,0,1
65815,0,1,0,0,1
65816,0,0,0,1,1
65817,0,1,0,0,1
65818,0,1,0,0,1
65819,0,1,0,0,1
65820,0,0,0,1,1
65821,1,0,0,0,1
65822,0,1,0,0,1
65823,0,1,0,0,1
65824,0,1,0,0,1
65825,0,1,0,0,1
65826,0,0,0,1,1
65827,1,0,0,0,1
65828,0,1,0,0,1
65829,0,1,0,0,1
65830,0,1,0,0,1
65831,0,1,0,0,1
65832,0,1,0,0,1
65833,1,0,0,0,1
65834,0,1,0,0,1
65835,0,1,0,0,1
65836,0,1,0,0,1
65837,1,0,0,0,1
65838,0,1,0,0,1
65839,1,0,0,0,1
65840,0,1,0,0,1
65841,0,1,0,0,1
65842,0,1,0,0,1
65843,1,0,0,0,1
65844,0,0,1,0,1
65845,0,1,0,0,1
65846,0,1,0,0,1
65847,0,1,0,0,1
65848,1,0,0,0,1
65849,0,1,0,0,1
65850,1,0,0,0,1
65851,1,0,0,0,1
65852,0,0,1,0,1
